index,base_salary,bonus_total,name,position,roster_status,team,total_money,year
0,5250000,1750000,Edgerrin James,RB,active,arizona-cardinals,7000000,2007
1,3580000,3262000,Larry Fitzgerald,WR,active,arizona-cardinals,6842000,2007
2,4500000,900000,Chike Okeafor,G,active,arizona-cardinals,5400000,2007
3,4000000,1000000,Kurt Warner,QB,active,arizona-cardinals,5000000,2007
4,510000,3500000,Darnell Dockett,DE,active,arizona-cardinals,4010000,2007
5,2000000,3000000,Anquan Boldin,WR,active,arizona-cardinals,5000000,2007
6,2430000,3104000,Antrel Rolle,SS,active,arizona-cardinals,5534000,2007
7,1000000,600000,Reggie Wells,G,active,arizona-cardinals,1600000,2007
8,1800000,700000,Oliver Ross,T,active,arizona-cardinals,2500000,2007
9,285000,1925000,Levi Brown,LT,active,arizona-cardinals,2210000,2007
10,811250,1650000,Calvin Pace,OLB,active,arizona-cardinals,2461250,2007
11,751250,1247500,Bryant Johnson,WR,active,arizona-cardinals,1998750,2007
12,894000,525000,Karlos Dansby,ILB,active,arizona-cardinals,1419000,2007
13,600000,800000,Mike Gandy,T,active,arizona-cardinals,1400000,2007
14,650000,300000,Monty Beisel,LB,active,arizona-cardinals,950000,2007
15,435000,459375,J.J. Arrington,RB,active,arizona-cardinals,894375,2007
16,360000,496250,Taitusi Lutui,G,active,arizona-cardinals,856250,2007
17,800000,0,Neil Rackers,K,active,arizona-cardinals,800000,2007
18,285000,500000,Alan Branch,DT,active,arizona-cardinals,785000,2007
19,435000,185667,Eric Green,CB,active,arizona-cardinals,620667,2007
20,435000,146333,Darryl Blackstock,LB,active,arizona-cardinals,581333,2007
21,360000,192667,Leonard Pope,TE,active,arizona-cardinals,552667,2007
22,435000,114167,Elton Brown,G,active,arizona-cardinals,549167,2007
23,510000,0,Oliver Celestin,S,active,arizona-cardinals,510000,2007
24,510000,0,Antonio Smith,DE,active,arizona-cardinals,510000,2007
25,510000,0,Matt Ware,CB,active,arizona-cardinals,510000,2007
26,360000,115833,Gabe Watson,DT,active,arizona-cardinals,475833,2007
27,720000,0,Ralph Brown,CB,active,arizona-cardinals,720000,2007
28,595000,0,Rodney Bailey,DE,active,arizona-cardinals,595000,2007
29,360000,0,Brandon Johnson,LB,active,arizona-cardinals,360000,2007
30,285000,47083,Steve Breaston,WR,active,arizona-cardinals,332083,2007
31,285000,16645,Ben Patrick,TE,active,arizona-cardinals,301645,2007
32,285000,6250,Lyle Sendlein,C,active,arizona-cardinals,291250,2007
33,285000,1750,Michael Adams,S,active,arizona-cardinals,286750,2007
34,285000,1500,Tim Castille,RB,active,arizona-cardinals,286500,2007
35,285000,0,Troy Bienemann,TE,active,arizona-cardinals,285000,2007
36,285000,0,Quentin Moses,DE,active,arizona-cardinals,285000,2007
37,241176,0,Mitch Berger,P,active,arizona-cardinals,241176,2007
38,201176,0,Mike Barr,P,active,arizona-cardinals,201176,2007
39,0,130000,Obafemi Ayanbadejo,FB,active,arizona-cardinals,130000,2007
40,79900,0,Scott Peters,C,active,arizona-cardinals,79900,2007
41,16764,0,David Holloway,LB,active,arizona-cardinals,16764,2007
42,16176,0,Shane Boyd,QB,active,arizona-cardinals,16176,2007
43,4000000,1000000,Bertrand Berry,DE,injured_reserve,arizona-cardinals,5000000,2007
44,4000000,900000,Adrian Wilson,S,injured_reserve,arizona-cardinals,4900000,2007
45,2760000,3030000,Matt Leinart,QB,injured_reserve,arizona-cardinals,5790000,2007
46,79900,0,David Holloway,LB,practice_squad,arizona-cardinals,79900,2007
47,14100,0,Matt Baker,QB,practice_squad,arizona-cardinals,14100,2007
48,0,750000,Milford Brown,G,dead_cap,arizona-cardinals,750000,2007
49,0,500000,Kendrick Clancy,DT,dead_cap,arizona-cardinals,500000,2007
50,385882,0,Brad Badger,G,dead_cap,arizona-cardinals,385882,2007
51,203333,0,Buster Davis,LB,dead_cap,arizona-cardinals,203333,2007
52,91964,1750,Michael Adams,S,dead_cap,arizona-cardinals,93714,2007
53,79900,1000,Steve Baylark,RB,dead_cap,arizona-cardinals,80900,2007
54,42300,6000,Travarous Bain,CB,dead_cap,arizona-cardinals,48300,2007
55,44150,0,Brandon Johnson,LB,dead_cap,arizona-cardinals,44150,2007
56,41298,0,Todd Watkins,WR,dead_cap,arizona-cardinals,41298,2007
57,36166,0,Lance Mitchell,LB,dead_cap,arizona-cardinals,36166,2007
58,27067,0,Jonathan Lewis,DT,dead_cap,arizona-cardinals,27067,2007
59,23500,0,Lang Campbell,QB,dead_cap,arizona-cardinals,23500,2007
60,14833,0,Ben Patrick,TE,dead_cap,arizona-cardinals,14833,2007
61,13333,0,LeRon McCoy,WR,dead_cap,arizona-cardinals,13333,2007
62,6000,0,David Holloway,LB,dead_cap,arizona-cardinals,6000,2007
63,8065000,0,Karlos Dansby,ILB,active,arizona-cardinals,8065000,2008
64,2100000,6262000,Larry Fitzgerald,WR,active,arizona-cardinals,8362000,2008
65,3500000,3300000,Mike Gandy,T,active,arizona-cardinals,6800000,2008
66,5000000,1750000,Edgerrin James,RB,active,arizona-cardinals,6750000,2008
67,370000,8710000,Levi Brown,LT,active,arizona-cardinals,9080000,2008
68,4000000,2000000,Kurt Warner,QB,active,arizona-cardinals,6000000,2008
69,4750000,900000,Adrian Wilson,S,active,arizona-cardinals,5650000,2008
70,4500000,900000,Chike Okeafor,G,active,arizona-cardinals,5400000,2008
71,2500000,3000000,Anquan Boldin,WR,active,arizona-cardinals,5500000,2008
72,1100000,600000,Reggie Wells,G,active,arizona-cardinals,1700000,2008
73,3250000,0,Darnell Dockett,DE,active,arizona-cardinals,3250000,2008
74,1210000,3104000,Antrel Rolle,SS,active,arizona-cardinals,4314000,2008
75,735000,3030000,Matt Leinart,QB,active,arizona-cardinals,3765000,2008
76,2017000,0,Antonio Smith,DE,active,arizona-cardinals,2017000,2008
77,1000000,1000000,Bertrand Berry,DE,active,arizona-cardinals,2000000,2008
78,750000,1150000,Travis LaBoy,DT,active,arizona-cardinals,1900000,2008
79,295000,1090000,Dominique Rodgers-Cromartie,CB,active,arizona-cardinals,1385000,2008
80,1000000,350000,Clark Haggans,LB,active,arizona-cardinals,1350000,2008
81,850000,350000,Bryan Robinson,DE,active,arizona-cardinals,1200000,2008
82,520000,459375,J.J. Arrington,RB,active,arizona-cardinals,979375,2008
83,445000,496250,Taitusi Lutui,G,active,arizona-cardinals,941250,2008
84,730000,200000,Jerame Tuman,TE,active,arizona-cardinals,930000,2008
85,927000,0,Elton Brown,G,active,arizona-cardinals,927000,2008
86,900000,0,Monty Beisel,LB,active,arizona-cardinals,900000,2008
87,370000,500000,Alan Branch,DT,active,arizona-cardinals,870000,2008
88,800000,0,Neil Rackers,K,active,arizona-cardinals,800000,2008
89,605000,125000,Matt Ware,CB,active,arizona-cardinals,730000,2008
90,445000,192667,Leonard Pope,TE,active,arizona-cardinals,637667,2008
91,605000,0,Victor Hobson,LB,active,arizona-cardinals,605000,2008
92,295000,300000,Calais Campbell,DE,active,arizona-cardinals,595000,2008
93,445000,115833,Gabe Watson,DT,active,arizona-cardinals,560833,2008
94,295000,183333,Early Doucet,WR,active,arizona-cardinals,478333,2008
95,730000,0,Ralph Brown,CB,active,arizona-cardinals,730000,2008
96,605000,20000,Brian St. Pierre,QB,active,arizona-cardinals,625000,2008
97,370000,47083,Steve Breaston,WR,active,arizona-cardinals,417083,2008
98,295000,115050,Kenny Iwebema,DE,active,arizona-cardinals,410050,2008
99,370000,16645,Ben Patrick,TE,active,arizona-cardinals,386645,2008
100,370000,6250,Lyle Sendlein,C,active,arizona-cardinals,376250,2008
101,370000,1750,Michael Adams,S,active,arizona-cardinals,371750,2008
102,370000,1500,Tim Castille,RB,active,arizona-cardinals,371500,2008
103,295000,45166,Tim Hightower,RB,active,arizona-cardinals,340166,2008
104,295000,13500,Brandon Keith,RT,active,arizona-cardinals,308500,2008
105,295000,6250,Dennis Keyes,S,active,arizona-cardinals,301250,2008
106,295000,0,Pat Ross,C,active,arizona-cardinals,295000,2008
107,445000,0,Herana-Daze Jones,S,active,arizona-cardinals,445000,2008
108,320000,20000,Oliver Ross,T,active,arizona-cardinals,340000,2008
109,249117,0,Oliver Celestin,S,active,arizona-cardinals,249117,2008
110,88400,0,Chris Harrington,DE,active,arizona-cardinals,88400,2008
111,270000,0,Scott Peters,C,injured_reserve,arizona-cardinals,270000,2008
112,88400,0,Keilen Dykes,DE,practice_squad,arizona-cardinals,88400,2008
113,88400,0,Wilrey Fontenot,CB,practice_squad,arizona-cardinals,88400,2008
114,88400,0,Onrea Jones,WR,practice_squad,arizona-cardinals,88400,2008
115,88400,0,Dennis Keyes,S,practice_squad,arizona-cardinals,88400,2008
116,0,1500000,Milford Brown,G,dead_cap,arizona-cardinals,1500000,2008
117,1400000,0,Oliver Ross,T,dead_cap,arizona-cardinals,1400000,2008
118,0,1000000,Kendrick Clancy,DT,dead_cap,arizona-cardinals,1000000,2008
119,406666,0,Buster Davis,LB,dead_cap,arizona-cardinals,406666,2008
120,171223,1750,Michael Adams,S,dead_cap,arizona-cardinals,172973,2008
121,44150,0,Brandon Johnson,LB,dead_cap,arizona-cardinals,44150,2008
122,29666,0,Ben Patrick,TE,dead_cap,arizona-cardinals,29666,2008
123,27067,0,Jonathan Lewis,DT,dead_cap,arizona-cardinals,27067,2008
124,24333,0,Chris Harrington,DE,dead_cap,arizona-cardinals,24333,2008
125,10400,0,Jason Banks,DE,dead_cap,arizona-cardinals,10400,2008
126,6250,0,Dennis Keyes,S,dead_cap,arizona-cardinals,6250,2008
127,0,6000,Travarous Bain,CB,dead_cap,arizona-cardinals,6000,2008
128,6000,0,David Holloway,LB,dead_cap,arizona-cardinals,6000,2008
129,0,2000,Steve Baylark,RB,dead_cap,arizona-cardinals,2000,2008
130,0,1500,Marcus Brown,CB,dead_cap,arizona-cardinals,1500,2008
131,4000000,7500000,Kurt Warner,QB,active,arizona-cardinals,11500000,2009
132,1600000,11912000,Larry Fitzgerald,WR,active,arizona-cardinals,13512000,2009
133,9678000,0,Karlos Dansby,ILB,active,arizona-cardinals,9678000,2009
134,5500000,800000,Adrian Wilson,S,active,arizona-cardinals,6300000,2009
135,4500000,900000,Chike Okeafor,G,active,arizona-cardinals,5400000,2009
136,3565000,3104000,Antrel Rolle,SS,active,arizona-cardinals,6669000,2009
137,2750000,3000000,Anquan Boldin,WR,active,arizona-cardinals,5750000,2009
138,3750000,0,Bryant McFadden,CB,active,arizona-cardinals,3750000,2009
139,385000,4420000,Dominique Rodgers-Cromartie,CB,active,arizona-cardinals,4805000,2009
140,3500000,0,Darnell Dockett,DE,active,arizona-cardinals,3500000,2009
141,2300000,600000,Reggie Wells,G,active,arizona-cardinals,2900000,2009
142,672500,5035000,Levi Brown,LT,active,arizona-cardinals,5707500,2009
143,1110000,3030000,Matt Leinart,QB,active,arizona-cardinals,4140000,2009
144,1545000,0,Gabe Watson,DT,active,arizona-cardinals,1545000,2009
145,1000000,250000,Bertrand Berry,DE,active,arizona-cardinals,1250000,2009
146,790000,400000,Beanie Wells,RB,active,arizona-cardinals,1190000,2009
147,1100000,0,Neil Rackers,K,active,arizona-cardinals,1100000,2009
148,535000,496250,Taitusi Lutui,G,active,arizona-cardinals,1031250,2009
149,800000,200000,Brian St. Pierre,QB,active,arizona-cardinals,1000000,2009
150,460000,500000,Alan Branch,DT,active,arizona-cardinals,960000,2009
151,675000,225000,Jason Wright,RB,active,arizona-cardinals,900000,2009
152,745000,150000,Mike Leach,LS,active,arizona-cardinals,895000,2009
153,385000,300000,Calais Campbell,DE,active,arizona-cardinals,685000,2009
154,385000,183333,Early Doucet,WR,active,arizona-cardinals,568333,2009
155,535000,0,Justin Green,RB,active,arizona-cardinals,535000,2009
156,460000,47083,Steve Breaston,WR,active,arizona-cardinals,507083,2009
157,385000,115050,Kenny Iwebema,DE,active,arizona-cardinals,500050,2009
158,310000,163000,Rashad Johnson,FS,active,arizona-cardinals,473000,2009
159,745000,50000,Anthony Becht,TE,active,arizona-cardinals,795000,2009
160,745000,0,Ralph Brown,CB,active,arizona-cardinals,745000,2009
161,745000,0,Dan Kreider,RB,active,arizona-cardinals,745000,2009
162,620000,0,Hamza Abdullah,CB,active,arizona-cardinals,620000,2009
163,620000,0,Jeremy Bridges,G,active,arizona-cardinals,620000,2009
164,460000,0,Michael Adams,S,active,arizona-cardinals,460000,2009
165,460000,0,Lyle Sendlein,C,active,arizona-cardinals,460000,2009
166,620000,0,Keith Lewis,S,active,arizona-cardinals,620000,2009
167,385000,45166,Tim Hightower,RB,active,arizona-cardinals,430166,2009
168,310000,105333,Greg Toler,CB,active,arizona-cardinals,415333,2009
169,385000,13500,Brandon Keith,RT,active,arizona-cardinals,398500,2009
170,385000,0,Ben Claxton,C,active,arizona-cardinals,385000,2009
171,310000,39333,Herman Johnson,T,active,arizona-cardinals,349333,2009
172,345000,0,Ben Patrick,TE,active,arizona-cardinals,345000,2009
173,310000,21972,Will Davis,LB,active,arizona-cardinals,331972,2009
174,310000,12500,LaRod Stephens-Howling,RB,active,arizona-cardinals,322500,2009
175,310000,8825,Trevor Canfield,G,active,arizona-cardinals,318825,2009
176,310000,4000,Reggie Walker,ILB,active,arizona-cardinals,314000,2009
177,310000,0,Jaymar Johnson,WR,active,arizona-cardinals,310000,2009
178,262941,0,Monty Beisel,LB,active,arizona-cardinals,262941,2009
179,72941,0,Keilen Dykes,DE,active,arizona-cardinals,72941,2009
180,54117,0,Pago Togafu,LB,active,arizona-cardinals,54117,2009
181,36470,0,Eric Brock,S,active,arizona-cardinals,36470,2009
182,18235,0,Jason Banks,DE,active,arizona-cardinals,18235,2009
183,500000,0,Ben Graham,P,active,arizona-cardinals,500000,2009
184,5000000,800000,Mike Gandy,T,injured_reserve,arizona-cardinals,5800000,2009
185,625000,0,Matt Ware,CB,injured_reserve,arizona-cardinals,625000,2009
186,310000,239000,Cody Brown,DE,injured_reserve,arizona-cardinals,549000,2009
187,88400,0,Keilen Dykes,DE,practice_squad,arizona-cardinals,88400,2009
188,88400,0,Pago Togafu,LB,practice_squad,arizona-cardinals,88400,2009
189,88400,0,Mark Washington,LB,practice_squad,arizona-cardinals,88400,2009
190,6100000,0,Travis LaBoy,DT,dead_cap,arizona-cardinals,6100000,2009
191,1750000,0,Edgerrin James,RB,dead_cap,arizona-cardinals,1750000,2009
192,297647,0,Dominique Byrd,T,dead_cap,arizona-cardinals,297647,2009
193,83200,8825,Trevor Canfield,G,dead_cap,arizona-cardinals,92025,2009
194,88400,0,Rashad Barksdale,CB,dead_cap,arizona-cardinals,88400,2009
195,48666,0,Chris Harrington,DE,dead_cap,arizona-cardinals,48666,2009
196,26000,0,Jason Banks,DE,dead_cap,arizona-cardinals,26000,2009
197,8693,0,Chansi Stuckey,WR,dead_cap,arizona-cardinals,8693,2009
198,6250,0,Dennis Keyes,S,dead_cap,arizona-cardinals,6250,2009
199,0,1500,Marcus Brown,CB,dead_cap,arizona-cardinals,1500,2009
200,6150000,5500000,Larry Fitzgerald,WR,active,arizona-cardinals,11650000,2010
201,6500000,1050000,Adrian Wilson,S,active,arizona-cardinals,7550000,2010
202,3225000,5035000,Levi Brown,LT,active,arizona-cardinals,8260000,2010
203,2780000,2250000,Kerry Rhodes,S,active,arizona-cardinals,5030000,2010
204,5000000,0,Bryant McFadden,CB,active,arizona-cardinals,5000000,2010
205,4550000,0,Darnell Dockett,DE,active,arizona-cardinals,4550000,2010
206,2400000,600000,Reggie Wells,G,active,arizona-cardinals,3000000,2010
207,1250000,1583333,Joey Porter,LB,active,arizona-cardinals,2833333,2010
208,2000000,500000,Alan Faneca,G,active,arizona-cardinals,2500000,2010
209,2396000,0,Steve Breaston,WR,active,arizona-cardinals,2396000,2010
210,1800000,250000,Rex Hadnot,G,active,arizona-cardinals,2050000,2010
211,650000,1447500,Derek Anderson,QB,active,arizona-cardinals,2097500,2010
212,730000,2220000,Dominique Rodgers-Cromartie,CB,active,arizona-cardinals,2950000,2010
213,550000,1250000,Alan Branch,DT,active,arizona-cardinals,1800000,2010
214,1759000,0,Taitusi Lutui,G,active,arizona-cardinals,1759000,2010
215,1759000,0,Gabe Watson,DT,active,arizona-cardinals,1759000,2010
216,1684000,0,Ben Patrick,TE,active,arizona-cardinals,1684000,2010
217,1684000,0,Lyle Sendlein,C,active,arizona-cardinals,1684000,2010
218,1000000,500000,Jay Feely,K,active,arizona-cardinals,1500000,2010
219,425000,1525000,Beanie Wells,RB,active,arizona-cardinals,1950000,2010
220,1000000,366666,Jeremy Bridges,G,active,arizona-cardinals,1366666,2010
221,320000,940000,Dan Williams,DT,active,arizona-cardinals,1260000,2010
222,1101000,0,Brandon McDonald,CB,active,arizona-cardinals,1101000,2010
223,1075000,25000,Jason Wright,RB,active,arizona-cardinals,1100000,2010
224,900000,166667,Paris Lenon,ILB,active,arizona-cardinals,1066667,2010
225,930000,25000,Mike Leach,LS,active,arizona-cardinals,955000,2010
226,470000,378450,Calais Campbell,DE,active,arizona-cardinals,848450,2010
227,630000,192500,Matt Ware,CB,active,arizona-cardinals,822500,2010
228,320000,418750,Daryl Washington,ILB,active,arizona-cardinals,738750,2010
229,470000,183333,Early Doucet,WR,active,arizona-cardinals,653333,2010
230,630000,0,Hamza Abdullah,CB,active,arizona-cardinals,630000,2010
231,395000,163000,Rashad Johnson,FS,active,arizona-cardinals,558000,2010
232,545000,0,Michael Adams,S,active,arizona-cardinals,545000,2010
233,470000,45166,Tim Hightower,RB,active,arizona-cardinals,515166,2010
234,320000,181050,Andre Roberts,WR,active,arizona-cardinals,501050,2010
235,395000,105333,Greg Toler,CB,active,arizona-cardinals,500333,2010
236,470000,0,Ben Claxton,C,active,arizona-cardinals,470000,2010
237,470000,0,Reagan Maui'a,RB,active,arizona-cardinals,470000,2010
238,470000,0,Trumaine McBride,CB,active,arizona-cardinals,470000,2010
239,320000,107125,O'Brien Schofield,OLB,active,arizona-cardinals,427125,2010
240,395000,12500,LaRod Stephens-Howling,RB,active,arizona-cardinals,407500,2010
241,395000,4000,Reggie Walker,ILB,active,arizona-cardinals,399000,2010
242,320000,45412,John Skelton,QB,active,arizona-cardinals,365412,2010
243,320000,12250,Jim Dray,TE,active,arizona-cardinals,332250,2010
244,320000,6000,Stephen Williams,WR,active,arizona-cardinals,326000,2010
245,320000,5000,A.J. Jefferson,CB,active,arizona-cardinals,325000,2010
246,320000,1500,Max Komar,WR,active,arizona-cardinals,321500,2010
247,470000,13500,Brandon Keith,RT,active,arizona-cardinals,483500,2010
248,259411,0,D'Anthony Batiste,G,active,arizona-cardinals,259411,2010
249,140000,0,Onrea Jones,WR,active,arizona-cardinals,140000,2010
250,92941,0,Richard Bartel,QB,active,arizona-cardinals,92941,2010
251,500000,0,Ben Graham,P,active,arizona-cardinals,500000,2010
252,470000,115050,Kenny Iwebema,DE,injured_reserve,arizona-cardinals,585050,2010
253,470000,0,Nehemiah Broughton,RB,injured_reserve,arizona-cardinals,470000,2010
254,240000,21972,Will Davis,LB,injured_reserve,arizona-cardinals,261972,2010
255,240000,0,Jaymar Johnson,WR,injured_reserve,arizona-cardinals,240000,2010
256,225000,2500,Max Hall,QB,injured_reserve,arizona-cardinals,227500,2010
257,88400,0,Curtis Gatewood,LB,practice_squad,arizona-cardinals,88400,2010
258,88400,0,Jeremy Navarre,DT,practice_squad,arizona-cardinals,88400,2010
259,88400,0,Brandon Sharpe,DE,practice_squad,arizona-cardinals,88400,2010
260,88400,0,Alfonso Smith,RB,practice_squad,arizona-cardinals,88400,2010
261,88400,0,Ronald Talley,DE,practice_squad,arizona-cardinals,88400,2010
262,88400,0,Pago Togafu,LB,practice_squad,arizona-cardinals,88400,2010
263,88400,0,Isaiah Williams,WR,practice_squad,arizona-cardinals,88400,2010
264,1552000,0,Antrel Rolle,SS,dead_cap,arizona-cardinals,1552000,2010
265,1000000,0,Anquan Boldin,WR,dead_cap,arizona-cardinals,1000000,2010
266,0,239000,Cody Brown,DE,dead_cap,arizona-cardinals,239000,2010
267,0,50000,Anthony Becht,TE,dead_cap,arizona-cardinals,50000,2010
268,0,22058,Jorrick Calvin,CB,dead_cap,arizona-cardinals,22058,2010
269,0,17650,Trevor Canfield,G,dead_cap,arizona-cardinals,17650,2010
270,2000000,15500000,Larry Fitzgerald,WR,active,arizona-cardinals,17500000,2011
271,6777500,5035000,Levi Brown,LT,active,arizona-cardinals,11812500,2011
272,3500000,4050000,Adrian Wilson,S,active,arizona-cardinals,7550000,2011
273,2350000,6250000,Darnell Dockett,DE,active,arizona-cardinals,8600000,2011
274,4087500,1300000,Derek Anderson,QB,active,arizona-cardinals,5387500,2011
275,2000000,2000000,Kevin Kolb,QB,active,arizona-cardinals,4000000,2011
276,2425000,1500000,Kerry Rhodes,S,active,arizona-cardinals,3925000,2011
277,3000000,500000,Richard Marshall,CB,active,arizona-cardinals,3500000,2011
278,375000,2975818,Patrick Peterson,CB,active,arizona-cardinals,3350818,2011
279,2000000,1000000,Stewart Bradley,ILB,active,arizona-cardinals,3000000,2011
280,1000000,1500000,Daryn Colledge,G,active,arizona-cardinals,2500000,2011
281,1500000,850000,Lyle Sendlein,C,active,arizona-cardinals,2350000,2011
282,2000000,250000,Jay Feely,K,active,arizona-cardinals,2250000,2011
283,1900000,266667,Paris Lenon,ILB,active,arizona-cardinals,2166667,2011
284,1000000,1125000,Todd Heap,TE,active,arizona-cardinals,2125000,2011
285,1500000,250000,Rex Hadnot,G,active,arizona-cardinals,1750000,2011
286,1835000,0,Brandon Keith,RT,active,arizona-cardinals,1835000,2011
287,1400000,366666,Jeremy Bridges,G,active,arizona-cardinals,1766666,2011
288,1000000,700000,Floyd Womack,G,active,arizona-cardinals,1700000,2011
289,450000,2190000,Dan Williams,DT,active,arizona-cardinals,2640000,2011
290,622500,1525000,Beanie Wells,RB,active,arizona-cardinals,2147500,2011
291,1500000,0,Joey Porter,LB,active,arizona-cardinals,1500000,2011
292,1050000,350000,Chansi Stuckey,WR,active,arizona-cardinals,1400000,2011
293,450000,923750,Daryl Washington,ILB,active,arizona-cardinals,1373750,2011
294,1000000,333333,Jeff King,TE,active,arizona-cardinals,1333333,2011
295,1250000,0,Taitusi Lutui,G,active,arizona-cardinals,1250000,2011
296,1000000,250000,Vonnie Holliday,DT,active,arizona-cardinals,1250000,2011
297,1200000,0,Early Doucet,WR,active,arizona-cardinals,1200000,2011
298,975000,25000,Mike Leach,LS,active,arizona-cardinals,1000000,2011
299,810000,150000,Nick Eason,DE,active,arizona-cardinals,960000,2011
300,600000,330000,Calais Campbell,DE,active,arizona-cardinals,930000,2011
301,375000,535442,Ryan Williams,RB,active,arizona-cardinals,910442,2011
302,685000,200000,Michael Adams,S,active,arizona-cardinals,885000,2011
303,525000,163000,Rashad Johnson,FS,active,arizona-cardinals,688000,2011
304,600000,50000,Reagan Maui'a,RB,active,arizona-cardinals,650000,2011
305,454000,181050,Andre Roberts,WR,active,arizona-cardinals,635050,2011
306,525000,105333,Greg Toler,CB,active,arizona-cardinals,630333,2011
307,375000,196023,Robert Housler,TE,active,arizona-cardinals,571023,2011
308,450000,107125,O'Brien Schofield,OLB,active,arizona-cardinals,557125,2011
309,525000,21972,Will Davis,LB,active,arizona-cardinals,546972,2011
310,525000,12500,LaRod Stephens-Howling,RB,active,arizona-cardinals,537500,2011
311,810000,0,Chester Taylor,RB,active,arizona-cardinals,810000,2011
312,810000,0,Dave Zastudil,P,active,arizona-cardinals,810000,2011
313,685000,0,Hamza Abdullah,CB,active,arizona-cardinals,685000,2011
314,685000,0,D'Anthony Batiste,G,active,arizona-cardinals,685000,2011
315,525000,0,Richard Bartel,QB,active,arizona-cardinals,525000,2011
316,525000,0,Reggie Walker,ILB,active,arizona-cardinals,525000,2011
317,450000,45412,John Skelton,QB,active,arizona-cardinals,495412,2011
318,375000,118607,Sam Acho,OLB,active,arizona-cardinals,493607,2011
319,450000,12250,Jim Dray,TE,active,arizona-cardinals,462250,2011
320,450000,6000,Stephen Williams,WR,active,arizona-cardinals,456000,2011
321,452500,2500,Max Hall,QB,active,arizona-cardinals,455000,2011
322,450000,0,Crezdon Butler,CB,active,arizona-cardinals,450000,2011
323,450000,0,Marshay Green,CB,active,arizona-cardinals,450000,2011
324,375000,51725,Anthony Sherman,FB,active,arizona-cardinals,426725,2011
325,405000,5000,A.J. Jefferson,CB,active,arizona-cardinals,410000,2011
326,405000,0,Antonio Coleman,DE,active,arizona-cardinals,405000,2011
327,405000,0,Ronald Talley,DE,active,arizona-cardinals,405000,2011
328,375000,28947,Quan Sturdivant,ILB,active,arizona-cardinals,403947,2011
329,375000,25966,David Carter,DT,active,arizona-cardinals,400966,2011
330,375000,11475,Demarco Sampson,WR,active,arizona-cardinals,386475,2011
331,380000,0,Alfonso Smith,RB,active,arizona-cardinals,380000,2011
332,375000,0,Korey Lindsey,CB,active,arizona-cardinals,375000,2011
333,88400,0,Ricky Lumpkin,DT,practice_squad,arizona-cardinals,88400,2011
334,1333333,0,Joey Porter,LB,dead_cap,arizona-cardinals,1333333,2011
335,1300000,0,Derek Anderson,QB,dead_cap,arizona-cardinals,1300000,2011
336,1060000,0,Dominique Rodgers-Cromartie,CB,dead_cap,arizona-cardinals,1060000,2011
337,850000,0,Ben Graham,P,dead_cap,arizona-cardinals,850000,2011
338,0,478000,Cody Brown,DE,dead_cap,arizona-cardinals,478000,2011
339,0,66175,Jorrick Calvin,CB,dead_cap,arizona-cardinals,66175,2011
340,55294,0,Curtis Gatewood,LB,dead_cap,arizona-cardinals,55294,2011
341,50000,0,Reagan Maui'a,RB,dead_cap,arizona-cardinals,50000,2011
342,0,28947,Quan Sturdivant,ILB,dead_cap,arizona-cardinals,28947,2011
343,2000,0,Sean Jeffcoat,WR,dead_cap,arizona-cardinals,2000,2011
344,0,1000,Ricky Lumpkin,DT,dead_cap,arizona-cardinals,1000,2011
345,1000,0,Andrew Rich,CB,dead_cap,arizona-cardinals,1000,2011
346,1000,0,Jake Vermiglio,G,dead_cap,arizona-cardinals,1000,2011
347,250,0,William Powell,RB,dead_cap,arizona-cardinals,250,2011
348,5000000,19750000,Larry Fitzgerald,WR,active,arizona-cardinals,24750000,2012
349,1000000,9500000,Kevin Kolb,QB,active,arizona-cardinals,10500000,2012
350,3400000,6250000,Darnell Dockett,DE,active,arizona-cardinals,9650000,2012
351,3500000,1500000,Kerry Rhodes,S,active,arizona-cardinals,5000000,2012
352,2000000,3000000,Calais Campbell,DE,active,arizona-cardinals,5000000,2012
353,1212705,2975818,Patrick Peterson,CB,active,arizona-cardinals,4188523,2012
354,2500000,1500000,Stewart Bradley,ILB,active,arizona-cardinals,4000000,2012
355,2500000,1018750,Daryl Washington,ILB,active,arizona-cardinals,3518750,2012
356,700000,2475000,Daryn Colledge,G,active,arizona-cardinals,3175000,2012
357,700000,2880000,Beanie Wells,RB,active,arizona-cardinals,3580000,2012
358,1500000,1425000,Adrian Wilson,S,active,arizona-cardinals,2925000,2012
359,2400000,266667,Paris Lenon,ILB,active,arizona-cardinals,2666667,2012
360,1000000,1650000,Levi Brown,LT,active,arizona-cardinals,2650000,2012
361,1950000,383334,Jeff King,TE,active,arizona-cardinals,2333334,2012
362,900000,1100000,Adam Snyder,G,active,arizona-cardinals,2000000,2012
363,700000,1275000,Lyle Sendlein,C,active,arizona-cardinals,1975000,2012
364,1927000,0,LaRod Stephens-Howling,RB,active,arizona-cardinals,1927000,2012
365,645000,2240000,Dan Williams,DT,active,arizona-cardinals,2885000,2012
366,390000,1423000,Michael Floyd,WR,active,arizona-cardinals,1813000,2012
367,1450000,250000,Early Doucet,WR,active,arizona-cardinals,1700000,2012
368,975000,375000,William Gay,CB,active,arizona-cardinals,1350000,2012
369,925000,366668,Jeremy Bridges,G,active,arizona-cardinals,1291668,2012
370,1260000,0,Rashad Johnson,FS,active,arizona-cardinals,1260000,2012
371,1260000,0,Greg Toler,CB,active,arizona-cardinals,1260000,2012
372,1000000,250000,Jay Feely,K,active,arizona-cardinals,1250000,2012
373,556261,585442,Ryan Williams,RB,active,arizona-cardinals,1141703,2012
374,1000000,91666,Mike Leach,LS,active,arizona-cardinals,1091666,2012
375,934375,100000,Todd Heap,TE,active,arizona-cardinals,1034375,2012
376,825000,200000,Michael Adams,S,active,arizona-cardinals,1025000,2012
377,825000,200000,Nick Eason,DE,active,arizona-cardinals,1025000,2012
378,915000,0,James Sanders,S,active,arizona-cardinals,915000,2012
379,825000,75000,Dave Zastudil,P,active,arizona-cardinals,900000,2012
380,615000,217500,Reggie Walker,ILB,active,arizona-cardinals,832500,2012
381,540000,181050,Andre Roberts,WR,active,arizona-cardinals,721050,2012
382,700000,0,Quentin Groves,OLB,active,arizona-cardinals,700000,2012
383,485000,196023,Robert Housler,TE,active,arizona-cardinals,681023,2012
384,540000,107125,O'Brien Schofield,OLB,active,arizona-cardinals,647125,2012
385,615000,0,Kory Sperry,TE,active,arizona-cardinals,615000,2012
386,540000,45412,John Skelton,QB,active,arizona-cardinals,585412,2012
387,465000,118607,Sam Acho,OLB,active,arizona-cardinals,583607,2012
388,540000,12250,Jim Dray,TE,active,arizona-cardinals,552250,2012
389,925000,0,Vonnie Holliday,DT,active,arizona-cardinals,925000,2012
390,700000,0,D'Anthony Batiste,G,active,arizona-cardinals,700000,2012
391,540000,0,Stephen Williams,WR,active,arizona-cardinals,540000,2012
392,615000,0,Mike Gibson,C,active,arizona-cardinals,615000,2012
393,465000,51725,Anthony Sherman,FB,active,arizona-cardinals,516725,2012
394,390000,110845,Bobby Massie,RT,active,arizona-cardinals,500845,2012
395,465000,25966,David Carter,DT,active,arizona-cardinals,490966,2012
396,540000,0,Rich Ohrnberger,C,active,arizona-cardinals,540000,2012
397,465000,0,Marshay Green,CB,active,arizona-cardinals,465000,2012
398,465000,0,Javarris James,RB,active,arizona-cardinals,465000,2012
399,465000,0,Ricky Lumpkin,DT,active,arizona-cardinals,465000,2012
400,465000,0,Alfonso Smith,RB,active,arizona-cardinals,465000,2012
401,390000,47900,Senio Kelemete,G,active,arizona-cardinals,437900,2012
402,700000,0,Pat McQuistan,RT,active,arizona-cardinals,700000,2012
403,390000,28556,Justin Bethel,CB,active,arizona-cardinals,418556,2012
404,390000,26327,Ryan Lindley,QB,active,arizona-cardinals,416327,2012
405,390000,14856,Nate Potter,LT,active,arizona-cardinals,404856,2012
406,390000,2166,Laron Byrd,WR,active,arizona-cardinals,392166,2012
407,390000,1166,Gerell Robinson,WR,active,arizona-cardinals,391166,2012
408,390000,0,Blake DeChristopher,G,active,arizona-cardinals,390000,2012
409,390000,0,Zack Nash,OLB,active,arizona-cardinals,390000,2012
410,390000,0,Kerry Taylor,WR,active,arizona-cardinals,390000,2012
411,465000,0,Ronald Talley,DE,active,arizona-cardinals,465000,2012
412,615000,0,Brian Hoyer,QB,active,arizona-cardinals,615000,2012
413,45882,0,Jamell Fleming,S,active,arizona-cardinals,45882,2012
414,0,4785000,Levi Brown,LT,dead_cap,arizona-cardinals,4785000,2012
415,2120000,0,Dominique Rodgers-Cromartie,CB,dead_cap,arizona-cardinals,2120000,2012
416,1333334,0,Joey Porter,LB,dead_cap,arizona-cardinals,1333334,2012
417,1125000,0,Todd Heap,TE,dead_cap,arizona-cardinals,1125000,2012
418,366667,0,Jeremy Bridges,G,dead_cap,arizona-cardinals,366667,2012
419,350000,0,Chansi Stuckey,WR,dead_cap,arizona-cardinals,350000,2012
420,250000,0,Rex Hadnot,G,dead_cap,arizona-cardinals,250000,2012
421,125000,0,Reagan Maui'a,RB,dead_cap,arizona-cardinals,125000,2012
422,0,86841,Quan Sturdivant,ILB,dead_cap,arizona-cardinals,86841,2012
423,65000,0,Russ Hochstein,G,dead_cap,arizona-cardinals,65000,2012
424,0,11475,Demarco Sampson,WR,dead_cap,arizona-cardinals,11475,2012
425,4000,0,Sean Jeffcoat,WR,dead_cap,arizona-cardinals,4000,2012
426,0,2000,Ricky Lumpkin,DT,dead_cap,arizona-cardinals,2000,2012
427,2000,0,Andrew Rich,CB,dead_cap,arizona-cardinals,2000,2012
428,2000,0,Jake Vermiglio,G,dead_cap,arizona-cardinals,2000,2012
429,500,0,William Powell,RB,dead_cap,arizona-cardinals,500,2012
430,5000000,8250000,Larry Fitzgerald,WR,active,arizona-cardinals,13250000,2013
431,3000000,8250000,Calais Campbell,DE,active,arizona-cardinals,11250000,2013
432,4450000,6250000,Darnell Dockett,DE,active,arizona-cardinals,10700000,2013
433,3800000,3475000,Daryn Colledge,G,active,arizona-cardinals,7275000,2013
434,2050409,2975818,Patrick Peterson,CB,active,arizona-cardinals,5026227,2013
435,2000000,2000000,Carson Palmer,QB,active,arizona-cardinals,4000000,2013
436,2400000,1275000,Lyle Sendlein,C,active,arizona-cardinals,3675000,2013
437,1835294,1018750,Daryl Washington,ILB,active,arizona-cardinals,2854044,2013
438,405000,2240273,Jonathan Cooper,G,active,arizona-cardinals,2645273,2013
439,2000000,500000,Rashard Mendenhall,RB,active,arizona-cardinals,2500000,2013
440,843250,1423000,Michael Floyd,WR,active,arizona-cardinals,2266250,2013
441,1250000,1000000,Karlos Dansby,ILB,active,arizona-cardinals,2250000,2013
442,910000,2240000,Dan Williams,DT,active,arizona-cardinals,3150000,2013
443,1500000,550000,Jay Feely,K,active,arizona-cardinals,2050000,2013
444,1000000,1000000,Jerraud Powers,CB,active,arizona-cardinals,2000000,2013
445,840000,1160000,Eric Winston,RT,active,arizona-cardinals,2000000,2013
446,1000000,666667,Drew Stanton,QB,active,arizona-cardinals,1666667,2013
447,1000000,600000,John Abraham,OLB,active,arizona-cardinals,1600000,2013
448,1475000,100000,Dave Zastudil,P,active,arizona-cardinals,1575000,2013
449,1323000,181050,Andre Roberts,WR,active,arizona-cardinals,1504050,2013
450,900000,600000,Antoine Cason,CB,active,arizona-cardinals,1500000,2013
451,780221,585442,Ryan Williams,RB,active,arizona-cardinals,1365663,2013
452,1050000,250000,Jasper Brinkley,ILB,active,arizona-cardinals,1300000,2013
453,715000,450000,Lorenzo Alexander,OLB,active,arizona-cardinals,1165000,2013
454,800000,333333,Rashad Johnson,FS,active,arizona-cardinals,1133333,2013
455,1000000,91666,Mike Leach,LS,active,arizona-cardinals,1091666,2013
456,850000,150000,Matt Shaughnessy,DE,active,arizona-cardinals,1000000,2013
457,620000,196023,Robert Housler,TE,active,arizona-cardinals,816023,2013
458,405000,393236,Kevin Minter,ILB,active,arizona-cardinals,798236,2013
459,715000,0,Mike Gibson,C,active,arizona-cardinals,715000,2013
460,715000,0,Kory Sperry,TE,active,arizona-cardinals,715000,2013
461,630000,50000,Paul Fanaika,G,active,arizona-cardinals,680000,2013
462,555000,118607,Sam Acho,OLB,active,arizona-cardinals,673607,2013
463,630000,15000,Javier Arenas,CB,active,arizona-cardinals,645000,2013
464,630000,12250,Jim Dray,TE,active,arizona-cardinals,642250,2013
465,840000,65000,Yeremiah Bell,S,active,arizona-cardinals,905000,2013
466,840000,65000,Frostee Rucker,DT,active,arizona-cardinals,905000,2013
467,480000,110845,Bobby Massie,RT,active,arizona-cardinals,590845,2013
468,405000,165625,Tyrann Mathieu,FS,active,arizona-cardinals,570625,2013
469,555000,0,Alfonso Smith,RB,active,arizona-cardinals,555000,2013
470,555000,0,Ronald Talley,DE,active,arizona-cardinals,555000,2013
471,405000,108716,Earl Watford,RT,active,arizona-cardinals,513716,2013
472,480000,28556,Justin Bethel,CB,active,arizona-cardinals,508556,2013
473,480000,26327,Ryan Lindley,QB,active,arizona-cardinals,506327,2013
474,480000,14856,Nate Potter,LT,active,arizona-cardinals,494856,2013
475,630000,0,Marcus Benard,OLB,active,arizona-cardinals,630000,2013
476,480000,0,Bradley Sowell,LT,active,arizona-cardinals,480000,2013
477,480000,0,Alameda Ta'amu,DT,active,arizona-cardinals,480000,2013
478,405000,50125,Stepfan Taylor,RB,active,arizona-cardinals,455125,2013
479,405000,25966,Andre Ellington,RB,active,arizona-cardinals,430966,2013
480,405000,3366,Tony Jefferson,SS,active,arizona-cardinals,408366,2013
481,405000,3000,Jaron Brown,WR,active,arizona-cardinals,408000,2013
482,288000,118607,Alex Okafor,DE,active,arizona-cardinals,406607,2013
483,405000,0,Brittan Golden,WR,active,arizona-cardinals,405000,2013
484,480000,0,Dontay Moch,DE,active,arizona-cardinals,480000,2013
485,303000,2166,Laron Byrd,WR,active,arizona-cardinals,305166,2013
486,630000,0,Jake Ballard,TE,active,arizona-cardinals,630000,2013
487,630000,0,Bryan McCann,CB,active,arizona-cardinals,630000,2013
488,480000,0,Teddy Williams,CB,active,arizona-cardinals,480000,2013
489,555000,0,Curtis Taylor,S,active,arizona-cardinals,555000,2013
490,1500000,383334,Jeff King,TE,injured_reserve,arizona-cardinals,1883334,2013
491,405000,0,Everrette Thompson,DT,injured_reserve,arizona-cardinals,405000,2013
492,24000,0,JoJo Dickson,ILB,practice_squad,arizona-cardinals,24000,2013
493,18000,0,Brittan Golden,WR,practice_squad,arizona-cardinals,18000,2013
494,6000000,0,Kevin Kolb,QB,dead_cap,arizona-cardinals,6000000,2013
495,1367647,2171397,Levi Brown,LT,dead_cap,arizona-cardinals,3539044,2013
496,3000000,0,Stewart Bradley,ILB,dead_cap,arizona-cardinals,3000000,2013
497,1925000,0,Adrian Wilson,S,dead_cap,arizona-cardinals,1925000,2013
498,1000000,0,Adam Snyder,G,dead_cap,arizona-cardinals,1000000,2013
499,0,1525000,Beanie Wells,RB,dead_cap,arizona-cardinals,1525000,2013
500,250000,0,Early Doucet,WR,dead_cap,arizona-cardinals,250000,2013
501,250000,0,William Gay,CB,dead_cap,arizona-cardinals,250000,2013
502,229474,0,D.C. Jefferson,TE,dead_cap,arizona-cardinals,229474,2013
503,217500,0,Reggie Walker,ILB,dead_cap,arizona-cardinals,217500,2013
504,146517,0,Jamell Fleming,S,dead_cap,arizona-cardinals,146517,2013
505,125296,0,Kerry Taylor,WR,dead_cap,arizona-cardinals,125296,2013
506,113794,0,Kenny Demens,ILB,dead_cap,arizona-cardinals,113794,2013
507,107125,0,O'Brien Schofield,OLB,dead_cap,arizona-cardinals,107125,2013
508,103450,0,Anthony Sherman,FB,dead_cap,arizona-cardinals,103450,2013
509,88765,0,Vic So'oto,OLB,dead_cap,arizona-cardinals,88765,2013
510,84000,0,Curtis Taylor,S,dead_cap,arizona-cardinals,84000,2013
511,47900,0,Senio Kelemete,G,dead_cap,arizona-cardinals,47900,2013
512,45412,0,John Skelton,QB,dead_cap,arizona-cardinals,45412,2013
513,36000,0,Orie Lemon,ILB,dead_cap,arizona-cardinals,36000,2013
514,28947,0,Ryan Swope,WR,dead_cap,arizona-cardinals,28947,2013
515,0,25966,David Carter,DT,dead_cap,arizona-cardinals,25966,2013
516,24000,0,Zack Nash,OLB,dead_cap,arizona-cardinals,24000,2013
517,0,22950,Demarco Sampson,WR,dead_cap,arizona-cardinals,22950,2013
518,18000,0,Dontay Moch,DE,dead_cap,arizona-cardinals,18000,2013
519,15058,0,Devon Wylie,WR,dead_cap,arizona-cardinals,15058,2013
520,12000,0,Sam McGuffie,WR,dead_cap,arizona-cardinals,12000,2013
521,12000,0,Bruce Taylor,ILB,dead_cap,arizona-cardinals,12000,2013
522,7666,0,Dan Buckner,WR,dead_cap,arizona-cardinals,7666,2013
523,4000,0,Jamaal Johnson-Webb,LT,dead_cap,arizona-cardinals,4000,2013
524,2000,0,Padric Scott,DT,dead_cap,arizona-cardinals,2000,2013
525,0,1000,Javone Lawson,WR,dead_cap,arizona-cardinals,1000,2013
526,1000,0,Joe Caprioglio,RT,dead_cap,arizona-cardinals,1000,2013
527,667,0,Michael Rios,WR,dead_cap,arizona-cardinals,667,2013
528,666,0,Javon Harris,S,dead_cap,arizona-cardinals,666,2013
529,666,0,Josh Hill,S,dead_cap,arizona-cardinals,666,2013
530,666,0,Korey Jones,ILB,dead_cap,arizona-cardinals,666,2013
531,333,0,Ronnie Yell,CB,dead_cap,arizona-cardinals,333,2013
532,9000000,4000000,Carson Palmer,QB,active,arizona-cardinals,13000000,2014
533,5500000,8250000,Calais Campbell,DE,active,arizona-cardinals,13750000,2014
534,1000000,10600000,Larry Fitzgerald,WR,active,arizona-cardinals,11600000,2014
535,888114,6049018,Patrick Peterson,CB,active,arizona-cardinals,6937132,2014
536,3750000,1000000,Jerraud Powers,CB,active,arizona-cardinals,4750000,2014
537,2850000,1275000,Lyle Sendlein,C,active,arizona-cardinals,4125000,2014
538,2250000,1750000,Antonio Cromartie,CB,active,arizona-cardinals,4000000,2014
539,495000,2811591,Jonathan Cooper,G,active,arizona-cardinals,3306591,2014
540,1296500,1423000,Michael Floyd,WR,active,arizona-cardinals,2719500,2014
541,1750000,916666,Drew Stanton,QB,active,arizona-cardinals,2666666,2014
542,1250000,1250000,Jared Veldheer,RT,active,arizona-cardinals,2500000,2014
543,1000000,1250000,Ted Ginn Jr.,WR,active,arizona-cardinals,2250000,2014
544,990000,2240000,Dan Williams,DT,active,arizona-cardinals,3230000,2014
545,1650000,483333,Rashad Johnson,FS,active,arizona-cardinals,2133333,2014
546,800000,825000,Matt Shaughnessy,DE,active,arizona-cardinals,1625000,2014
547,1406000,196023,Robert Housler,TE,active,arizona-cardinals,1602023,2014
548,1431000,118607,Sam Acho,OLB,active,arizona-cardinals,1549607,2014
549,855000,600000,Lorenzo Alexander,OLB,active,arizona-cardinals,1455000,2014
550,800000,637500,John Carlson,TE,active,arizona-cardinals,1437500,2014
551,420000,981673,Deone Bucannon,ILB,active,arizona-cardinals,1401673,2014
552,1000000,91668,Mike Leach,LS,active,arizona-cardinals,1091668,2014
553,730000,335000,Ted Larsen,G,active,arizona-cardinals,1065000,2014
554,604559,393236,Kevin Minter,ILB,active,arizona-cardinals,997795,2014
555,955000,0,Tommy Kelly,DT,active,arizona-cardinals,955000,2014
556,855000,72500,Frostee Rucker,DT,active,arizona-cardinals,927500,2014
557,730000,50000,Paul Fanaika,G,active,arizona-cardinals,780000,2014
558,420000,311509,Troy Niklas,TE,active,arizona-cardinals,731509,2014
559,495000,218281,Tyrann Mathieu,FS,active,arizona-cardinals,713281,2014
560,570000,110845,Bobby Massie,RT,active,arizona-cardinals,680845,2014
561,495000,118607,Alex Okafor,DE,active,arizona-cardinals,613607,2014
562,495000,108716,Earl Watford,RT,active,arizona-cardinals,603716,2014
563,570000,28556,Justin Bethel,CB,active,arizona-cardinals,598556,2014
564,955000,0,Larry Foote,ILB,active,arizona-cardinals,955000,2014
565,570000,0,Bradley Sowell,LT,active,arizona-cardinals,570000,2014
566,570000,0,Alameda Ta'amu,DT,active,arizona-cardinals,570000,2014
567,420000,141890,Kareem Martin,OLB,active,arizona-cardinals,561890,2014
568,420000,135725,John Brown,WR,active,arizona-cardinals,555725,2014
569,495000,50125,Stepfan Taylor,RB,active,arizona-cardinals,545125,2014
570,420000,108023,Logan Thomas,TE,active,arizona-cardinals,528023,2014
571,495000,25966,Andre Ellington,RB,active,arizona-cardinals,520966,2014
572,495000,3366,Tony Jefferson,SS,active,arizona-cardinals,498366,2014
573,495000,3000,Jaron Brown,WR,active,arizona-cardinals,498000,2014
574,495000,0,Kenny Demens,ILB,active,arizona-cardinals,495000,2014
575,495000,0,Robert Hughes,RB,active,arizona-cardinals,495000,2014
576,406235,46685,Ed Stinson,DE,active,arizona-cardinals,452920,2014
577,420000,500,Chandler Catanzaro,K,active,arizona-cardinals,420500,2014
578,420000,0,Glenn Carson,ILB,active,arizona-cardinals,420000,2014
579,420000,0,Darren Fells,TE,active,arizona-cardinals,420000,2014
580,730000,0,Marcus Benard,OLB,active,arizona-cardinals,730000,2014
581,495000,0,Drew Butler,P,active,arizona-cardinals,495000,2014
582,420000,0,Marion Grice,RB,active,arizona-cardinals,420000,2014
583,570000,0,Ryan Lindley,QB,active,arizona-cardinals,570000,2014
584,420000,0,Josh Mauro,DT,active,arizona-cardinals,420000,2014
585,730000,0,Chris Clemons,FS,active,arizona-cardinals,730000,2014
586,420000,0,Anthony Steen,G,active,arizona-cardinals,420000,2014
587,420000,0,Kerwynn Williams,RB,active,arizona-cardinals,420000,2014
588,495000,0,Brittan Golden,WR,active,arizona-cardinals,495000,2014
589,5500000,6250000,Darnell Dockett,DE,injured_reserve,arizona-cardinals,11750000,2014
590,3000000,925000,John Abraham,OLB,injured_reserve,arizona-cardinals,3925000,2014
591,955000,297500,Dave Zastudil,P,injured_reserve,arizona-cardinals,1252500,2014
592,303000,0,Eddie Whitley,S,injured_reserve,arizona-cardinals,303000,2014
593,730000,65000,Jonathan Dwyer,RB,non_fb_injury,arizona-cardinals,795000,2014
594,107100,0,Jimmy LeGree,CB,practice_squad,arizona-cardinals,107100,2014
595,69300,0,Ross Weaver,FS,practice_squad,arizona-cardinals,69300,2014
596,44100,0,Darren Woodard,CB,practice_squad,arizona-cardinals,44100,2014
597,25200,0,Kelvin Palmer,RT,practice_squad,arizona-cardinals,25200,2014
598,25200,0,Ryan Spadola,WR,practice_squad,arizona-cardinals,25200,2014
599,18900,0,John Fullington,G,practice_squad,arizona-cardinals,18900,2014
600,18900,0,Travis Harvey,WR,practice_squad,arizona-cardinals,18900,2014
601,12600,0,Zach Bauman,RB,practice_squad,arizona-cardinals,12600,2014
602,12600,0,Jeff Mathews,QB,practice_squad,arizona-cardinals,12600,2014
603,0,6514191,Levi Brown,LT,dead_cap,arizona-cardinals,6514191,2014
604,3000000,0,Adam Snyder,G,dead_cap,arizona-cardinals,3000000,2014
605,2275000,0,Daryn Colledge,G,dead_cap,arizona-cardinals,2275000,2014
606,535442,0,Ryan Williams,RB,dead_cap,arizona-cardinals,535442,2014
607,417353,0,Thomas Keiser,OLB,dead_cap,arizona-cardinals,417353,2014
608,335294,0,Desmond Bishop,OLB,dead_cap,arizona-cardinals,335294,2014
609,293034,0,Jamell Fleming,S,dead_cap,arizona-cardinals,293034,2014
610,200000,0,Jasper Brinkley,ILB,dead_cap,arizona-cardinals,200000,2014
611,179735,0,Bruce Gaston,DT,dead_cap,arizona-cardinals,179735,2014
612,168124,0,Kerwynn Williams,RB,dead_cap,arizona-cardinals,168124,2014
613,161029,0,Victor Butler,OLB,dead_cap,arizona-cardinals,161029,2014
614,134118,10000,Marcus Benard,OLB,dead_cap,arizona-cardinals,144118,2014
615,125735,0,Jalen Parmele,RB,dead_cap,arizona-cardinals,125735,2014
616,107100,0,Andre Hardy,TE,dead_cap,arizona-cardinals,107100,2014
617,100588,0,Matthew Mulligan,TE,dead_cap,arizona-cardinals,100588,2014
618,99953,0,Drew Butler,P,dead_cap,arizona-cardinals,99953,2014
619,95580,0,Senio Kelemete,G,dead_cap,arizona-cardinals,95580,2014
620,94500,0,Brittan Golden,WR,dead_cap,arizona-cardinals,94500,2014
621,86841,0,Ryan Swope,WR,dead_cap,arizona-cardinals,86841,2014
622,81900,4000,Anthony Steen,G,dead_cap,arizona-cardinals,85900,2014
623,75600,0,Kelvin Palmer,RT,dead_cap,arizona-cardinals,75600,2014
624,67059,0,Michael Bush,RB,dead_cap,arizona-cardinals,67059,2014
625,0,65000,Jake Ballard,TE,dead_cap,arizona-cardinals,65000,2014
626,50400,0,Anthony Gaitor,CB,dead_cap,arizona-cardinals,50400,2014
627,45186,0,D.C. Jefferson,TE,dead_cap,arizona-cardinals,45186,2014
628,37800,3000,Jonathan Brown,OLB,dead_cap,arizona-cardinals,40800,2014
629,37800,0,Kaelin Burnett,OLB,dead_cap,arizona-cardinals,37800,2014
630,37800,0,Solomon Patton,WR,dead_cap,arizona-cardinals,37800,2014
631,0,26327,Ryan Lindley,QB,dead_cap,arizona-cardinals,26327,2014
632,0,25968,David Carter,DT,dead_cap,arizona-cardinals,25968,2014
633,0,25947,Walter Powell,WR,dead_cap,arizona-cardinals,25947,2014
634,25200,0,Jalen Saunders,WR,dead_cap,arizona-cardinals,25200,2014
635,25200,0,Christian Tupou,DT,dead_cap,arizona-cardinals,25200,2014
636,18900,0,Teddy Williams,CB,dead_cap,arizona-cardinals,18900,2014
637,18900,0,Kion Wilson,ILB,dead_cap,arizona-cardinals,18900,2014
638,0,14856,Nate Potter,LT,dead_cap,arizona-cardinals,14856,2014
639,12600,1334,Zach Bauman,RB,dead_cap,arizona-cardinals,13934,2014
640,12600,0,Chris Rainey,RB,dead_cap,arizona-cardinals,12600,2014
641,8000,0,Jamaal Johnson-Webb,LT,dead_cap,arizona-cardinals,8000,2014
642,6000,1000,Tim Cornett,RB,dead_cap,arizona-cardinals,7000,2014
643,6300,0,Kevin Cone,WR,dead_cap,arizona-cardinals,6300,2014
644,6300,0,Dennis Dixon,QB,dead_cap,arizona-cardinals,6300,2014
645,5500,0,Dan Giordano,OLB,dead_cap,arizona-cardinals,5500,2014
646,4000,0,Padric Scott,DT,dead_cap,arizona-cardinals,4000,2014
647,3334,0,Dan Buckner,WR,dead_cap,arizona-cardinals,3334,2014
648,3000,0,Tyler Shaw,WR,dead_cap,arizona-cardinals,3000,2014
649,2168,0,Laron Byrd,WR,dead_cap,arizona-cardinals,2168,2014
650,0,2000,Javone Lawson,WR,dead_cap,arizona-cardinals,2000,2014
651,2000,0,Joe Caprioglio,RT,dead_cap,arizona-cardinals,2000,2014
652,0,1334,Justin Renfrow,DT,dead_cap,arizona-cardinals,1334,2014
653,0,1334,Brandon Sermons,CB,dead_cap,arizona-cardinals,1334,2014
654,1334,0,Javon Harris,S,dead_cap,arizona-cardinals,1334,2014
655,1334,0,Korey Jones,ILB,dead_cap,arizona-cardinals,1334,2014
656,1334,0,Michael Rios,WR,dead_cap,arizona-cardinals,1334,2014
657,0,1333,Kevin Smith,WR,dead_cap,arizona-cardinals,1333,2014
658,0,1000,Kadeem Williams,LT,dead_cap,arizona-cardinals,1000,2014
659,1000,0,Kenny Demens,ILB,dead_cap,arizona-cardinals,1000,2014
660,667,0,Josh Hill,S,dead_cap,arizona-cardinals,667,2014
661,667,0,Ronnie Yell,CB,dead_cap,arizona-cardinals,667,2014
662,0,500,Corey Washington,WR,dead_cap,arizona-cardinals,500,2014
663,0,167,Todd Washington,CB,dead_cap,arizona-cardinals,167,2014
664,0,166,Kelsey Pope,WR,dead_cap,arizona-cardinals,166,2014
665,11619114,3172377,Patrick Peterson,CB,active,arizona-cardinals,14791491,2015
666,9000000,8250000,Calais Campbell,DE,active,arizona-cardinals,17250000,2015
667,1000000,12850000,Larry Fitzgerald,WR,active,arizona-cardinals,13850000,2015
668,6750000,1750000,Jared Veldheer,RT,active,arizona-cardinals,8500000,2015
669,1000000,6375000,Carson Palmer,QB,active,arizona-cardinals,7375000,2015
670,1500000,5200000,Mike Iupati,G,active,arizona-cardinals,6700000,2015
671,4350000,1000000,Jerraud Powers,CB,active,arizona-cardinals,5350000,2015
672,585000,3382910,Jonathan Cooper,G,active,arizona-cardinals,3967910,2015
673,2450000,1416668,Drew Stanton,QB,active,arizona-cardinals,3866668,2015
674,2350000,1500000,Sean Weatherspoon,ILB,active,arizona-cardinals,3850000,2015
675,1749750,1423000,Michael Floyd,WR,active,arizona-cardinals,3172750,2015
676,1250000,1859375,Jermaine Gresham,TE,active,arizona-cardinals,3109375,2015
677,1000000,1666666,Corey Peters,DT,active,arizona-cardinals,2666666,2015
678,1600000,835000,Ted Larsen,G,active,arizona-cardinals,2435000,2015
679,1100000,1081875,Frostee Rucker,DT,active,arizona-cardinals,2181875,2015
680,1350000,783334,Rashad Johnson,FS,active,arizona-cardinals,2133334,2015
681,1000000,1000000,Lyle Sendlein,C,active,arizona-cardinals,2000000,2015
682,770418,981673,Deone Bucannon,ILB,active,arizona-cardinals,1752091,2015
683,435000,1185384,D.J. Humphries,LT,active,arizona-cardinals,1620384,2015
684,1360588,110845,Bobby Massie,RT,active,arizona-cardinals,1471433,2015
685,660000,778556,Justin Bethel,CB,active,arizona-cardinals,1438556,2015
686,804118,393236,Kevin Minter,ILB,active,arizona-cardinals,1197354,2015
687,602877,311509,Troy Niklas,TE,active,arizona-cardinals,914386,2015
688,660000,100000,Bradley Sowell,LT,active,arizona-cardinals,760000,2015
689,660000,75000,A.Q. Shipley,C,active,arizona-cardinals,735000,2015
690,435000,277424,Markus Golden,OLB,active,arizona-cardinals,712424,2015
691,528000,141890,Kareem Martin,OLB,active,arizona-cardinals,669890,2015
692,970000,80000,Mike Leach,LS,active,arizona-cardinals,1050000,2015
693,522000,135725,John Brown,WR,active,arizona-cardinals,657725,2015
694,585000,50125,Stepfan Taylor,RB,active,arizona-cardinals,635125,2015
695,585000,25966,Andre Ellington,RB,active,arizona-cardinals,610966,2015
696,435000,159843,David Johnson,RB,active,arizona-cardinals,594843,2015
697,592500,0,Matt Barkley,QB,active,arizona-cardinals,592500,2015
698,585000,3368,Tony Jefferson,SS,active,arizona-cardinals,588368,2015
699,585000,3000,Jaron Brown,WR,active,arizona-cardinals,588000,2015
700,585000,0,Drew Butler,P,active,arizona-cardinals,585000,2015
701,435000,127479,Rodney Gunter,DT,active,arizona-cardinals,562479,2015
702,510000,46685,Ed Stinson,DE,active,arizona-cardinals,556685,2015
703,510000,500,Chandler Catanzaro,K,active,arizona-cardinals,510500,2015
704,510000,0,Darren Fells,TE,active,arizona-cardinals,510000,2015
705,510000,0,Brittan Golden,WR,active,arizona-cardinals,510000,2015
706,510000,0,Josh Mauro,DT,active,arizona-cardinals,510000,2015
707,435000,52958,Shaquille Riddick,OLB,active,arizona-cardinals,487958,2015
708,435000,52450,J.J. Nelson,WR,active,arizona-cardinals,487450,2015
709,435000,5666,Alani Fua,OLB,active,arizona-cardinals,440666,2015
710,435000,2666,Xavier Williams,DT,active,arizona-cardinals,437666,2015
711,684705,0,Dwight Freeney,OLB,active,arizona-cardinals,684705,2015
712,318000,13195,Gerald Christian,TE,active,arizona-cardinals,331195,2015
713,318000,2666,Zack Wagenmann,DE,active,arizona-cardinals,320666,2015
714,318000,0,John Fullington,G,active,arizona-cardinals,318000,2015
715,318000,0,Ifeanyi Momah,TE,active,arizona-cardinals,318000,2015
716,307058,0,Red Bryant,DE,active,arizona-cardinals,307058,2015
717,194117,0,Corey White,CB,active,arizona-cardinals,194117,2015
718,150000,0,Kerwynn Williams,RB,active,arizona-cardinals,150000,2015
719,137647,0,D.J. Swearinger,FS,active,arizona-cardinals,137647,2015
720,87647,0,Chris Clemons,FS,active,arizona-cardinals,87647,2015
721,435000,0,Gabe Martin,ILB,active,arizona-cardinals,435000,2015
722,0,0,Jason Babin,DE,active,arizona-cardinals,0,2015
723,1000000,1000000,Cory Redding,DE,injured_reserve,arizona-cardinals,2000000,2015
724,585000,270937,Tyrann Mathieu,FS,injured_reserve,arizona-cardinals,855937,2015
725,870000,80000,LaMarr Woodley,OLB,injured_reserve,arizona-cardinals,950000,2015
726,529235,108716,Earl Watford,RT,injured_reserve,arizona-cardinals,637951,2015
727,870000,0,Chris Johnson,RB,injured_reserve,arizona-cardinals,870000,2015
728,417705,0,Kenny Demens,ILB,injured_reserve,arizona-cardinals,417705,2015
729,318000,0,Travis Harvey,WR,injured_reserve,arizona-cardinals,318000,2015
730,318000,0,Brandon Person,FS,injured_reserve,arizona-cardinals,318000,2015
731,585000,118607,Alex Okafor,DE,non_fb_injury,arizona-cardinals,703607,2015
732,0,6000000,Darnell Dockett,DE,dead_cap,arizona-cardinals,6000000,2015
733,2275000,0,Daryn Colledge,G,dead_cap,arizona-cardinals,2275000,2015
734,0,1500000,Ted Ginn Jr.,WR,dead_cap,arizona-cardinals,1500000,2015
735,0,1325000,Matt Shaughnessy,DE,dead_cap,arizona-cardinals,1325000,2015
736,0,1125000,Lyle Sendlein,C,dead_cap,arizona-cardinals,1125000,2015
737,0,600000,Lorenzo Alexander,OLB,dead_cap,arizona-cardinals,600000,2015
738,0,542500,Dave Zastudil,P,dead_cap,arizona-cardinals,542500,2015
739,442410,1333,Cariel Brooks,CB,dead_cap,arizona-cardinals,443743,2015
740,262941,0,Chris Clemons,FS,dead_cap,arizona-cardinals,262941,2015
741,149400,0,Robert Nelson,CB,dead_cap,arizona-cardinals,149400,2015
742,112200,5000,Rob Crisp,LT,dead_cap,arizona-cardinals,117200,2015
743,112200,3000,Jaxon Shipley,WR,dead_cap,arizona-cardinals,115200,2015
744,112200,1500,Gabe Martin,ILB,dead_cap,arizona-cardinals,113700,2015
745,112200,0,Antoine McClain,G,dead_cap,arizona-cardinals,112200,2015
746,0,108023,Logan Thomas,TE,dead_cap,arizona-cardinals,108023,2015
747,102600,0,Kerwynn Williams,RB,dead_cap,arizona-cardinals,102600,2015
748,79200,0,Durell Eskridge,FS,dead_cap,arizona-cardinals,79200,2015
749,0,77841,Walter Powell,WR,dead_cap,arizona-cardinals,77841,2015
750,72600,0,Carrington Byndom,CB,dead_cap,arizona-cardinals,72600,2015
751,72600,0,Robert Hughes,RB,dead_cap,arizona-cardinals,72600,2015
752,72600,0,Olsen Pierre,DT,dead_cap,arizona-cardinals,72600,2015
753,72600,0,Brandon Bostick,TE,dead_cap,arizona-cardinals,72600,2015
754,52800,0,Kevin White,CB,dead_cap,arizona-cardinals,52800,2015
755,0,50000,John Carlson,TE,dead_cap,arizona-cardinals,50000,2015
756,41011,0,Joseph Fauria,TE,dead_cap,arizona-cardinals,41011,2015
757,0,40000,Darryl Sharpton,ILB,dead_cap,arizona-cardinals,40000,2015
758,39600,0,Leon McFadden,CB,dead_cap,arizona-cardinals,39600,2015
759,39600,0,Lawrence Okoye,DT,dead_cap,arizona-cardinals,39600,2015
760,26400,0,Mike Gillislee,RB,dead_cap,arizona-cardinals,26400,2015
761,26400,0,John Wetzel,RT,dead_cap,arizona-cardinals,26400,2015
762,0,26327,Ryan Lindley,QB,dead_cap,arizona-cardinals,26327,2015
763,0,25000,Alameda Ta'amu,DT,dead_cap,arizona-cardinals,25000,2015
764,13200,8000,Anthony Steen,G,dead_cap,arizona-cardinals,21200,2015
765,19800,0,Abou Toure,RB,dead_cap,arizona-cardinals,19800,2015
766,0,14856,Nate Potter,LT,dead_cap,arizona-cardinals,14856,2015
767,13200,0,Marion Grice,RB,dead_cap,arizona-cardinals,13200,2015
768,6600,0,D.J. Swearinger,FS,dead_cap,arizona-cardinals,6600,2015
769,0,6000,Jonathan Brown,OLB,dead_cap,arizona-cardinals,6000,2015
770,0,2667,Zach Bauman,RB,dead_cap,arizona-cardinals,2667,2015
771,0,2667,Justin Renfrow,DT,dead_cap,arizona-cardinals,2667,2015
772,0,2667,Brandon Sermons,CB,dead_cap,arizona-cardinals,2667,2015
773,0,2667,Kevin Smith,WR,dead_cap,arizona-cardinals,2667,2015
774,0,2666,C.J. Roberts,CB,dead_cap,arizona-cardinals,2666,2015
775,0,2333,Glenn Carson,ILB,dead_cap,arizona-cardinals,2333,2015
776,0,1666,Gannon Sinclair,TE,dead_cap,arizona-cardinals,1666,2015
777,0,1000,Andrae Kirk,ILB,dead_cap,arizona-cardinals,1000,2015
778,0,1000,Corey Washington,WR,dead_cap,arizona-cardinals,1000,2015
779,0,500,Edwin Jackson,ILB,dead_cap,arizona-cardinals,500,2015
780,0,334,Kelsey Pope,WR,dead_cap,arizona-cardinals,334,2015
781,0,334,Todd Washington,CB,dead_cap,arizona-cardinals,334,2015
782,0,166,Paul Lasike,RB,dead_cap,arizona-cardinals,166,2015
783,4900000,13475000,Carson Palmer,QB,active,arizona-cardinals,18375000,2016
784,11000000,4850000,Larry Fitzgerald,WR,active,arizona-cardinals,15850000,2016
785,9500000,8250000,Calais Campbell,DE,active,arizona-cardinals,17750000,2016
786,6577059,3956965,Patrick Peterson,CB,active,arizona-cardinals,10534024,2016
787,7799000,0,Chandler Jones,OLB,active,arizona-cardinals,7799000,2016
788,2500000,1700000,Mike Iupati,G,active,arizona-cardinals,4200000,2016
789,3000000,468750,Jermaine Gresham,TE,active,arizona-cardinals,3468750,2016
790,1000000,2250000,Justin Bethel,CB,active,arizona-cardinals,3250000,2016
791,1750000,816666,Corey Peters,DT,active,arizona-cardinals,2566666,2016
792,1000000,1500000,Drew Stanton,QB,active,arizona-cardinals,2500000,2016
793,840096,1185384,D.J. Humphries,LT,active,arizona-cardinals,2025480,2016
794,1671000,118607,Alex Okafor,DE,active,arizona-cardinals,1789607,2016
795,1671000,25966,Andre Ellington,RB,active,arizona-cardinals,1696966,2016
796,1671000,0,D.J. Swearinger,FS,active,arizona-cardinals,1671000,2016
797,450000,1113745,Robert Nkemdiche,DE,active,arizona-cardinals,1563745,2016
798,1003667,393236,Kevin Minter,ILB,active,arizona-cardinals,1396903,2016
799,1000000,353125,Frostee Rucker,DT,active,arizona-cardinals,1353125,2016
800,613106,277424,Markus Golden,OLB,active,arizona-cardinals,890530,2016
801,760000,75000,A.Q. Shipley,C,active,arizona-cardinals,835000,2016
802,675000,108716,Earl Watford,RT,active,arizona-cardinals,783716,2016
803,618000,141890,Kareem Martin,OLB,active,arizona-cardinals,759890,2016
804,612000,135725,John Brown,WR,active,arizona-cardinals,747725,2016
805,675000,50125,Stepfan Taylor,RB,active,arizona-cardinals,725125,2016
806,525000,183843,David Johnson,RB,active,arizona-cardinals,708843,2016
807,675000,0,Marcus Cooper,CB,active,arizona-cardinals,675000,2016
808,525000,127479,Rodney Gunter,DT,active,arizona-cardinals,652479,2016
809,600000,46685,Ed Stinson,DE,active,arizona-cardinals,646685,2016
810,450000,168173,Brandon Williams,CB,active,arizona-cardinals,618173,2016
811,600000,500,Chandler Catanzaro,K,active,arizona-cardinals,600500,2016
812,600000,0,Darren Fells,TE,active,arizona-cardinals,600000,2016
813,600000,0,Josh Mauro,DT,active,arizona-cardinals,600000,2016
814,525000,52450,J.J. Nelson,WR,active,arizona-cardinals,577450,2016
815,450000,126620,Evan Boehm,G,active,arizona-cardinals,576620,2016
816,555882,0,Aaron Brewer,LS,active,arizona-cardinals,555882,2016
817,525000,2666,Xavier Williams,DT,active,arizona-cardinals,527666,2016
818,450000,46096,Cole Toner,G,active,arizona-cardinals,496096,2016
819,458823,0,Brittan Golden,WR,active,arizona-cardinals,458823,2016
820,450000,0,Olsen Pierre,DT,active,arizona-cardinals,450000,2016
821,450000,0,John Wetzel,RT,active,arizona-cardinals,450000,2016
822,423529,0,Kerwynn Williams,RB,active,arizona-cardinals,423529,2016
823,344117,0,Hakeem Valles,TE,active,arizona-cardinals,344117,2016
824,268235,0,Sio Moore,OLB,active,arizona-cardinals,268235,2016
825,247058,0,Zaviar Gooden,ILB,active,arizona-cardinals,247058,2016
826,158820,0,Marquis Bundy,WR,active,arizona-cardinals,158820,2016
827,119117,0,Jeremy Ross,WR,active,arizona-cardinals,119117,2016
828,92646,0,Zac Dysert,QB,active,arizona-cardinals,92646,2016
829,79410,0,Givens Price,T,active,arizona-cardinals,79410,2016
830,79410,0,Matt Wile,P,active,arizona-cardinals,79410,2016
831,79410,0,Scooby Wright,ILB,active,arizona-cardinals,79410,2016
832,52940,0,Trevon Hartfield,S,active,arizona-cardinals,52940,2016
833,52940,0,Harlan Miller,CB,active,arizona-cardinals,52940,2016
834,35294,0,Brian Dixon,CB,active,arizona-cardinals,35294,2016
835,30882,0,Christian Bryant,FS,active,arizona-cardinals,30882,2016
836,1250000,3750000,Jared Veldheer,RT,injured_reserve,arizona-cardinals,5000000,2016
837,1000000,3337657,Tyrann Mathieu,FS,injured_reserve,arizona-cardinals,4337657,2016
838,1006900,3000000,Evan Mathis,G,injured_reserve,arizona-cardinals,4006900,2016
839,1250000,2250000,Tyvon Branch,SS,injured_reserve,arizona-cardinals,3500000,2016
840,1120837,981673,Deone Bucannon,ILB,injured_reserve,arizona-cardinals,2102510,2016
841,1671000,0,Tony Jefferson,SS,injured_reserve,arizona-cardinals,1671000,2016
842,1260882,317500,Jaron Brown,WR,injured_reserve,arizona-cardinals,1578382,2016
843,885000,615000,Chris Johnson,RB,injured_reserve,arizona-cardinals,1500000,2016
844,785755,311509,Troy Niklas,TE,injured_reserve,arizona-cardinals,1097264,2016
845,885000,0,Mike Jenkins,CB,injured_reserve,arizona-cardinals,885000,2016
846,450000,0,Gabe Martin,ILB,injured_reserve,arizona-cardinals,450000,2016
847,379234,5666,Alani Fua,OLB,injured_reserve,arizona-cardinals,384900,2016
848,370588,0,Ulrick John,LT,injured_reserve,arizona-cardinals,370588,2016
849,370580,0,Ifeanyi Momah,TE,injured_reserve,arizona-cardinals,370580,2016
850,357354,0,Taylor Boggs,G,injured_reserve,arizona-cardinals,357354,2016
851,333000,0,Elie Bouka,CB,injured_reserve,arizona-cardinals,333000,2016
852,62100,0,Brian Leonhardt,TE,practice_squad,arizona-cardinals,62100,2016
853,20700,0,Aaron Epps,T,practice_squad,arizona-cardinals,20700,2016
854,6028236,0,Michael Floyd,WR,dead_cap,arizona-cardinals,6028236,2016
855,0,2240273,Jonathan Cooper,G,dead_cap,arizona-cardinals,2240273,2016
856,858823,150000,Drew Butler,P,dead_cap,arizona-cardinals,1008823,2016
857,0,1000000,Cory Redding,DE,dead_cap,arizona-cardinals,1000000,2016
858,595575,0,Tharold Simon,CB,dead_cap,arizona-cardinals,595575,2016
859,317647,0,Joplo Bartu,OLB,dead_cap,arizona-cardinals,317647,2016
860,277941,0,Ryan Quigley,P,dead_cap,arizona-cardinals,277941,2016
861,0,216046,Logan Thomas,TE,dead_cap,arizona-cardinals,216046,2016
862,185290,0,Durell Eskridge,FS,dead_cap,arizona-cardinals,185290,2016
863,151129,0,Christian Bryant,FS,dead_cap,arizona-cardinals,151129,2016
864,147280,0,Chris Hubert,WR,dead_cap,arizona-cardinals,147280,2016
865,103500,29499,Harlan Miller,CB,dead_cap,arizona-cardinals,132999,2016
866,79410,52550,Marqui Christian,S,dead_cap,arizona-cardinals,131960,2016
867,120582,0,Zac Dysert,QB,dead_cap,arizona-cardinals,120582,2016
868,117300,0,Elijhaa Penny,RB,dead_cap,arizona-cardinals,117300,2016
869,96600,0,Trevon Hartfield,S,dead_cap,arizona-cardinals,96600,2016
870,96600,0,Kaleb Johnson,T,dead_cap,arizona-cardinals,96600,2016
871,96600,0,Givens Price,T,dead_cap,arizona-cardinals,96600,2016
872,89700,0,Nordly Capi,OLB,dead_cap,arizona-cardinals,89700,2016
873,79410,0,Kameron Canaday,LS,dead_cap,arizona-cardinals,79410,2016
874,20700,52958,Shaquille Riddick,OLB,dead_cap,arizona-cardinals,73658,2016
875,69000,0,Marquis Bundy,WR,dead_cap,arizona-cardinals,69000,2016
876,26470,40000,Tristan Okpalaugo,DE,dead_cap,arizona-cardinals,66470,2016
877,27600,2333,Hakeem Valles,TE,dead_cap,arizona-cardinals,29933,2016
878,27600,0,Brittan Golden,WR,dead_cap,arizona-cardinals,27600,2016
879,27600,0,Reshard Cliett,OLB,dead_cap,arizona-cardinals,27600,2016
880,26470,0,Lamar Louis,ILB,dead_cap,arizona-cardinals,26470,2016
881,0,25000,Red Bryant,DE,dead_cap,arizona-cardinals,25000,2016
882,0,25000,Shaun Prater,CB,dead_cap,arizona-cardinals,25000,2016
883,0,21000,Jaxon Shipley,WR,dead_cap,arizona-cardinals,21000,2016
884,20700,0,Marvin Hall,WR,dead_cap,arizona-cardinals,20700,2016
885,20700,0,Ifeanyi Momah,TE,dead_cap,arizona-cardinals,20700,2016
886,0,20000,Matt Barkley,QB,dead_cap,arizona-cardinals,20000,2016
887,0,20000,Chris Clemons,FS,dead_cap,arizona-cardinals,20000,2016
888,13800,0,Zaviar Gooden,ILB,dead_cap,arizona-cardinals,13800,2016
889,13800,0,Ronald Zamort,CB,dead_cap,arizona-cardinals,13800,2016
890,13800,0,Martin Wallace,LT,dead_cap,arizona-cardinals,13800,2016
891,0,13196,Gerald Christian,TE,dead_cap,arizona-cardinals,13196,2016
892,0,10000,Rob Crisp,LT,dead_cap,arizona-cardinals,10000,2016
893,6900,0,Cam Johnson,OLB,dead_cap,arizona-cardinals,6900,2016
894,6900,0,Daniel Munyer,C,dead_cap,arizona-cardinals,6900,2016
895,6900,0,Aaron Murray,QB,dead_cap,arizona-cardinals,6900,2016
896,6900,0,Matt Wile,P,dead_cap,arizona-cardinals,6900,2016
897,0,5334,C.J. Roberts,CB,dead_cap,arizona-cardinals,5334,2016
898,0,3334,Gannon Sinclair,TE,dead_cap,arizona-cardinals,3334,2016
899,0,3000,Gabe Martin,ILB,dead_cap,arizona-cardinals,3000,2016
900,0,2667,Cariel Brooks,CB,dead_cap,arizona-cardinals,2667,2016
901,0,2666,Zack Wagenmann,DE,dead_cap,arizona-cardinals,2666,2016
902,0,2334,Glenn Carson,ILB,dead_cap,arizona-cardinals,2334,2016
903,0,2000,Jared Baker,RB,dead_cap,arizona-cardinals,2000,2016
904,0,2000,Andrae Kirk,ILB,dead_cap,arizona-cardinals,2000,2016
905,0,1666,Jake Coker,QB,dead_cap,arizona-cardinals,1666,2016
906,0,1000,Edwin Jackson,ILB,dead_cap,arizona-cardinals,1000,2016
907,0,666,Chris King,WR,dead_cap,arizona-cardinals,666,2016
908,0,334,Paul Lasike,RB,dead_cap,arizona-cardinals,334,2016
909,0,334,Damond Powell,WR,dead_cap,arizona-cardinals,334,2016
910,11000000,4850000,Larry Fitzgerald,WR,active,arizona-cardinals,15850000,2017
911,9750000,3956965,Patrick Peterson,CB,active,arizona-cardinals,13706965,2017
912,7000000,3000000,Chandler Jones,OLB,active,arizona-cardinals,10000000,2017
913,4750000,3350000,Tyrann Mathieu,FS,active,arizona-cardinals,8100000,2017
914,2750000,1597918,Corey Peters,DT,active,arizona-cardinals,4347918,2017
915,2550000,1500000,Drew Stanton,QB,active,arizona-cardinals,4050000,2017
916,2000000,1750000,Jermaine Gresham,TE,active,arizona-cardinals,3750000,2017
917,2000000,1500000,Justin Bethel,CB,active,arizona-cardinals,3500000,2017
918,2000000,500000,Phil Dawson,K,active,arizona-cardinals,2500000,2017
919,750000,1750000,Josh Mauro,DT,active,arizona-cardinals,2500000,2017
920,1471255,981673,Deone Bucannon,ILB,active,arizona-cardinals,2452928,2017
921,465000,1985539,Haason Reddick,ILB,active,arizona-cardinals,2450539,2017
922,1000000,1250000,Karlos Dansby,ILB,active,arizona-cardinals,2250000,2017
923,840936,1113745,Robert Nkemdiche,DE,active,arizona-cardinals,1954681,2017
924,1100000,850000,Tramon Williams,CB,active,arizona-cardinals,1950000,2017
925,900000,1037500,Alex Boone,G,active,arizona-cardinals,1937500,2017
926,1797000,135725,John Brown,WR,active,arizona-cardinals,1932725,2017
927,775000,862500,A.Q. Shipley,C,active,arizona-cardinals,1637500,2017
928,1000000,362500,Andy Lee,P,active,arizona-cardinals,1362500,2017
929,775000,536250,Jaron Brown,WR,active,arizona-cardinals,1311250,2017
930,968632,311509,Troy Niklas,TE,active,arizona-cardinals,1280141,2017
931,465000,776819,Budda Baker,SS,active,arizona-cardinals,1241819,2017
932,1000000,80000,Frostee Rucker,DT,active,arizona-cardinals,1080000,2017
933,775000,120000,Blaine Gabbert,QB,active,arizona-cardinals,895000,2017
934,710000,141890,Kareem Martin,OLB,active,arizona-cardinals,851890,2017
935,615000,127479,Rodney Gunter,DT,active,arizona-cardinals,742479,2017
936,563500,168173,Brandon Williams,CB,active,arizona-cardinals,731673,2017
937,690000,0,Kerwynn Williams,RB,active,arizona-cardinals,690000,2017
938,615000,52450,J.J. Nelson,WR,active,arizona-cardinals,667450,2017
939,540000,126620,Evan Boehm,G,active,arizona-cardinals,666620,2017
940,465000,176572,Chad Williams,WR,active,arizona-cardinals,641572,2017
941,615000,2668,Xavier Williams,DT,active,arizona-cardinals,617668,2017
942,775000,0,Josh Bynes,OLB,active,arizona-cardinals,775000,2017
943,592647,0,Earl Watford,RT,active,arizona-cardinals,592647,2017
944,540647,0,Aaron Brewer,LS,active,arizona-cardinals,540647,2017
945,540000,0,Olsen Pierre,DT,active,arizona-cardinals,540000,2017
946,540000,0,John Wetzel,RT,active,arizona-cardinals,540000,2017
947,465000,67032,Will Holden,T,active,arizona-cardinals,532032,2017
948,508235,0,D.J. Foster,WR,active,arizona-cardinals,508235,2017
949,465000,0,Elijhaa Penny,RB,active,arizona-cardinals,465000,2017
950,412945,0,Scooby Wright,ILB,active,arizona-cardinals,412945,2017
951,410294,0,Ricky Seals-Jones,TE,active,arizona-cardinals,410294,2017
952,319118,0,Matt Barkley,QB,active,arizona-cardinals,319118,2017
953,254118,0,Max Tuerk,C,active,arizona-cardinals,254118,2017
954,246177,0,Bryson Albright,OLB,active,arizona-cardinals,246177,2017
955,176471,0,Khalif Barnes,LT,active,arizona-cardinals,176471,2017
956,158825,0,Gabe Martin,ILB,active,arizona-cardinals,158825,2017
957,127059,0,Harlan Miller,CB,active,arizona-cardinals,127059,2017
958,95295,0,C.J. Goodwin,S,active,arizona-cardinals,95295,2017
959,95294,0,Gabe Holmes,TE,active,arizona-cardinals,95294,2017
960,95294,0,Vinston Painter,RT,active,arizona-cardinals,95294,2017
961,63529,0,Bronson Hill,RB,active,arizona-cardinals,63529,2017
962,36176,0,Edmond Robinson,OLB,active,arizona-cardinals,36176,2017
963,15500000,8625000,Carson Palmer,QB,injured_reserve,arizona-cardinals,24125000,2017
964,6500000,3500000,Jared Veldheer,RT,injured_reserve,arizona-cardinals,10000000,2017
965,8000000,1700000,Mike Iupati,G,injured_reserve,arizona-cardinals,9700000,2017
966,2000000,1416666,Antoine Bethea,SS,injured_reserve,arizona-cardinals,3416666,2017
967,1245192,1185384,D.J. Humphries,LT,injured_reserve,arizona-cardinals,2430576,2017
968,1000000,1187500,Tyvon Branch,SS,injured_reserve,arizona-cardinals,2187500,2017
969,791212,277424,Markus Golden,OLB,injured_reserve,arizona-cardinals,1068636,2017
970,615000,184843,David Johnson,RB,injured_reserve,arizona-cardinals,799843,2017
971,705882,0,Adrian Peterson,RB,injured_reserve,arizona-cardinals,705882,2017
972,690000,0,Brittan Golden,WR,injured_reserve,arizona-cardinals,690000,2017
973,437469,35045,Johnathan Ford,S,injured_reserve,arizona-cardinals,472514,2017
974,467121,0,Ifeanyi Momah,TE,injured_reserve,arizona-cardinals,467121,2017
975,409937,0,Daniel Munyer,C,injured_reserve,arizona-cardinals,409937,2017
976,348000,50484,T.J. Logan,RB,injured_reserve,arizona-cardinals,398484,2017
977,348000,0,Ronald Zamort,CB,injured_reserve,arizona-cardinals,348000,2017
978,100800,0,Earl Okine,DE,practice_squad,arizona-cardinals,100800,2017
979,28800,0,K.J. Dillon,S,practice_squad,arizona-cardinals,28800,2017
980,0,5000000,Daryl Washington,ILB,dead_cap,arizona-cardinals,5000000,2017
981,0,1000000,Jarvis Jones,OLB,dead_cap,arizona-cardinals,1000000,2017
982,501471,130000,Andre Ellington,RB,dead_cap,arizona-cardinals,631471,2017
983,335294,100000,Chris Johnson,RB,dead_cap,arizona-cardinals,435294,2017
984,476471,0,Justin Drescher,LS,dead_cap,arizona-cardinals,476471,2017
985,142729,88499,Harlan Miller,CB,dead_cap,arizona-cardinals,231228,2017
986,36000,164095,Dorian Johnson,G,dead_cap,arizona-cardinals,200095,2017
987,182859,4333,Carlton Agudosi,WR,dead_cap,arizona-cardinals,187192,2017
988,171705,0,Vinston Painter,RT,dead_cap,arizona-cardinals,171705,2017
989,0,157651,Marqui Christian,S,dead_cap,arizona-cardinals,157651,2017
990,144704,0,Aaron Dobson,WR,dead_cap,arizona-cardinals,144704,2017
991,52941,80000,Philip Wheeler,OLB,dead_cap,arizona-cardinals,132941,2017
992,122400,0,Pasoni Tasini,DE,dead_cap,arizona-cardinals,122400,2017
993,0,105916,Shaquille Riddick,OLB,dead_cap,arizona-cardinals,105916,2017
994,100800,0,Anthony Denham,TE,dead_cap,arizona-cardinals,100800,2017
995,40588,46685,Ed Stinson,DE,dead_cap,arizona-cardinals,87273,2017
996,79200,0,Peli Anau,DT,dead_cap,arizona-cardinals,79200,2017
997,72352,5668,Alani Fua,OLB,dead_cap,arizona-cardinals,78020,2017
998,70729,0,Bronson Hill,RB,dead_cap,arizona-cardinals,70729,2017
999,57600,0,Bryson Albright,OLB,dead_cap,arizona-cardinals,57600,2017
1000,57600,0,Connor Harris,FB,dead_cap,arizona-cardinals,57600,2017
1001,53365,0,Scooby Wright,ILB,dead_cap,arizona-cardinals,53365,2017
1002,50576,0,Ulrick John,LT,dead_cap,arizona-cardinals,50576,2017
1003,50400,0,Jarell Carter,CB,dead_cap,arizona-cardinals,50400,2017
1004,0,50000,Drew Butler,P,dead_cap,arizona-cardinals,50000,2017
1005,49827,0,Jim Dray,TE,dead_cap,arizona-cardinals,49827,2017
1006,0,46096,Cole Toner,G,dead_cap,arizona-cardinals,46096,2017
1007,43200,0,Alonzo Russell,WR,dead_cap,arizona-cardinals,43200,2017
1008,36000,0,Mike Bercovici,QB,dead_cap,arizona-cardinals,36000,2017
1009,36000,0,Darius Victor,RB,dead_cap,arizona-cardinals,36000,2017
1010,28800,0,Obum Gwacham,DE,dead_cap,arizona-cardinals,28800,2017
1011,0,26392,Gerald Christian,TE,dead_cap,arizona-cardinals,26392,2017
1012,21600,0,Storm Norton,T,dead_cap,arizona-cardinals,21600,2017
1013,21600,0,Kevin Snyder,ILB,dead_cap,arizona-cardinals,21600,2017
1014,21600,0,Vontarrius Dora,OLB,dead_cap,arizona-cardinals,21600,2017
1015,14400,0,Gabe Holmes,TE,dead_cap,arizona-cardinals,14400,2017
1016,14400,0,Givens Price,T,dead_cap,arizona-cardinals,14400,2017
1017,14400,0,Rashad Ross,WR,dead_cap,arizona-cardinals,14400,2017
1018,14400,0,Ricky Seals-Jones,TE,dead_cap,arizona-cardinals,14400,2017
1019,0,8333,Sojourn Shelton,CB,dead_cap,arizona-cardinals,8333,2017
1020,7200,0,Javarius Leamon,T,dead_cap,arizona-cardinals,7200,2017
1021,7200,0,Ryan Lewis,CB,dead_cap,arizona-cardinals,7200,2017
1022,7200,0,Jonathan Moxey,CB,dead_cap,arizona-cardinals,7200,2017
1023,7200,0,Edmond Robinson,OLB,dead_cap,arizona-cardinals,7200,2017
1024,7200,0,James Summers,RB,dead_cap,arizona-cardinals,7200,2017
1025,0,4667,Hakeem Valles,TE,dead_cap,arizona-cardinals,4667,2017
1026,0,3334,Jake Coker,QB,dead_cap,arizona-cardinals,3334,2017
1027,0,2668,Zack Wagenmann,DE,dead_cap,arizona-cardinals,2668,2017
1028,0,1334,Chris King,WR,dead_cap,arizona-cardinals,1334,2017
1029,11000000,8200000,Larry Fitzgerald,WR,active,arizona-cardinals,19200000,2018
1030,12500000,3000000,Chandler Jones,DE,active,arizona-cardinals,15500000,2018
1031,11000000,3956965,Patrick Peterson,CB,active,arizona-cardinals,14956965,2018
1032,8718000,0,Deone Bucannon,OLB,active,arizona-cardinals,8718000,2018
1033,5250000,1968750,Jermaine Gresham,TE,active,arizona-cardinals,7218750,2018
1034,1882500,3159844,David Johnson,RB,active,arizona-cardinals,5042344,2018
1035,1015000,2643541,Antoine Bethea,FS,active,arizona-cardinals,3658541,2018
1036,480000,2719592,Josh Rosen,QB,active,arizona-cardinals,3199592,2018
1037,1077635,1985539,Haason Reddick,OLB,active,arizona-cardinals,3063174,2018
1038,1250000,1390625,Corey Peters,DT,active,arizona-cardinals,2640625,2018
1039,1015000,1612500,Andy Lee,P,active,arizona-cardinals,2627500,2018
1040,1000000,1475000,Tre Boston,FS,active,arizona-cardinals,2475000,2018
1041,1000000,1000000,Mike Glennon,QB,active,arizona-cardinals,2000000,2018
1042,1907000,52450,J.J. Nelson,WR,active,arizona-cardinals,1959450,2018
1043,775455,776819,Budda Baker,SS,active,arizona-cardinals,1552274,2018
1044,790000,544375,Benson Mayowa,DE,active,arizona-cardinals,1334375,2018
1045,969318,277424,Markus Golden,DE,active,arizona-cardinals,1246742,2018
1046,790000,93750,Aaron Brewer,LS,active,arizona-cardinals,883750,2018
1047,705000,127480,Rodney Gunter,DT,active,arizona-cardinals,832480,2018
1048,656000,168173,Brandon Williams,CB,active,arizona-cardinals,824173,2018
1049,581500,176572,Chad Williams,WR,active,arizona-cardinals,758072,2018
1050,705000,0,Zach Moore,DE,active,arizona-cardinals,705000,2018
1051,480000,190379,Mason Cole,C,active,arizona-cardinals,670379,2018
1052,790000,0,Derrick Coleman,FB,active,arizona-cardinals,790000,2018
1053,790000,0,Gerald Hodges,OLB,active,arizona-cardinals,790000,2018
1054,480000,113089,Chase Edmonds,RB,active,arizona-cardinals,593089,2018
1055,555000,35045,Johnathan Ford,S,active,arizona-cardinals,590045,2018
1056,555000,0,Daniel Munyer,C,active,arizona-cardinals,555000,2018
1057,555000,0,Ricky Seals-Jones,TE,active,arizona-cardinals,555000,2018
1058,480000,50484,T.J. Logan,RB,active,arizona-cardinals,530484,2018
1059,489706,0,Joe Walker,ILB,active,arizona-cardinals,489706,2018
1060,480000,3333,Trent Sherfield,WR,active,arizona-cardinals,483333,2018
1061,480000,2000,Dennis Gardeck,OLB,active,arizona-cardinals,482000,2018
1062,480000,1000,Ezekiel Turner,S,active,arizona-cardinals,481000,2018
1063,464710,0,Oday Aboushi,G,active,arizona-cardinals,464710,2018
1064,484416,0,John Phillips,TE,active,arizona-cardinals,484416,2018
1065,278824,0,David Amerson,CB,active,arizona-cardinals,278824,2018
1066,254115,0,Colby Gossett,G,active,arizona-cardinals,254115,2018
1067,225880,0,Zack Golditch,G,active,arizona-cardinals,225880,2018
1068,215294,0,Joe Barksdale,RT,active,arizona-cardinals,215294,2018
1069,176471,0,D.J. Swearinger,FS,active,arizona-cardinals,176471,2018
1070,163235,0,Darrell Daniels,TE,active,arizona-cardinals,163235,2018
1071,163235,0,Zane Gonzalez,K,active,arizona-cardinals,163235,2018
1072,163235,0,Will Holden,T,active,arizona-cardinals,163235,2018
1073,163235,0,Cameron Malveaux,DE,active,arizona-cardinals,163235,2018
1074,148236,0,Rees Odhiambo,T,active,arizona-cardinals,148236,2018
1075,130588,0,Vontarrius Dora,OLB,active,arizona-cardinals,130588,2018
1076,112940,0,Jalen Tolliver,WR,active,arizona-cardinals,112940,2018
1077,97941,0,Vincent Valentine,DT,active,arizona-cardinals,97941,2018
1078,74118,0,Pharoh Cooper,WR,active,arizona-cardinals,74118,2018
1079,56470,0,Chris Jones,S,active,arizona-cardinals,56470,2018
1080,28235,0,Malachi Dupre,WR,active,arizona-cardinals,28235,2018
1081,28235,0,Pasoni Tasini,DE,active,arizona-cardinals,28235,2018
1082,915000,3742500,Mike Iupati,G,injured_reserve,arizona-cardinals,4657500,2018
1083,2500000,1000000,Phil Dawson,K,injured_reserve,arizona-cardinals,3500000,2018
1084,1000000,2250000,Justin Pugh,G,injured_reserve,arizona-cardinals,3250000,2018
1085,1450288,1385384,D.J. Humphries,LT,injured_reserve,arizona-cardinals,2835672,2018
1086,1231873,1113745,Robert Nkemdiche,DT,injured_reserve,arizona-cardinals,2345618,2018
1087,790000,717500,A.Q. Shipley,C,injured_reserve,arizona-cardinals,1507500,2018
1088,790000,460515,Josh Bynes,ILB,injured_reserve,arizona-cardinals,1250515,2018
1089,480000,591794,Christian Kirk,WR,injured_reserve,arizona-cardinals,1071794,2018
1090,630000,0,Jeremy Cash,OLB,injured_reserve,arizona-cardinals,630000,2018
1091,630000,0,Olsen Pierre,DT,injured_reserve,arizona-cardinals,630000,2018
1092,630000,0,Jeremy Vujnovich,LT,injured_reserve,arizona-cardinals,630000,2018
1093,630000,0,John Wetzel,RT,injured_reserve,arizona-cardinals,630000,2018
1094,473112,17267,Korey Cunningham,T,injured_reserve,arizona-cardinals,490379,2018
1095,393000,0,D.J. Foster,WR,injured_reserve,arizona-cardinals,393000,2018
1096,393000,0,Gabe Martin,ILB,injured_reserve,arizona-cardinals,393000,2018
1097,363000,4000,Jonathan Owens,S,injured_reserve,arizona-cardinals,367000,2018
1098,185295,0,Thurston Armbrister,OLB,injured_reserve,arizona-cardinals,185295,2018
1099,5000000,5937500,Sam Bradford,QB,dead_cap,arizona-cardinals,10937500,2018
1100,0,9300000,Tyrann Mathieu,FS,dead_cap,arizona-cardinals,9300000,2018
1101,0,6625000,Carson Palmer,QB,dead_cap,arizona-cardinals,6625000,2018
1102,0,3250000,Jared Veldheer,RT,dead_cap,arizona-cardinals,3250000,2018
1103,915000,1542500,Andre Smith,RT,dead_cap,arizona-cardinals,2457500,2018
1104,630882,431250,Jamar Taylor,CB,dead_cap,arizona-cardinals,1062132,2018
1105,790000,90000,Bene Benwikere,CB,dead_cap,arizona-cardinals,880000,2018
1106,705000,0,Jacquies Smith,OLB,dead_cap,arizona-cardinals,705000,2018
1107,0,500000,Josh Mauro,DT,dead_cap,arizona-cardinals,500000,2018
1108,0,492288,Dorian Johnson,G,dead_cap,arizona-cardinals,492288,2018
1109,364872,0,Gabe Holmes,TE,dead_cap,arizona-cardinals,364872,2018
1110,200000,150000,Brice Butler,WR,dead_cap,arizona-cardinals,350000,2018
1111,266045,0,Deatrick Nichols,CB,dead_cap,arizona-cardinals,266045,2018
1112,262337,0,Chad Kanoff,QB,dead_cap,arizona-cardinals,262337,2018
1113,261176,0,Blaine Clausell,T,dead_cap,arizona-cardinals,261176,2018
1114,232355,0,Kendall Wright,WR,dead_cap,arizona-cardinals,232355,2018
1115,322941,0,Leonard Johnson,CB,dead_cap,arizona-cardinals,322941,2018
1116,139412,0,Dontae Johnson,CB,dead_cap,arizona-cardinals,139412,2018
1117,134635,0,Chris Jones,S,dead_cap,arizona-cardinals,134635,2018
1118,0,126620,Evan Boehm,G,dead_cap,arizona-cardinals,126620,2018
1119,124412,0,Quinten Rollins,CB,dead_cap,arizona-cardinals,124412,2018
1120,121102,0,Jalen Tolliver,WR,dead_cap,arizona-cardinals,121102,2018
1121,115588,0,Arthur Moats,OLB,dead_cap,arizona-cardinals,115588,2018
1122,112941,0,Ifeadi Odenigbo,DE,dead_cap,arizona-cardinals,112941,2018
1123,111176,0,Eddie Pleasant,FS,dead_cap,arizona-cardinals,111176,2018
1124,0,92192,Cole Toner,G,dead_cap,arizona-cardinals,92192,2018
1125,83600,0,Coleman Shelton,T,dead_cap,arizona-cardinals,83600,2018
1126,83600,0,Brandon Wilds,RB,dead_cap,arizona-cardinals,83600,2018
1127,83600,0,Pasoni Tasini,DE,dead_cap,arizona-cardinals,83600,2018
1128,74118,0,Garrison Smith,DE,dead_cap,arizona-cardinals,74118,2018
1129,0,67032,Will Holden,T,dead_cap,arizona-cardinals,67032,2018
1130,63047,0,Vontarrius Dora,OLB,dead_cap,arizona-cardinals,63047,2018
1131,60800,0,Andrew Vollert,TE,dead_cap,arizona-cardinals,60800,2018
1132,53200,0,Rick Leonard,T,dead_cap,arizona-cardinals,53200,2018
1133,53200,0,Will House,G,dead_cap,arizona-cardinals,53200,2018
1134,0,42684,Chris Campbell,CB,dead_cap,arizona-cardinals,42684,2018
1135,41471,0,Jonathan Anderson,ILB,dead_cap,arizona-cardinals,41471,2018
1136,38000,0,Ufomba Kamalu,DE,dead_cap,arizona-cardinals,38000,2018
1137,35835,0,Matt McCrane,K,dead_cap,arizona-cardinals,35835,2018
1138,30400,0,Demetrious Cox,S,dead_cap,arizona-cardinals,30400,2018
1139,30400,0,Jalen Simmons,RB,dead_cap,arizona-cardinals,30400,2018
1140,30400,0,Vincent Valentine,DT,dead_cap,arizona-cardinals,30400,2018
1141,22800,0,Malachi Dupre,WR,dead_cap,arizona-cardinals,22800,2018
1142,22800,0,Alec James,DE,dead_cap,arizona-cardinals,22800,2018
1143,22800,0,Montay Crockett,WR,dead_cap,arizona-cardinals,22800,2018
1144,22800,0,Justin Evans,G,dead_cap,arizona-cardinals,22800,2018
1145,0,16667,Sojourn Shelton,CB,dead_cap,arizona-cardinals,16667,2018
1146,15200,0,B.J. Bello,ILB,dead_cap,arizona-cardinals,15200,2018
1147,15200,0,Daniel Braverman,WR,dead_cap,arizona-cardinals,15200,2018
1148,15200,0,Nigel Harris,OLB,dead_cap,arizona-cardinals,15200,2018
1149,15200,0,Jonathan Moxey,CB,dead_cap,arizona-cardinals,15200,2018
1150,15200,0,Elijhaa Penny,FB,dead_cap,arizona-cardinals,15200,2018
1151,15200,0,Bernard Reedy,WR,dead_cap,arizona-cardinals,15200,2018
1152,15200,0,Pete Robertson,OLB,dead_cap,arizona-cardinals,15200,2018
1153,15200,0,Kyle Friend,T,dead_cap,arizona-cardinals,15200,2018
1154,0,8667,Carlton Agudosi,WR,dead_cap,arizona-cardinals,8667,2018
1155,7600,0,Zane Gonzalez,K,dead_cap,arizona-cardinals,7600,2018
1156,7600,0,Denver Kirkland,G,dead_cap,arizona-cardinals,7600,2018
1157,7600,0,Fish Smithson,S,dead_cap,arizona-cardinals,7600,2018
1158,7600,0,Darian Thompson,FS,dead_cap,arizona-cardinals,7600,2018
1159,9500000,5333333,Chandler Jones,OLB,active,arizona-cardinals,14833333,2019
1160,11000000,750000,Larry Fitzgerald,WR,active,arizona-cardinals,11750000,2019
1161,5700000,3956250,David Johnson,RB,active,arizona-cardinals,9656250,2019
1162,9625000,0,D.J. Humphries,LT,active,arizona-cardinals,9625000,2019
1163,7117647,884588,Patrick Peterson,CB,active,arizona-cardinals,8002235,2019
1164,5000000,2750000,Justin Pugh,G,active,arizona-cardinals,7750000,2019
1165,2000000,4400000,Jordan Hicks,ILB,active,arizona-cardinals,6400000,2019
1166,495000,5897481,Kyler Murray,QB,active,arizona-cardinals,6392481,2019
1167,3250000,1437500,Corey Peters,DT,active,arizona-cardinals,4687500,2019
1168,1500000,2500000,J.R. Sweezy,G,active,arizona-cardinals,4000000,2019
1169,1690270,1985539,Haason Reddick,ILB,active,arizona-cardinals,3675809,2019
1170,2000000,0,Andy Lee,P,active,arizona-cardinals,2000000,2019
1171,1150000,818750,Charles Clay,TE,active,arizona-cardinals,1968750,2019
1172,1125000,750000,Brett Hundley,QB,active,arizona-cardinals,1875000,2019
1173,1085910,776819,Budda Baker,SS,active,arizona-cardinals,1862729,2019
1174,1100000,618750,Max Garcia,G,active,arizona-cardinals,1718750,2019
1175,805000,750000,A.Q. Shipley,C,active,arizona-cardinals,1555000,2019
1176,495000,957636,Byron Murphy,CB,active,arizona-cardinals,1452636,2019
1177,747948,591794,Christian Kirk,WR,active,arizona-cardinals,1339742,2019
1178,1072059,0,Kenyan Drake,RB,active,arizona-cardinals,1072059,2019
1179,805000,250000,Maxx Williams,TE,active,arizona-cardinals,1055000,2019
1180,930000,118750,Aaron Brewer,LS,active,arizona-cardinals,1048750,2019
1181,805000,195000,Cassius Marsh,OLB,active,arizona-cardinals,1000000,2019
1182,495000,346794,Andy Isabella,WR,active,arizona-cardinals,841794,2019
1183,570000,225879,Mason Cole,C,active,arizona-cardinals,795879,2019
1184,720000,0,Damiere Byrd,WR,active,arizona-cardinals,720000,2019
1185,570000,113089,Chase Edmonds,RB,active,arizona-cardinals,683089,2019
1186,662941,0,Chris Banjo,SS,active,arizona-cardinals,662941,2019
1187,645000,0,Zane Gonzalez,K,active,arizona-cardinals,645000,2019
1188,645000,0,Joe Walker,ILB,active,arizona-cardinals,645000,2019
1189,645000,0,Charles Washington,S,active,arizona-cardinals,645000,2019
1190,615588,0,Zach Kerr,DT,active,arizona-cardinals,615588,2019
1191,495000,87208,Deionte Thompson,S,active,arizona-cardinals,582208,2019
1192,495000,85730,Jalen Thompson,S,active,arizona-cardinals,580730,2019
1193,570000,3333,Trent Sherfield,WR,active,arizona-cardinals,573333,2019
1194,570000,2000,Dennis Gardeck,OLB,active,arizona-cardinals,572000,2019
1195,570000,1000,Ezekiel Turner,ILB,active,arizona-cardinals,571000,2019
1196,570000,0,Justin Murray,T,active,arizona-cardinals,570000,2019
1197,550588,0,Pharoh Cooper,WR,active,arizona-cardinals,550588,2019
1198,495000,52328,Keesean Johnson,WR,active,arizona-cardinals,547328,2019
1199,495000,47034,Lamont Gaillard,G,active,arizona-cardinals,542034,2019
1200,495000,18644,Michael Dogbe,DE,active,arizona-cardinals,513644,2019
1201,495000,18644,Joshua Miles,T,active,arizona-cardinals,513644,2019
1202,268232,0,Chris Jones,CB,active,arizona-cardinals,268232,2019
1203,203824,0,Miles Brown,DT,active,arizona-cardinals,203824,2019
1204,189412,0,Caraun Reid,DT,active,arizona-cardinals,189412,2019
1205,134118,0,Dan Arnold,WR,active,arizona-cardinals,134118,2019
1206,134118,0,Jalen Davis,CB,active,arizona-cardinals,134118,2019
1207,134118,0,Kylie Fitts,DE,active,arizona-cardinals,134118,2019
1208,75882,0,Vontarrius Dora,OLB,active,arizona-cardinals,75882,2019
1209,67058,0,Keishawn Bierria,ILB,active,arizona-cardinals,67058,2019
1210,58235,0,Andre Chachere,CB,active,arizona-cardinals,58235,2019
1211,29118,0,Drew Anderson,QB,active,arizona-cardinals,29118,2019
1212,4450000,1550000,Robert Alford,CB,injured_reserve,arizona-cardinals,6000000,2019
1213,4865000,50000,Marcus Gilbert,RT,injured_reserve,arizona-cardinals,4915000,2019
1214,1000000,750000,Rodney Gunter,DE,injured_reserve,arizona-cardinals,1750000,2019
1215,1125000,390625,Brooks Reed,OLB,injured_reserve,arizona-cardinals,1515625,2019
1216,941176,250000,Jordan Mills,RT,injured_reserve,arizona-cardinals,1191176,2019
1217,930000,232500,Clinton McDonald,DE,injured_reserve,arizona-cardinals,1162500,2019
1218,740500,168176,Brandon Williams,CB,injured_reserve,arizona-cardinals,908676,2019
1219,820000,0,Jonathan Bullard,DE,injured_reserve,arizona-cardinals,820000,2019
1220,446827,285684,Zach Allen,DE,injured_reserve,arizona-cardinals,732511,2019
1221,378000,201126,Hakeem Butler,WR,injured_reserve,arizona-cardinals,579126,2019
1222,570000,0,Kevin Peterson,CB,injured_reserve,arizona-cardinals,570000,2019
1223,519528,0,D.J. Foster,RB,injured_reserve,arizona-cardinals,519528,2019
1224,493235,0,Darrell Daniels,TE,injured_reserve,arizona-cardinals,493235,2019
1225,423000,95000,Josh Shaw,FS,injured_reserve,arizona-cardinals,518000,2019
1226,378000,2333,William Sweet,T,injured_reserve,arizona-cardinals,380333,2019
1227,151765,0,Tanner Vallejo,OLB,injured_reserve,arizona-cardinals,151765,2019
1228,136000,0,Johnnie Dixon,WR,injured_reserve,arizona-cardinals,136000,2019
1229,495000,0,Brett Toth,RT,non_fb_injury,arizona-cardinals,495000,2019
1230,96000,0,Justin Davis,RB,practice_squad,arizona-cardinals,96000,2019
1231,32000,0,Saeed Blacknall,WR,practice_squad,arizona-cardinals,32000,2019
1232,24000,0,Javier Edwards,DT,practice_squad,arizona-cardinals,24000,2019
1233,16000,0,Jamey Mosley,LB,practice_squad,arizona-cardinals,16000,2019
1234,0,8158776,Josh Rosen,QB,dead_cap,arizona-cardinals,8158776,2019
1235,2250000,3500000,Jermaine Gresham,TE,dead_cap,arizona-cardinals,5750000,2019
1236,0,5000000,Sam Bradford,QB,dead_cap,arizona-cardinals,5000000,2019
1237,2647059,2000000,Terrell Suggs,OLB,dead_cap,arizona-cardinals,4647059,2019
1238,4250000,62500,D.J. Swearinger,FS,dead_cap,arizona-cardinals,4312500,2019
1239,0,3742500,Mike Iupati,G,dead_cap,arizona-cardinals,3742500,2019
1240,0,3000000,Mike Glennon,QB,dead_cap,arizona-cardinals,3000000,2019
1241,1000000,2000000,Darius Philon,DT,dead_cap,arizona-cardinals,3000000,2019
1242,875000,1500000,Michael Crabtree,WR,dead_cap,arizona-cardinals,2375000,2019
1243,0,2159168,Antoine Bethea,FS,dead_cap,arizona-cardinals,2159168,2019
1244,0,1292500,Andre Smith,RT,dead_cap,arizona-cardinals,1292500,2019
1245,0,1213747,Robert Nkemdiche,DE,dead_cap,arizona-cardinals,1213747,2019
1246,764704,312500,Tramaine Brock,CB,dead_cap,arizona-cardinals,1077204,2019
1247,0,666667,Josh Bynes,ILB,dead_cap,arizona-cardinals,666667,2019
1248,0,400000,Kevin White,WR,dead_cap,arizona-cardinals,400000,2019
1249,357353,0,Trevor Williams,CB,dead_cap,arizona-cardinals,357353,2019
1250,284118,0,Zach Zenner,RB,dead_cap,arizona-cardinals,284118,2019
1251,233176,0,Chris Jones,CB,dead_cap,arizona-cardinals,233176,2019
1252,223765,0,Pete Robertson,OLB,dead_cap,arizona-cardinals,223765,2019
1253,0,176572,Chad Williams,WR,dead_cap,arizona-cardinals,176572,2019
1254,169412,0,Jeremy Vujnovich,G,dead_cap,arizona-cardinals,169412,2019
1255,164471,4667,Miles Brown,DT,dead_cap,arizona-cardinals,169138,2019
1256,162500,0,Kylie Fitts,DE,dead_cap,arizona-cardinals,162500,2019
1257,0,150000,Brice Butler,WR,dead_cap,arizona-cardinals,150000,2019
1258,136000,0,Johnnie Dixon,WR,dead_cap,arizona-cardinals,136000,2019
1259,136000,0,Sam Jones,C,dead_cap,arizona-cardinals,136000,2019
1260,0,134064,Will Holden,T,dead_cap,arizona-cardinals,134064,2019
1261,112000,18644,Caleb Wilson,TE,dead_cap,arizona-cardinals,130644,2019
1262,0,128054,Chris Campbell,CB,dead_cap,arizona-cardinals,128054,2019
1263,0,126620,Evan Boehm,G,dead_cap,arizona-cardinals,126620,2019
1264,121823,0,Darrell Daniels,TE,dead_cap,arizona-cardinals,121823,2019
1265,113823,0,Ramik Wilson,ILB,dead_cap,arizona-cardinals,113823,2019
1266,104000,1666,A.J. Richardson,WR,dead_cap,arizona-cardinals,105666,2019
1267,105412,0,Rees Odhiambo,T,dead_cap,arizona-cardinals,105412,2019
1268,104000,0,Jalen Davis,CB,dead_cap,arizona-cardinals,104000,2019
1269,96000,0,Kyle Sloter,QB,dead_cap,arizona-cardinals,96000,2019
1270,0,90000,Andre Branch,DE,dead_cap,arizona-cardinals,90000,2019
1271,0,90000,Terrell McClain,DT,dead_cap,arizona-cardinals,90000,2019
1272,58235,0,Ryan Winslow,P,dead_cap,arizona-cardinals,58235,2019
1273,56000,0,Sojourn Shelton,CB,dead_cap,arizona-cardinals,56000,2019
1274,0,50484,T.J. Logan,RB,dead_cap,arizona-cardinals,50484,2019
1275,40000,0,Vontarrius Dora,OLB,dead_cap,arizona-cardinals,40000,2019
1276,54706,0,Zach Brown,ILB,dead_cap,arizona-cardinals,54706,2019
1277,54706,0,Alfred Morris,RB,dead_cap,arizona-cardinals,54706,2019
1278,0,35045,Johnathan Ford,S,dead_cap,arizona-cardinals,35045,2019
1279,32000,0,Andre Chachere,CB,dead_cap,arizona-cardinals,32000,2019
1280,32000,0,Justin Davis,RB,dead_cap,arizona-cardinals,32000,2019
1281,32000,0,Lyndon Johnson,DE,dead_cap,arizona-cardinals,32000,2019
1282,24000,2333,Drew Anderson,QB,dead_cap,arizona-cardinals,26333,2019
1283,24000,0,Pita Taumoepenu,OLB,dead_cap,arizona-cardinals,24000,2019
1284,0,17267,Korey Cunningham,T,dead_cap,arizona-cardinals,17267,2019
1285,16000,0,Tanner Vallejo,OLB,dead_cap,arizona-cardinals,16000,2019
1286,8000,2333,Dante Booker,LB,dead_cap,arizona-cardinals,10333,2019
1287,8000,0,Ian Silberman,G,dead_cap,arizona-cardinals,8000,2019
1288,0,4000,Jonathan Owens,S,dead_cap,arizona-cardinals,4000,2019
1289,0,3333,Xavier Turner,RB,dead_cap,arizona-cardinals,3333,2019
1290,0,2666,Immanuel Turner,DT,dead_cap,arizona-cardinals,2666,2019
1291,0,2000,Tariq Cole,T,dead_cap,arizona-cardinals,2000,2019
1292,0,1333,Drew Belcher,TE,dead_cap,arizona-cardinals,1333,2019
1293,16000000,5333333,Chandler Jones,OLB,active,arizona-cardinals,21333333,2020
1294,10200000,3956250,David Johnson,RB,active,arizona-cardinals,14156250,2020
1295,12050000,1134588,Patrick Peterson,CB,active,arizona-cardinals,13184588,2020
1296,11000000,750000,Larry Fitzgerald,WR,active,arizona-cardinals,11750000,2020
1297,7250000,3250000,Justin Pugh,G,active,arizona-cardinals,10500000,2020
1298,6000000,4000000,Jordan Hicks,ILB,active,arizona-cardinals,10000000,2020
1299,585000,7405601,Kyler Murray,QB,active,arizona-cardinals,7990601,2020
1300,5950000,1550000,Robert Alford,CB,active,arizona-cardinals,7500000,2020
1301,3500000,2000000,J.R. Sweezy,G,active,arizona-cardinals,5500000,2020
1302,2302904,1985540,Haason Reddick,ILB,active,arizona-cardinals,4288444,2020
1303,3000000,1187500,Corey Peters,DT,active,arizona-cardinals,4187500,2020
1304,2850000,550000,Maxx Williams,TE,active,arizona-cardinals,3400000,2020
1305,1396364,776820,Budda Baker,SS,active,arizona-cardinals,2173184,2020
1306,2000000,0,Andy Lee,P,active,arizona-cardinals,2000000,2020
1307,858159,957636,Byron Murphy,CB,active,arizona-cardinals,1815795,2020
1308,1015897,591794,Christian Kirk,WR,active,arizona-cardinals,1607691,2020
1309,945000,118750,Aaron Brewer,LS,active,arizona-cardinals,1063750,2020
1310,705450,346794,Andy Isabella,WR,active,arizona-cardinals,1052244,2020
1311,690171,285684,Zach Allen,DE,active,arizona-cardinals,975855,2020
1312,660000,227629,Mason Cole,C,active,arizona-cardinals,887629,2020
1313,660000,113089,Chase Edmonds,RB,active,arizona-cardinals,773089,2020
1314,735000,0,Darrell Daniels,TE,active,arizona-cardinals,735000,2020
1315,735000,0,Tanner Vallejo,OLB,active,arizona-cardinals,735000,2020
1316,510000,201126,Hakeem Butler,WR,active,arizona-cardinals,711126,2020
1317,585000,87208,Deionte Thompson,S,active,arizona-cardinals,672208,2020
1318,585000,85730,Jalen Thompson,S,active,arizona-cardinals,670730,2020
1319,660000,3334,Trent Sherfield,WR,active,arizona-cardinals,663334,2020
1320,660000,2000,Dennis Gardeck,OLB,active,arizona-cardinals,662000,2020
1321,660000,1000,Ezekiel Turner,ILB,active,arizona-cardinals,661000,2020
1322,660000,0,Dan Arnold,WR,active,arizona-cardinals,660000,2020
1323,660000,0,Keishawn Bierria,ILB,active,arizona-cardinals,660000,2020
1324,660000,0,Jalen Davis,CB,active,arizona-cardinals,660000,2020
1325,660000,0,Vontarrius Dora,OLB,active,arizona-cardinals,660000,2020
1326,660000,0,Kylie Fitts,DE,active,arizona-cardinals,660000,2020
1327,660000,0,Chris Jones,CB,active,arizona-cardinals,660000,2020
1328,585000,52328,Keesean Johnson,WR,active,arizona-cardinals,637328,2020
1329,585000,47034,Lamont Gaillard,G,active,arizona-cardinals,632034,2020
1330,585000,18644,Michael Dogbe,DE,active,arizona-cardinals,603644,2020
1331,585000,18644,Joshua Miles,T,active,arizona-cardinals,603644,2020
1332,585000,0,Miles Brown,DT,active,arizona-cardinals,585000,2020
1333,585000,0,Lyndon Johnson,DE,active,arizona-cardinals,585000,2020
1334,585000,0,Sam Jones,C,active,arizona-cardinals,585000,2020
1335,585000,0,Brett Toth,RT,active,arizona-cardinals,585000,2020
1336,510000,2333,William Sweet,T,active,arizona-cardinals,512333,2020
1337,510000,0,Drew Anderson,QB,active,arizona-cardinals,510000,2020
1338,510000,0,Andre Chachere,CB,active,arizona-cardinals,510000,2020
1339,510000,0,Johnnie Dixon,WR,active,arizona-cardinals,510000,2020
1340,510000,0,A.J. Richardson,WR,active,arizona-cardinals,510000,2020
1341,510000,0,Sojourn Shelton,CB,active,arizona-cardinals,510000,2020
1342,510000,0,Duke Thomas,S,active,arizona-cardinals,510000,2020
1343,510000,0,Ryan Winslow,P,active,arizona-cardinals,510000,2020
1344,0,2000000,Darius Philon,DT,dead_cap,arizona-cardinals,2000000,2020
1345,0,2000000,Terrell Suggs,OLB,dead_cap,arizona-cardinals,2000000,2020
1346,0,176572,Chad Williams,WR,dead_cap,arizona-cardinals,176572,2020
1347,0,55932,Caleb Wilson,TE,dead_cap,arizona-cardinals,55932,2020
1348,0,50486,T.J. Logan,RB,dead_cap,arizona-cardinals,50486,2020
1349,0,35047,Johnathan Ford,S,dead_cap,arizona-cardinals,35047,2020
1350,0,34534,Korey Cunningham,T,dead_cap,arizona-cardinals,34534,2020
1351,0,9334,Miles Brown,DT,dead_cap,arizona-cardinals,9334,2020
1352,0,6667,Xavier Turner,RB,dead_cap,arizona-cardinals,6667,2020
1353,0,5334,Immanuel Turner,DT,dead_cap,arizona-cardinals,5334,2020
1354,0,4667,Drew Anderson,QB,dead_cap,arizona-cardinals,4667,2020
1355,0,4667,Dante Booker,LB,dead_cap,arizona-cardinals,4667,2020
1356,0,4000,Tariq Cole,T,dead_cap,arizona-cardinals,4000,2020
1357,0,4000,Jonathan Owens,S,dead_cap,arizona-cardinals,4000,2020
1358,0,3334,A.J. Richardson,WR,dead_cap,arizona-cardinals,3334,2020
1359,0,2667,Drew Belcher,TE,dead_cap,arizona-cardinals,2667,2020
1360,3250000,3028332,Warrick Dunn,RB,active,atlanta-falcons,6278332,2007
1361,4900000,3042226,Keith Brooking,LB,active,atlanta-falcons,7942226,2007
1362,2000000,4083333,John Abraham,OLB,active,atlanta-falcons,6083333,2007
1363,3110000,4225000,DeAngelo Hall,CB,active,atlanta-falcons,7335000,2007
1364,1000000,1375000,Joe Horn,WR,active,atlanta-falcons,2375000,2007
1365,2350000,0,Byron Leftwich,QB,active,atlanta-falcons,2350000,2007
1366,750000,1375000,Joey Harrington,QB,active,atlanta-falcons,2125000,2007
1367,285000,1744000,Jamaal Anderson,DE,active,atlanta-falcons,2029000,2007
1368,990000,750000,Brian Finneran,WR,active,atlanta-falcons,1740000,2007
1369,1000000,1000000,Todd McClure,C,active,atlanta-falcons,2000000,2007
1370,627500,1812500,Roddy White,WR,active,atlanta-falcons,2440000,2007
1371,1000000,500000,Ovie Mughelli,RB,active,atlanta-falcons,1500000,2007
1372,1460000,0,Courtney Anderson,TE,active,atlanta-falcons,1460000,2007
1373,285000,1033000,Justin Blalock,G,active,atlanta-falcons,1318000,2007
1374,1300000,0,Demorrio Williams,LB,active,atlanta-falcons,1300000,2007
1375,625000,986000,Michael Jenkins,WR,active,atlanta-falcons,1611000,2007
1376,360000,390000,Jimmy Williams,S,active,atlanta-falcons,750000,2007
1377,435000,287500,Jonathan Babineaux,DT,active,atlanta-falcons,722500,2007
1378,720000,0,Mike Schneck,LS,active,atlanta-falcons,720000,2007
1379,545000,145600,Chris Crocker,S,active,atlanta-falcons,690600,2007
1380,285000,392750,Chris Houston,CB,active,atlanta-falcons,677750,2007
1381,600000,50000,Kindal Moorehead,DT,active,atlanta-falcons,650000,2007
1382,360000,0,Jerious Norwood,RB,active,atlanta-falcons,360000,2007
1383,385000,100000,Chauncey Davis,DE,active,atlanta-falcons,485000,2007
1384,285000,190350,Laurent Robinson,WR,active,atlanta-falcons,475350,2007
1385,435000,38750,Frank Omiyale,T,active,atlanta-falcons,473750,2007
1386,595000,0,Chris Redman,QB,active,atlanta-falcons,595000,2007
1387,435000,0,Michael Koenen,P,active,atlanta-falcons,435000,2007
1388,435000,0,Corey McIntyre,FB,active,atlanta-falcons,435000,2007
1389,385000,39733,Michael Boley,LB,active,atlanta-falcons,424733,2007
1390,360000,45125,Quinn Ojinnaka,T,active,atlanta-falcons,405125,2007
1391,285000,116875,Stephen Nicholas,OLB,active,atlanta-falcons,401875,2007
1392,360000,23600,Adam Jennings,WR,active,atlanta-falcons,383600,2007
1393,285000,96575,Martrez Milner,TE,active,atlanta-falcons,381575,2007
1394,360000,0,D'Anthony Batiste,G,active,atlanta-falcons,360000,2007
1395,360000,0,Tyson Clabo,RT,active,atlanta-falcons,360000,2007
1396,360000,0,Terrance Pennington,T,active,atlanta-falcons,360000,2007
1397,360000,0,Ben Wilkerson,C,active,atlanta-falcons,360000,2007
1398,285000,23486,David Irons,CB,active,atlanta-falcons,308486,2007
1399,285000,21350,Daren Stone,S,active,atlanta-falcons,306350,2007
1400,275294,0,Harvey Dahl,G,active,atlanta-falcons,275294,2007
1401,270000,0,Tim Anderson,DT,active,atlanta-falcons,270000,2007
1402,201176,0,Travis Williams,CB,active,atlanta-falcons,201176,2007
1403,117352,0,Jason Snelling,RB,active,atlanta-falcons,117352,2007
1404,67058,0,Brent Grimes,CB,active,atlanta-falcons,67058,2007
1405,63529,0,Pat McCoy,T,active,atlanta-falcons,63529,2007
1406,1000000,2300000,Todd Weiner,T,injured_reserve,atlanta-falcons,3300000,2007
1407,285000,24406,Trey Lewis,DT,injured_reserve,atlanta-falcons,309406,2007
1408,205000,13437,D.J. Shockley,QB,injured_reserve,atlanta-falcons,218437,2007
1409,190000,22412,Doug Datish,C,injured_reserve,atlanta-falcons,212412,2007
1410,79900,0,George Cooper,TE,practice_squad,atlanta-falcons,79900,2007
1411,79900,0,Brent Grimes,CB,practice_squad,atlanta-falcons,79900,2007
1412,79900,0,Jason Snelling,RB,practice_squad,atlanta-falcons,79900,2007
1413,79900,0,Eric Weems,WR,practice_squad,atlanta-falcons,79900,2007
1414,79900,0,Travis Williams,CB,practice_squad,atlanta-falcons,79900,2007
1415,3307746,0,Patrick Kerney,DE,dead_cap,atlanta-falcons,3307746,2007
1416,250000,0,Bryan Scott,OLB,dead_cap,atlanta-falcons,250000,2007
1417,0,166668,Matt Lehr,C,dead_cap,atlanta-falcons,166668,2007
1418,155000,0,Jordan Beck,LB,dead_cap,atlanta-falcons,155000,2007
1419,80000,0,Casey Bramlet,QB,dead_cap,atlanta-falcons,80000,2007
1420,11000,0,Darrell Shropshire,DT,dead_cap,atlanta-falcons,11000,2007
1421,10100,0,Jason Snelling,RB,dead_cap,atlanta-falcons,10100,2007
1422,0,1500,Eric Weems,WR,dead_cap,atlanta-falcons,1500,2007
1423,0,500,Daniel Fells,TE,dead_cap,atlanta-falcons,500,2007
1424,6000000,2083333,John Abraham,OLB,active,atlanta-falcons,8083333,2008
1425,4900000,3042226,Keith Brooking,LB,active,atlanta-falcons,7942226,2008
1426,295000,6305000,Matt Ryan,QB,active,atlanta-falcons,6600000,2008
1427,2250000,2300000,Todd Weiner,T,active,atlanta-falcons,4550000,2008
1428,1000000,2500000,Michael Turner,RB,active,atlanta-falcons,3500000,2008
1429,2000000,500000,Von Hutchins,CB,active,atlanta-falcons,2500000,2008
1430,1750000,500000,Ovie Mughelli,RB,active,atlanta-falcons,2250000,2008
1431,370000,3666500,Jamaal Anderson,DE,active,atlanta-falcons,4036500,2008
1432,1000000,1375000,Chris Redman,QB,active,atlanta-falcons,2375000,2008
1433,1050000,1586000,Michael Jenkins,WR,active,atlanta-falcons,2636000,2008
1434,2017000,0,Michael Boley,LB,active,atlanta-falcons,2017000,2008
1435,1300000,1000000,Todd McClure,C,active,atlanta-falcons,2300000,2008
1436,295000,1445000,Curtis Lofton,ILB,active,atlanta-falcons,1740000,2008
1437,805500,1812500,Roddy White,WR,active,atlanta-falcons,2618000,2008
1438,650000,625000,Erik Coleman,S,active,atlanta-falcons,1275000,2008
1439,730000,750000,Brian Finneran,WR,active,atlanta-falcons,1480000,2008
1440,1417000,0,Michael Koenen,P,active,atlanta-falcons,1417000,2008
1441,520000,787500,Jonathan Babineaux,DT,active,atlanta-falcons,1307500,2008
1442,295000,960000,Sam Baker,LT,active,atlanta-falcons,1255000,2008
1443,927000,0,Chauncey Davis,DE,active,atlanta-falcons,927000,2008
1444,927000,0,Domonique Foxworth,CB,active,atlanta-falcons,927000,2008
1445,650000,175000,Alex Stepanovich,C,active,atlanta-falcons,825000,2008
1446,370000,423000,Justin Blalock,G,active,atlanta-falcons,793000,2008
1447,370000,392750,Chris Houston,CB,active,atlanta-falcons,762750,2008
1448,730000,0,Mike Schneck,LS,active,atlanta-falcons,730000,2008
1449,605000,50000,Kindal Moorehead,DT,active,atlanta-falcons,655000,2008
1450,445000,0,Jerious Norwood,RB,active,atlanta-falcons,445000,2008
1451,520000,40000,Simon Fraser,DE,active,atlanta-falcons,560000,2008
1452,520000,38750,Frank Omiyale,T,active,atlanta-falcons,558750,2008
1453,445000,45125,Quinn Ojinnaka,T,active,atlanta-falcons,490125,2008
1454,370000,116875,Stephen Nicholas,OLB,active,atlanta-falcons,486875,2008
1455,295000,176012,Harry Douglas,WR,active,atlanta-falcons,471012,2008
1456,445000,13437,D.J. Shockley,QB,active,atlanta-falcons,458437,2008
1457,605000,40000,Justin Peelle,TE,active,atlanta-falcons,645000,2008
1458,605000,0,Coy Wire,LS,active,atlanta-falcons,605000,2008
1459,445000,0,Tyson Clabo,RT,active,atlanta-falcons,445000,2008
1460,445000,0,Harvey Dahl,G,active,atlanta-falcons,445000,2008
1461,445000,0,Jamaal Fudge,S,active,atlanta-falcons,445000,2008
1462,445000,0,Ben Wilkerson,C,active,atlanta-falcons,445000,2008
1463,295000,145000,Thomas DeCoud,S,active,atlanta-falcons,440000,2008
1464,370000,0,Jason Snelling,RB,active,atlanta-falcons,370000,2008
1465,295000,43687,Kroy Biermann,OLB,active,atlanta-falcons,338687,2008
1466,295000,27125,Thomas Brown,RB,active,atlanta-falcons,322125,2008
1467,295000,0,Brent Grimes,CB,active,atlanta-falcons,295000,2008
1468,282941,0,Jason Rader,TE,active,atlanta-falcons,282941,2008
1469,200000,49731,Robert James,OLB,active,atlanta-falcons,249731,2008
1470,215000,24406,Trey Lewis,DT,active,atlanta-falcons,239406,2008
1471,104117,0,Eric Weems,WR,active,atlanta-falcons,104117,2008
1472,830000,0,Marcus Pollard,TE,active,atlanta-falcons,830000,2008
1473,34705,0,Eric Brock,S,active,atlanta-falcons,34705,2008
1474,370000,190350,Laurent Robinson,WR,injured_reserve,atlanta-falcons,560350,2008
1475,370000,23486,David Irons,CB,injured_reserve,atlanta-falcons,393486,2008
1476,230000,0,Pat McCoy,T,injured_reserve,atlanta-falcons,230000,2008
1477,88400,0,Eric Brock,S,practice_squad,atlanta-falcons,88400,2008
1478,88400,0,Willie Evans,DE,practice_squad,atlanta-falcons,88400,2008
1479,88400,0,Keith Zinger,TE,practice_squad,atlanta-falcons,88400,2008
1480,57200,0,Eric Weems,WR,practice_squad,atlanta-falcons,57200,2008
1481,3875000,0,DeAngelo Hall,CB,dead_cap,atlanta-falcons,3875000,2008
1482,2500000,875000,Joe Horn,WR,dead_cap,atlanta-falcons,3375000,2008
1483,0,1375000,Joey Harrington,QB,dead_cap,atlanta-falcons,1375000,2008
1484,0,833334,Warrick Dunn,RB,dead_cap,atlanta-falcons,833334,2008
1485,390000,0,Jimmy Williams,S,dead_cap,atlanta-falcons,390000,2008
1486,96575,0,Martrez Milner,TE,dead_cap,atlanta-falcons,96575,2008
1487,72800,0,D'Anthony Batiste,G,dead_cap,atlanta-falcons,72800,2008
1488,0,40000,Tim Anderson,DT,dead_cap,atlanta-falcons,40000,2008
1489,30300,0,Jason Snelling,RB,dead_cap,atlanta-falcons,30300,2008
1490,23150,0,Keith Zinger,TE,dead_cap,atlanta-falcons,23150,2008
1491,22412,0,Doug Datish,C,dead_cap,atlanta-falcons,22412,2008
1492,21350,0,Daren Stone,S,dead_cap,atlanta-falcons,21350,2008
1493,15300,0,Wilrey Fontenot,CB,dead_cap,atlanta-falcons,15300,2008
1494,0,1500,Eric Weems,WR,dead_cap,atlanta-falcons,1500,2008
1495,5000000,4900000,Matt Ryan,QB,active,atlanta-falcons,9900000,2009
1496,6000000,1200000,Roddy White,WR,active,atlanta-falcons,7200000,2009
1497,5000000,2083333,John Abraham,OLB,active,atlanta-falcons,7083333,2009
1498,2000000,4500000,Jonathan Babineaux,DT,active,atlanta-falcons,6500000,2009
1499,1500000,4586000,Michael Jenkins,WR,active,atlanta-falcons,6086000,2009
1500,4000000,500000,Tony Gonzalez,TE,active,atlanta-falcons,4500000,2009
1501,1000000,2500000,Michael Turner,RB,active,atlanta-falcons,3500000,2009
1502,2500000,500000,Ovie Mughelli,RB,active,atlanta-falcons,3000000,2009
1503,1750000,1375000,Chris Redman,QB,active,atlanta-falcons,3125000,2009
1504,766250,3666500,Jamaal Anderson,DE,active,atlanta-falcons,4432750,2009
1505,2000000,750000,Mike Peterson,LB,active,atlanta-falcons,2750000,2009
1506,2483000,0,Michael Koenen,P,active,atlanta-falcons,2483000,2009
1507,1400000,1000000,Todd McClure,C,active,atlanta-falcons,2400000,2009
1508,1250000,625000,Erik Coleman,S,active,atlanta-falcons,1875000,2009
1509,385000,2367500,Sam Baker,LT,active,atlanta-falcons,2752500,2009
1510,1545000,0,Tyson Clabo,RT,active,atlanta-falcons,1545000,2009
1511,1030000,416667,Justin Peelle,TE,active,atlanta-falcons,1446667,2009
1512,310000,890000,Peria Jerry,DT,active,atlanta-falcons,1200000,2009
1513,1100000,0,Matt Bryant,K,active,atlanta-falcons,1100000,2009
1514,1037000,0,Tye Hill,CB,active,atlanta-falcons,1037000,2009
1515,460000,423000,Justin Blalock,G,active,atlanta-falcons,883000,2009
1516,700000,175000,Brett Romberg,C,active,atlanta-falcons,875000,2009
1517,445000,410000,Curtis Lofton,ILB,active,atlanta-falcons,855000,2009
1518,460000,392750,Chris Houston,CB,active,atlanta-falcons,852750,2009
1519,745000,62500,Coy Wire,LS,active,atlanta-falcons,807500,2009
1520,535000,0,Jerious Norwood,RB,active,atlanta-falcons,535000,2009
1521,1600000,0,Brian Williams,CB,active,atlanta-falcons,1600000,2009
1522,310000,275000,William Moore,SS,active,atlanta-falcons,585000,2009
1523,535000,45125,Quinn Ojinnaka,T,active,atlanta-falcons,580125,2009
1524,460000,116875,Stephen Nicholas,OLB,active,atlanta-falcons,576875,2009
1525,385000,176012,Harry Douglas,WR,active,atlanta-falcons,561012,2009
1526,535000,0,Charlie Peprah,S,active,atlanta-falcons,535000,2009
1527,535000,0,Will Svitek,LT,active,atlanta-falcons,535000,2009
1528,385000,145000,Thomas DeCoud,S,active,atlanta-falcons,530000,2009
1529,460000,24406,Trey Lewis,DT,active,atlanta-falcons,484406,2009
1530,310000,172175,Christopher Owens,CB,active,atlanta-falcons,482175,2009
1531,845000,0,Joe Zelenka,LS,active,atlanta-falcons,845000,2009
1532,745000,0,Aaron Stecker,RB,active,atlanta-falcons,745000,2009
1533,460000,0,Jason Snelling,RB,active,atlanta-falcons,460000,2009
1534,385000,43687,Kroy Biermann,OLB,active,atlanta-falcons,428687,2009
1535,310000,111225,Lawrence Sidbury,OLB,active,atlanta-falcons,421225,2009
1536,385000,0,Brent Grimes,CB,active,atlanta-falcons,385000,2009
1537,385000,0,Eric Weems,WR,active,atlanta-falcons,385000,2009
1538,310000,45150,Garrett Reynolds,G,active,atlanta-falcons,355150,2009
1539,310000,29762,Spencer Adkins,OLB,active,atlanta-falcons,339762,2009
1540,310000,8750,John Parker Wilson,QB,active,atlanta-falcons,318750,2009
1541,310000,0,Keith Zinger,TE,active,atlanta-falcons,310000,2009
1542,437647,0,Verron Haynes,RB,active,atlanta-falcons,437647,2009
1543,273529,0,Vance Walker,DE,active,atlanta-falcons,273529,2009
1544,108235,0,Jason Rader,TE,active,atlanta-falcons,108235,2009
1545,88400,0,Robert James,OLB,active,atlanta-falcons,88400,2009
1546,88400,0,Antone Smith,RB,active,atlanta-falcons,88400,2009
1547,2000000,750000,Chauncey Davis,DE,active,atlanta-falcons,2750000,2009
1548,1545000,0,Harvey Dahl,G,injured_reserve,atlanta-falcons,1545000,2009
1549,500000,750000,Brian Finneran,WR,injured_reserve,atlanta-falcons,1250000,2009
1550,845000,0,Mike Schneck,LS,injured_reserve,atlanta-falcons,845000,2009
1551,535000,0,Jamaal Fudge,S,injured_reserve,atlanta-falcons,535000,2009
1552,96900,0,Vance Walker,DE,practice_squad,atlanta-falcons,96900,2009
1553,88400,0,Blake Schlueter,C,practice_squad,atlanta-falcons,88400,2009
1554,88400,0,D.J. Shockley,QB,practice_squad,atlanta-falcons,88400,2009
1555,7110000,0,Michael Vick,QB,dead_cap,atlanta-falcons,7110000,2009
1556,3800000,0,Todd Weiner,T,dead_cap,atlanta-falcons,3800000,2009
1557,0,2292226,Keith Brooking,LB,dead_cap,atlanta-falcons,2292226,2009
1558,0,1750000,Joe Horn,WR,dead_cap,atlanta-falcons,1750000,2009
1559,750000,0,Von Hutchins,CB,dead_cap,atlanta-falcons,750000,2009
1560,390000,0,Jimmy Williams,S,dead_cap,atlanta-falcons,390000,2009
1561,0,380700,Laurent Robinson,WR,dead_cap,atlanta-falcons,380700,2009
1562,193150,0,Martrez Milner,TE,dead_cap,atlanta-falcons,193150,2009
1563,175000,0,Alex Stepanovich,C,dead_cap,atlanta-falcons,175000,2009
1564,51725,0,William Middleton,CB,dead_cap,atlanta-falcons,51725,2009
1565,50000,0,Kindal Moorehead,DT,dead_cap,atlanta-falcons,50000,2009
1566,49731,0,Robert James,OLB,dead_cap,atlanta-falcons,49731,2009
1567,45900,0,Wilrey Fontenot,CB,dead_cap,atlanta-falcons,45900,2009
1568,44824,0,Doug Datish,C,dead_cap,atlanta-falcons,44824,2009
1569,42700,0,Daren Stone,S,dead_cap,atlanta-falcons,42700,2009
1570,40000,0,Simon Fraser,DE,dead_cap,atlanta-falcons,40000,2009
1571,27125,0,Thomas Brown,RB,dead_cap,atlanta-falcons,27125,2009
1572,23486,0,David Irons,CB,dead_cap,atlanta-falcons,23486,2009
1573,23150,0,Keith Zinger,TE,dead_cap,atlanta-falcons,23150,2009
1574,16681,0,Vance Walker,DE,dead_cap,atlanta-falcons,16681,2009
1575,13437,0,D.J. Shockley,QB,dead_cap,atlanta-falcons,13437,2009
1576,10250000,2000000,Matt Ryan,QB,active,atlanta-falcons,12250000,2010
1577,6500000,2083333,John Abraham,OLB,active,atlanta-falcons,8583333,2010
1578,6600000,1200000,Roddy White,WR,active,atlanta-falcons,7800000,2010
1579,4500000,2000000,Tony Gonzalez,TE,active,atlanta-falcons,6500000,2010
1580,5000000,1400000,Dunta Robinson,CB,active,atlanta-falcons,6400000,2010
1581,3162500,3666500,Jamaal Anderson,DE,active,atlanta-falcons,6829000,2010
1582,2000000,2500000,Michael Turner,RB,active,atlanta-falcons,4500000,2010
1583,2070588,2000000,Jonathan Babineaux,DT,active,atlanta-falcons,4070588,2010
1584,3100000,750000,Mike Peterson,LB,active,atlanta-falcons,3850000,2010
1585,2750000,500000,Ovie Mughelli,RB,active,atlanta-falcons,3250000,2010
1586,2600000,750000,Chauncey Davis,DE,active,atlanta-falcons,3350000,2010
1587,2250000,1100000,Michael Jenkins,WR,active,atlanta-falcons,3350000,2010
1588,1951250,2367500,Sam Baker,LT,active,atlanta-falcons,4318750,2010
1589,2250000,625000,Erik Coleman,S,active,atlanta-falcons,2875000,2010
1590,2731000,0,Michael Koenen,P,active,atlanta-falcons,2731000,2010
1591,1300000,500000,Chris Redman,QB,active,atlanta-falcons,1800000,2010
1592,2521000,0,Tyson Clabo,RT,active,atlanta-falcons,2521000,2010
1593,2521000,0,Harvey Dahl,G,active,atlanta-falcons,2521000,2010
1594,1600000,1000000,Todd McClure,C,active,atlanta-falcons,2600000,2010
1595,1759000,0,Jerious Norwood,RB,active,atlanta-falcons,1759000,2010
1596,1335000,416667,Justin Peelle,TE,active,atlanta-falcons,1751667,2010
1597,1684000,0,Jason Snelling,RB,active,atlanta-falcons,1684000,2010
1598,755000,0,Brian Williams,CB,active,atlanta-falcons,755000,2010
1599,395000,2210000,Peria Jerry,DT,active,atlanta-falcons,2605000,2010
1600,360000,1065000,Sean Weatherspoon,ILB,active,atlanta-falcons,1425000,2010
1601,1100000,0,Matt Bryant,K,active,atlanta-falcons,1100000,2010
1602,550000,423000,Justin Blalock,G,active,atlanta-falcons,973000,2010
1603,550000,392750,Chris Houston,CB,active,atlanta-falcons,942750,2010
1604,508000,410000,Curtis Lofton,ILB,active,atlanta-falcons,918000,2010
1605,855000,0,Joe Zelenka,LS,active,atlanta-falcons,855000,2010
1606,755000,62500,Coy Wire,LS,active,atlanta-falcons,817500,2010
1607,755000,0,Brian Finneran,WR,active,atlanta-falcons,755000,2010
1608,395000,275000,William Moore,SS,active,atlanta-falcons,670000,2010
1609,550000,116875,Stephen Nicholas,OLB,active,atlanta-falcons,666875,2010
1610,470000,176012,Harry Douglas,WR,active,atlanta-falcons,646012,2010
1611,630000,0,Will Svitek,LT,active,atlanta-falcons,630000,2010
1612,470000,145000,Thomas DeCoud,S,active,atlanta-falcons,615000,2010
1613,550000,24406,Trey Lewis,DT,active,atlanta-falcons,574406,2010
1614,395000,172175,Christopher Owens,CB,active,atlanta-falcons,567175,2010
1615,470000,43687,Kroy Biermann,OLB,active,atlanta-falcons,513687,2010
1616,320000,191750,Corey Peters,DT,active,atlanta-falcons,511750,2010
1617,395000,111225,Lawrence Sidbury,OLB,active,atlanta-falcons,506225,2010
1618,320000,160553,Mike Johnson,RT,active,atlanta-falcons,480553,2010
1619,470000,0,Brent Grimes,CB,active,atlanta-falcons,470000,2010
1620,470000,0,Carlton Powell,DT,active,atlanta-falcons,470000,2010
1621,470000,0,Eric Weems,WR,active,atlanta-falcons,470000,2010
1622,320000,120795,Joe Hawley,C,active,atlanta-falcons,440795,2010
1623,395000,45150,Garrett Reynolds,G,active,atlanta-falcons,440150,2010
1624,395000,29762,Spencer Adkins,OLB,active,atlanta-falcons,424762,2010
1625,395000,8750,John Parker Wilson,QB,active,atlanta-falcons,403750,2010
1626,395000,0,Vance Walker,DE,active,atlanta-falcons,395000,2010
1627,320000,52762,Dominique Franks,CB,active,atlanta-falcons,372762,2010
1628,320000,31280,Shann Schillinger,S,active,atlanta-falcons,351280,2010
1629,320000,0,Michael Palmer,TE,active,atlanta-falcons,320000,2010
1630,320000,0,Antone Smith,RB,active,atlanta-falcons,320000,2010
1631,225000,39251,Kerry Meier,WR,active,atlanta-falcons,264251,2010
1632,88400,0,Robert James,OLB,active,atlanta-falcons,88400,2010
1633,37647,0,Rafael Bush,FS,active,atlanta-falcons,37647,2010
1634,98800,0,Robert Agnone,TE,practice_squad,atlanta-falcons,98800,2010
1635,88400,0,Rafael Bush,FS,practice_squad,atlanta-falcons,88400,2010
1636,88400,0,Dimitri Nance,RB,practice_squad,atlanta-falcons,88400,2010
1637,750000,0,Von Hutchins,CB,dead_cap,atlanta-falcons,750000,2010
1638,175000,0,Brett Romberg,C,dead_cap,atlanta-falcons,175000,2010
1639,155175,0,William Middleton,CB,dead_cap,atlanta-falcons,155175,2010
1640,100086,0,Vance Walker,DE,dead_cap,atlanta-falcons,100086,2010
1641,99462,0,Robert James,OLB,dead_cap,atlanta-falcons,99462,2010
1642,54250,0,Thomas Brown,RB,dead_cap,atlanta-falcons,54250,2010
1643,23486,0,David Irons,CB,dead_cap,atlanta-falcons,23486,2010
1644,1333,0,Dimitri Nance,RB,dead_cap,atlanta-falcons,1333,2010
1645,333,0,Rafael Bush,FS,dead_cap,atlanta-falcons,333,2010
1646,11250000,2000000,Matt Ryan,QB,active,atlanta-falcons,13250000,2011
1647,8000000,2083333,John Abraham,OLB,active,atlanta-falcons,10083333,2011
1648,5750000,2984375,Tony Gonzalez,TE,active,atlanta-falcons,8734375,2011
1649,5500000,3400000,Dunta Robinson,CB,active,atlanta-falcons,8900000,2011
1650,5000000,2500000,Michael Turner,RB,active,atlanta-falcons,7500000,2011
1651,4000000,3850000,Roddy White,WR,active,atlanta-falcons,7850000,2011
1652,450000,6302500,Sean Weatherspoon,ILB,active,atlanta-falcons,6752500,2011
1653,2000000,2200000,Justin Blalock,G,active,atlanta-falcons,4200000,2011
1654,3500000,500000,Jonathan Babineaux,DT,active,atlanta-falcons,4000000,2011
1655,2576250,2367500,Sam Baker,LT,active,atlanta-falcons,4943750,2011
1656,3000000,500000,Ovie Mughelli,RB,active,atlanta-falcons,3500000,2011
1657,2550000,500000,Chris Redman,QB,active,atlanta-falcons,3050000,2011
1658,390000,2567500,Julio Jones,WR,active,atlanta-falcons,2957500,2011
1659,2000000,800000,Tyson Clabo,RT,active,atlanta-falcons,2800000,2011
1660,2000000,800000,Ray Edwards,DE,active,atlanta-falcons,2800000,2011
1661,2611000,0,Brent Grimes,CB,active,atlanta-falcons,2611000,2011
1662,1700000,800000,Todd McClure,C,active,atlanta-falcons,2500000,2011
1663,1635000,416667,Justin Peelle,TE,active,atlanta-falcons,2051667,2011
1664,1000000,1000000,Stephen Nicholas,OLB,active,atlanta-falcons,2000000,2011
1665,1835000,0,Eric Weems,WR,active,atlanta-falcons,1835000,2011
1666,1250000,562500,Matt Bryant,K,active,atlanta-falcons,1812500,2011
1667,695000,2210000,Peria Jerry,DT,active,atlanta-falcons,2905000,2011
1668,790500,630000,Will Svitek,LT,active,atlanta-falcons,1420500,2011
1669,1200000,176012,Harry Douglas,WR,active,atlanta-falcons,1376012,2011
1670,1200000,145000,Thomas DeCoud,S,active,atlanta-falcons,1345000,2011
1671,1300000,0,James Sanders,S,active,atlanta-falcons,1300000,2011
1672,1200000,43687,Kroy Biermann,OLB,active,atlanta-falcons,1243687,2011
1673,602000,410000,Curtis Lofton,ILB,active,atlanta-falcons,1012000,2011
1674,1000000,0,Jason Snelling,RB,active,atlanta-falcons,1000000,2011
1675,910000,0,Joe Zelenka,LS,active,atlanta-falcons,910000,2011
1676,480000,275000,William Moore,SS,active,atlanta-falcons,755000,2011
1677,480000,172175,Christopher Owens,CB,active,atlanta-falcons,652175,2011
1678,405000,191750,Corey Peters,DT,active,atlanta-falcons,596750,2011
1679,480000,111225,Lawrence Sidbury,OLB,active,atlanta-falcons,591225,2011
1680,405000,160553,Mike Johnson,RT,active,atlanta-falcons,565553,2011
1681,405000,120795,Joe Hawley,C,active,atlanta-falcons,525795,2011
1682,480000,45150,Garrett Reynolds,G,active,atlanta-falcons,525150,2011
1683,910000,50000,Reggie Kelly,TE,active,atlanta-falcons,960000,2011
1684,910000,50000,Mike Peterson,LB,active,atlanta-falcons,960000,2011
1685,810000,0,Brett Romberg,C,active,atlanta-falcons,810000,2011
1686,375000,135725,Akeem Dent,ILB,active,atlanta-falcons,510725,2011
1687,480000,29762,Spencer Adkins,OLB,active,atlanta-falcons,509762,2011
1688,480000,0,Vance Walker,DE,active,atlanta-falcons,480000,2011
1689,405000,52762,Dominique Franks,CB,active,atlanta-falcons,457762,2011
1690,405000,31280,Shann Schillinger,S,active,atlanta-falcons,436280,2011
1691,375000,47750,Jacquizz Rodgers,RB,active,atlanta-falcons,422750,2011
1692,375000,39251,Kerry Meier,WR,active,atlanta-falcons,414251,2011
1693,405000,0,Michael Palmer,TE,active,atlanta-falcons,405000,2011
1694,405000,0,Antone Smith,RB,active,atlanta-falcons,405000,2011
1695,375000,23950,Matt Bosher,P,active,atlanta-falcons,398950,2011
1696,388235,0,Mike Cox,FB,active,atlanta-falcons,388235,2011
1697,375000,11750,Cliff Matthews,DE,active,atlanta-falcons,386750,2011
1698,375000,2833,Darrin Walls,CB,active,atlanta-falcons,377833,2011
1699,375000,0,Kevin Cone,WR,active,atlanta-falcons,375000,2011
1700,375000,0,Robert James,OLB,active,atlanta-falcons,375000,2011
1701,402941,0,Kirk Chambers,G,active,atlanta-falcons,402941,2011
1702,96900,0,Rafael Bush,FS,practice_squad,atlanta-falcons,96900,2011
1703,96900,0,Tommy Gallarda,TE,practice_squad,atlanta-falcons,96900,2011
1704,96900,0,Andrew Jackson,G,practice_squad,atlanta-falcons,96900,2011
1705,79800,0,John Parker Wilson,QB,practice_squad,atlanta-falcons,79800,2011
1706,0,3222500,Jamaal Anderson,DE,dead_cap,atlanta-falcons,3222500,2011
1707,1500000,0,Chauncey Davis,DE,dead_cap,atlanta-falcons,1500000,2011
1708,625000,0,Erik Coleman,S,dead_cap,atlanta-falcons,625000,2011
1709,95294,0,John Parker Wilson,QB,dead_cap,atlanta-falcons,95294,2011
1710,25000,0,Coy Wire,LS,dead_cap,atlanta-falcons,25000,2011
1711,0,15375,Andrew Jackson,G,dead_cap,atlanta-falcons,15375,2011
1712,2667,0,Dimitri Nance,RB,dead_cap,atlanta-falcons,2667,2011
1713,664,0,Rafael Bush,FS,dead_cap,atlanta-falcons,664,2011
1714,11500000,2000000,Matt Ryan,QB,active,atlanta-falcons,13500000,2012
1715,10281000,0,Brent Grimes,CB,active,atlanta-falcons,10281000,2012
1716,5500000,3850000,Roddy White,WR,active,atlanta-falcons,9350000,2012
1717,5000000,3400000,Dunta Robinson,CB,active,atlanta-falcons,8400000,2012
1718,5000000,2000000,Michael Turner,RB,active,atlanta-falcons,7000000,2012
1719,3900000,2015625,Tony Gonzalez,TE,active,atlanta-falcons,5915625,2012
1720,4100000,500000,Jonathan Babineaux,DT,active,atlanta-falcons,4600000,2012
1721,3000000,2300000,Ray Edwards,DE,active,atlanta-falcons,5300000,2012
1722,1500000,2906000,John Abraham,OLB,active,atlanta-falcons,4406000,2012
1723,2500000,2300000,Tyson Clabo,RT,active,atlanta-falcons,4800000,2012
1724,700000,3760000,Justin Blalock,G,active,atlanta-falcons,4460000,2012
1725,2576250,2367500,Sam Baker,LT,active,atlanta-falcons,4943750,2012
1726,1110625,2567500,Julio Jones,WR,active,atlanta-falcons,3678125,2012
1727,1250000,2437500,Asante Samuel,CB,active,atlanta-falcons,3687500,2012
1728,2050000,562500,Matt Bryant,K,active,atlanta-falcons,2612500,2012
1729,1500000,1000000,Stephen Nicholas,OLB,active,atlanta-falcons,2500000,2012
1730,1751000,630000,Will Svitek,LT,active,atlanta-falcons,2381000,2012
1731,1100000,1033333,Kroy Biermann,OLB,active,atlanta-falcons,2133333,2012
1732,726250,2502500,Sean Weatherspoon,ILB,active,atlanta-falcons,3228750,2012
1733,1400000,600000,Thomas DeCoud,S,active,atlanta-falcons,2000000,2012
1734,845000,2210000,Peria Jerry,DT,active,atlanta-falcons,3055000,2012
1735,1250000,562500,Harry Douglas,WR,active,atlanta-falcons,1812500,2012
1736,1260000,0,Vance Walker,DE,active,atlanta-falcons,1260000,2012
1737,700000,358333,Jason Snelling,RB,active,atlanta-falcons,1058333,2012
1738,565000,275000,William Moore,SS,active,atlanta-falcons,840000,2012
1739,615000,172175,Christopher Owens,CB,active,atlanta-falcons,787175,2012
1740,615000,111225,Lawrence Sidbury,OLB,active,atlanta-falcons,726225,2012
1741,540000,160553,Mike Johnson,RT,active,atlanta-falcons,700553,2012
1742,490000,191750,Corey Peters,DT,active,atlanta-falcons,681750,2012
1743,540000,120795,Joe Hawley,C,active,atlanta-falcons,660795,2012
1744,390000,262473,Peter Konz,C,active,atlanta-falcons,652473,2012
1745,925000,65000,Chris Hope,S,active,atlanta-falcons,990000,2012
1746,500000,135725,Akeem Dent,ILB,active,atlanta-falcons,635725,2012
1747,565000,45150,Garrett Reynolds,G,active,atlanta-falcons,610150,2012
1748,925000,65000,Todd McClure,C,active,atlanta-falcons,990000,2012
1749,825000,0,Luke McCown,QB,active,atlanta-falcons,825000,2012
1750,540000,0,Chase Coffman,TE,active,atlanta-falcons,540000,2012
1751,540000,0,Dominique Franks,CB,active,atlanta-falcons,540000,2012
1752,540000,0,Michael Palmer,TE,active,atlanta-falcons,540000,2012
1753,540000,0,Antone Smith,RB,active,atlanta-falcons,540000,2012
1754,490000,39251,Kerry Meier,WR,active,atlanta-falcons,529251,2012
1755,390000,133400,Lamar Holmes,RT,active,atlanta-falcons,523400,2012
1756,490000,31280,Shann Schillinger,S,active,atlanta-falcons,521280,2012
1757,465000,47750,Jacquizz Rodgers,RB,active,atlanta-falcons,512750,2012
1758,465000,23950,Matt Bosher,P,active,atlanta-falcons,488950,2012
1759,465000,11750,Cliff Matthews,DE,active,atlanta-falcons,476750,2012
1760,465000,0,Robert McClain,CB,active,atlanta-falcons,465000,2012
1761,390000,42215,Jonathan Massaquoi,DE,active,atlanta-falcons,432215,2012
1762,390000,25418,Charles Mitchell,S,active,atlanta-falcons,415418,2012
1763,390000,11474,Travian Robertson,DT,active,atlanta-falcons,401474,2012
1764,390000,833,Josh Harris,LS,active,atlanta-falcons,390833,2012
1765,390000,666,Dominique Davis,DE,active,atlanta-falcons,390666,2012
1766,390000,0,Drew Davis,WR,active,atlanta-falcons,390000,2012
1767,390000,0,Harland Gunn,G,active,atlanta-falcons,390000,2012
1768,390000,0,Matt Hansen,S,active,atlanta-falcons,390000,2012
1769,390000,0,Robert James,OLB,active,atlanta-falcons,390000,2012
1770,390000,0,Tim Toone,WR,active,atlanta-falcons,390000,2012
1771,700000,0,Mike Cox,FB,active,atlanta-falcons,700000,2012
1772,218823,0,Terrence Johnson,CB,active,atlanta-falcons,218823,2012
1773,170625,0,Phillip Manley,G,active,atlanta-falcons,170625,2012
1774,925000,65000,Mike Peterson,LB,injured_reserve,atlanta-falcons,990000,2012
1775,390000,0,Kevin Cone,WR,injured_reserve,atlanta-falcons,390000,2012
1776,273000,46048,Bradie Ewing,FB,injured_reserve,atlanta-falcons,319048,2012
1777,273000,1000,Adam Nissley,TE,injured_reserve,atlanta-falcons,274000,2012
1778,273000,0,Tommy Gallarda,TE,injured_reserve,atlanta-falcons,273000,2012
1779,96900,0,Marcus Jackson,WR,practice_squad,atlanta-falcons,96900,2012
1780,96900,0,Mark LeGree,S,practice_squad,atlanta-falcons,96900,2012
1781,96900,0,Pat Schiller,ILB,practice_squad,atlanta-falcons,96900,2012
1782,0,3222500,Jamaal Anderson,DE,dead_cap,atlanta-falcons,3222500,2012
1783,500000,0,Ovie Mughelli,RB,dead_cap,atlanta-falcons,500000,2012
1784,300000,0,Lofa Tatupa,LB,dead_cap,atlanta-falcons,300000,2012
1785,203437,0,Terrence Johnson,CB,dead_cap,atlanta-falcons,203437,2012
1786,52762,0,Dominique Franks,CB,dead_cap,atlanta-falcons,52762,2012
1787,0,46125,Andrew Jackson,G,dead_cap,atlanta-falcons,46125,2012
1788,29762,0,Spencer Adkins,OLB,dead_cap,atlanta-falcons,29762,2012
1789,25000,0,Coy Wire,LS,dead_cap,atlanta-falcons,25000,2012
1790,2833,0,Darrin Walls,CB,dead_cap,atlanta-falcons,2833,2012
1791,1667,0,Louis Nzegwu,DE,dead_cap,atlanta-falcons,1667,2012
1792,1333,0,Jerrell Harris,OLB,dead_cap,atlanta-falcons,1333,2012
1793,1167,0,Micanor Regis,DT,dead_cap,atlanta-falcons,1167,2012
1794,667,0,Marcus Jackson,WR,dead_cap,atlanta-falcons,667,2012
1795,667,0,Phillip Manley,G,dead_cap,atlanta-falcons,667,2012
1796,667,0,James Rodgers,WR,dead_cap,atlanta-falcons,667,2012
1797,666,0,Michael Calvin,WR,dead_cap,atlanta-falcons,666,2012
1798,500,0,Rico Council,LB,dead_cap,atlanta-falcons,500,2012
1799,500,0,Chad Faulcon,S,dead_cap,atlanta-falcons,500,2012
1800,500,0,Max Gruder,LB,dead_cap,atlanta-falcons,500,2012
1801,0,333,Peyton Thompson,SS,dead_cap,atlanta-falcons,333,2012
1802,333,0,Robbie Frey,RB,dead_cap,atlanta-falcons,333,2012
1803,333,0,Bryce Harris,RT,dead_cap,atlanta-falcons,333,2012
1804,333,0,Tyler Horn,C,dead_cap,atlanta-falcons,333,2012
1805,333,0,Marty Markett,CB,dead_cap,atlanta-falcons,333,2012
1806,333,0,Pat Schiller,ILB,dead_cap,atlanta-falcons,333,2012
1807,333,0,Dawson Zimmerman,P,dead_cap,atlanta-falcons,333,2012
1808,2000000,7600000,Matt Ryan,QB,active,atlanta-falcons,9600000,2013
1809,5600000,4850000,Roddy White,WR,active,atlanta-falcons,10450000,2013
1810,4500000,3760000,Justin Blalock,G,active,atlanta-falcons,8260000,2013
1811,3200000,3250000,Asante Samuel,CB,active,atlanta-falcons,6450000,2013
1812,3500000,1750000,Tony Gonzalez,TE,active,atlanta-falcons,5250000,2013
1813,4700000,500000,Jonathan Babineaux,DT,active,atlanta-falcons,5200000,2013
1814,1846250,2567500,Julio Jones,WR,active,atlanta-falcons,4413750,2013
1815,2250000,1650000,William Moore,SS,active,atlanta-falcons,3900000,2013
1816,1750000,2000000,Osi Umenyiora,OLB,active,atlanta-falcons,3750000,2013
1817,2500000,1000000,Stephen Nicholas,OLB,active,atlanta-falcons,3500000,2013
1818,2400000,1033333,Kroy Biermann,OLB,active,atlanta-falcons,3433333,2013
1819,2400000,562500,Matt Bryant,K,active,atlanta-falcons,2962500,2013
1820,1750000,1166666,Steven Jackson,RB,active,atlanta-falcons,2916666,2013
1821,1750000,1229166,Harry Douglas,WR,active,atlanta-falcons,2979166,2013
1822,1900000,600000,Thomas DeCoud,S,active,atlanta-falcons,2500000,2013
1823,1047500,2502500,Sean Weatherspoon,ILB,active,atlanta-falcons,3550000,2013
1824,905000,2210000,Peria Jerry,DT,active,atlanta-falcons,3115000,2013
1825,1323000,191750,Corey Peters,DT,active,atlanta-falcons,1514750,2013
1826,405000,1079745,Desmond Trufant,CB,active,atlanta-falcons,1484745,2013
1827,850000,358333,Jason Snelling,RB,active,atlanta-falcons,1208333,2013
1828,715000,350000,Garrett Reynolds,G,active,atlanta-falcons,1065000,2013
1829,553118,262473,Peter Konz,C,active,atlanta-falcons,815591,2013
1830,630000,160554,Mike Johnson,RT,active,atlanta-falcons,790554,2013
1831,625000,135725,Akeem Dent,ILB,active,atlanta-falcons,760725,2013
1832,630000,120795,Joe Hawley,C,active,atlanta-falcons,750795,2013
1833,630000,32500,Antone Smith,RB,active,atlanta-falcons,662500,2013
1834,630000,0,Chase Coffman,TE,active,atlanta-falcons,630000,2013
1835,630000,0,Dominique Franks,CB,active,atlanta-falcons,630000,2013
1836,405000,213436,Robert Alford,CB,active,atlanta-falcons,618436,2013
1837,480000,133400,Lamar Holmes,RT,active,atlanta-falcons,613400,2013
1838,555000,47750,Jacquizz Rodgers,RB,active,atlanta-falcons,602750,2013
1839,555000,23950,Matt Bosher,P,active,atlanta-falcons,578950,2013
1840,555000,11750,Cliff Matthews,DE,active,atlanta-falcons,566750,2013
1841,840000,0,Jeremy Trueblood,RT,active,atlanta-falcons,840000,2013
1842,555000,0,Robert McClain,CB,active,atlanta-falcons,555000,2013
1843,555000,0,Josh Vaughan,RB,active,atlanta-falcons,555000,2013
1844,480000,42215,Jonathan Massaquoi,DE,active,atlanta-falcons,522215,2013
1845,405000,99272,Malliciah Goodman,DE,active,atlanta-falcons,504272,2013
1846,480000,11474,Travian Robertson,DT,active,atlanta-falcons,491474,2013
1847,840000,0,Omar Gaither,ILB,active,atlanta-falcons,840000,2013
1848,480000,833,Josh Harris,LS,active,atlanta-falcons,480833,2013
1849,480000,666,Dominique Davis,DE,active,atlanta-falcons,480666,2013
1850,405000,75146,Levine Toilolo,TE,active,atlanta-falcons,480146,2013
1851,480000,0,Kevin Cone,WR,active,atlanta-falcons,480000,2013
1852,480000,0,Drew Davis,WR,active,atlanta-falcons,480000,2013
1853,480000,0,Harland Gunn,G,active,atlanta-falcons,480000,2013
1854,405000,46685,Stansly Maponga,DE,active,atlanta-falcons,451685,2013
1855,423529,0,Patrick DiMarco,FB,active,atlanta-falcons,423529,2013
1856,405000,11474,Kemal Ishmael,SS,active,atlanta-falcons,416474,2013
1857,405000,1666,Joplo Bartu,OLB,active,atlanta-falcons,406666,2013
1858,405000,666,Ryan Schraeder,RT,active,atlanta-falcons,405666,2013
1859,405000,666,Paul Worrilow,OLB,active,atlanta-falcons,405666,2013
1860,288000,11474,Sean Renfree,QB,active,atlanta-falcons,299474,2013
1861,262058,0,Darius Johnson,WR,active,atlanta-falcons,262058,2013
1862,840000,0,Sean Locklear,T,active,atlanta-falcons,840000,2013
1863,119117,0,Terren Jones,LT,active,atlanta-falcons,119117,2013
1864,405000,0,Sean Baker,FS,active,atlanta-falcons,405000,2013
1865,23823,0,Adam Replogle,G,active,atlanta-falcons,23823,2013
1866,1000000,2000000,Sam Baker,LT,injured_reserve,atlanta-falcons,3000000,2013
1867,405000,46048,Bradie Ewing,FB,injured_reserve,atlanta-falcons,451048,2013
1868,405000,11474,Zeke Motta,S,injured_reserve,atlanta-falcons,416474,2013
1869,288000,1000,Adam Nissley,TE,injured_reserve,atlanta-falcons,289000,2013
1870,288000,0,Saeed Lee,CB,injured_reserve,atlanta-falcons,288000,2013
1871,288000,0,Andrew Szczerba,TE,injured_reserve,atlanta-falcons,288000,2013
1872,96000,0,Adam Replogle,G,practice_squad,atlanta-falcons,96000,2013
1873,0,8800000,Dunta Robinson,CB,dead_cap,atlanta-falcons,8800000,2013
1874,4650000,0,Ray Edwards,DE,dead_cap,atlanta-falcons,4650000,2013
1875,2000000,0,Michael Turner,RB,dead_cap,atlanta-falcons,2000000,2013
1876,1550000,0,Tyson Clabo,RT,dead_cap,atlanta-falcons,1550000,2013
1877,1500000,0,John Abraham,OLB,dead_cap,atlanta-falcons,1500000,2013
1878,300000,0,Lofa Tatupa,LB,dead_cap,atlanta-falcons,300000,2013
1879,268045,0,Shann Schillinger,S,dead_cap,atlanta-falcons,268045,2013
1880,228529,0,Brian Robiskie,WR,dead_cap,atlanta-falcons,228529,2013
1881,213882,0,Tommy Gallarda,TE,dead_cap,atlanta-falcons,213882,2013
1882,185294,0,Jamar Chaney,ILB,dead_cap,atlanta-falcons,185294,2013
1883,130588,0,Thomas Howard,LB,dead_cap,atlanta-falcons,130588,2013
1884,73666,0,Terren Jones,LT,dead_cap,atlanta-falcons,73666,2013
1885,54000,0,Sean Baker,FS,dead_cap,atlanta-falcons,54000,2013
1886,52762,0,Dominique Franks,CB,dead_cap,atlanta-falcons,52762,2013
1887,39251,0,Kerry Meier,WR,dead_cap,atlanta-falcons,39251,2013
1888,36333,0,Darius Johnson,WR,dead_cap,atlanta-falcons,36333,2013
1889,25418,0,Charles Mitchell,S,dead_cap,atlanta-falcons,25418,2013
1890,12000,0,Patrick DiMarco,FB,dead_cap,atlanta-falcons,12000,2013
1891,0,4500,Seth Doege,QB,dead_cap,atlanta-falcons,4500,2013
1892,3334,0,Louis Nzegwu,DE,dead_cap,atlanta-falcons,3334,2013
1893,2833,0,Darrin Walls,CB,dead_cap,atlanta-falcons,2833,2013
1894,2667,0,Jerrell Harris,OLB,dead_cap,atlanta-falcons,2667,2013
1895,2334,0,Micanor Regis,DT,dead_cap,atlanta-falcons,2334,2013
1896,1666,0,Nick Clancy,OLB,dead_cap,atlanta-falcons,1666,2013
1897,1666,0,Alex Savoie,RT,dead_cap,atlanta-falcons,1666,2013
1898,1334,0,Michael Calvin,WR,dead_cap,atlanta-falcons,1334,2013
1899,1334,0,Marcus Jackson,WR,dead_cap,atlanta-falcons,1334,2013
1900,1334,0,Phillip Manley,G,dead_cap,atlanta-falcons,1334,2013
1901,1334,0,James Rodgers,WR,dead_cap,atlanta-falcons,1334,2013
1902,1000,0,Rico Council,LB,dead_cap,atlanta-falcons,1000,2013
1903,1000,0,Chad Faulcon,S,dead_cap,atlanta-falcons,1000,2013
1904,1000,0,Max Gruder,LB,dead_cap,atlanta-falcons,1000,2013
1905,833,0,Adam Replogle,G,dead_cap,atlanta-falcons,833,2013
1906,0,667,Peyton Thompson,SS,dead_cap,atlanta-falcons,667,2013
1907,667,0,Robbie Frey,RB,dead_cap,atlanta-falcons,667,2013
1908,667,0,Bryce Harris,RT,dead_cap,atlanta-falcons,667,2013
1909,667,0,Tyler Horn,C,dead_cap,atlanta-falcons,667,2013
1910,667,0,Marty Markett,CB,dead_cap,atlanta-falcons,667,2013
1911,667,0,Pat Schiller,ILB,dead_cap,atlanta-falcons,667,2013
1912,667,0,Dawson Zimmerman,P,dead_cap,atlanta-falcons,667,2013
1913,500,0,Cam Henderson,DE,dead_cap,atlanta-falcons,500,2013
1914,500,0,Brandon Thurmond,DE,dead_cap,atlanta-falcons,500,2013
1915,500,0,Ronnie Wingo,RB,dead_cap,atlanta-falcons,500,2013
1916,333,0,Rashad Evans,WR,dead_cap,atlanta-falcons,333,2013
1917,333,0,Martel Moore,WR,dead_cap,atlanta-falcons,333,2013
1918,333,0,Donald Russell,RB,dead_cap,atlanta-falcons,333,2013
1919,333,0,Troy Sanders,S,dead_cap,atlanta-falcons,333,2013
1920,333,0,Sean Sellwood,P,dead_cap,atlanta-falcons,333,2013
1921,9500000,10400000,Matt Ryan,QB,active,atlanta-falcons,19900000,2014
1922,4500000,3760000,Justin Blalock,G,active,atlanta-falcons,8260000,2014
1923,3000000,4537500,Roddy White,WR,active,atlanta-falcons,7537500,2014
1924,2000000,3400000,Paul Soliai,DT,active,atlanta-falcons,5400000,2014
1925,3500000,1650000,William Moore,SS,active,atlanta-falcons,5150000,2014
1926,2581875,2567500,Julio Jones,WR,active,atlanta-falcons,5149375,2014
1927,2500000,2250000,Osi Umenyiora,OLB,active,atlanta-falcons,4750000,2014
1928,3000000,1166666,Steven Jackson,RB,active,atlanta-falcons,4166666,2014
1929,2831250,2502500,Sean Weatherspoon,ILB,active,atlanta-falcons,5333750,2014
1930,3050000,1033334,Kroy Biermann,OLB,active,atlanta-falcons,4083334,2014
1931,2750000,1229166,Harry Douglas,WR,active,atlanta-falcons,3979166,2014
1932,2750000,562500,Matt Bryant,K,active,atlanta-falcons,3312500,2014
1933,1500000,1600000,Tyson Jackson,DE,active,atlanta-falcons,3100000,2014
1934,420000,2567182,Jake Matthews,LT,active,atlanta-falcons,2987182,2014
1935,2000000,800000,Jon Asamoah,G,active,atlanta-falcons,2800000,2014
1936,2000000,666666,Jonathan Babineaux,DT,active,atlanta-falcons,2666666,2014
1937,1000000,1000000,Joe Hawley,C,active,atlanta-falcons,2000000,2014
1938,776125,1079745,Desmond Trufant,CB,active,atlanta-falcons,1855870,2014
1939,1000000,833333,Devin Hester,WR,active,atlanta-falcons,1833333,2014
1940,1431000,47750,Jacquizz Rodgers,RB,active,atlanta-falcons,1478750,2014
1941,1000000,468750,Corey Peters,DT,active,atlanta-falcons,1468750,2014
1942,1431000,0,Robert McClain,CB,active,atlanta-falcons,1431000,2014
1943,645000,523950,Matt Bosher,P,active,atlanta-falcons,1168950,2014
1944,420000,550153,Ra'Shede Hageman,DE,active,atlanta-falcons,970153,2014
1945,645000,187500,Gabe Carimi,G,active,atlanta-falcons,832500,2014
1946,559609,213436,Robert Alford,CB,active,atlanta-falcons,773045,2014
1947,730000,32500,Antone Smith,RB,active,atlanta-falcons,762500,2014
1948,645000,30000,Mike Johnson,RT,active,atlanta-falcons,675000,2014
1949,570000,100834,Josh Harris,LS,active,atlanta-falcons,670834,2014
1950,645000,11750,Cliff Matthews,DE,active,atlanta-falcons,656750,2014
1951,645000,0,T.J. Yates,QB,active,atlanta-falcons,645000,2014
1952,855000,65000,Josh Wilson,CB,active,atlanta-falcons,920000,2014
1953,730000,65000,Javier Arenas,CB,active,atlanta-falcons,795000,2014
1954,570000,42215,Jonathan Massaquoi,DE,active,atlanta-falcons,612215,2014
1955,730000,30000,Dwight Lowery,FS,active,atlanta-falcons,760000,2014
1956,495000,99272,Malliciah Goodman,DE,active,atlanta-falcons,594272,2014
1957,420000,172708,Dezmen Southward,CB,active,atlanta-falcons,592708,2014
1958,495000,75146,Levine Toilolo,TE,active,atlanta-falcons,570146,2014
1959,730000,0,Bear Pascoe,TE,active,atlanta-falcons,730000,2014
1960,730000,0,Eric Weems,WR,active,atlanta-falcons,730000,2014
1961,570000,0,Patrick DiMarco,FB,active,atlanta-falcons,570000,2014
1962,495000,46685,Stansly Maponga,DE,active,atlanta-falcons,541685,2014
1963,420000,121106,Devonta Freeman,RB,active,atlanta-falcons,541106,2014
1964,495000,11474,Kemal Ishmael,SS,active,atlanta-falcons,506474,2014
1965,495000,1666,Joplo Bartu,OLB,active,atlanta-falcons,496666,2014
1966,495000,666,Ryan Schraeder,RT,active,atlanta-falcons,495666,2014
1967,495000,666,Paul Worrilow,OLB,active,atlanta-falcons,495666,2014
1968,420000,75146,Prince Shembo,ILB,active,atlanta-falcons,495146,2014
1969,495000,0,Nathan Stupar,OLB,active,atlanta-falcons,495000,2014
1970,570000,0,Harland Gunn,G,active,atlanta-falcons,570000,2014
1971,420000,11474,Sean Renfree,QB,active,atlanta-falcons,431474,2014
1972,420000,11474,Tyler Starr,OLB,active,atlanta-falcons,431474,2014
1973,420000,1333,James Stone,C,active,atlanta-falcons,421333,2014
1974,486353,0,Drew Davis,WR,active,atlanta-falcons,486353,2014
1975,730000,0,Charles Godfrey,SS,active,atlanta-falcons,730000,2014
1976,855000,0,Jonathan Scott,LT,active,atlanta-falcons,855000,2014
1977,420000,0,Ricardo Allen,SS,active,atlanta-falcons,420000,2014
1978,420000,0,Sean Baker,FS,active,atlanta-falcons,420000,2014
1979,420000,0,Jerome Smith,RB,active,atlanta-falcons,420000,2014
1980,3250000,3600000,Sam Baker,LT,injured_reserve,atlanta-falcons,6850000,2014
1981,716236,262473,Peter Konz,C,injured_reserve,atlanta-falcons,978709,2014
1982,570000,133400,Lamar Holmes,RT,injured_reserve,atlanta-falcons,703400,2014
1983,303000,42870,Marquis Spruill,ILB,injured_reserve,atlanta-falcons,345870,2014
1984,107100,0,Kyle Miller,TE,practice_squad,atlanta-falcons,107100,2014
1985,107100,0,Bernard Reedy,WR,practice_squad,atlanta-falcons,107100,2014
1986,107100,0,Jacques Smith,DE,practice_squad,atlanta-falcons,107100,2014
1987,88200,0,Reid Fragel,RT,practice_squad,atlanta-falcons,88200,2014
1988,81900,0,Adam Replogle,G,practice_squad,atlanta-falcons,81900,2014
1989,37800,0,Ricky Havili-Heimuli,DT,practice_squad,atlanta-falcons,37800,2014
1990,37800,0,Yawin Smallwood,ILB,practice_squad,atlanta-falcons,37800,2014
1991,31500,0,Freddie Martino,WR,practice_squad,atlanta-falcons,31500,2014
1992,12600,0,Jordan Mabin,CB,practice_squad,atlanta-falcons,12600,2014
1993,6300,0,Brandon Bishop,S,practice_squad,atlanta-falcons,6300,2014
1994,6300,0,Ronnie Wingo,RB,practice_squad,atlanta-falcons,6300,2014
1995,3100000,0,Tyson Clabo,RT,dead_cap,atlanta-falcons,3100000,2014
1996,2000000,0,Stephen Nicholas,OLB,dead_cap,atlanta-falcons,2000000,2014
1997,1750000,0,Tony Gonzalez,TE,dead_cap,atlanta-falcons,1750000,2014
1998,750000,0,Asante Samuel,CB,dead_cap,atlanta-falcons,750000,2014
1999,600000,0,Thomas DeCoud,S,dead_cap,atlanta-falcons,600000,2014
2000,570000,0,Courtney Roby,WR,dead_cap,atlanta-falcons,570000,2014
2001,358333,0,Jason Snelling,RB,dead_cap,atlanta-falcons,358333,2014
2002,341470,0,Cameron Bradfield,RT,dead_cap,atlanta-falcons,341470,2014
2003,250000,0,Garrett Reynolds,G,dead_cap,atlanta-falcons,250000,2014
2004,204442,666,Freddie Martino,WR,dead_cap,atlanta-falcons,205108,2014
2005,201176,0,James Anderson,OLB,dead_cap,atlanta-falcons,201176,2014
2006,174424,0,Sean Baker,FS,dead_cap,atlanta-falcons,174424,2014
2007,94500,50125,Ricardo Allen,SS,dead_cap,atlanta-falcons,144625,2014
2008,0,135725,Akeem Dent,ILB,dead_cap,atlanta-falcons,135725,2014
2009,100800,1000,Jerome Smith,RB,dead_cap,atlanta-falcons,101800,2014
2010,92096,0,Bradie Ewing,FB,dead_cap,atlanta-falcons,92096,2014
2011,69300,11474,Travian Robertson,DT,dead_cap,atlanta-falcons,80774,2014
2012,50836,0,Charles Mitchell,S,dead_cap,atlanta-falcons,50836,2014
2013,44100,0,Ryan Spadola,WR,dead_cap,atlanta-falcons,44100,2014
2014,31500,833,Kimario McFadden,SS,dead_cap,atlanta-falcons,32333,2014
2015,25200,0,Harland Gunn,G,dead_cap,atlanta-falcons,25200,2014
2016,22234,0,Terren Jones,LT,dead_cap,atlanta-falcons,22234,2014
2017,0,11474,Yawin Smallwood,ILB,dead_cap,atlanta-falcons,11474,2014
2018,0,5000,Roosevelt Nix,FB,dead_cap,atlanta-falcons,5000,2014
2019,1667,0,Adam Replogle,G,dead_cap,atlanta-falcons,1667,2014
2020,0,1666,Jacques Smith,DE,dead_cap,atlanta-falcons,1666,2014
2021,0,1000,Devonta Glover-Wright,CB,dead_cap,atlanta-falcons,1000,2014
2022,1000,0,Cam Henderson,DE,dead_cap,atlanta-falcons,1000,2014
2023,1000,0,Adam Nissley,TE,dead_cap,atlanta-falcons,1000,2014
2024,1000,0,Brandon Thurmond,DE,dead_cap,atlanta-falcons,1000,2014
2025,1000,0,Ronnie Wingo,RB,dead_cap,atlanta-falcons,1000,2014
2026,0,667,Dominique Davis,DE,dead_cap,atlanta-falcons,667,2014
2027,667,0,Rashad Evans,WR,dead_cap,atlanta-falcons,667,2014
2028,667,0,Darius Johnson,WR,dead_cap,atlanta-falcons,667,2014
2029,667,0,Martel Moore,WR,dead_cap,atlanta-falcons,667,2014
2030,667,0,Donald Russell,RB,dead_cap,atlanta-falcons,667,2014
2031,667,0,Troy Sanders,S,dead_cap,atlanta-falcons,667,2014
2032,667,0,Sean Sellwood,P,dead_cap,atlanta-falcons,667,2014
2033,0,666,Geraldo Boldewijn,WR,dead_cap,atlanta-falcons,666,2014
2034,0,666,Nosa Eguae,DT,dead_cap,atlanta-falcons,666,2014
2035,0,666,Julian Jones,WR,dead_cap,atlanta-falcons,666,2014
2036,0,666,Donte Rumph,DT,dead_cap,atlanta-falcons,666,2014
2037,0,666,Tramaine Thompson,WR,dead_cap,atlanta-falcons,666,2014
2038,0,666,Brian Wozniak,TE,dead_cap,atlanta-falcons,666,2014
2039,0,500,Bernard Reedy,WR,dead_cap,atlanta-falcons,500,2014
2040,0,333,Brenden Daley,ILB,dead_cap,atlanta-falcons,333,2014
2041,0,333,Maurice Hagens,FB,dead_cap,atlanta-falcons,333,2014
2042,0,333,Matt Yoklic,P,dead_cap,atlanta-falcons,333,2014
2043,11500000,10400000,Matt Ryan,QB,active,atlanta-falcons,21900000,2015
2044,2500000,9900000,Julio Jones,WR,active,atlanta-falcons,12400000,2015
2045,2200000,3356250,Roddy White,WR,active,atlanta-falcons,5556250,2015
2046,2250000,1600000,Tyson Jackson,DE,active,atlanta-falcons,3850000,2015
2047,510000,3223978,Jake Matthews,LT,active,atlanta-falcons,3733978,2015
2048,2875000,833333,Devin Hester,WR,active,atlanta-falcons,3708333,2015
2049,2250000,1369791,Jonathan Babineaux,DT,active,atlanta-falcons,3619791,2015
2050,1105000,2250000,Matt Bosher,P,active,atlanta-falcons,3355000,2015
2051,2200000,940000,Brooks Reed,DE,active,atlanta-falcons,3140000,2015
2052,1500000,1375000,Andy Levitre,G,active,atlanta-falcons,2875000,2015
2053,1550000,1250000,Chris Chester,G,active,atlanta-falcons,2800000,2015
2054,435000,2200496,Vic Beasley,DE,active,atlanta-falcons,2635496,2015
2055,1147372,1079745,Desmond Trufant,CB,active,atlanta-falcons,2227117,2015
2056,1400000,810416,Justin Durant,OLB,active,atlanta-falcons,2210416,2015
2057,1000000,1062500,Adrian Clayborn,DE,active,atlanta-falcons,2062500,2015
2058,1100000,825000,Kroy Biermann,OLB,active,atlanta-falcons,1925000,2015
2059,745000,955000,O'Brien Schofield,OLB,active,atlanta-falcons,1700000,2015
2060,1542000,0,Gino Gradkowski,C,active,atlanta-falcons,1542000,2015
2061,1000000,387500,Jacob Tamme,TE,active,atlanta-falcons,1387500,2015
2062,1100000,175000,Jake Long,LT,active,atlanta-falcons,1275000,2015
2063,662538,550153,Ra'Shede Hageman,DE,active,atlanta-falcons,1212691,2015
2064,870000,262500,Eric Weems,WR,active,atlanta-falcons,1132500,2015
2065,435000,551879,Jalen Collins,CB,active,atlanta-falcons,986879,2015
2066,714218,213436,Robert Alford,CB,active,atlanta-falcons,927654,2015
2067,745000,166666,Michael Person,G,active,atlanta-falcons,911666,2015
2068,660000,100000,Josh Harris,LS,active,atlanta-falcons,760000,2015
2069,660000,37500,Patrick DiMarco,FB,active,atlanta-falcons,697500,2015
2070,585000,99272,Malliciah Goodman,DE,active,atlanta-falcons,684272,2015
2071,585000,75146,Levine Toilolo,TE,active,atlanta-falcons,660146,2015
2072,660000,0,Bryce Harris,RT,active,atlanta-falcons,660000,2015
2073,510000,121106,Devonta Freeman,RB,active,atlanta-falcons,631106,2015
2074,435000,186311,Tevin Coleman,RB,active,atlanta-falcons,621311,2015
2075,585000,11474,Kemal Ishmael,SS,active,atlanta-falcons,596474,2015
2076,585000,11474,Sean Renfree,QB,active,atlanta-falcons,596474,2015
2077,585000,668,Ryan Schraeder,RT,active,atlanta-falcons,585668,2015
2078,585000,668,Paul Worrilow,OLB,active,atlanta-falcons,585668,2015
2079,745000,0,Phillip Adams,CB,active,atlanta-falcons,745000,2015
2080,585000,0,Nathan Stupar,OLB,active,atlanta-falcons,585000,2015
2081,435000,135205,Justin Hardy,WR,active,atlanta-falcons,570205,2015
2082,510000,0,Nick Williams,WR,active,atlanta-falcons,510000,2015
2083,435000,61963,Grady Jarrett,DT,active,atlanta-falcons,496963,2015
2084,569705,0,Tony Moeaki,TE,active,atlanta-falcons,569705,2015
2085,435000,333,Terron Ward,RB,active,atlanta-falcons,435333,2015
2086,435000,0,Ricardo Allen,SS,active,atlanta-falcons,435000,2015
2087,435000,0,Robenson Therezie,FS,active,atlanta-falcons,435000,2015
2088,562941,0,Philip Wheeler,OLB,active,atlanta-falcons,562941,2015
2089,511764,0,Charles Godfrey,SS,active,atlanta-falcons,511764,2015
2090,230294,0,Akeem King,SS,active,atlanta-falcons,230294,2015
2091,342352,0,Shayne Graham,K,active,atlanta-falcons,342352,2015
2092,102353,0,Joey Mbu,DT,active,atlanta-falcons,102353,2015
2093,90000,0,Ben Garland,G,active,atlanta-falcons,90000,2015
2094,90000,0,Tyler Starr,OLB,active,atlanta-falcons,90000,2015
2095,25588,0,D.J. Tialavea,TE,active,atlanta-falcons,25588,2015
2096,3500000,1868750,William Moore,SS,injured_reserve,atlanta-falcons,5368750,2015
2097,3000000,1400000,Paul Soliai,DT,injured_reserve,atlanta-falcons,4400000,2015
2098,1350000,1477083,Matt Bryant,K,injured_reserve,atlanta-falcons,2827083,2015
2099,478764,1333,James Stone,C,injured_reserve,atlanta-falcons,480097,2015
2100,333000,0,Collin Mooney,FB,injured_reserve,atlanta-falcons,333000,2015
2101,318000,1000,Beau Gardner,TE,injured_reserve,atlanta-falcons,319000,2015
2102,318000,0,Travis Howard,CB,injured_reserve,atlanta-falcons,318000,2015
2103,2500000,2268750,Jon Asamoah,G,dead_cap,atlanta-falcons,4768750,2015
2104,0,5320000,Justin Blalock,G,dead_cap,atlanta-falcons,5320000,2015
2105,0,3600000,Sam Baker,LT,dead_cap,atlanta-falcons,3600000,2015
2106,1200000,0,Thomas DeCoud,S,dead_cap,atlanta-falcons,1200000,2015
2107,0,1166668,Steven Jackson,RB,dead_cap,atlanta-falcons,1166668,2015
2108,0,1000000,Joe Hawley,C,dead_cap,atlanta-falcons,1000000,2015
2109,902352,75000,Charles Godfrey,SS,dead_cap,atlanta-falcons,977352,2015
2110,0,1229168,Harry Douglas,WR,dead_cap,atlanta-falcons,1229168,2015
2111,613529,255000,Leonard Hankerson,WR,dead_cap,atlanta-falcons,868529,2015
2112,870000,0,Tyler Polumbus,LT,dead_cap,atlanta-falcons,870000,2015
2113,310360,262473,Peter Konz,C,dead_cap,atlanta-falcons,572833,2015
2114,265724,172708,Dezmen Southward,CB,dead_cap,atlanta-falcons,438432,2015
2115,211765,200000,Antone Smith,RB,dead_cap,atlanta-falcons,411765,2015
2116,378529,1668,Joplo Bartu,OLB,dead_cap,atlanta-falcons,380197,2015
2117,0,375000,T.J. Yates,QB,dead_cap,atlanta-falcons,375000,2015
2118,271764,0,Allen Bradford,ILB,dead_cap,atlanta-falcons,271764,2015
2119,243176,0,Ricky Havili-Heimuli,DT,dead_cap,atlanta-falcons,243176,2015
2120,0,225438,Prince Shembo,ILB,dead_cap,atlanta-falcons,225438,2015
2121,0,150375,Ricardo Allen,SS,dead_cap,atlanta-falcons,150375,2015
2122,85800,46685,Stansly Maponga,DE,dead_cap,atlanta-falcons,132485,2015
2123,112200,0,Matt Simms,QB,dead_cap,atlanta-falcons,112200,2015
2124,92400,11474,Tyler Starr,OLB,dead_cap,atlanta-falcons,103874,2015
2125,92400,0,Ben Garland,G,dead_cap,atlanta-falcons,92400,2015
2126,85800,1666,Joey Mbu,DT,dead_cap,atlanta-falcons,87466,2015
2127,72600,0,Marcel Jensen,TE,dead_cap,atlanta-falcons,72600,2015
2128,68471,0,Evan Royster,RB,dead_cap,atlanta-falcons,68471,2015
2129,66000,0,Gus Johnson,RB,dead_cap,atlanta-falcons,66000,2015
2130,52800,13195,Akeem King,SS,dead_cap,atlanta-falcons,65995,2015
2131,59400,0,C.J. Goodwin,S,dead_cap,atlanta-falcons,59400,2015
2132,46200,666,Dere Akunne,OLB,dead_cap,atlanta-falcons,46866,2015
2133,46200,0,Laron Byrd,WR,dead_cap,atlanta-falcons,46200,2015
2134,46200,0,Jahwan Edwards,RB,dead_cap,atlanta-falcons,46200,2015
2135,46200,0,Devon Wylie,WR,dead_cap,atlanta-falcons,46200,2015
2136,0,42870,Marquis Spruill,ILB,dead_cap,atlanta-falcons,42870,2015
2137,0,42215,Jonathan Massaquoi,DE,dead_cap,atlanta-falcons,42215,2015
2138,0,34422,Yawin Smallwood,ILB,dead_cap,atlanta-falcons,34422,2015
2139,34411,0,Mickey Shuler,TE,dead_cap,atlanta-falcons,34411,2015
2140,33000,0,D.J. Tialavea,TE,dead_cap,atlanta-falcons,33000,2015
2141,26400,0,Terrance Parks,SS,dead_cap,atlanta-falcons,26400,2015
2142,0,22948,Zeke Motta,S,dead_cap,atlanta-falcons,22948,2015
2143,19800,0,Curtis Grant,ILB,dead_cap,atlanta-falcons,19800,2015
2144,19800,0,R.J. Harris,WR,dead_cap,atlanta-falcons,19800,2015
2145,19800,0,T.J. Heath,CB,dead_cap,atlanta-falcons,19800,2015
2146,19800,0,Jordan Leslie,WR,dead_cap,atlanta-falcons,19800,2015
2147,19800,0,Dontay Moch,DE,dead_cap,atlanta-falcons,19800,2015
2148,18706,0,Terrell Floyd,CB,dead_cap,atlanta-falcons,18706,2015
2149,0,17954,Jake Rodgers,T,dead_cap,atlanta-falcons,17954,2015
2150,13200,0,Pierce Burton,RT,dead_cap,atlanta-falcons,13200,2015
2151,13200,0,Collin Rahrig,G,dead_cap,atlanta-falcons,13200,2015
2152,0,11474,Travian Robertson,DT,dead_cap,atlanta-falcons,11474,2015
2153,10000,500,Cody Clay,G,dead_cap,atlanta-falcons,10500,2015
2154,0,10000,Roosevelt Nix,FB,dead_cap,atlanta-falcons,10000,2015
2155,6600,0,Xzavier Dickson,OLB,dead_cap,atlanta-falcons,6600,2015
2156,0,5000,Jared Smith,G,dead_cap,atlanta-falcons,5000,2015
2157,0,3334,Jacques Smith,DE,dead_cap,atlanta-falcons,3334,2015
2158,0,2000,Devonta Glover-Wright,CB,dead_cap,atlanta-falcons,2000,2015
2159,0,2000,Jerome Smith,RB,dead_cap,atlanta-falcons,2000,2015
2160,0,1667,Kimario McFadden,SS,dead_cap,atlanta-falcons,1667,2015
2161,0,1666,Eric Lefeld,G,dead_cap,atlanta-falcons,1666,2015
2162,0,1334,Geraldo Boldewijn,WR,dead_cap,atlanta-falcons,1334,2015
2163,0,1334,Nosa Eguae,DT,dead_cap,atlanta-falcons,1334,2015
2164,0,1334,Julian Jones,WR,dead_cap,atlanta-falcons,1334,2015
2165,0,1334,Freddie Martino,WR,dead_cap,atlanta-falcons,1334,2015
2166,0,1334,Donte Rumph,DT,dead_cap,atlanta-falcons,1334,2015
2167,0,1334,Tramaine Thompson,WR,dead_cap,atlanta-falcons,1334,2015
2168,0,1334,Brian Wozniak,TE,dead_cap,atlanta-falcons,1334,2015
2169,0,1166,Marquez Clark,WR,dead_cap,atlanta-falcons,1166,2015
2170,0,1000,Jordan Ozerities,CB,dead_cap,atlanta-falcons,1000,2015
2171,0,1000,Damien Parms,S,dead_cap,atlanta-falcons,1000,2015
2172,0,1000,Bernard Reedy,WR,dead_cap,atlanta-falcons,1000,2015
2173,0,1000,Joshua Stangby,WR,dead_cap,atlanta-falcons,1000,2015
2174,0,1000,Valerian Ume-Ezeoke,C,dead_cap,atlanta-falcons,1000,2015
2175,0,667,Brenden Daley,ILB,dead_cap,atlanta-falcons,667,2015
2176,0,667,Maurice Hagens,FB,dead_cap,atlanta-falcons,667,2015
2177,0,667,Matt Yoklic,P,dead_cap,atlanta-falcons,667,2015
2178,0,666,Shane Wynn,WR,dead_cap,atlanta-falcons,666,2015
2179,0,666,Warren Herring,DT,dead_cap,atlanta-falcons,666,2015
2180,0,333,Michael Lee,CB,dead_cap,atlanta-falcons,333,2015
2181,0,333,Kevin White,CB,dead_cap,atlanta-falcons,333,2015
2182,15750000,10400000,Matt Ryan,QB,active,atlanta-falcons,26150000,2016
2183,9500000,6400000,Julio Jones,WR,active,atlanta-falcons,15900000,2016
2184,4250000,2100000,Tyson Jackson,DE,active,atlanta-falcons,6350000,2016
2185,4000000,1375000,Andy Levitre,G,active,atlanta-falcons,5375000,2016
2186,600000,3880773,Jake Matthews,LT,active,atlanta-falcons,4480773,2016
2187,1750000,2300000,Alex Mack,C,active,atlanta-falcons,4050000,2016
2188,2500000,940000,Brooks Reed,DE,active,atlanta-falcons,3440000,2016
2189,525000,2769370,Vic Beasley,DE,active,atlanta-falcons,3294370,2016
2190,1550000,1633333,Matt Bryant,K,active,atlanta-falcons,3183333,2016
2191,2200000,500000,Matt Bosher,P,active,atlanta-falcons,2700000,2016
2192,1250000,1416668,Jonathan Babineaux,DT,active,atlanta-falcons,2666668,2016
2193,2553000,100000,Ryan Schraeder,RT,active,atlanta-falcons,2653000,2016
2194,1100000,1500000,Chris Chester,G,active,atlanta-falcons,2600000,2016
2195,2553000,0,Paul Worrilow,OLB,active,atlanta-falcons,2553000,2016
2196,1000000,1400000,Mohamed Sanu,WR,active,atlanta-falcons,2400000,2016
2197,450000,1502299,Keanu Neal,FS,active,atlanta-falcons,1952299,2016
2198,1250000,500000,Matt Schaub,QB,active,atlanta-falcons,1750000,2016
2199,1671000,75146,Levine Toilolo,TE,active,atlanta-falcons,1746146,2016
2200,868827,813436,Robert Alford,CB,active,atlanta-falcons,1682263,2016
2201,905077,550153,Ra'Shede Hageman,DE,active,atlanta-falcons,1455230,2016
2202,760000,640000,Courtney Upshaw,DT,active,atlanta-falcons,1400000,2016
2203,885000,262500,Eric Weems,WR,active,atlanta-falcons,1147500,2016
2204,521315,551879,Jalen Collins,CB,active,atlanta-falcons,1073194,2016
2205,1000000,0,Dwight Freeney,OLB,active,atlanta-falcons,1000000,2016
2206,760000,137500,Patrick DiMarco,FB,active,atlanta-falcons,897500,2016
2207,760000,100000,Josh Harris,LS,active,atlanta-falcons,860000,2016
2208,450000,376479,Deion Jones,ILB,active,atlanta-falcons,826479,2016
2209,567500,186311,Tevin Coleman,RB,active,atlanta-falcons,753811,2016
2210,600000,121106,Devonta Freeman,RB,active,atlanta-falcons,721106,2016
2211,885000,80000,Philip Wheeler,OLB,active,atlanta-falcons,965000,2016
2212,675000,0,LaRoy Reynolds,ILB,active,atlanta-falcons,675000,2016
2213,675000,0,Aldrick Robinson,WR,active,atlanta-falcons,675000,2016
2214,525000,135205,Justin Hardy,WR,active,atlanta-falcons,660205,2016
2215,450000,193357,Austin Hooper,TE,active,atlanta-falcons,643357,2016
2216,760000,25000,Tom Compton,T,active,atlanta-falcons,785000,2016
2217,600000,0,Taylor Gabriel,WR,active,atlanta-falcons,600000,2016
2218,600000,0,Ben Garland,G,active,atlanta-falcons,600000,2016
2219,450000,141382,De'Vondre Campbell,OLB,active,atlanta-falcons,591382,2016
2220,525000,61963,Grady Jarrett,DT,active,atlanta-falcons,586963,2016
2221,525000,0,Ricardo Allen,SS,active,atlanta-falcons,525000,2016
2222,450000,33095,Wes Schweitzer,G,active,atlanta-falcons,483095,2016
2223,450000,1166,Brian Poole,S,active,atlanta-falcons,451166,2016
2224,450000,833,Joshua Perkins,TE,active,atlanta-falcons,450833,2016
2225,450000,0,C.J. Goodwin,S,active,atlanta-falcons,450000,2016
2226,300823,0,Terron Ward,RB,active,atlanta-falcons,300823,2016
2227,291170,0,Sharrod Neasman,S,active,atlanta-falcons,291170,2016
2228,185294,0,Deji Olatoye,CB,active,atlanta-falcons,185294,2016
2229,141176,0,Nick Williams,WR,active,atlanta-falcons,141176,2016
2230,119117,0,Blidi Wreh-Wilson,CB,active,atlanta-falcons,119117,2016
2231,104117,0,Dashon Goldson,FS,active,atlanta-falcons,104117,2016
2232,61764,0,Josh Keyes,ILB,active,atlanta-falcons,61764,2016
2233,52940,0,D.J. Tialavea,TE,active,atlanta-falcons,52940,2016
2234,1750000,1250000,Adrian Clayborn,DE,injured_reserve,atlanta-falcons,3000000,2016
2235,918558,1679745,Desmond Trufant,CB,injured_reserve,atlanta-falcons,2598303,2016
2236,1900000,684375,Jacob Tamme,TE,injured_reserve,atlanta-falcons,2584375,2016
2237,1000000,1250000,Derrick Shelby,DT,injured_reserve,atlanta-falcons,2250000,2016
2238,1671000,11474,Kemal Ishmael,SS,injured_reserve,atlanta-falcons,1682474,2016
2239,1000000,468750,Sean Weatherspoon,ILB,injured_reserve,atlanta-falcons,1468750,2016
2240,525000,0,Akeem King,SS,injured_reserve,atlanta-falcons,525000,2016
2241,363000,0,Tyler Starr,OLB,injured_reserve,atlanta-falcons,363000,2016
2242,333000,18446,Devin Fuller,WR,injured_reserve,atlanta-falcons,351446,2016
2243,333000,2500,Chris Mayes,DT,injured_reserve,atlanta-falcons,335500,2016
2244,20700,0,Ryan White,CB,practice_squad,atlanta-falcons,20700,2016
2245,0,8800000,Sam Baker,LT,dead_cap,atlanta-falcons,8800000,2016
2246,0,5400000,Jon Asamoah,G,dead_cap,atlanta-falcons,5400000,2016
2247,0,3775000,Roddy White,WR,dead_cap,atlanta-falcons,3775000,2016
2248,0,3300000,William Moore,SS,dead_cap,atlanta-falcons,3300000,2016
2249,1000000,468750,Dashon Goldson,FS,dead_cap,atlanta-falcons,1468750,2016
2250,0,1400000,Paul Soliai,DT,dead_cap,atlanta-falcons,1400000,2016
2251,0,833334,Justin Durant,OLB,dead_cap,atlanta-falcons,833334,2016
2252,0,833334,Devin Hester,WR,dead_cap,atlanta-falcons,833334,2016
2253,411764,166666,Michael Person,G,dead_cap,atlanta-falcons,578430,2016
2254,463230,0,Robenson Therezie,FS,dead_cap,atlanta-falcons,463230,2016
2255,0,345418,Dezmen Southward,CB,dead_cap,atlanta-falcons,345418,2016
2256,312941,0,Cliff Matthews,DE,dead_cap,atlanta-falcons,312941,2016
2257,173823,15000,A.J. Hawk,OLB,dead_cap,atlanta-falcons,188823,2016
2258,178823,0,Stevan Ridley,RB,dead_cap,atlanta-falcons,178823,2016
2259,70588,99272,Malliciah Goodman,DE,dead_cap,atlanta-falcons,169860,2016
2260,123070,0,J.D. McKissic,RB,dead_cap,atlanta-falcons,123070,2016
2261,117300,0,Matt Simms,QB,dead_cap,atlanta-falcons,117300,2016
2262,117300,0,Joe Vellano,DT,dead_cap,atlanta-falcons,117300,2016
2263,103500,0,Carter Bykowski,LT,dead_cap,atlanta-falcons,103500,2016
2264,103500,0,D.J. Tialavea,TE,dead_cap,atlanta-falcons,103500,2016
2265,96264,333,Terron Ward,RB,dead_cap,atlanta-falcons,96597,2016
2266,89700,0,Nick Williams,WR,dead_cap,atlanta-falcons,89700,2016
2267,89411,0,O'Brien Schofield,OLB,dead_cap,atlanta-falcons,89411,2016
2268,0,85740,Marquis Spruill,ILB,dead_cap,atlanta-falcons,85740,2016
2269,0,80000,Charles Godfrey,SS,dead_cap,atlanta-falcons,80000,2016
2270,75900,0,Deji Olatoye,CB,dead_cap,atlanta-falcons,75900,2016
2271,69000,0,Jhurrell Pressley,RB,dead_cap,atlanta-falcons,69000,2016
2272,62100,0,Josh Keyes,ILB,dead_cap,atlanta-falcons,62100,2016
2273,0,60000,Bryce Harris,RT,dead_cap,atlanta-falcons,60000,2016
2274,58482,0,Kevin Graf,RT,dead_cap,atlanta-falcons,58482,2016
2275,55200,0,Blake Muir,T,dead_cap,atlanta-falcons,55200,2016
2276,0,53862,Jake Rodgers,T,dead_cap,atlanta-falcons,53862,2016
2277,0,46685,Stansly Maponga,DE,dead_cap,atlanta-falcons,46685,2016
2278,44705,0,Trevor Robinson,C,dead_cap,atlanta-falcons,44705,2016
2279,41400,2500,Sharrod Neasman,S,dead_cap,atlanta-falcons,43900,2016
2280,41400,0,Davis Tull,DE,dead_cap,atlanta-falcons,41400,2016
2281,39705,0,Blidi Wreh-Wilson,CB,dead_cap,atlanta-falcons,39705,2016
2282,0,39585,Akeem King,SS,dead_cap,atlanta-falcons,39585,2016
2283,26470,0,Matt Wile,P,dead_cap,atlanta-falcons,26470,2016
2284,0,22948,Tyler Starr,OLB,dead_cap,atlanta-falcons,22948,2016
2285,13800,0,Nordly Capi,OLB,dead_cap,atlanta-falcons,13800,2016
2286,13800,0,B.J. Daniels,WR,dead_cap,atlanta-falcons,13800,2016
2287,13800,0,Devonte Johnson,CB,dead_cap,atlanta-falcons,13800,2016
2288,0,11474,Sean Renfree,QB,dead_cap,atlanta-falcons,11474,2016
2289,6900,3334,Joey Mbu,DT,dead_cap,atlanta-falcons,10234,2016
2290,6900,0,Darion Griswold,TE,dead_cap,atlanta-falcons,6900,2016
2291,6900,0,Martin Ifedi,DE,dead_cap,atlanta-falcons,6900,2016
2292,6900,0,Gus Johnson,RB,dead_cap,atlanta-falcons,6900,2016
2293,6900,0,Michael Palardy,K,dead_cap,atlanta-falcons,6900,2016
2294,6900,0,Blake Sims,RB,dead_cap,atlanta-falcons,6900,2016
2295,0,6000,Cody Elenz,T,dead_cap,atlanta-falcons,6000,2016
2296,0,3334,Eric Lefeld,G,dead_cap,atlanta-falcons,3334,2016
2297,0,3000,Gerald Dixon,DT,dead_cap,atlanta-falcons,3000,2016
2298,0,2334,Marquez Clark,WR,dead_cap,atlanta-falcons,2334,2016
2299,0,2000,Terrell Floyd,CB,dead_cap,atlanta-falcons,2000,2016
2300,0,2000,Beau Gardner,TE,dead_cap,atlanta-falcons,2000,2016
2301,0,2000,Damien Parms,S,dead_cap,atlanta-falcons,2000,2016
2302,0,2000,Valerian Ume-Ezeoke,C,dead_cap,atlanta-falcons,2000,2016
2303,0,1334,Dere Akunne,OLB,dead_cap,atlanta-falcons,1334,2016
2304,0,1334,Warren Herring,DT,dead_cap,atlanta-falcons,1334,2016
2305,0,1334,James Stone,C,dead_cap,atlanta-falcons,1334,2016
2306,0,1334,Shane Wynn,WR,dead_cap,atlanta-falcons,1334,2016
2307,0,1333,Torrey Green,OLB,dead_cap,atlanta-falcons,1333,2016
2308,0,1000,Malachi Jones,WR,dead_cap,atlanta-falcons,1000,2016
2309,0,1000,David Richards,WR,dead_cap,atlanta-falcons,1000,2016
2310,0,833,Josh Dawson,DT,dead_cap,atlanta-falcons,833,2016
2311,0,667,Michael Lee,CB,dead_cap,atlanta-falcons,667,2016
2312,0,667,Kevin White,CB,dead_cap,atlanta-falcons,667,2016
2313,0,666,Daje Johnson,WR,dead_cap,atlanta-falcons,666,2016
2314,0,500,Alex Fifita,T,dead_cap,atlanta-falcons,500,2016
2315,15750000,10400000,Matt Ryan,QB,active,atlanta-falcons,26150000,2017
2316,11500000,2400000,Julio Jones,WR,active,atlanta-falcons,13900000,2017
2317,2000000,7600000,Robert Alford,CB,active,atlanta-falcons,9600000,2017
2318,5750000,2550000,Alex Mack,C,active,atlanta-falcons,8300000,2017
2319,7500000,500000,Dontari Poe,DT,active,atlanta-falcons,8000000,2017
2320,6000000,1400000,Mohamed Sanu,WR,active,atlanta-falcons,7400000,2017
2321,3750000,1656250,Adrian Clayborn,DE,active,atlanta-falcons,5406250,2017
2322,690000,4537569,Jake Matthews,LT,active,atlanta-falcons,5227569,2017
2323,4100000,940000,Brooks Reed,DE,active,atlanta-falcons,5040000,2017
2324,1526000,3000000,Desmond Trufant,CB,active,atlanta-falcons,4526000,2017
2325,1297000,3121106,Devonta Freeman,RB,active,atlanta-falcons,4418106,2017
2326,3000000,1250000,Derrick Shelby,DT,active,atlanta-falcons,4250000,2017
2327,615000,3338244,Vic Beasley,DE,active,atlanta-falcons,3953244,2017
2328,2250000,1250000,Matt Schaub,QB,active,atlanta-falcons,3500000,2017
2329,1450000,1633334,Matt Bryant,K,active,atlanta-falcons,3083334,2017
2330,2746000,0,Taylor Gabriel,WR,active,atlanta-falcons,2746000,2017
2331,2200000,500000,Matt Bosher,P,active,atlanta-falcons,2700000,2017
2332,1500000,1000000,Levine Toilolo,TE,active,atlanta-falcons,2500000,2017
2333,938075,1502299,Keanu Neal,FS,active,atlanta-falcons,2440374,2017
2334,1000000,1300000,Ryan Schraeder,RT,active,atlanta-falcons,2300000,2017
2335,1250000,703125,Kemal Ishmael,SS,active,atlanta-falcons,1953125,2017
2336,465000,1392551,Takkarist McKinley,DE,active,atlanta-falcons,1857551,2017
2337,1300000,500000,Andre Roberts,WR,active,atlanta-falcons,1800000,2017
2338,850000,450000,LaRoy Reynolds,ILB,active,atlanta-falcons,1300000,2017
2339,775000,356250,Courtney Upshaw,DT,active,atlanta-falcons,1131250,2017
2340,656620,376479,Deion Jones,ILB,active,atlanta-falcons,1033099,2017
2341,780000,100000,Josh Harris,LS,active,atlanta-falcons,880000,2017
2342,680000,186311,Tevin Coleman,RB,active,atlanta-falcons,866311,2017
2343,784633,0,Ty Sambrailo,LT,active,atlanta-falcons,784633,2017
2344,615000,135205,Justin Hardy,WR,active,atlanta-falcons,750205,2017
2345,540000,193357,Austin Hooper,TE,active,atlanta-falcons,733357,2017
2346,775000,80000,Austin Pasztor,T,active,atlanta-falcons,855000,2017
2347,690000,0,Derrick Coleman,FB,active,atlanta-falcons,690000,2017
2348,690000,0,Ben Garland,G,active,atlanta-falcons,690000,2017
2349,690000,0,Nick Williams,WR,active,atlanta-falcons,690000,2017
2350,465000,222438,Duke Riley,LB,active,atlanta-falcons,687438,2017
2351,540000,141382,De'Vondre Campbell,OLB,active,atlanta-falcons,681382,2017
2352,615000,61963,Grady Jarrett,DT,active,atlanta-falcons,676963,2017
2353,775000,0,Blidi Wreh-Wilson,CB,active,atlanta-falcons,775000,2017
2354,615000,0,Ricardo Allen,SS,active,atlanta-falcons,615000,2017
2355,615000,0,Terron Ward,RB,active,atlanta-falcons,615000,2017
2356,465000,138576,Sean Harlow,G,active,atlanta-falcons,603576,2017
2357,540000,33095,Wes Schweitzer,G,active,atlanta-falcons,573095,2017
2358,540000,1166,Brian Poole,S,active,atlanta-falcons,541166,2017
2359,540000,0,Sharrod Neasman,S,active,atlanta-falcons,540000,2017
2360,465000,72230,Damontae Kazee,CB,active,atlanta-falcons,537230,2017
2361,465000,56847,Eric Saubert,TE,active,atlanta-falcons,521847,2017
2362,582353,0,Ahtyba Rubin,DT,active,atlanta-falcons,582353,2017
2363,455882,0,Sean Weatherspoon,ILB,active,atlanta-falcons,455882,2017
2364,328236,0,Marvin Hall,WR,active,atlanta-falcons,328236,2017
2365,182353,0,Leon McFadden,CB,active,atlanta-falcons,182353,2017
2366,20470,0,Jamil Douglas,C,active,atlanta-falcons,20470,2017
2367,615000,0,Terrence Magee,RT,active,atlanta-falcons,615000,2017
2368,5250000,1375000,Andy Levitre,G,injured_reserve,atlanta-falcons,6625000,2017
2369,1250000,833333,Jack Crawford,DE,injured_reserve,atlanta-falcons,2083333,2017
2370,690000,0,Jordan Tripp,ILB,injured_reserve,atlanta-falcons,690000,2017
2371,348000,18446,Devin Fuller,WR,injured_reserve,atlanta-falcons,366446,2017
2372,348000,0,Martin Ifedi,DE,injured_reserve,atlanta-falcons,348000,2017
2373,348000,0,Quincy Mauger,S,injured_reserve,atlanta-falcons,348000,2017
2374,0,0,Lucas Crowley,C,practice_squad,atlanta-falcons,0,2017
2375,0,0,Rannell Hall,WR,practice_squad,atlanta-falcons,0,2017
2376,0,2800000,Paul Soliai,DT,dead_cap,atlanta-falcons,2800000,2017
2377,0,1600000,Tyson Jackson,DE,dead_cap,atlanta-falcons,1600000,2017
2378,0,551879,Jalen Collins,CB,dead_cap,atlanta-falcons,551879,2017
2379,0,550153,Ra'Shede Hageman,DE,dead_cap,atlanta-falcons,550153,2017
2380,444710,0,C.J. Goodwin,S,dead_cap,atlanta-falcons,444710,2017
2381,273530,1666,Jermaine Grace,OLB,dead_cap,atlanta-falcons,275196,2017
2382,165565,67312,Brian Hill,RB,dead_cap,atlanta-falcons,232877,2017
2383,195282,0,Joe Vellano,DT,dead_cap,atlanta-falcons,195282,2017
2384,0,166668,Michael Person,G,dead_cap,atlanta-falcons,166668,2017
2385,137329,0,Terrence Magee,RT,dead_cap,atlanta-falcons,137329,2017
2386,135882,0,Deji Olatoye,CB,dead_cap,atlanta-falcons,135882,2017
2387,128153,0,Taniela Tupou,DT,dead_cap,atlanta-falcons,128153,2017
2388,122400,833,Joshua Perkins,TE,dead_cap,atlanta-falcons,123233,2017
2389,122400,0,Marcelis Branch,CB,dead_cap,atlanta-falcons,122400,2017
2390,122400,0,Daniel Brunskill,T,dead_cap,atlanta-falcons,122400,2017
2391,122400,0,Deante Burton,WR,dead_cap,atlanta-falcons,122400,2017
2392,122400,0,Alex Gray,TE,dead_cap,atlanta-falcons,122400,2017
2393,122400,0,J’terius Jones,OLB,dead_cap,atlanta-falcons,122400,2017
2394,115200,0,Jamil Douglas,C,dead_cap,atlanta-falcons,115200,2017
2395,100800,0,Reggie Davis,WR,dead_cap,atlanta-falcons,100800,2017
2396,79200,0,Joey Ivie,DT,dead_cap,atlanta-falcons,79200,2017
2397,72000,0,Garrett Grayson,QB,dead_cap,atlanta-falcons,72000,2017
2398,36176,0,Josh Keyes,ILB,dead_cap,atlanta-falcons,36176,2017
2399,36000,0,Marvin Hall,WR,dead_cap,atlanta-falcons,36000,2017
2400,21600,0,Jeremy Boykins,CB,dead_cap,atlanta-falcons,21600,2017
2401,14400,0,Jonathan Woodard,DE,dead_cap,atlanta-falcons,14400,2017
2402,14400,0,Mike Meyer,K,dead_cap,atlanta-falcons,14400,2017
2403,0,5000,Chris Mayes,DT,dead_cap,atlanta-falcons,5000,2017
2404,0,5000,Sharrod Neasman,S,dead_cap,atlanta-falcons,5000,2017
2405,0,2667,Torrey Green,OLB,dead_cap,atlanta-falcons,2667,2017
2406,0,1667,Josh Dawson,DT,dead_cap,atlanta-falcons,1667,2017
2407,0,1334,Daje Johnson,WR,dead_cap,atlanta-falcons,1334,2017
2408,0,334,Terron Ward,RB,dead_cap,atlanta-falcons,334,2017
2409,6000000,14100000,Matt Ryan,QB,active,atlanta-falcons,20100000,2018
2410,8500000,5800000,Desmond Trufant,CB,active,atlanta-falcons,14300000,2018
2411,9000000,3866667,Julio Jones,WR,active,atlanta-falcons,12866667,2018
2412,8500000,2550000,Alex Mack,C,active,atlanta-falcons,11050000,2018
2413,9000000,600000,Robert Alford,CB,active,atlanta-falcons,9600000,2018
2414,5500000,2789200,Jake Matthews,LT,active,atlanta-falcons,8289200,2018
2415,6125000,1400000,Mohamed Sanu,WR,active,atlanta-falcons,7525000,2018
2416,5000000,1500000,Ryan Schraeder,RT,active,atlanta-falcons,6500000,2018
2417,705000,3907118,Vic Beasley,DE,active,atlanta-falcons,4612118,2018
2418,2750000,1750000,Matt Schaub,QB,active,atlanta-falcons,4500000,2018
2419,3000000,940000,Brooks Reed,DE,active,atlanta-falcons,3940000,2018
2420,2250000,1108333,Jack Crawford,DT,active,atlanta-falcons,3358333,2018
2421,2914000,0,Ben Garland,G,active,atlanta-falcons,2914000,2018
2422,2200000,500000,Matt Bosher,P,active,atlanta-falcons,2700000,2018
2423,929388,1392551,Takkarist McKinley,DE,active,atlanta-falcons,2321939,2018
2424,1100000,1066666,Matt Bryant,K,active,atlanta-falcons,2166666,2018
2425,480000,1501947,Calvin Ridley,WR,active,atlanta-falcons,1981947,2018
2426,1907000,61964,Grady Jarrett,DT,active,atlanta-falcons,1968964,2018
2427,850000,837500,Justin Bethel,CB,active,atlanta-falcons,1687500,2018
2428,1500000,0,Bruce Irvin,DE,active,atlanta-falcons,1500000,2018
2429,825000,662500,Terrell McClain,DT,active,atlanta-falcons,1487500,2018
2430,863240,376479,Deion Jones,ILB,active,atlanta-falcons,1239719,2018
2431,790000,210000,Kemal Ishmael,SS,active,atlanta-falcons,1000000,2018
2432,791628,186311,Tevin Coleman,RB,active,atlanta-falcons,977939,2018
2433,959447,0,Ty Sambrailo,LT,active,atlanta-falcons,959447,2018
2434,941121,0,Jordan Richards,SS,active,atlanta-falcons,941121,2018
2435,480000,363026,Isaiah Oliver,CB,active,atlanta-falcons,843026,2018
2436,705000,135206,Justin Hardy,WR,active,atlanta-falcons,840206,2018
2437,616500,222438,Duke Riley,OLB,active,atlanta-falcons,838938,2018
2438,630000,193357,Austin Hooper,TE,active,atlanta-falcons,823357,2018
2439,630000,141382,De'Vondre Campbell,OLB,active,atlanta-falcons,771382,2018
2440,915000,90000,Logan Paulsen,TE,active,atlanta-falcons,1005000,2018
2441,790000,90000,Blidi Wreh-Wilson,CB,active,atlanta-falcons,880000,2018
2442,480000,204490,Deadrin Senat,DT,active,atlanta-falcons,684490,2018
2443,630000,33095,Wes Schweitzer,G,active,atlanta-falcons,663095,2018
2444,630000,1168,Brian Poole,LB,active,atlanta-falcons,631168,2018
2445,555000,72230,Damontae Kazee,SS,active,atlanta-falcons,627230,2018
2446,555000,56847,Eric Saubert,TE,active,atlanta-falcons,611847,2018
2447,790000,0,Steven Means,DE,active,atlanta-falcons,790000,2018
2448,555000,0,Marvin Hall,WR,active,atlanta-falcons,555000,2018
2449,522353,0,Brian Hill,RB,active,atlanta-falcons,522353,2018
2450,480000,39048,Russell Gage,WR,active,atlanta-falcons,519048,2018
2451,753529,0,Bruce Carter,ILB,active,atlanta-falcons,753529,2018
2452,518824,0,Sharrod Neasman,S,active,atlanta-falcons,518824,2018
2453,480000,36657,Foyesade Oluokun,ILB,active,atlanta-falcons,516657,2018
2454,480000,2500,Matt Gono,T,active,atlanta-falcons,482500,2018
2455,480000,0,Ricky Ortiz,FB,active,atlanta-falcons,480000,2018
2456,359117,0,Giorgio Tavecchio,K,active,atlanta-falcons,359117,2018
2457,484412,0,Zane Beadles,G,active,atlanta-falcons,484412,2018
2458,238824,0,Jon Condo,LS,active,atlanta-falcons,238824,2018
2459,141175,0,Ryan Neal,FS,active,atlanta-falcons,141175,2018
2460,112940,0,Justin Zimmer,DT,active,atlanta-falcons,112940,2018
2461,74118,0,Jeremy Langford,RB,active,atlanta-falcons,74118,2018
2462,3500000,1500000,Andy Levitre,G,injured_reserve,atlanta-falcons,5000000,2018
2463,2000000,3000000,Devonta Freeman,RB,injured_reserve,atlanta-falcons,5000000,2018
2464,1914000,1375000,Ricardo Allen,FS,injured_reserve,atlanta-falcons,3289000,2018
2465,2250000,750000,Brandon Fusco,G,injured_reserve,atlanta-falcons,3000000,2018
2466,1426150,1502299,Keanu Neal,FS,injured_reserve,atlanta-falcons,2928449,2018
2467,2000000,0,Derrick Shelby,DE,injured_reserve,atlanta-falcons,2000000,2018
2468,1205000,100000,Josh Harris,LS,injured_reserve,atlanta-falcons,1305000,2018
2469,466229,155218,Ito Smith,RB,injured_reserve,atlanta-falcons,621447,2018
2470,0,2500000,Derrick Shelby,DT,dead_cap,atlanta-falcons,2500000,2018
2471,0,1600000,Tyson Jackson,DE,dead_cap,atlanta-falcons,1600000,2018
2472,0,1000000,Levine Toilolo,TE,dead_cap,atlanta-falcons,1000000,2018
2473,0,551879,Jalen Collins,CB,dead_cap,atlanta-falcons,551879,2018
2474,557647,0,Keith Tandy,FS,dead_cap,atlanta-falcons,557647,2018
2475,318141,0,Justin Zimmer,DT,dead_cap,atlanta-falcons,318141,2018
2476,213529,0,Colby Pearson,WR,dead_cap,atlanta-falcons,213529,2018
2477,76000,136624,Sean Harlow,G,dead_cap,atlanta-falcons,212624,2018
2478,7600,201936,Brian Hill,RB,dead_cap,atlanta-falcons,209536,2018
2479,207353,0,Zac Kerin,C,dead_cap,atlanta-falcons,207353,2018
2480,111176,90000,Austin Pasztor,T,dead_cap,atlanta-falcons,201176,2018
2481,179200,3333,Kurt Benkert,QB,dead_cap,atlanta-falcons,182533,2018
2482,130588,0,Michael Bennett,DT,dead_cap,atlanta-falcons,130588,2018
2483,129200,0,Daniel Brunskill,T,dead_cap,atlanta-falcons,129200,2018
2484,129200,0,Jaeden Graham,TE,dead_cap,atlanta-falcons,129200,2018
2485,129200,0,Alex Gray,TE,dead_cap,atlanta-falcons,129200,2018
2486,129200,0,Devin Gray,WR,dead_cap,atlanta-falcons,129200,2018
2487,121600,3333,Jacob Tuioti-Mariner,DT,dead_cap,atlanta-falcons,124933,2018
2488,111177,0,Rees Odhiambo,T,dead_cap,atlanta-falcons,111177,2018
2489,91200,0,Ryan Neal,FS,dead_cap,atlanta-falcons,91200,2018
2490,83600,3334,Jermaine Grace,OLB,dead_cap,atlanta-falcons,86934,2018
2491,83600,0,Taveze Calhoun,S,dead_cap,atlanta-falcons,83600,2018
2492,66235,0,Deante Burton,WR,dead_cap,atlanta-falcons,66235,2018
2493,53200,0,J.C. Hassenauer,C,dead_cap,atlanta-falcons,53200,2018
2494,46471,0,Corey Nelson,ILB,dead_cap,atlanta-falcons,46471,2018
2495,43435,0,Richard Jarvis,OLB,dead_cap,atlanta-falcons,43435,2018
2496,32647,0,Jeff Overbaugh,LS,dead_cap,atlanta-falcons,32647,2018
2497,30400,0,Christian Blake,WR,dead_cap,atlanta-falcons,30400,2018
2498,22800,0,Richie Brown,ILB,dead_cap,atlanta-falcons,22800,2018
2499,22800,0,Jeremy Langford,RB,dead_cap,atlanta-falcons,22800,2018
2500,22800,0,Julian Williams,WR,dead_cap,atlanta-falcons,22800,2018
2501,0,18446,Devin Fuller,WR,dead_cap,atlanta-falcons,18446,2018
2502,15200,0,Chris Durant,T,dead_cap,atlanta-falcons,15200,2018
2503,7600,0,Prince Charles Iworah,CB,dead_cap,atlanta-falcons,7600,2018
2504,0,1666,Chris Lammons,CB,dead_cap,atlanta-falcons,1666,2018
2505,0,1666,Daniel Marx,FB,dead_cap,atlanta-falcons,1666,2018
2506,0,834,Joshua Perkins,TE,dead_cap,atlanta-falcons,834,2018
2507,2750000,15050000,Matt Ryan,QB,active,atlanta-falcons,17800000,2019
2508,12810000,0,Vic Beasley,DE,active,atlanta-falcons,12810000,2019
2509,8500000,2550000,Alex Mack,C,active,atlanta-falcons,11050000,2019
2510,6500000,4500000,Grady Jarrett,DT,active,atlanta-falcons,11000000,2019
2511,1500000,8866667,Julio Jones,WR,active,atlanta-falcons,10366667,2019
2512,2125000,7264200,Jake Matthews,LT,active,atlanta-falcons,9389200,2019
2513,3750000,3000000,Devonta Freeman,RB,active,atlanta-falcons,6750000,2019
2514,1950000,3076482,Deion Jones,ILB,active,atlanta-falcons,5026482,2019
2515,2750000,1734375,Allen Bailey,DE,active,atlanta-falcons,4484375,2019
2516,2500000,1833333,Jamon Brown,G,active,atlanta-falcons,4333333,2019
2517,2550000,1108334,Jack Crawford,DT,active,atlanta-falcons,3658334,2019
2518,1250000,2125000,Ricardo Allen,SS,active,atlanta-falcons,3375000,2019
2519,2000000,1218750,Ty Sambrailo,RT,active,atlanta-falcons,3218750,2019
2520,495000,2171012,Chris Lindstrom,G,active,atlanta-falcons,2666012,2019
2521,2025000,193357,Austin Hooper,TE,active,atlanta-falcons,2218357,2019
2522,2025000,141382,De'Vondre Campbell,OLB,active,atlanta-falcons,2166382,2019
2523,1400000,750000,Luke Stocker,TE,active,atlanta-falcons,2150000,2019
2524,2025000,33096,Wes Schweitzer,C,active,atlanta-falcons,2058096,2019
2525,930000,1050000,Adrian Clayborn,DE,active,atlanta-falcons,1980000,2019
2526,495000,1371498,Kaleb McGary,RT,active,atlanta-falcons,1866498,2019
2527,1030000,375000,Matt Schaub,QB,active,atlanta-falcons,1405000,2019
2528,690757,363026,Isaiah Oliver,CB,active,atlanta-falcons,1053783,2019
2529,930000,0,Josh Harris,LS,active,atlanta-falcons,930000,2019
2530,622000,204490,Deadrin Senat,DT,active,atlanta-falcons,826490,2019
2531,805000,0,Keith Smith,FB,active,atlanta-falcons,805000,2019
2532,805000,90000,Kenjon Barner,RB,active,atlanta-falcons,895000,2019
2533,805000,90000,Tyeler Davison,DT,active,atlanta-falcons,895000,2019
2534,805000,90000,Justin Hardy,WR,active,atlanta-falcons,895000,2019
2535,805000,90000,Kemal Ishmael,SS,active,atlanta-falcons,895000,2019
2536,805000,90000,Blidi Wreh-Wilson,CB,active,atlanta-falcons,895000,2019
2537,720000,0,Sharrod Neasman,S,active,atlanta-falcons,720000,2019
2538,645000,72230,Damontae Kazee,CB,active,atlanta-falcons,717230,2019
2539,495000,189197,Kendall Sheffield,CB,active,atlanta-falcons,684197,2019
2540,645000,0,Brian Hill,RB,active,atlanta-falcons,645000,2019
2541,495000,122098,John Cominsky,DE,active,atlanta-falcons,617098,2019
2542,570000,39048,Russell Gage,WR,active,atlanta-falcons,609048,2019
2543,570000,36657,Foyesade Oluokun,LB,active,atlanta-falcons,606657,2019
2544,495000,77891,Qadree Ollison,RB,active,atlanta-falcons,572891,2019
2545,570000,2500,Matt Gono,T,active,atlanta-falcons,572500,2019
2546,495000,1666,Olamide Zaccheaus,WR,active,atlanta-falcons,496666,2019
2547,495000,0,Jaeden Graham,TE,active,atlanta-falcons,495000,2019
2548,469412,0,Jamal Carter,SS,active,atlanta-falcons,469412,2019
2549,341471,0,Younghoe Koo,K,active,atlanta-falcons,341471,2019
2550,291176,0,Christian Blake,WR,active,atlanta-falcons,291176,2019
2551,268235,0,Brandon Powell,WR,active,atlanta-falcons,268235,2019
2552,232944,0,Jacob Tuioti-Mariner,DT,active,atlanta-falcons,232944,2019
2553,189412,0,Ryan Allen,P,active,atlanta-falcons,189412,2019
2554,169412,0,John Wetzel,G,active,atlanta-falcons,169412,2019
2555,142059,0,Jamar Taylor,CB,active,atlanta-falcons,142059,2019
2556,100588,0,Ahmad Thomas,S,active,atlanta-falcons,100588,2019
2557,67059,0,Sean Harlow,G,active,atlanta-falcons,67059,2019
2558,58235,0,Austin Larkin,DE,active,atlanta-falcons,58235,2019
2559,29118,0,Chris Cooper,DE,active,atlanta-falcons,29118,2019
2560,9500000,5800000,Desmond Trufant,CB,injured_reserve,atlanta-falcons,15300000,2019
2561,1914224,1502299,Keanu Neal,FS,injured_reserve,atlanta-falcons,3416523,2019
2562,2000000,875000,James Carpenter,G,injured_reserve,atlanta-falcons,2875000,2019
2563,1393775,1392551,Takkarist McKinley,DE,injured_reserve,atlanta-falcons,2786326,2019
2564,2545000,0,Matt Bosher,P,injured_reserve,atlanta-falcons,2545000,2019
2565,975487,1501947,Calvin Ridley,WR,injured_reserve,atlanta-falcons,2477434,2019
2566,805000,90000,Steven Means,DE,injured_reserve,atlanta-falcons,895000,2019
2567,805000,90000,J.J. Wilcox,FS,injured_reserve,atlanta-falcons,895000,2019
2568,570000,155218,Ito Smith,RB,injured_reserve,atlanta-falcons,725218,2019
2569,395294,15000,Ra'Shede Hageman,DE,injured_reserve,atlanta-falcons,410294,2019
2570,408000,0,Michael Bennett,DT,injured_reserve,atlanta-falcons,408000,2019
2571,408000,0,Matt Simms,QB,injured_reserve,atlanta-falcons,408000,2019
2572,378000,0,Kurt Benkert,QB,injured_reserve,atlanta-falcons,378000,2019
2573,378000,0,Alex Gray,TE,injured_reserve,atlanta-falcons,378000,2019
2574,615588,0,John Cyprien,SS,injured_reserve,atlanta-falcons,615588,2019
2575,136000,0,Chris Cooper,S,practice_squad,atlanta-falcons,136000,2019
2576,24000,0,Quentin Poling,ILB,practice_squad,atlanta-falcons,24000,2019
2577,16000,0,Carroll Phillips,OLB,practice_squad,atlanta-falcons,16000,2019
2578,2470588,1400000,Mohamed Sanu,WR,dead_cap,atlanta-falcons,3870588,2019
2579,1500000,2145834,Matt Bryant,K,dead_cap,atlanta-falcons,3645834,2019
2580,1000000,1500000,Brandon Fusco,G,dead_cap,atlanta-falcons,2500000,2019
2581,0,1300000,Ryan Schraeder,RT,dead_cap,atlanta-falcons,1300000,2019
2582,0,1200000,Robert Alford,CB,dead_cap,atlanta-falcons,1200000,2019
2583,0,1000000,Levine Toilolo,TE,dead_cap,atlanta-falcons,1000000,2019
2584,0,940000,Brooks Reed,DE,dead_cap,atlanta-falcons,940000,2019
2585,677647,0,John Wetzel,G,dead_cap,atlanta-falcons,677647,2019
2586,163059,273248,Sean Harlow,G,dead_cap,atlanta-falcons,436307,2019
2587,435877,0,Jermaine Grace,OLB,dead_cap,atlanta-falcons,435877,2019
2588,170941,222438,Duke Riley,OLB,dead_cap,atlanta-falcons,393379,2019
2589,333525,0,Taveze Calhoun,S,dead_cap,atlanta-falcons,333525,2019
2590,215353,0,Danny Etling,WR,dead_cap,atlanta-falcons,215353,2019
2591,189412,0,Ryan Allen,P,dead_cap,atlanta-falcons,189412,2019
2592,140470,0,Austin Larkin,DE,dead_cap,atlanta-falcons,140470,2019
2593,133118,0,Carson Meier,TE,dead_cap,atlanta-falcons,133118,2019
2594,121823,0,Matt Wile,P,dead_cap,atlanta-falcons,121823,2019
2595,113824,0,D.J. White,CB,dead_cap,atlanta-falcons,113824,2019
2596,104000,0,Lukayus McNeil,G,dead_cap,atlanta-falcons,104000,2019
2597,104000,0,Justin Zimmer,DT,dead_cap,atlanta-falcons,104000,2019
2598,0,90000,Logan Paulsen,TE,dead_cap,atlanta-falcons,90000,2019
2599,87353,0,Kasey Redfern,P,dead_cap,atlanta-falcons,87353,2019
2600,80000,0,Devin Gray,WR,dead_cap,atlanta-falcons,80000,2019
2601,80000,0,Ahmad Thomas,S,dead_cap,atlanta-falcons,80000,2019
2602,72000,6667,Jacob Tuioti-Mariner,DT,dead_cap,atlanta-falcons,78667,2019
2603,72000,0,Brandon Powell,WR,dead_cap,atlanta-falcons,72000,2019
2604,64000,0,C.J. Reavis,S,dead_cap,atlanta-falcons,64000,2019
2605,0,56847,Eric Saubert,TE,dead_cap,atlanta-falcons,56847,2019
2606,56000,0,Christian Blake,WR,dead_cap,atlanta-falcons,56000,2019
2607,56000,0,Craig Reynolds,RB,dead_cap,atlanta-falcons,56000,2019
2608,0,36963,Marcus Green,WR,dead_cap,atlanta-falcons,36963,2019
2609,24000,0,Jamal Carter,SS,dead_cap,atlanta-falcons,24000,2019
2610,0,18446,Devin Fuller,WR,dead_cap,atlanta-falcons,18446,2019
2611,16000,0,Anthony Coyle,G,dead_cap,atlanta-falcons,16000,2019
2612,8000,0,Nate Wozniak,G,dead_cap,atlanta-falcons,8000,2019
2613,0,6667,Kurt Benkert,QB,dead_cap,atlanta-falcons,6667,2019
2614,0,5000,Tre Crawford III,OLB,dead_cap,atlanta-falcons,5000,2019
2615,0,3334,Chris Lammons,CB,dead_cap,atlanta-falcons,3334,2019
2616,0,3334,Daniel Marx,FB,dead_cap,atlanta-falcons,3334,2019
2617,0,3333,Rashard Causey,CB,dead_cap,atlanta-falcons,3333,2019
2618,0,2333,Durrant Miles,DE,dead_cap,atlanta-falcons,2333,2019
2619,0,1666,C.J. Worton,WR,dead_cap,atlanta-falcons,1666,2019
2620,0,1333,Jaelin Robinson,T,dead_cap,atlanta-falcons,1333,2019
2621,0,1167,Yurik Bethune,OLB,dead_cap,atlanta-falcons,1167,2019
2622,0,1166,Del'Shawn Phillips,LB,dead_cap,atlanta-falcons,1166,2019
2623,0,1000,Jayson Stanley,WR,dead_cap,atlanta-falcons,1000,2019
2624,0,833,Parker Baldwin,S,dead_cap,atlanta-falcons,833,2019
2625,0,833,Kahlil Lewis,WR,dead_cap,atlanta-falcons,833,2019
2626,0,667,Kyle Vasey,LS,dead_cap,atlanta-falcons,667,2019
2627,0,666,Chandler Miller,C,dead_cap,atlanta-falcons,666,2019
2628,0,500,Shawn Bane Jr.,WR,dead_cap,atlanta-falcons,500,2019
2629,8000000,18175000,Matt Ryan,QB,active,atlanta-falcons,26175000,2020
2630,11200000,11966668,Julio Jones,WR,active,atlanta-falcons,23166668,2020
2631,10550000,7264200,Jake Matthews,LT,active,atlanta-falcons,17814200,2020
2632,10750000,5800000,Desmond Trufant,CB,active,atlanta-falcons,16550000,2020
2633,5001000,8333000,Grady Jarrett,DT,active,atlanta-falcons,13334000,2020
2634,8000000,2550000,Alex Mack,C,active,atlanta-falcons,10550000,2020
2635,5850000,6220000,Deion Jones,ILB,active,atlanta-falcons,12070000,2020
2636,6500000,3000000,Devonta Freeman,RB,active,atlanta-falcons,9500000,2020
2637,5250000,2125000,Ricardo Allen,SS,active,atlanta-falcons,7375000,2020
2638,4750000,1833333,Jamon Brown,G,active,atlanta-falcons,6583333,2020
2639,6466000,0,Keanu Neal,FS,active,atlanta-falcons,6466000,2020
2640,3500000,2484375,Allen Bailey,DE,active,atlanta-falcons,5984375,2020
2641,4500000,1218750,Ty Sambrailo,RT,active,atlanta-falcons,5718750,2020
2642,3750000,1713541,James Carpenter,G,active,atlanta-falcons,5463541,2020
2643,2600000,750000,Luke Stocker,TE,active,atlanta-falcons,3350000,2020
2644,1161503,2171012,Chris Lindstrom,G,active,atlanta-falcons,3332515,2020
2645,1858163,1392551,Takkarist McKinley,DE,active,atlanta-falcons,3250714,2020
2646,1470974,1501947,Calvin Ridley,WR,active,atlanta-falcons,2972921,2020
2647,2000000,375000,Matt Schaub,QB,active,atlanta-falcons,2375000,2020
2648,961625,1371498,Kaleb McGary,RT,active,atlanta-falcons,2333123,2020
2649,901513,363026,Isaiah Oliver,CB,active,atlanta-falcons,1264539,2020
2650,945000,0,Josh Harris,LS,active,atlanta-falcons,945000,2020
2651,713000,204490,Deadrin Senat,DT,active,atlanta-falcons,917490,2020
2652,660000,155218,Ito Smith,RB,active,atlanta-falcons,815218,2020
2653,735000,72230,Damontae Kazee,CB,active,atlanta-falcons,807230,2020
2654,585000,189197,Kendall Sheffield,CB,active,atlanta-falcons,774197,2020
2655,585000,122098,John Cominsky,DE,active,atlanta-falcons,707098,2020
2656,660000,39048,Russell Gage,WR,active,atlanta-falcons,699048,2020
2657,660000,36657,Foyesade Oluokun,LB,active,atlanta-falcons,696657,2020
2658,585000,77891,Qadree Ollison,RB,active,atlanta-falcons,662891,2020
2659,660000,2500,Matt Gono,T,active,atlanta-falcons,662500,2020
2660,660000,0,Jamal Carter,SS,active,atlanta-falcons,660000,2020
2661,660000,0,Sean Harlow,G,active,atlanta-falcons,660000,2020
2662,660000,0,Brandon Powell,WR,active,atlanta-falcons,660000,2020
2663,660000,0,Ahmad Thomas,S,active,atlanta-falcons,660000,2020
2664,585000,1666,Olamide Zaccheaus,WR,active,atlanta-falcons,586666,2020
2665,585000,0,Christian Blake,WR,active,atlanta-falcons,585000,2020
2666,585000,0,Jaeden Graham,TE,active,atlanta-falcons,585000,2020
2667,585000,0,Austin Larkin,DE,active,atlanta-falcons,585000,2020
2668,585000,0,C.J. Reavis,S,active,atlanta-falcons,585000,2020
2669,585000,0,Craig Reynolds,RB,active,atlanta-falcons,585000,2020
2670,585000,0,Jacob Tuioti-Mariner,DT,active,atlanta-falcons,585000,2020
2671,481765,58497,Jordan Miller,CB,active,atlanta-falcons,540262,2020
2672,510000,0,Kurt Benkert,QB,active,atlanta-falcons,510000,2020
2673,510000,0,Chris Cooper,DE,active,atlanta-falcons,510000,2020
2674,510000,0,Danny Etling,WR,active,atlanta-falcons,510000,2020
2675,510000,0,Devin Gray,WR,active,atlanta-falcons,510000,2020
2676,510000,0,Lukayus McNeil,G,active,atlanta-falcons,510000,2020
2677,510000,0,Carson Meier,TE,active,atlanta-falcons,510000,2020
2678,0,2500000,Ryan Schraeder,RT,dead_cap,atlanta-falcons,2500000,2020
2679,0,1400000,Mohamed Sanu,WR,dead_cap,atlanta-falcons,1400000,2020
2680,0,222438,Duke Riley,OLB,dead_cap,atlanta-falcons,222438,2020
2681,0,110889,Marcus Green,WR,dead_cap,atlanta-falcons,110889,2020
2682,0,56847,Eric Saubert,TE,dead_cap,atlanta-falcons,56847,2020
2683,0,10000,Tre Crawford III,OLB,dead_cap,atlanta-falcons,10000,2020
2684,0,6667,Rashard Causey,CB,dead_cap,atlanta-falcons,6667,2020
2685,0,4667,Durrant Miles,DE,dead_cap,atlanta-falcons,4667,2020
2686,0,3334,C.J. Worton,WR,dead_cap,atlanta-falcons,3334,2020
2687,0,2667,Jaelin Robinson,T,dead_cap,atlanta-falcons,2667,2020
2688,0,2334,Del'Shawn Phillips,LB,dead_cap,atlanta-falcons,2334,2020
2689,0,2333,Yurik Bethune,OLB,dead_cap,atlanta-falcons,2333,2020
2690,0,2000,Jayson Stanley,WR,dead_cap,atlanta-falcons,2000,2020
2691,0,1667,Parker Baldwin,S,dead_cap,atlanta-falcons,1667,2020
2692,0,1667,Kahlil Lewis,WR,dead_cap,atlanta-falcons,1667,2020
2693,0,1334,Lanard Bonner,TE,dead_cap,atlanta-falcons,1334,2020
2694,0,1334,Chandler Miller,C,dead_cap,atlanta-falcons,1334,2020
2695,0,1334,Kyle Vasey,LS,dead_cap,atlanta-falcons,1334,2020
2696,0,1000,Shawn Bane Jr.,WR,dead_cap,atlanta-falcons,1000,2020
2697,6500000,4428571,Ray Lewis,LB,active,baltimore-ravens,10928571,2007
2698,5000000,2525000,Terrell Suggs,OLB,active,baltimore-ravens,7525000,2007
2699,2600000,2166667,Bart Scott,LB,active,baltimore-ravens,4766667,2007
2700,3000000,1400000,Derrick Mason,WR,active,baltimore-ravens,4400000,2007
2701,595000,2250000,Willis McGahee,RB,active,baltimore-ravens,2845000,2007
2702,600000,2715000,Kyle Boller,QB,active,baltimore-ravens,3315000,2007
2703,595000,3071428,Ed Reed,S,active,baltimore-ravens,3666428,2007
2704,285000,1680000,Ben Grubbs,G,active,baltimore-ravens,1965000,2007
2705,360000,3067500,Haloti Ngata,DT,active,baltimore-ravens,3427500,2007
2706,600000,1080000,Jarret Johnson,OLB,active,baltimore-ravens,1680000,2007
2707,555000,2030000,Mark Clayton,WR,active,baltimore-ravens,2585000,2007
2708,780000,133333,Daniel Wilcox,WR,active,baltimore-ravens,913333,2007
2709,850000,0,Devard Darling,WR,active,baltimore-ravens,850000,2007
2710,510000,420000,Dwan Edwards,DT,active,baltimore-ravens,930000,2007
2711,595000,83333,Corey Ivy,CB,active,baltimore-ravens,678333,2007
2712,435000,140000,Adam Terry,T,active,baltimore-ravens,575000,2007
2713,360000,265000,Chris Chester,G,active,baltimore-ravens,625000,2007
2714,435000,103166,Jason Brown,G,active,baltimore-ravens,538166,2007
2715,360000,163333,David Pittman,CB,active,baltimore-ravens,523333,2007
2716,285000,192833,Yamon Figurs,WR,active,baltimore-ravens,477833,2007
2717,435000,40500,Justin Green,RB,active,baltimore-ravens,475500,2007
2718,360000,111667,Demetrius Williams,WR,active,baltimore-ravens,471667,2007
2719,360000,93667,P.J.  Daniels,RB,active,baltimore-ravens,453667,2007
2720,285000,167566,Marshal Yanda,G,active,baltimore-ravens,452566,2007
2721,435000,0,Mike Smith,LB,active,baltimore-ravens,435000,2007
2722,360000,43000,Dawan Landry,S,active,baltimore-ravens,403000,2007
2723,360000,34833,Quinn Sypniewski,TE,active,baltimore-ravens,394833,2007
2724,285000,95667,Antwan Barnes,OLB,active,baltimore-ravens,380667,2007
2725,360000,18163,Sam Koch,P,active,baltimore-ravens,378163,2007
2726,285000,93000,LeRon McClain,FB,active,baltimore-ravens,378000,2007
2727,360000,16650,Derrick Martin,CB,active,baltimore-ravens,376650,2007
2728,360000,0,Robert McCune,LB,active,baltimore-ravens,360000,2007
2729,338823,0,Cory Ross,RB,active,baltimore-ravens,338823,2007
2730,285000,37667,Jared Gaither,T,active,baltimore-ravens,322667,2007
2731,285000,35000,Troy Smith,QB,active,baltimore-ravens,320000,2007
2732,3000000,2200000,Samari Rolle,CB,injured_reserve,baltimore-ravens,5200000,2007
2733,2700000,3600000,Todd Heap,TE,injured_reserve,baltimore-ravens,6300000,2007
2734,2250000,4900000,Steve McNair,QB,injured_reserve,baltimore-ravens,7150000,2007
2735,385000,516666,Dan Cody,LB,injured_reserve,baltimore-ravens,901666,2007
2736,178125,18916,Prescott Burgess,LB,injured_reserve,baltimore-ravens,197041,2007
2737,79900,0,Cory Ross,RB,practice_squad,baltimore-ravens,79900,2007
2738,80000,0,Robert McCune,LB,dead_cap,baltimore-ravens,80000,2007
2739,0,38334,Roderick Green,LB,dead_cap,baltimore-ravens,38334,2007
2740,27480,0,Ryan LaCasse,LB,dead_cap,baltimore-ravens,27480,2007
2741,23500,0,Romby Bryant,WR,dead_cap,baltimore-ravens,23500,2007
2742,6500000,4428571,Ray Lewis,LB,active,baltimore-ravens,10928571,2008
2743,8475000,0,Terrell Suggs,OLB,active,baltimore-ravens,8475000,2008
2744,3400000,2166667,Bart Scott,LB,active,baltimore-ravens,5566667,2008
2745,3000000,1400000,Derrick Mason,WR,active,baltimore-ravens,4400000,2008
2746,1400000,2700000,Samari Rolle,CB,active,baltimore-ravens,4100000,2008
2747,730000,4167500,Todd Heap,TE,active,baltimore-ravens,4897500,2008
2748,2000000,1580000,Jarret Johnson,OLB,active,baltimore-ravens,3580000,2008
2749,2000000,1250000,Kyle Boller,QB,active,baltimore-ravens,3250000,2008
2750,605000,3750000,Willis McGahee,RB,active,baltimore-ravens,4355000,2008
2751,605000,3671428,Ed Reed,S,active,baltimore-ravens,4276428,2008
2752,445000,3067500,Haloti Ngata,DT,active,baltimore-ravens,3512500,2008
2753,800000,2030000,Mark Clayton,WR,active,baltimore-ravens,2830000,2008
2754,1417000,0,Jason Brown,G,active,baltimore-ravens,1417000,2008
2755,295000,1005000,Joe Flacco,QB,active,baltimore-ravens,1300000,2008
2756,370000,1560000,Ben Grubbs,G,active,baltimore-ravens,1930000,2008
2757,960000,133334,Daniel Wilcox,WR,active,baltimore-ravens,1093334,2008
2758,615000,475000,Brendon Ayanbadejo,LB,active,baltimore-ravens,1090000,2008
2759,445000,515000,Chris Chester,G,active,baltimore-ravens,960000,2008
2760,605000,420000,Dwan Edwards,DT,active,baltimore-ravens,1025000,2008
2761,730000,83333,Corey Ivy,CB,active,baltimore-ravens,813333,2008
2762,520000,140000,Adam Terry,T,active,baltimore-ravens,660000,2008
2763,750000,0,Fabian Washington,CB,active,baltimore-ravens,750000,2008
2764,295000,275000,Ray Rice,RB,active,baltimore-ravens,570000,2008
2765,370000,192833,Yamon Figurs,WR,active,baltimore-ravens,562833,2008
2766,445000,111667,Demetrius Williams,WR,active,baltimore-ravens,556667,2008
2767,445000,93667,P.J.  Daniels,RB,active,baltimore-ravens,538667,2008
2768,370000,167566,Marshal Yanda,G,active,baltimore-ravens,537566,2008
2769,520000,0,Jim Leonhard,S,active,baltimore-ravens,520000,2008
2770,295000,203366,Tavares Gooden,ILB,active,baltimore-ravens,498366,2008
2771,445000,43000,Dawan Landry,S,active,baltimore-ravens,488000,2008
2772,445000,34833,Quinn Sypniewski,TE,active,baltimore-ravens,479833,2008
2773,295000,172000,Tom Zbikowski,S,active,baltimore-ravens,467000,2008
2774,370000,95667,Antwan Barnes,OLB,active,baltimore-ravens,465667,2008
2775,445000,18163,Sam Koch,P,active,baltimore-ravens,463163,2008
2776,370000,93000,LeRon McClain,FB,active,baltimore-ravens,463000,2008
2777,295000,147833,Oniel Cousins,G,active,baltimore-ravens,442833,2008
2778,417187,16650,Derrick Martin,CB,active,baltimore-ravens,433837,2008
2779,295000,123041,Marcus Smith,WR,active,baltimore-ravens,418041,2008
2780,370000,37667,Jared Gaither,T,active,baltimore-ravens,407667,2008
2781,370000,35000,Troy Smith,QB,active,baltimore-ravens,405000,2008
2782,295000,98166,David Hale,G,active,baltimore-ravens,393166,2008
2783,370000,0,Robert McCune,LB,active,baltimore-ravens,370000,2008
2784,295000,17767,Haruki Nakamura,S,active,baltimore-ravens,312767,2008
2785,295000,3000,Jameel McClain,ILB,active,baltimore-ravens,298000,2008
2786,174117,0,Daren Stone,S,active,baltimore-ravens,174117,2008
2787,157941,0,Mike Smith,LB,active,baltimore-ravens,157941,2008
2788,156176,0,Steven Hauschka,K,active,baltimore-ravens,156176,2008
2789,201666,0,Chad Slaughter,T,active,baltimore-ravens,201666,2008
2790,26176,0,Cory Ross,RB,active,baltimore-ravens,26176,2008
2791,295000,0,Lamar Divens,DT,active,baltimore-ravens,295000,2008
2792,215000,18916,Prescott Burgess,LB,injured_reserve,baltimore-ravens,233916,2008
2793,200000,0,Kelly Talavou,DT,injured_reserve,baltimore-ravens,200000,2008
2794,88400,0,Justin Harper,WR,practice_squad,baltimore-ravens,88400,2008
2795,88400,0,Steven Hauschka,K,practice_squad,baltimore-ravens,88400,2008
2796,88400,0,Brian Johnson,G,practice_squad,baltimore-ravens,88400,2008
2797,88400,0,Matt Lawrence,RB,practice_squad,baltimore-ravens,88400,2008
2798,88400,0,Marvin Philip,C,practice_squad,baltimore-ravens,88400,2008
2799,88400,0,Joe Reitz,G,practice_squad,baltimore-ravens,88400,2008
2800,88400,0,Tre Stallings,G,practice_squad,baltimore-ravens,88400,2008
2801,88400,0,Ernie Wheelwright,WR,practice_squad,baltimore-ravens,88400,2008
2802,0,4900000,Steve McNair,QB,dead_cap,baltimore-ravens,4900000,2008
2803,353333,0,Dan Cody,LB,dead_cap,baltimore-ravens,353333,2008
2804,163333,0,David Pittman,CB,dead_cap,baltimore-ravens,163333,2008
2805,88400,0,Casey Bramlet,QB,dead_cap,baltimore-ravens,88400,2008
2806,69411,0,Ernie Wheelwright,WR,dead_cap,baltimore-ravens,69411,2008
2807,62000,0,Chris Canty,DE,dead_cap,baltimore-ravens,62000,2008
2808,14667,0,Justin Harper,WR,dead_cap,baltimore-ravens,14667,2008
2809,10667,0,Allen Patrick,RB,dead_cap,baltimore-ravens,10667,2008
2810,0,2000,Joe Reitz,G,dead_cap,baltimore-ravens,2000,2008
2811,1000000,6020000,Terrell Suggs,OLB,active,baltimore-ravens,7020000,2009
2812,3600000,4167500,Todd Heap,TE,active,baltimore-ravens,7767500,2009
2813,3600000,3671428,Ed Reed,S,active,baltimore-ravens,7271428,2009
2814,1000000,4150000,Ray Lewis,LB,active,baltimore-ravens,5150000,2009
2815,620000,4380000,Domonique Foxworth,CB,active,baltimore-ravens,5000000,2009
2816,1535000,4580000,Joe Flacco,QB,active,baltimore-ravens,6115000,2009
2817,2694999,2015000,Jarret Johnson,OLB,active,baltimore-ravens,4709999,2009
2818,3000000,1400000,Derrick Mason,WR,active,baltimore-ravens,4400000,2009
2819,1000000,3000000,Matt Birk,C,active,baltimore-ravens,4000000,2009
2820,850000,2850000,Samari Rolle,CB,active,baltimore-ravens,3700000,2009
2821,2070000,2030000,Mark Clayton,WR,active,baltimore-ravens,4100000,2009
2822,620000,3750000,Willis McGahee,RB,active,baltimore-ravens,4370000,2009
2823,1000000,1500000,Chris Carr,CB,active,baltimore-ravens,2500000,2009
2824,823750,3067500,Haloti Ngata,DT,active,baltimore-ravens,3891250,2009
2825,1695000,350000,Cleo Lemon,QB,active,baltimore-ravens,2045000,2009
2826,1545000,0,Sam Koch,P,active,baltimore-ravens,1545000,2009
2827,1515000,0,Fabian Washington,CB,active,baltimore-ravens,1515000,2009
2828,1000000,500000,L.J. Smith,TE,active,baltimore-ravens,1500000,2009
2829,570000,1560000,Ben Grubbs,G,active,baltimore-ravens,2130000,2009
2830,1000000,400000,Dwan Edwards,DT,active,baltimore-ravens,1400000,2009
2831,310000,942000,Michael Oher,RT,active,baltimore-ravens,1252000,2009
2832,1010000,0,Dawan Landry,S,active,baltimore-ravens,1010000,2009
2833,1010000,0,Tony Moll,T,active,baltimore-ravens,1010000,2009
2834,1010000,0,Demetrius Williams,WR,active,baltimore-ravens,1010000,2009
2835,620000,140000,Adam Terry,T,active,baltimore-ravens,760000,2009
2836,530000,265000,Chris Chester,G,active,baltimore-ravens,795000,2009
2837,385000,275000,Ray Rice,RB,active,baltimore-ravens,660000,2009
2838,460000,167566,Marshal Yanda,G,active,baltimore-ravens,627566,2009
2839,620000,0,David Tyree,WR,active,baltimore-ravens,620000,2009
2840,385000,203366,Tavares Gooden,ILB,active,baltimore-ravens,588366,2009
2841,310000,260000,Cedric Peerman,RB,active,baltimore-ravens,570000,2009
2842,310000,250000,Paul Kruger,OLB,active,baltimore-ravens,560000,2009
2843,385000,172000,Tom Zbikowski,S,active,baltimore-ravens,557000,2009
2844,460000,95667,Antwan Barnes,OLB,active,baltimore-ravens,555667,2009
2845,460000,93000,LeRon McClain,FB,active,baltimore-ravens,553000,2009
2846,385000,147833,Oniel Cousins,G,active,baltimore-ravens,532833,2009
2847,460000,37667,Jared Gaither,T,active,baltimore-ravens,497667,2009
2848,460000,35000,Troy Smith,QB,active,baltimore-ravens,495000,2009
2849,310000,176506,Lardarius Webb,CB,active,baltimore-ravens,486506,2009
2850,385000,98166,David Hale,G,active,baltimore-ravens,483166,2009
2851,745000,0,Corey Ivy,CB,active,baltimore-ravens,745000,2009
2852,620000,0,Billy Cundiff,K,active,baltimore-ravens,620000,2009
2853,460000,0,Charles Ali,RB,active,baltimore-ravens,460000,2009
2854,460000,0,John Beck,QB,active,baltimore-ravens,460000,2009
2855,385000,17767,Haruki Nakamura,S,active,baltimore-ravens,402767,2009
2856,385000,0,Steven Hauschka,K,active,baltimore-ravens,385000,2009
2857,385000,0,Jameel McClain,ILB,active,baltimore-ravens,385000,2009
2858,310000,2000,Dannell Ellerbe,OLB,active,baltimore-ravens,312000,2009
2859,72941,0,Justin Harper,WR,active,baltimore-ravens,72941,2009
2860,385000,0,Lamar Divens,DT,active,baltimore-ravens,385000,2009
2861,840000,475000,Brendon Ayanbadejo,LB,injured_reserve,baltimore-ravens,1315000,2009
2862,1010000,0,Quinn Sypniewski,TE,injured_reserve,baltimore-ravens,1010000,2009
2863,385000,123041,Marcus Smith,WR,injured_reserve,baltimore-ravens,508041,2009
2864,310000,0,Matt Lawrence,RB,injured_reserve,baltimore-ravens,310000,2009
2865,88400,0,Davon Drew,TE,practice_squad,baltimore-ravens,88400,2009
2866,88400,0,Justin Harper,WR,practice_squad,baltimore-ravens,88400,2009
2867,88400,0,Marcus Paschal,CB,practice_squad,baltimore-ravens,88400,2009
2868,88400,0,Maurice Price,WR,practice_squad,baltimore-ravens,88400,2009
2869,88400,0,Joe Reitz,G,practice_squad,baltimore-ravens,88400,2009
2870,88400,0,Stefan Rodgers,T,practice_squad,baltimore-ravens,88400,2009
2871,4900000,9800000,Steve McNair,QB,dead_cap,baltimore-ravens,14700000,2009
2872,192833,0,Yamon Figurs,WR,dead_cap,baltimore-ravens,192833,2009
2873,62000,0,Chris Canty,DE,dead_cap,baltimore-ravens,62000,2009
2874,46416,0,Davon Drew,TE,dead_cap,baltimore-ravens,46416,2009
2875,29334,0,Justin Harper,WR,dead_cap,baltimore-ravens,29334,2009
2876,21334,0,Allen Patrick,RB,dead_cap,baltimore-ravens,21334,2009
2877,18916,0,Prescott Burgess,LB,dead_cap,baltimore-ravens,18916,2009
2878,0,2000,Graham Gano,K,dead_cap,baltimore-ravens,2000,2009
2879,1900000,11220000,Terrell Suggs,OLB,active,baltimore-ravens,13120000,2010
2880,6000000,3671428,Ed Reed,S,active,baltimore-ravens,9671428,2010
2881,3600000,3750000,Willis McGahee,RB,active,baltimore-ravens,7350000,2010
2882,4000000,3367500,Todd Heap,TE,active,baltimore-ravens,7367500,2010
2883,4250000,1900000,Ray Lewis,LB,active,baltimore-ravens,6150000,2010
2884,2000000,3406250,Anquan Boldin,WR,active,baltimore-ravens,5406250,2010
2885,3500000,2015000,Jarret Johnson,OLB,active,baltimore-ravens,5515000,2010
2886,3000000,1000000,Matt Birk,C,active,baltimore-ravens,4000000,2010
2887,2660000,2480000,Joe Flacco,QB,active,baltimore-ravens,5140000,2010
2888,2000000,1800000,Marc Bulger,QB,active,baltimore-ravens,3800000,2010
2889,1500000,2000000,Derrick Mason,WR,active,baltimore-ravens,3500000,2010
2890,395000,4228000,Michael Oher,RT,active,baltimore-ravens,4623000,2010
2891,1746250,3067500,Haloti Ngata,DT,active,baltimore-ravens,4813750,2010
2892,2000000,500000,Chris Carr,CB,active,baltimore-ravens,2500000,2010
2893,2396000,0,Jared Gaither,T,active,baltimore-ravens,2396000,2010
2894,2396000,0,LeRon McClain,FB,active,baltimore-ravens,2396000,2010
2895,1886500,0,Fabian Washington,CB,active,baltimore-ravens,1886500,2010
2896,1759000,0,Sam Koch,P,active,baltimore-ravens,1759000,2010
2897,1759000,0,Dawan Landry,S,active,baltimore-ravens,1759000,2010
2898,1684000,0,Marshal Yanda,G,active,baltimore-ravens,1684000,2010
2899,680000,1560000,Ben Grubbs,G,active,baltimore-ravens,2240000,2010
2900,760000,475000,Brendon Ayanbadejo,LB,active,baltimore-ravens,1235000,2010
2901,1226000,0,Billy Cundiff,K,active,baltimore-ravens,1226000,2010
2902,1176000,0,Chris Chester,G,active,baltimore-ravens,1176000,2010
2903,1176000,0,Tony Moll,T,active,baltimore-ravens,1176000,2010
2904,1176000,0,Demetrius Williams,WR,active,baltimore-ravens,1176000,2010
2905,1101000,0,Prescott Burgess,LB,active,baltimore-ravens,1101000,2010
2906,470000,619000,Ray Rice,RB,active,baltimore-ravens,1089000,2010
2907,900000,0,Donte Stallworth,WR,active,baltimore-ravens,900000,2010
2908,855000,0,Kevin Houser,LS,active,baltimore-ravens,855000,2010
2909,470000,203366,Tavares Gooden,ILB,active,baltimore-ravens,673366,2010
2910,395000,250000,Paul Kruger,OLB,active,baltimore-ravens,645000,2010
2911,470000,172000,Tom Zbikowski,S,active,baltimore-ravens,642000,2010
2912,470000,147833,Oniel Cousins,G,active,baltimore-ravens,617833,2010
2913,320000,280000,Terrence Cody,DT,active,baltimore-ravens,600000,2010
2914,470000,123041,Marcus Smith,WR,active,baltimore-ravens,593041,2010
2915,395000,176506,Lardarius Webb,CB,active,baltimore-ravens,571506,2010
2916,550000,0,Josh Wilson,CB,active,baltimore-ravens,550000,2010
2917,320000,220833,Ed Dickson,TE,active,baltimore-ravens,540833,2010
2918,470000,17767,Haruki Nakamura,S,active,baltimore-ravens,487767,2010
2919,470000,0,Jameel McClain,ILB,active,baltimore-ravens,470000,2010
2920,320000,123667,Dennis Pitta,TE,active,baltimore-ravens,443667,2010
2921,395000,0,Lamar Divens,DT,active,baltimore-ravens,395000,2010
2922,395000,0,Dannell Ellerbe,OLB,active,baltimore-ravens,395000,2010
2923,320000,44633,David Reed,WR,active,baltimore-ravens,364633,2010
2924,320000,44500,Arthur Jones,DT,active,baltimore-ravens,364500,2010
2925,348529,0,Cary Williams,CB,active,baltimore-ravens,348529,2010
2926,320000,24723,Ramon Harewood,G,active,baltimore-ravens,344723,2010
2927,225000,10000,Morgan Cox,LS,active,baltimore-ravens,235000,2010
2928,165882,0,Cary Williams,CB,active,baltimore-ravens,165882,2010
2929,37647,0,Davon Drew,TE,active,baltimore-ravens,37647,2010
2930,3200000,5000000,Domonique Foxworth,CB,injured_reserve,baltimore-ravens,8200000,2010
2931,470000,98166,David Hale,G,injured_reserve,baltimore-ravens,568166,2010
2932,240000,0,Kelly Talavou,DT,injured_reserve,baltimore-ravens,240000,2010
2933,225000,0,Daniel Sanders,G,injured_reserve,baltimore-ravens,225000,2010
2934,13235,0,Stefan Rodgers,T,injured_reserve,baltimore-ravens,13235,2010
2935,320000,0,Sergio Kindle,LB,non_fb_injury,baltimore-ravens,320000,2010
2936,176800,0,Danny Gorrer,CB,practice_squad,baltimore-ravens,176800,2010
2937,88400,0,Colin Brown,G,practice_squad,baltimore-ravens,88400,2010
2938,88400,0,Davon Drew,TE,practice_squad,baltimore-ravens,88400,2010
2939,88400,0,Justin Harper,WR,practice_squad,baltimore-ravens,88400,2010
2940,975000,0,Samari Rolle,CB,dead_cap,baltimore-ravens,975000,2010
2941,310882,0,Scott Kooistra,T,dead_cap,baltimore-ravens,310882,2010
2942,260000,0,Cedric Peerman,RB,dead_cap,baltimore-ravens,260000,2010
2943,200000,0,Jason McKie,RB,dead_cap,baltimore-ravens,200000,2010
2944,92834,0,Davon Drew,TE,dead_cap,baltimore-ravens,92834,2010
2945,0,2000,Albert McClellan,OLB,dead_cap,baltimore-ravens,2000,2010
2946,3400000,11220000,Terrell Suggs,OLB,active,baltimore-ravens,14620000,2011
2947,6500000,3671428,Ed Reed,S,active,baltimore-ravens,10171428,2011
2948,6000000,1531250,Anquan Boldin,WR,active,baltimore-ravens,7531250,2011
2949,2100000,5000000,Haloti Ngata,DT,active,baltimore-ravens,7100000,2011
2950,4500000,2700000,Ray Lewis,LB,active,baltimore-ravens,7200000,2011
2951,4485000,2480000,Joe Flacco,QB,active,baltimore-ravens,6965000,2011
2952,3500000,2015000,Jarret Johnson,OLB,active,baltimore-ravens,5515000,2011
2953,3000000,1000000,Matt Birk,C,active,baltimore-ravens,4000000,2011
2954,2000000,2000000,Marshal Yanda,G,active,baltimore-ravens,4000000,2011
2955,2995000,1560000,Ben Grubbs,G,active,baltimore-ravens,4555000,2011
2956,3175000,100000,Lee Evans,WR,active,baltimore-ravens,3275000,2011
2957,3000000,0,Andre Gurode,C,active,baltimore-ravens,3000000,2011
2958,2115000,713000,Maake Kemoeatu,DT,active,baltimore-ravens,2828000,2011
2959,1000000,1333333,Vonta Leach,FB,active,baltimore-ravens,2333333,2011
2960,1500000,600000,Billy Cundiff,K,active,baltimore-ravens,2100000,2011
2961,700000,1250000,Chris Carr,CB,active,baltimore-ravens,1950000,2011
2962,1300000,600000,Sam Koch,P,active,baltimore-ravens,1900000,2011
2963,1000000,800000,Bryant McKinnie,LT,active,baltimore-ravens,1800000,2011
2964,630000,2340000,Michael Oher,RT,active,baltimore-ravens,2970000,2011
2965,1385000,0,Jameel McClain,ILB,active,baltimore-ravens,1385000,2011
2966,375000,981672,Jimmy Smith,CB,active,baltimore-ravens,1356672,2011
2967,810000,475000,Brendon Ayanbadejo,LB,active,baltimore-ravens,1285000,2011
2968,1200000,0,Haruki Nakamura,S,active,baltimore-ravens,1200000,2011
2969,1200000,0,Tom Zbikowski,S,active,baltimore-ravens,1200000,2011
2970,1000000,50000,Ricky Williams,RB,active,baltimore-ravens,1050000,2011
2971,985000,0,Bernard Pollard,S,active,baltimore-ravens,985000,2011
2972,600000,275000,Ray Rice,RB,active,baltimore-ravens,875000,2011
2973,525000,250000,Paul Kruger,OLB,active,baltimore-ravens,775000,2011
2974,450000,280000,Terrence Cody,DT,active,baltimore-ravens,730000,2011
2975,525000,176506,Lardarius Webb,CB,active,baltimore-ravens,701506,2011
2976,450000,220833,Ed Dickson,TE,active,baltimore-ravens,670833,2011
2977,375000,241224,Torrey Smith,WR,active,baltimore-ravens,616224,2011
2978,600000,0,Lamar Divens,DT,active,baltimore-ravens,600000,2011
2979,600000,0,Marcus Smith,WR,active,baltimore-ravens,600000,2011
2980,450000,123667,Dennis Pitta,TE,active,baltimore-ravens,573667,2011
2981,525000,0,Dannell Ellerbe,OLB,active,baltimore-ravens,525000,2011
2982,525000,0,Cary Williams,CB,active,baltimore-ravens,525000,2011
2983,375000,140810,Jah Reid,RT,active,baltimore-ravens,515810,2011
2984,450000,44500,Arthur Jones,DT,active,baltimore-ravens,494500,2011
2985,375000,103140,Tandon Doss,WR,active,baltimore-ravens,478140,2011
2986,423529,44633,David Reed,WR,active,baltimore-ravens,468162,2011
2987,450000,0,Colin Brown,G,active,baltimore-ravens,450000,2011
2988,450000,0,Emanuel Cook,CB,active,baltimore-ravens,450000,2011
2989,450000,0,Morgan Cox,LS,active,baltimore-ravens,450000,2011
2990,405000,24723,Ramon Harewood,G,active,baltimore-ravens,429723,2011
2991,423529,0,Danny Gorrer,CB,active,baltimore-ravens,423529,2011
2992,375000,36140,Chykie Brown,CB,active,baltimore-ravens,411140,2011
2993,375000,36140,Pernell McPhee,OLB,active,baltimore-ravens,411140,2011
2994,375000,26327,Tyrod Taylor,QB,active,baltimore-ravens,401327,2011
2995,375000,12625,Anthony Allen,RB,active,baltimore-ravens,387625,2011
2996,375000,166,LaQuan Williams,WR,active,baltimore-ravens,375166,2011
2997,375000,0,Justin Boren,G,active,baltimore-ravens,375000,2011
2998,375000,0,Josh Bynes,OLB,active,baltimore-ravens,375000,2011
2999,375000,0,Sergio Kindle,LB,active,baltimore-ravens,375000,2011
3000,375000,0,Albert McClellan,OLB,active,baltimore-ravens,375000,2011
3001,258000,0,Michael McAdoo,DE,active,baltimore-ravens,258000,2011
3002,4400000,5000000,Domonique Foxworth,CB,injured_reserve,baltimore-ravens,9400000,2011
3003,525000,0,Matt Lawrence,RB,injured_reserve,baltimore-ravens,525000,2011
3004,487500,0,Prescott Burgess,LB,injured_reserve,baltimore-ravens,487500,2011
3005,96900,0,Damien Berry,RB,practice_squad,baltimore-ravens,96900,2011
3006,96900,0,Rodney Bradley,WR,practice_squad,baltimore-ravens,96900,2011
3007,96900,0,Davon Drew,TE,practice_squad,baltimore-ravens,96900,2011
3008,96900,0,Bryan Hall,ILB,practice_squad,baltimore-ravens,96900,2011
3009,96900,0,Cecil Newton,C,practice_squad,baltimore-ravens,96900,2011
3010,96900,0,Mana Silva,S,practice_squad,baltimore-ravens,96900,2011
3011,96900,0,Chavis Williams,LB,practice_squad,baltimore-ravens,96900,2011
3012,0,3750000,Willis McGahee,RB,dead_cap,baltimore-ravens,3750000,2011
3013,567500,0,Todd Heap,TE,dead_cap,baltimore-ravens,567500,2011
3014,2833,0,Ryan Bartholomew,C,dead_cap,baltimore-ravens,2833,2011
3015,2500,0,Damien Berry,RB,dead_cap,baltimore-ravens,2500,2011
3016,1000,0,Mana Silva,S,dead_cap,baltimore-ravens,1000,2011
3017,333,0,Rodney Bradley,WR,dead_cap,baltimore-ravens,333,2011
3018,183,0,Bryan Hall,ILB,dead_cap,baltimore-ravens,183,2011
3019,4900000,11220000,Terrell Suggs,OLB,active,baltimore-ravens,16120000,2012
3020,2900000,10000000,Haloti Ngata,DT,active,baltimore-ravens,12900000,2012
3021,7200000,3671428,Ed Reed,S,active,baltimore-ravens,10871428,2012
3022,6760000,2480000,Joe Flacco,QB,active,baltimore-ravens,9240000,2012
3023,6000000,1531250,Anquan Boldin,WR,active,baltimore-ravens,7531250,2012
3024,4950000,2700000,Ray Lewis,LB,active,baltimore-ravens,7650000,2012
3025,2000000,3000000,Ray Rice,RB,active,baltimore-ravens,5000000,2012
3026,3000000,1333333,Vonta Leach,FB,active,baltimore-ravens,4333333,2012
3027,700000,2950000,Marshal Yanda,G,active,baltimore-ravens,3650000,2012
3028,2745000,713000,Maake Kemoeatu,DT,active,baltimore-ravens,3458000,2012
3029,2200000,1000000,Bryant McKinnie,LT,active,baltimore-ravens,3200000,2012
3030,615000,2000000,Lardarius Webb,CB,active,baltimore-ravens,2615000,2012
3031,1600000,600000,Sam Koch,P,active,baltimore-ravens,2200000,2012
3032,865000,2340000,Michael Oher,RT,active,baltimore-ravens,3205000,2012
3033,700000,1250000,Bernard Pollard,S,active,baltimore-ravens,1950000,2012
3034,1927000,0,Dannell Ellerbe,OLB,active,baltimore-ravens,1927000,2012
3035,1927000,0,Cary Williams,CB,active,baltimore-ravens,1927000,2012
3036,714168,981672,Jimmy Smith,CB,active,baltimore-ravens,1695840,2012
3037,925000,700000,Matt Birk,C,active,baltimore-ravens,1625000,2012
3038,700000,900000,Jacoby Jones,WR,active,baltimore-ravens,1600000,2012
3039,925000,400000,Bobbie Williams,G,active,baltimore-ravens,1325000,2012
3040,700000,600000,Corey Graham,FS,active,baltimore-ravens,1300000,2012
3041,1214286,0,Ryan McBean,DE,active,baltimore-ravens,1214286,2012
3042,925000,133333,Brendon Ayanbadejo,LB,active,baltimore-ravens,1058333,2012
3043,390000,573036,Courtney Upshaw,DT,active,baltimore-ravens,963036,2012
3044,615000,250000,Paul Kruger,OLB,active,baltimore-ravens,865000,2012
3045,540000,280000,Terrence Cody,DT,active,baltimore-ravens,820000,2012
3046,529000,241224,Torrey Smith,WR,active,baltimore-ravens,770224,2012
3047,540000,220833,Ed Dickson,TE,active,baltimore-ravens,760833,2012
3048,700000,40000,James Ihedigbo,SS,active,baltimore-ravens,740000,2012
3049,540000,123667,Dennis Pitta,TE,active,baltimore-ravens,663667,2012
3050,615000,0,Cody Glenn,LB,active,baltimore-ravens,615000,2012
3051,390000,218340,Kelechi Osemele,G,active,baltimore-ravens,608340,2012
3052,465000,140810,Jah Reid,RT,active,baltimore-ravens,605810,2012
3053,825000,65000,Billy Bajema,TE,active,baltimore-ravens,890000,2012
3054,540000,44633,David Reed,WR,active,baltimore-ravens,584633,2012
3055,540000,44500,Arthur Jones,DT,active,baltimore-ravens,584500,2012
3056,465000,103140,Tandon Doss,WR,active,baltimore-ravens,568140,2012
3057,825000,65000,Sean Considine,S,active,baltimore-ravens,890000,2012
3058,800000,25000,Maake Kemoeatu,DT,active,baltimore-ravens,825000,2012
3059,540000,0,Morgan Cox,LS,active,baltimore-ravens,540000,2012
3060,390000,138986,Bernard Pierce,RB,active,baltimore-ravens,528986,2012
3061,490000,24723,Ramon Harewood,G,active,baltimore-ravens,514723,2012
3062,390000,121106,Gino Gradkowski,C,active,baltimore-ravens,511106,2012
3063,465000,36140,Chykie Brown,CB,active,baltimore-ravens,501140,2012
3064,465000,36140,Pernell McPhee,OLB,active,baltimore-ravens,501140,2012
3065,465000,26327,Tyrod Taylor,QB,active,baltimore-ravens,491327,2012
3066,465000,0,Anthony Allen,RB,active,baltimore-ravens,465000,2012
3067,465000,0,Albert McClellan,OLB,active,baltimore-ravens,465000,2012
3068,390000,36140,Asa Jackson,CB,active,baltimore-ravens,426140,2012
3069,390000,23513,Tommy Streeter,WR,active,baltimore-ravens,413513,2012
3070,390000,11898,Deangelo Tyson,DE,active,baltimore-ravens,401898,2012
3071,390000,1333,Deonte Thompson,WR,active,baltimore-ravens,391333,2012
3072,390000,0,Howard Barbieri,G,active,baltimore-ravens,390000,2012
3073,390000,0,Rodney Bradley,WR,active,baltimore-ravens,390000,2012
3074,390000,0,Omar Brown,S,active,baltimore-ravens,390000,2012
3075,390000,0,Bryan Hall,ILB,active,baltimore-ravens,390000,2012
3076,390000,0,Adrian Hamilton,OLB,active,baltimore-ravens,390000,2012
3077,390000,0,Justin Tucker,K,active,baltimore-ravens,390000,2012
3078,288000,0,Michael McAdoo,DE,active,baltimore-ravens,288000,2012
3079,273000,0,Anthony Levine,ILB,active,baltimore-ravens,273000,2012
3080,273000,0,Bobby Rainey,RB,active,baltimore-ravens,273000,2012
3081,825000,0,Chris Johnson,CB,active,baltimore-ravens,825000,2012
3082,243750,0,Josh Bynes,OLB,active,baltimore-ravens,243750,2012
3083,191470,0,Sergio Kindle,LB,active,baltimore-ravens,191470,2012
3084,700000,1200000,Jameel McClain,ILB,injured_reserve,baltimore-ravens,1900000,2012
3085,700000,0,Ricky Brown,LB,injured_reserve,baltimore-ravens,700000,2012
3086,540000,0,Emanuel Cook,CB,injured_reserve,baltimore-ravens,540000,2012
3087,465000,166,LaQuan Williams,WR,injured_reserve,baltimore-ravens,465166,2012
3088,368000,0,Darryl Blackstock,LB,injured_reserve,baltimore-ravens,368000,2012
3089,273000,75146,Christian Thompson,S,injured_reserve,baltimore-ravens,348146,2012
3090,273000,0,Damien Berry,RB,injured_reserve,baltimore-ravens,273000,2012
3091,198259,0,Chavis Williams,LB,injured_reserve,baltimore-ravens,198259,2012
3092,170000,0,Sergio Kindle,LB,practice_squad,baltimore-ravens,170000,2012
3093,96900,0,Nigel Carr,ILB,practice_squad,baltimore-ravens,96900,2012
3094,96900,0,Jack Cornell,G,practice_squad,baltimore-ravens,96900,2012
3095,96900,0,Bobby Rainey,RB,practice_squad,baltimore-ravens,96900,2012
3096,0,3750000,Chris Carr,CB,dead_cap,baltimore-ravens,3750000,2012
3097,0,6250000,Willis McGahee,RB,dead_cap,baltimore-ravens,6250000,2012
3098,3000000,0,Domonique Foxworth,CB,dead_cap,baltimore-ravens,3000000,2012
3099,600000,0,Billy Cundiff,K,dead_cap,baltimore-ravens,600000,2012
3100,96900,0,Anthony Levine,ILB,dead_cap,baltimore-ravens,96900,2012
3101,80294,0,Bruce Figgins,FB,dead_cap,baltimore-ravens,80294,2012
3102,50000,0,Ricky Williams,RB,dead_cap,baltimore-ravens,50000,2012
3103,48176,0,Steve Baggs,LB,dead_cap,baltimore-ravens,48176,2012
3104,0,12625,Anthony Allen,RB,dead_cap,baltimore-ravens,12625,2012
3105,6000,0,Nick Provo,TE,dead_cap,baltimore-ravens,6000,2012
3106,5668,0,Ryan Bartholomew,C,dead_cap,baltimore-ravens,5668,2012
3107,5000,0,Damien Berry,RB,dead_cap,baltimore-ravens,5000,2012
3108,5000,0,Michael McAdoo,DE,dead_cap,baltimore-ravens,5000,2012
3109,2000,0,Mana Silva,S,dead_cap,baltimore-ravens,2000,2012
3110,1666,0,Nick Jean-Baptiste,DT,dead_cap,baltimore-ravens,1666,2012
3111,1666,0,Ishmaa'ily Kitchen,DT,dead_cap,baltimore-ravens,1666,2012
3112,1333,0,Jack Cornell,G,dead_cap,baltimore-ravens,1333,2012
3113,1333,0,Antoine McClain,G,dead_cap,baltimore-ravens,1333,2012
3114,1333,0,Chyl Quarles,S,dead_cap,baltimore-ravens,1333,2012
3115,1000,0,John Brantley,QB,dead_cap,baltimore-ravens,1000,2012
3116,1000,0,Dorian Graham,WR,dead_cap,baltimore-ravens,1000,2012
3117,833,0,Devin Goda,WR,dead_cap,baltimore-ravens,833,2012
3118,833,0,Terrance Moore,DT,dead_cap,baltimore-ravens,833,2012
3119,667,0,Rodney Bradley,WR,dead_cap,baltimore-ravens,667,2012
3120,667,0,Elliott Henigan,DT,dead_cap,baltimore-ravens,667,2012
3121,500,0,Bobby Rainey,RB,dead_cap,baltimore-ravens,500,2012
3122,367,0,Bryan Hall,ILB,dead_cap,baltimore-ravens,367,2012
3123,333,0,Omar Brown,S,dead_cap,baltimore-ravens,333,2012
3124,6400000,11220000,Terrell Suggs,OLB,active,baltimore-ravens,17620000,2013
3125,4000000,10000000,Haloti Ngata,DT,active,baltimore-ravens,14000000,2013
3126,4500000,2950000,Marshal Yanda,G,active,baltimore-ravens,7450000,2013
3127,1000000,5800000,Joe Flacco,QB,active,baltimore-ravens,6800000,2013
3128,1000000,6500000,Ray Rice,RB,active,baltimore-ravens,7500000,2013
3129,2385000,4000000,Lardarius Webb,CB,active,baltimore-ravens,6385000,2013
3130,3785000,2340000,Michael Oher,RT,active,baltimore-ravens,6125000,2013
3131,3000000,1900000,Jacoby Jones,WR,active,baltimore-ravens,4900000,2013
3132,3375000,380000,Maake Kemoeatu,DT,active,baltimore-ravens,3755000,2013
3133,2905882,205000,Eugene Monroe,LT,active,baltimore-ravens,3110882,2013
3134,1500000,1200000,Jameel McClain,ILB,active,baltimore-ravens,2700000,2013
3135,2050000,600000,Corey Graham,FS,active,baltimore-ravens,2650000,2013
3136,1900000,600000,Sam Koch,P,active,baltimore-ravens,2500000,2013
3137,1000000,1500000,Elvis Dumervil,OLB,active,baltimore-ravens,2500000,2013
3138,1053336,981672,Jimmy Smith,CB,active,baltimore-ravens,2035008,2013
3139,2023000,0,Arthur Jones,DT,active,baltimore-ravens,2023000,2013
3140,2023000,0,Dennis Pitta,TE,active,baltimore-ravens,2023000,2013
3141,840000,666666,Chris Canty,DE,active,baltimore-ravens,1506666,2013
3142,840000,580000,Vonta Leach,FB,active,baltimore-ravens,1420000,2013
3143,1323000,0,Ed Dickson,TE,active,baltimore-ravens,1323000,2013
3144,405000,825364,Matt Elam,SS,active,baltimore-ravens,1230364,2013
3145,630759,573036,Courtney Upshaw,DT,active,baltimore-ravens,1203795,2013
3146,840000,285000,Daryl Smith,ILB,active,baltimore-ravens,1125000,2013
3147,1089529,0,Jeromy Miles,SS,active,baltimore-ravens,1089529,2013
3148,683112,241224,Torrey Smith,WR,active,baltimore-ravens,924336,2013
3149,630000,280000,Terrence Cody,DT,active,baltimore-ravens,910000,2013
3150,542085,218340,Kelechi Osemele,G,active,baltimore-ravens,760425,2013
3151,630000,125000,Morgan Cox,LS,active,baltimore-ravens,755000,2013
3152,555000,140810,Jah Reid,RT,active,baltimore-ravens,695810,2013
3153,405000,241224,Arthur Brown,ILB,active,baltimore-ravens,646224,2013
3154,940000,65000,Dallas Clark,TE,active,baltimore-ravens,1005000,2013
3155,715000,65000,James Ihedigbo,SS,active,baltimore-ravens,780000,2013
3156,480000,138986,Bernard Pierce,RB,active,baltimore-ravens,618986,2013
3157,480000,121106,Gino Gradkowski,C,active,baltimore-ravens,601106,2013
3158,555000,36140,Chykie Brown,CB,active,baltimore-ravens,591140,2013
3159,555000,36140,Pernell McPhee,OLB,active,baltimore-ravens,591140,2013
3160,555000,26327,Tyrod Taylor,QB,active,baltimore-ravens,581327,2013
3161,555000,0,Albert McClellan,OLB,active,baltimore-ravens,555000,2013
3162,405000,128750,Brandon Williams,DT,active,baltimore-ravens,533750,2013
3163,522353,0,Tandon Doss,WR,active,baltimore-ravens,522353,2013
3164,405000,96413,John Simon,OLB,active,baltimore-ravens,501413,2013
3165,480000,11898,Deangelo Tyson,DE,active,baltimore-ravens,491898,2013
3166,480000,1333,Deonte Thompson,WR,active,baltimore-ravens,481333,2013
3167,405000,75146,Kyle Juszczyk,FB,active,baltimore-ravens,480146,2013
3168,480000,0,Josh Bynes,OLB,active,baltimore-ravens,480000,2013
3169,480000,0,Anthony Levine,ILB,active,baltimore-ravens,480000,2013
3170,480000,0,A.Q. Shipley,C,active,baltimore-ravens,480000,2013
3171,480000,0,Justin Tucker,K,active,baltimore-ravens,480000,2013
3172,405000,36140,Ricky Wagner,RT,active,baltimore-ravens,441140,2013
3173,405000,19670,Ryan Jensen,C,active,baltimore-ravens,424670,2013
3174,405000,1666,Marlon Brown,WR,active,baltimore-ravens,406666,2013
3175,254117,36140,Asa Jackson,CB,active,baltimore-ravens,290257,2013
3176,254117,0,Omar Brown,S,active,baltimore-ravens,254117,2013
3177,405000,0,Brynden Trawick,SS,active,baltimore-ravens,405000,2013
3178,97491,0,Bernard Scott,RB,active,baltimore-ravens,97491,2013
3179,940000,65000,Brandon Stokley,WR,injured_reserve,baltimore-ravens,1005000,2013
3180,405000,11474,Aaron Mellette,WR,injured_reserve,baltimore-ravens,416474,2013
3181,303000,0,Adrian Hamilton,OLB,injured_reserve,baltimore-ravens,303000,2013
3182,288000,0,D.J. Bryant,OLB,injured_reserve,baltimore-ravens,288000,2013
3183,405000,22058,Kapron Lewis-Moore,DE,non_fb_injury,baltimore-ravens,427058,2013
3184,24000,0,Brandon Copeland,DE,practice_squad,baltimore-ravens,24000,2013
3185,2950000,0,Ray Lewis,LB,dead_cap,baltimore-ravens,2950000,2013
3186,1849265,0,Bryant McKinnie,LT,dead_cap,baltimore-ravens,1849265,2013
3187,1800000,0,Billy Cundiff,K,dead_cap,baltimore-ravens,1800000,2013
3188,1531250,0,Anquan Boldin,WR,dead_cap,baltimore-ravens,1531250,2013
3189,1400000,0,Matt Birk,C,dead_cap,baltimore-ravens,1400000,2013
3190,1350000,0,Michael Huff,S,dead_cap,baltimore-ravens,1350000,2013
3191,1333334,0,Vonta Leach,FB,dead_cap,baltimore-ravens,1333334,2013
3192,1200000,0,Marcus Spears,DE,dead_cap,baltimore-ravens,1200000,2013
3193,750000,0,Bernard Pollard,S,dead_cap,baltimore-ravens,750000,2013
3194,620000,0,Brandon Stokley,WR,dead_cap,baltimore-ravens,620000,2013
3195,555000,0,Billy Bajema,TE,dead_cap,baltimore-ravens,555000,2013
3196,400000,0,Bobbie Williams,G,dead_cap,baltimore-ravens,400000,2013
3197,320000,0,Ramon Harewood,G,dead_cap,baltimore-ravens,320000,2013
3198,266667,0,Brendon Ayanbadejo,LB,dead_cap,baltimore-ravens,266667,2013
3199,250000,0,David Reed,WR,dead_cap,baltimore-ravens,250000,2013
3200,195882,0,Bernard Scott,RB,dead_cap,baltimore-ravens,195882,2013
3201,141176,0,Shaun Draughn,RB,dead_cap,baltimore-ravens,141176,2013
3202,103140,0,Tandon Doss,WR,dead_cap,baltimore-ravens,103140,2013
3203,100138,0,Brynden Trawick,SS,dead_cap,baltimore-ravens,100138,2013
3204,76107,0,Robert James,OLB,dead_cap,baltimore-ravens,76107,2013
3205,75146,0,Christian Thompson,S,dead_cap,baltimore-ravens,75146,2013
3206,62666,0,Joe Unga,G,dead_cap,baltimore-ravens,62666,2013
3207,48667,0,Omar Brown,S,dead_cap,baltimore-ravens,48667,2013
3208,35000,0,Chris Johnson,CB,dead_cap,baltimore-ravens,35000,2013
3209,0,25250,Anthony Allen,RB,dead_cap,baltimore-ravens,25250,2013
3210,23513,0,Tommy Streeter,WR,dead_cap,baltimore-ravens,23513,2013
3211,11474,0,Marc Anthony,CB,dead_cap,baltimore-ravens,11474,2013
3212,4500,0,Will Pericak,DT,dead_cap,baltimore-ravens,4500,2013
3213,3334,0,Nick Jean-Baptiste,DT,dead_cap,baltimore-ravens,3334,2013
3214,3334,0,Ishmaa'ily Kitchen,DT,dead_cap,baltimore-ravens,3334,2013
3215,0,3333,Matt Furstenburg,TE,dead_cap,baltimore-ravens,3333,2013
3216,3333,0,Jordan Devey,G,dead_cap,baltimore-ravens,3333,2013
3217,3000,0,Rogers Gaines,LT,dead_cap,baltimore-ravens,3000,2013
3218,2667,0,Jack Cornell,G,dead_cap,baltimore-ravens,2667,2013
3219,2667,0,Antoine McClain,G,dead_cap,baltimore-ravens,2667,2013
3220,2667,0,Chyl Quarles,S,dead_cap,baltimore-ravens,2667,2013
3221,2000,0,John Brantley,QB,dead_cap,baltimore-ravens,2000,2013
3222,2000,0,Dorian Graham,WR,dead_cap,baltimore-ravens,2000,2013
3223,1833,0,Omarius Hines,WR,dead_cap,baltimore-ravens,1833,2013
3224,1667,0,Devin Goda,WR,dead_cap,baltimore-ravens,1667,2013
3225,1667,0,Terrance Moore,DT,dead_cap,baltimore-ravens,1667,2013
3226,1334,0,Elliott Henigan,DT,dead_cap,baltimore-ravens,1334,2013
3227,1000,0,Bobby Rainey,RB,dead_cap,baltimore-ravens,1000,2013
3228,333,0,Brandon Copeland,DE,dead_cap,baltimore-ravens,333,2013
3229,6000000,11800000,Joe Flacco,QB,active,baltimore-ravens,17800000,2014
3230,8500000,10000000,Haloti Ngata,DT,active,baltimore-ravens,18500000,2014
3231,5500000,2950000,Marshal Yanda,G,active,baltimore-ravens,8450000,2014
3232,1000000,11400000,Terrell Suggs,OLB,active,baltimore-ravens,12400000,2014
3233,3500000,5000000,Lardarius Webb,CB,active,baltimore-ravens,8500000,2014
3234,1000000,3250000,Elvis Dumervil,OLB,active,baltimore-ravens,4250000,2014
3235,1000000,2200000,Eugene Monroe,LT,active,baltimore-ravens,3200000,2014
3236,1000000,2200000,Dennis Pitta,TE,active,baltimore-ravens,3200000,2014
3237,2000000,1166666,Chris Canty,DE,active,baltimore-ravens,3166666,2014
3238,2200000,600000,Sam Koch,P,active,baltimore-ravens,2800000,2014
3239,1600000,875000,Daryl Smith,ILB,active,baltimore-ravens,2475000,2014
3240,1392504,981672,Jimmy Smith,CB,active,baltimore-ravens,2374176,2014
3241,1000000,1166666,Steve Smith,WR,active,baltimore-ravens,2166666,2014
3242,1000000,875000,Jacoby Jones,WR,active,baltimore-ravens,1875000,2014
3243,1000000,700000,Jeremy Zuttah,C,active,baltimore-ravens,1700000,2014
3244,420000,1177818,C.J. Mosley,ILB,active,baltimore-ravens,1597818,2014
3245,712591,825364,Matt Elam,SS,active,baltimore-ravens,1537955,2014
3246,871518,573036,Courtney Upshaw,DT,active,baltimore-ravens,1444554,2014
3247,1000000,300000,Darian Stewart,FS,active,baltimore-ravens,1300000,2014
3248,837168,241224,Torrey Smith,WR,active,baltimore-ravens,1078392,2014
3249,1000000,0,Owen Daniels,TE,active,baltimore-ravens,1000000,2014
3250,800000,200000,Albert McClellan,OLB,active,baltimore-ravens,1000000,2014
3251,694170,218340,Kelechi Osemele,G,active,baltimore-ravens,912510,2014
3252,730000,125000,Morgan Cox,LS,active,baltimore-ravens,855000,2014
3253,566556,241224,Arthur Brown,ILB,active,baltimore-ravens,807780,2014
3254,420000,376891,Timmy Jernigan,DT,active,baltimore-ravens,796891,2014
3255,645000,140810,Jah Reid,RT,active,baltimore-ravens,785810,2014
3256,570000,138986,Bernard Pierce,RB,active,baltimore-ravens,708986,2014
3257,570000,121106,Gino Gradkowski,C,active,baltimore-ravens,691106,2014
3258,645000,36140,Pernell McPhee,OLB,active,baltimore-ravens,681140,2014
3259,645000,26327,Tyrod Taylor,QB,active,baltimore-ravens,671327,2014
3260,730000,65000,Jeromy Miles,SS,active,baltimore-ravens,795000,2014
3261,495000,128750,Brandon Williams,DT,active,baltimore-ravens,623750,2014
3262,570000,34015,Asa Jackson,CB,active,baltimore-ravens,604015,2014
3263,570000,11898,Deangelo Tyson,DE,active,baltimore-ravens,581898,2014
3264,495000,75146,Kyle Juszczyk,FB,active,baltimore-ravens,570146,2014
3265,730000,0,Justin Forsett,RB,active,baltimore-ravens,730000,2014
3266,570000,0,Will Rackley,G,active,baltimore-ravens,570000,2014
3267,570000,0,Justin Tucker,K,active,baltimore-ravens,570000,2014
3268,406235,151594,Terrence Brooks,FS,active,baltimore-ravens,557829,2014
3269,420000,126504,Crockett Gillmore,T,active,baltimore-ravens,546504,2014
3270,495000,36140,Ricky Wagner,RT,active,baltimore-ravens,531140,2014
3271,495000,1666,Marlon Brown,WR,active,baltimore-ravens,496666,2014
3272,495000,0,Kamar Aiken,WR,active,baltimore-ravens,495000,2014
3273,495000,0,Anthony Levine,ILB,active,baltimore-ravens,495000,2014
3274,495000,0,Brynden Trawick,SS,active,baltimore-ravens,495000,2014
3275,406235,75146,Lorenzo Taliaferro,RB,active,baltimore-ravens,481381,2014
3276,469411,0,Lawrence Guy,DE,active,baltimore-ravens,469411,2014
3277,420000,36140,John Urschel,G,active,baltimore-ravens,456140,2014
3278,420000,16875,Michael Campanaro,WR,active,baltimore-ravens,436875,2014
3279,420000,3000,James Hurst,RT,active,baltimore-ravens,423000,2014
3280,420000,1000,Zach Orr,ILB,active,baltimore-ravens,421000,2014
3281,570000,0,Christo Bilukidi,DT,active,baltimore-ravens,570000,2014
3282,303000,75146,Brent Urban,DE,active,baltimore-ravens,378146,2014
3283,368824,0,Will Hill,SS,active,baltimore-ravens,368824,2014
3284,318000,22058,Kapron Lewis-Moore,DE,active,baltimore-ravens,340058,2014
3285,303000,1333,Jeremy Butler,WR,active,baltimore-ravens,304333,2014
3286,420000,0,Kevin McDermott,LS,active,baltimore-ravens,420000,2014
3287,495000,0,Rashaan Melvin,CB,active,baltimore-ravens,495000,2014
3288,197647,0,Tramain Jacobs,CB,active,baltimore-ravens,197647,2014
3289,730000,0,Antoine Cason,CB,active,baltimore-ravens,730000,2014
3290,420000,0,Phillip Supernaw,TE,active,baltimore-ravens,420000,2014
3291,420000,0,Fitz Toussaint,RB,active,baltimore-ravens,420000,2014
3292,570000,0,Chris Greenwood,CB,active,baltimore-ravens,570000,2014
3293,495000,0,Ryan Jensen,C,active,baltimore-ravens,495000,2014
3294,420000,0,Patrick Scales,LS,active,baltimore-ravens,420000,2014
3295,420000,0,Casey Walker,DT,active,baltimore-ravens,420000,2014
3296,495000,0,Steven Means,DE,active,baltimore-ravens,495000,2014
3297,855000,0,Aaron Ross,CB,injured_reserve,baltimore-ravens,855000,2014
3298,730000,0,Danny Gorrer,CB,injured_reserve,baltimore-ravens,730000,2014
3299,110500,0,Jamell Fleming,S,practice_squad,baltimore-ravens,110500,2014
3300,107100,0,Marcel Jones,RT,practice_squad,baltimore-ravens,107100,2014
3301,107100,0,Keith Wenning,QB,practice_squad,baltimore-ravens,107100,2014
3302,44100,0,Konrad Reuland,TE,practice_squad,baltimore-ravens,44100,2014
3303,44100,0,Kiero Small,FB,practice_squad,baltimore-ravens,44100,2014
3304,30000,0,Aldrick Robinson,WR,practice_squad,baltimore-ravens,30000,2014
3305,21000,0,Allen Reisner,TE,practice_squad,baltimore-ravens,21000,2014
3306,12600,0,Quinton Pointer,CB,practice_squad,baltimore-ravens,12600,2014
3307,12600,0,Tauren Poole,RB,practice_squad,baltimore-ravens,12600,2014
3308,1588000,6500000,Ray Rice,RB,dead_cap,baltimore-ravens,8088000,2014
3309,1500000,0,Bernard Pollard,S,dead_cap,baltimore-ravens,1500000,2014
3310,1200000,0,Jameel McClain,ILB,dead_cap,baltimore-ravens,1200000,2014
3311,1000000,0,Michael Huff,S,dead_cap,baltimore-ravens,1000000,2014
3312,1000000,0,Bryant McKinnie,LT,dead_cap,baltimore-ravens,1000000,2014
3313,580000,0,Vonta Leach,FB,dead_cap,baltimore-ravens,580000,2014
3314,341471,36140,Chykie Brown,CB,dead_cap,baltimore-ravens,377611,2014
3315,338117,1334,Deonte Thompson,WR,dead_cap,baltimore-ravens,339451,2014
3316,300000,0,Marcus Spears,DE,dead_cap,baltimore-ravens,300000,2014
3317,250000,0,David Reed,WR,dead_cap,baltimore-ravens,250000,2014
3318,150292,0,Christian Thompson,S,dead_cap,baltimore-ravens,150292,2014
3319,50000,96413,John Simon,OLB,dead_cap,baltimore-ravens,146413,2014
3320,137074,0,Phillip Supernaw,TE,dead_cap,baltimore-ravens,137074,2014
3321,134118,0,Dominique Franks,CB,dead_cap,baltimore-ravens,134118,2014
3322,121200,6667,Matt Furstenburg,TE,dead_cap,baltimore-ravens,127867,2014
3323,125012,0,Fitz Toussaint,RB,dead_cap,baltimore-ravens,125012,2014
3324,121000,0,Michael Willie,WR,dead_cap,baltimore-ravens,121000,2014
3325,97900,19670,Ryan Jensen,C,dead_cap,baltimore-ravens,117570,2014
3326,103140,0,Tandon Doss,WR,dead_cap,baltimore-ravens,103140,2014
3327,75882,0,Ryan Taylor,TE,dead_cap,baltimore-ravens,75882,2014
3328,69300,0,Steven Means,DE,dead_cap,baltimore-ravens,69300,2014
3329,69300,0,Emmanuel Ogbuehi,TE,dead_cap,baltimore-ravens,69300,2014
3330,63000,1166,Jamie Meder,DE,dead_cap,baltimore-ravens,64166,2014
3331,58471,2000,Brett Van Sloten,RT,dead_cap,baltimore-ravens,60471,2014
3332,58765,0,Shaun Chapas,TE,dead_cap,baltimore-ravens,58765,2014
3333,56700,1500,Tramain Jacobs,CB,dead_cap,baltimore-ravens,58200,2014
3334,47026,0,Tommy Streeter,WR,dead_cap,baltimore-ravens,47026,2014
3335,34422,0,Marc Anthony,CB,dead_cap,baltimore-ravens,34422,2014
3336,33529,0,Derek Cox,CB,dead_cap,baltimore-ravens,33529,2014
3337,0,26018,Keith Wenning,QB,dead_cap,baltimore-ravens,26018,2014
3338,25200,0,Louis Young,CB,dead_cap,baltimore-ravens,25200,2014
3339,18900,1333,Jace Davis,WR,dead_cap,baltimore-ravens,20233,2014
3340,18900,0,Josh Bynes,OLB,dead_cap,baltimore-ravens,18900,2014
3341,18900,0,Terren Jones,LT,dead_cap,baltimore-ravens,18900,2014
3342,18900,0,Alec Lemon,WR,dead_cap,baltimore-ravens,18900,2014
3343,18900,0,Allen Reisner,TE,dead_cap,baltimore-ravens,18900,2014
3344,12600,333,A.J. Pataialiim,DT,dead_cap,baltimore-ravens,12933,2014
3345,0,11474,Aaron Mellette,WR,dead_cap,baltimore-ravens,11474,2014
3346,9634,0,Joe Unga,G,dead_cap,baltimore-ravens,9634,2014
3347,9000,0,Will Pericak,DT,dead_cap,baltimore-ravens,9000,2014
3348,6667,0,Jordan Devey,G,dead_cap,baltimore-ravens,6667,2014
3349,6500,0,Jamell Fleming,S,dead_cap,baltimore-ravens,6500,2014
3350,6300,0,Nate Menkin,G,dead_cap,baltimore-ravens,6300,2014
3351,6300,0,Zach Thompson,DE,dead_cap,baltimore-ravens,6300,2014
3352,6300,0,LaQuan Williams,WR,dead_cap,baltimore-ravens,6300,2014
3353,6000,0,Rogers Gaines,LT,dead_cap,baltimore-ravens,6000,2014
3354,3667,0,Omarius Hines,WR,dead_cap,baltimore-ravens,3667,2014
3355,0,3333,Derrick Hopkins,DT,dead_cap,baltimore-ravens,3333,2014
3356,0,3000,Parker Graham,G,dead_cap,baltimore-ravens,3000,2014
3357,0,2666,Sammy Seamster,CB,dead_cap,baltimore-ravens,2666,2014
3358,0,2000,Deji Olatoye,CB,dead_cap,baltimore-ravens,2000,2014
3359,1334,0,Brynden Trawick,SS,dead_cap,baltimore-ravens,1334,2014
3360,0,1000,Avery Patterson,CB,dead_cap,baltimore-ravens,1000,2014
3361,667,0,Brandon Copeland,DE,dead_cap,baltimore-ravens,667,2014
3362,0,500,Xavius Boyd,OLB,dead_cap,baltimore-ravens,500,2014
3363,0,500,Richie Leone,P,dead_cap,baltimore-ravens,500,2014
3364,0,333,Ryan Jones,OLB,dead_cap,baltimore-ravens,333,2014
3365,2250000,8000000,Lardarius Webb,CB,active,baltimore-ravens,10250000,2015
3366,5000000,3250000,Elvis Dumervil,OLB,active,baltimore-ravens,8250000,2015
3367,2231764,4750000,Marshal Yanda,G,active,baltimore-ravens,6981764,2015
3368,1000000,2950000,Terrell Suggs,OLB,active,baltimore-ravens,3950000,2015
3369,3000000,875000,Daryl Smith,ILB,active,baltimore-ravens,3875000,2015
3370,1000000,2600000,Jimmy Smith,CB,active,baltimore-ravens,3600000,2015
3371,660000,1756045,Will Hill,SS,active,baltimore-ravens,2416045,2015
3372,1000000,1400000,Sam Koch,P,active,baltimore-ravens,2400000,2015
3373,2356000,0,Justin Tucker,K,active,baltimore-ravens,2356000,2015
3374,1000000,1000000,Matt Schaub,QB,active,baltimore-ravens,2000000,2015
3375,819455,1177818,C.J. Mosley,ILB,active,baltimore-ravens,1997273,2015
3376,1020182,825364,Matt Elam,SS,active,baltimore-ravens,1845546,2015
3377,1112277,573036,Courtney Upshaw,DT,active,baltimore-ravens,1685313,2015
3378,800000,666666,Kyle Arrington,CB,active,baltimore-ravens,1466666,2015
3379,800000,466666,Kendrick Lewis,FS,active,baltimore-ravens,1266666,2015
3380,1000000,200000,Albert McClellan,OLB,active,baltimore-ravens,1200000,2015
3381,846255,218340,Kelechi Osemele,G,active,baltimore-ravens,1064595,2015
3382,800000,250000,Lawrence Guy,DE,active,baltimore-ravens,1050000,2015
3383,800000,200000,Anthony Levine,ILB,active,baltimore-ravens,1000000,2015
3384,619223,376891,Timmy Jernigan,DT,active,baltimore-ravens,996114,2015
3385,728111,241224,Arthur Brown,ILB,active,baltimore-ravens,969335,2015
3386,435000,301861,Maxx Williams,TE,active,baltimore-ravens,736861,2015
3387,585000,128750,Brandon Williams,DT,active,baltimore-ravens,713750,2015
3388,525000,151594,Terrence Brooks,FS,active,baltimore-ravens,676594,2015
3389,745000,80000,Morgan Cox,LS,active,baltimore-ravens,825000,2015
3390,585000,75146,Kyle Juszczyk,FB,active,baltimore-ravens,660146,2015
3391,635294,0,Shareece Wright,CB,active,baltimore-ravens,635294,2015
3392,585000,36140,Ricky Wagner,RT,active,baltimore-ravens,621140,2015
3393,585000,22058,Kapron Lewis-Moore,DE,active,baltimore-ravens,607058,2015
3394,435000,156271,Carl Davis,DT,active,baltimore-ravens,591271,2015
3395,585000,0,Kamar Aiken,WR,active,baltimore-ravens,585000,2015
3396,585000,0,Brynden Trawick,SS,active,baltimore-ravens,585000,2015
3397,435000,120788,Za'Darius Smith,OLB,active,baltimore-ravens,555788,2015
3398,435000,118618,Javorius Allen,RB,active,baltimore-ravens,553618,2015
3399,510000,36140,John Urschel,G,active,baltimore-ravens,546140,2015
3400,522794,0,Will Davis,CB,active,baltimore-ravens,522794,2015
3401,435000,86423,Tray Walker,CB,active,baltimore-ravens,521423,2015
3402,510000,3000,James Hurst,RT,active,baltimore-ravens,513000,2015
3403,510000,1000,Zach Orr,ILB,active,baltimore-ravens,511000,2015
3404,435000,75146,Brent Urban,DE,active,baltimore-ravens,510146,2015
3405,510000,0,Ryan Jensen,C,active,baltimore-ravens,510000,2015
3406,374647,16875,Michael Campanaro,WR,active,baltimore-ravens,391522,2015
3407,300000,0,Jeremy Butler,WR,active,baltimore-ravens,300000,2015
3408,262941,0,Jimmy Clausen,QB,active,baltimore-ravens,262941,2015
3409,255882,0,De'Ondre Wesley,G,active,baltimore-ravens,255882,2015
3410,210000,0,Terrance West,RB,active,baltimore-ravens,210000,2015
3411,179117,0,Kaelin Clay,WR,active,baltimore-ravens,179117,2015
3412,153529,0,Daniel Brown,TE,active,baltimore-ravens,153529,2015
3413,175294,0,Richard Gordon,TE,active,baltimore-ravens,175294,2015
3414,137647,0,Konrad Reuland,TE,active,baltimore-ravens,137647,2015
3415,131470,0,Ryan Mallett,QB,active,baltimore-ravens,131470,2015
3416,1179176,0,Chris Givens,WR,active,baltimore-ravens,1179176,2015
3417,120000,0,Chris Matthews,WR,active,baltimore-ravens,120000,2015
3418,90000,0,Jumal Rolle,CB,active,baltimore-ravens,90000,2015
3419,87647,0,Chris Carter,ILB,active,baltimore-ravens,87647,2015
3420,76764,0,Terrence Magee,RT,active,baltimore-ravens,76764,2015
3421,51176,0,Jermaine Whitehead,FS,active,baltimore-ravens,51176,2015
3422,30000,0,Sheldon Price,CB,active,baltimore-ravens,30000,2015
3423,4000000,15300000,Joe Flacco,QB,injured_reserve,baltimore-ravens,19300000,2015
3424,5500000,2200000,Eugene Monroe,LT,injured_reserve,baltimore-ravens,7700000,2015
3425,4000000,2200000,Dennis Pitta,TE,injured_reserve,baltimore-ravens,6200000,2015
3426,3000000,1166666,Steve Smith,WR,injured_reserve,baltimore-ravens,4166666,2015
3427,1371176,1107206,Jeremy Zuttah,C,injured_reserve,baltimore-ravens,2478382,2015
3428,970000,765000,Chris Canty,DE,injured_reserve,baltimore-ravens,1735000,2015
3429,900000,700000,Justin Forsett,RB,injured_reserve,baltimore-ravens,1600000,2015
3430,386823,1147784,Breshad Perriman,WR,injured_reserve,baltimore-ravens,1534607,2015
3431,489176,126504,Crockett Gillmore,T,injured_reserve,baltimore-ravens,615680,2015
3432,571058,1668,Marlon Brown,WR,injured_reserve,baltimore-ravens,572726,2015
3433,385058,75146,Lorenzo Taliaferro,RB,injured_reserve,baltimore-ravens,460204,2015
3434,366176,26183,Darren Waller,TE,injured_reserve,baltimore-ravens,392359,2015
3435,333000,0,Allen Reisner,TE,injured_reserve,baltimore-ravens,333000,2015
3436,318000,3000,Julian Wilson,CB,injured_reserve,baltimore-ravens,321000,2015
3437,318000,833,Cam Worthy,WR,injured_reserve,baltimore-ravens,318833,2015
3438,318000,0,Micajah Reynolds,DT,injured_reserve,baltimore-ravens,318000,2015
3439,240882,0,Chase Ford,TE,injured_reserve,baltimore-ravens,240882,2015
3440,0,13000000,Ray Rice,RB,dead_cap,baltimore-ravens,13000000,2015
3441,0,10000000,Haloti Ngata,DT,dead_cap,baltimore-ravens,10000000,2015
3442,0,2625000,Jacoby Jones,WR,dead_cap,baltimore-ravens,2625000,2015
3443,0,666667,Chris Canty,DE,dead_cap,baltimore-ravens,666667,2015
3444,260117,34015,Asa Jackson,CB,dead_cap,baltimore-ravens,294132,2015
3445,265941,0,Jeremy Ross,WR,dead_cap,baltimore-ravens,265941,2015
3446,243176,0,Zach Thompson,DE,dead_cap,baltimore-ravens,243176,2015
3447,155294,40000,Christo Bilukidi,DT,dead_cap,baltimore-ravens,195294,2015
3448,0,192826,John Simon,OLB,dead_cap,baltimore-ravens,192826,2015
3449,172058,0,Rashaan Melvin,CB,dead_cap,baltimore-ravens,172058,2015
3450,168352,1000,Terrence Magee,RT,dead_cap,baltimore-ravens,169352,2015
3451,131470,50000,Cassius Vaughn,CB,dead_cap,baltimore-ravens,181470,2015
3452,0,138986,Bernard Pierce,RB,dead_cap,baltimore-ravens,138986,2015
3453,204705,0,Jason Babin,DE,dead_cap,baltimore-ravens,204705,2015
3454,92400,41563,Robert Myers,G,dead_cap,baltimore-ravens,133963,2015
3455,123776,2166,Kaleb Johnson,T,dead_cap,baltimore-ravens,125942,2015
3456,0,121106,Gino Gradkowski,C,dead_cap,baltimore-ravens,121106,2015
3457,103235,0,Joseph Morgan,WR,dead_cap,baltimore-ravens,103235,2015
3458,102353,0,Chris Greenwood,CB,dead_cap,baltimore-ravens,102353,2015
3459,102353,0,Raheem Mostert,RB,dead_cap,baltimore-ravens,102353,2015
3460,99000,2000,Brennen Beyer,ILB,dead_cap,baltimore-ravens,101000,2015
3461,99000,1666,Nick Perry,FS,dead_cap,baltimore-ravens,100666,2015
3462,78388,0,Chuck Jacobs,WR,dead_cap,baltimore-ravens,78388,2015
3463,0,78054,Keith Wenning,QB,dead_cap,baltimore-ravens,78054,2015
3464,66000,0,Sheldon Price,CB,dead_cap,baltimore-ravens,66000,2015
3465,46200,3333,Blaine Clausell,T,dead_cap,baltimore-ravens,49533,2015
3466,47611,0,Bryn Renner,QB,dead_cap,baltimore-ravens,47611,2015
3467,46200,1333,Jeremy Butler,WR,dead_cap,baltimore-ravens,47533,2015
3468,46200,1000,De'Ondre Wesley,G,dead_cap,baltimore-ravens,47200,2015
3469,46200,0,Daniel Brown,TE,dead_cap,baltimore-ravens,46200,2015
3470,46200,0,Marcel Jones,RT,dead_cap,baltimore-ravens,46200,2015
3471,39600,0,Nordly Capi,OLB,dead_cap,baltimore-ravens,39600,2015
3472,39600,0,Konrad Reuland,TE,dead_cap,baltimore-ravens,39600,2015
3473,0,39340,Ryan Jensen,C,dead_cap,baltimore-ravens,39340,2015
3474,30000,0,Charles James,CB,dead_cap,baltimore-ravens,30000,2015
3475,26400,0,Jumal Rolle,CB,dead_cap,baltimore-ravens,26400,2015
3476,0,22950,Aaron Mellette,WR,dead_cap,baltimore-ravens,22950,2015
3477,19800,0,Eric Herman,RT,dead_cap,baltimore-ravens,19800,2015
3478,19800,0,Dominique Jones,TE,dead_cap,baltimore-ravens,19800,2015
3479,13200,0,Alonzo Harris,RB,dead_cap,baltimore-ravens,13200,2015
3480,0,11898,Deangelo Tyson,DE,dead_cap,baltimore-ravens,11898,2015
3481,0,6667,Derrick Hopkins,DT,dead_cap,baltimore-ravens,6667,2015
3482,6600,0,Leon Brown,G,dead_cap,baltimore-ravens,6600,2015
3483,6600,0,DuJuan Harris,RB,dead_cap,baltimore-ravens,6600,2015
3484,6600,0,Tony Hills,LT,dead_cap,baltimore-ravens,6600,2015
3485,6600,0,Akeem Hunt,RB,dead_cap,baltimore-ravens,6600,2015
3486,6600,0,Chris Matthews,WR,dead_cap,baltimore-ravens,6600,2015
3487,6600,0,Terrance West,RB,dead_cap,baltimore-ravens,6600,2015
3488,0,6000,Parker Graham,G,dead_cap,baltimore-ravens,6000,2015
3489,0,5334,Sammy Seamster,CB,dead_cap,baltimore-ravens,5334,2015
3490,0,5000,Trey DePriest,LB,dead_cap,baltimore-ravens,5000,2015
3491,0,4000,Deji Olatoye,CB,dead_cap,baltimore-ravens,4000,2015
3492,0,4000,Brett Van Sloten,RT,dead_cap,baltimore-ravens,4000,2015
3493,0,3000,Darryl Baldwin,T,dead_cap,baltimore-ravens,3000,2015
3494,0,3000,Nick Easton,C,dead_cap,baltimore-ravens,3000,2015
3495,0,3000,Tramain Jacobs,CB,dead_cap,baltimore-ravens,3000,2015
3496,0,2667,Jace Davis,WR,dead_cap,baltimore-ravens,2667,2015
3497,0,2500,Deandre Carter,WR,dead_cap,baltimore-ravens,2500,2015
3498,0,2334,Jamie Meder,DE,dead_cap,baltimore-ravens,2334,2015
3499,0,2000,Avery Patterson,CB,dead_cap,baltimore-ravens,2000,2015
3500,0,1666,Jerry Lovelocke,QB,dead_cap,baltimore-ravens,1666,2015
3501,0,1000,Darius Allen,LB,dead_cap,baltimore-ravens,1000,2015
3502,0,1000,Xavius Boyd,OLB,dead_cap,baltimore-ravens,1000,2015
3503,0,1000,Richie Leone,P,dead_cap,baltimore-ravens,1000,2015
3504,0,667,Ryan Jones,OLB,dead_cap,baltimore-ravens,667,2015
3505,0,667,A.J. Pataialiim,DT,dead_cap,baltimore-ravens,667,2015
3506,4000000,23300000,Joe Flacco,QB,active,baltimore-ravens,27300000,2016
3507,5500000,5000000,Lardarius Webb,CB,active,baltimore-ravens,10500000,2016
3508,4500000,2950000,Terrell Suggs,OLB,active,baltimore-ravens,7450000,2016
3509,5000000,3250000,Elvis Dumervil,OLB,active,baltimore-ravens,8250000,2016
3510,3500000,1107206,Jeremy Zuttah,C,active,baltimore-ravens,4607206,2016
3511,3000000,1166668,Steve Smith,WR,active,baltimore-ravens,4166668,2016
3512,885000,3125220,Marshal Yanda,G,active,baltimore-ravens,4010220,2016
3513,1000000,2750000,Eric Weddle,FS,active,baltimore-ravens,3750000,2016
3514,450000,3274423,Ronnie Stanley,LT,active,baltimore-ravens,3724423,2016
3515,2000000,1500000,Justin Tucker,K,active,baltimore-ravens,3500000,2016
3516,1250000,2250000,Mike Wallace,WR,active,baltimore-ravens,3500000,2016
3517,1000000,2200000,Dennis Pitta,TE,active,baltimore-ravens,3200000,2016
3518,2300000,800000,Sam Koch,P,active,baltimore-ravens,3100000,2016
3519,2553000,0,Kamar Aiken,WR,active,baltimore-ravens,2553000,2016
3520,1218910,1177818,C.J. Mosley,ILB,active,baltimore-ravens,2396728,2016
3521,1327773,813224,Matt Elam,SS,active,baltimore-ravens,2140997,2016
3522,760000,1333333,Shareece Wright,CB,active,baltimore-ravens,2093333,2016
3523,830696,1147785,Breshad Perriman,WR,active,baltimore-ravens,1978481,2016
3524,1671000,128750,Brandon Williams,DT,active,baltimore-ravens,1799750,2016
3525,1000000,750000,Jerraud Powers,CB,active,baltimore-ravens,1750000,2016
3526,1671000,36140,Ricky Wagner,RT,active,baltimore-ravens,1707140,2016
3527,1500000,0,Ryan Mallett,QB,active,baltimore-ravens,1500000,2016
3528,1000000,250000,Lawrence Guy,DE,active,baltimore-ravens,1250000,2016
3529,1000000,200000,Anthony Levine,ILB,active,baltimore-ravens,1200000,2016
3530,818446,376891,Timmy Jernigan,DT,active,baltimore-ravens,1195337,2016
3531,900000,200000,Albert McClellan,OLB,active,baltimore-ravens,1100000,2016
3532,800000,140000,Morgan Cox,LS,active,baltimore-ravens,940000,2016
3533,675000,75146,Kyle Juszczyk,FB,active,baltimore-ravens,750146,2016
3534,600000,126504,Crockett Gillmore,T,active,baltimore-ravens,726504,2016
3535,600000,75146,Brent Urban,DE,active,baltimore-ravens,675146,2016
3536,525000,120788,Za'Darius Smith,OLB,active,baltimore-ravens,645788,2016
3537,525000,118618,Javorius Allen,RB,active,baltimore-ravens,643618,2016
3538,600000,36140,John Urschel,G,active,baltimore-ravens,636140,2016
3539,600000,3000,James Hurst,RT,active,baltimore-ravens,603000,2016
3540,450000,151282,Tavon Young,CB,active,baltimore-ravens,601282,2016
3541,600000,0,Ryan Jensen,C,active,baltimore-ravens,600000,2016
3542,600000,0,Terrance West,RB,active,baltimore-ravens,600000,2016
3543,450000,149090,Chris Moore,WR,active,baltimore-ravens,599090,2016
3544,450000,122974,Alex Lewis,G,active,baltimore-ravens,572974,2016
3545,450000,95848,Kenneth Dixon,RB,active,baltimore-ravens,545848,2016
3546,536470,0,Vladimir Ducasse,G,active,baltimore-ravens,536470,2016
3547,450000,63934,Matt Judon,OLB,active,baltimore-ravens,513934,2016
3548,458823,0,Marqueston Huff,FS,active,baltimore-ravens,458823,2016
3549,450000,3333,Michael Pierce,DT,active,baltimore-ravens,453333,2016
3550,401471,26183,Darren Waller,TE,active,baltimore-ravens,427654,2016
3551,357352,0,Chris Lewis-Harris,CB,active,baltimore-ravens,357352,2016
3552,317640,0,Patrick Onwuasor,ILB,active,baltimore-ravens,317640,2016
3553,216176,31784,Nick Boyle,TE,active,baltimore-ravens,247960,2016
3554,105882,0,Michael Campanaro,WR,active,baltimore-ravens,105882,2016
3555,79410,0,Lamar Louis,ILB,active,baltimore-ravens,79410,2016
3556,52940,0,Brennen Beyer,ILB,active,baltimore-ravens,52940,2016
3557,30882,0,Vince Mayle,WR,active,baltimore-ravens,30882,2016
3558,26470,0,Keenan Reynolds,WR,active,baltimore-ravens,26470,2016
3559,1000000,4100000,Jimmy Smith,CB,injured_reserve,baltimore-ravens,5100000,2016
3560,1000000,2000000,Benjamin Watson,TE,injured_reserve,baltimore-ravens,3000000,2016
3561,1400000,466667,Kendrick Lewis,FS,injured_reserve,baltimore-ravens,1866667,2016
3562,900000,666666,Kyle Arrington,CB,injured_reserve,baltimore-ravens,1566666,2016
3563,450000,595388,Kamalei Correa,ILB,injured_reserve,baltimore-ravens,1045388,2016
3564,411815,301861,Maxx Williams,TE,injured_reserve,baltimore-ravens,713676,2016
3565,540750,156271,Carl Davis,DT,injured_reserve,baltimore-ravens,697021,2016
3566,600000,75146,Lorenzo Taliaferro,RB,injured_reserve,baltimore-ravens,675146,2016
3567,600000,1000,Zach Orr,ILB,injured_reserve,baltimore-ravens,601000,2016
3568,600000,0,Chris Matthews,WR,injured_reserve,baltimore-ravens,600000,2016
3569,600000,0,Jumal Rolle,CB,injured_reserve,baltimore-ravens,600000,2016
3570,450000,95848,Willie Henry,DT,injured_reserve,baltimore-ravens,545848,2016
3571,333000,211254,Bronson Kaufusi,DE,injured_reserve,baltimore-ravens,544254,2016
3572,525000,0,De'Ondre Wesley,G,injured_reserve,baltimore-ravens,525000,2016
3573,450000,4166,Stephane Nembot,T,injured_reserve,baltimore-ravens,454166,2016
3574,450000,833,Cavellis Luckett,ILB,injured_reserve,baltimore-ravens,450833,2016
3575,400057,0,Sheldon Price,CB,injured_reserve,baltimore-ravens,400057,2016
3576,360526,25089,Maurice Canady,CB,injured_reserve,baltimore-ravens,385615,2016
3577,3000000,700000,Justin Forsett,RB,dead_cap,baltimore-ravens,3700000,2016
3578,0,2200000,Eugene Monroe,LT,dead_cap,baltimore-ravens,2200000,2016
3579,0,1750000,Will Hill,SS,dead_cap,baltimore-ravens,1750000,2016
3580,0,1750000,Daryl Smith,ILB,dead_cap,baltimore-ravens,1750000,2016
3581,1000000,100000,Devin Hester,WR,dead_cap,baltimore-ravens,1100000,2016
3582,1000000,0,Chris Carter,ILB,dead_cap,baltimore-ravens,1000000,2016
3583,0,765000,Chris Canty,DE,dead_cap,baltimore-ravens,765000,2016
3584,321176,0,Will Davis,CB,dead_cap,baltimore-ravens,321176,2016
3585,308820,0,Kaelin Clay,WR,dead_cap,baltimore-ravens,308820,2016
3586,264000,36486,Keenan Reynolds,WR,dead_cap,baltimore-ravens,300486,2016
3587,0,259269,Tray Walker,CB,dead_cap,baltimore-ravens,259269,2016
3588,0,241224,Arthur Brown,ILB,dead_cap,baltimore-ravens,241224,2016
3589,0,151594,Terrence Brooks,FS,dead_cap,baltimore-ravens,151594,2016
3590,127500,22058,Kapron Lewis-Moore,DE,dead_cap,baltimore-ravens,149558,2016
3591,0,124690,Robert Myers,G,dead_cap,baltimore-ravens,124690,2016
3592,117300,2500,Matt Skura,C,dead_cap,baltimore-ravens,119800,2016
3593,115040,0,Robertson Daniel,CB,dead_cap,baltimore-ravens,115040,2016
3594,103500,4000,Brennen Beyer,ILB,dead_cap,baltimore-ravens,107500,2016
3595,103800,0,David Fales,QB,dead_cap,baltimore-ravens,103800,2016
3596,89700,3333,Jarell Broxton,G,dead_cap,baltimore-ravens,93033,2016
3597,89700,0,Kenny Bell,WR,dead_cap,baltimore-ravens,89700,2016
3598,89364,0,Daniel Brown,TE,dead_cap,baltimore-ravens,89364,2016
3599,82800,0,Stephen Houston,RB,dead_cap,baltimore-ravens,82800,2016
3600,79205,0,Asa Jackson,CB,dead_cap,baltimore-ravens,79205,2016
3601,62100,6667,Blaine Clausell,T,dead_cap,baltimore-ravens,68767,2016
3602,34500,16875,Michael Campanaro,WR,dead_cap,baltimore-ravens,51375,2016
3603,48300,0,Jarrod Pughsley,LT,dead_cap,baltimore-ravens,48300,2016
3604,0,40000,Christo Bilukidi,DT,dead_cap,baltimore-ravens,40000,2016
3605,34500,0,Patrick Onwuasor,ILB,dead_cap,baltimore-ravens,34500,2016
3606,20700,0,Sam Brown,CB,dead_cap,baltimore-ravens,20700,2016
3607,13800,0,Dobson Collins,WR,dead_cap,baltimore-ravens,13800,2016
3608,6900,0,James Burgess,ILB,dead_cap,baltimore-ravens,6900,2016
3609,6900,0,Mitchell Henry,TE,dead_cap,baltimore-ravens,6900,2016
3610,6900,0,Dustin Vaughan,QB,dead_cap,baltimore-ravens,6900,2016
3611,0,6000,Darryl Baldwin,T,dead_cap,baltimore-ravens,6000,2016
3612,0,6000,Nick Easton,C,dead_cap,baltimore-ravens,6000,2016
3613,0,5000,Deandre Carter,WR,dead_cap,baltimore-ravens,5000,2016
3614,0,4334,Kaleb Johnson,T,dead_cap,baltimore-ravens,4334,2016
3615,0,3334,Jerry Lovelocke,QB,dead_cap,baltimore-ravens,3334,2016
3616,0,3334,Nick Perry,FS,dead_cap,baltimore-ravens,3334,2016
3617,0,3333,Anthony Fabiano,T,dead_cap,baltimore-ravens,3333,2016
3618,0,3000,Julian Wilson,CB,dead_cap,baltimore-ravens,3000,2016
3619,0,2000,Terrence Magee,RT,dead_cap,baltimore-ravens,2000,2016
3620,0,2000,De'Ondre Wesley,G,dead_cap,baltimore-ravens,2000,2016
3621,0,1667,Cam Worthy,WR,dead_cap,baltimore-ravens,1667,2016
3622,0,1334,Jeremy Butler,WR,dead_cap,baltimore-ravens,1334,2016
3623,6000000,23300000,Joe Flacco,QB,active,baltimore-ravens,29300000,2017
3624,4750000,3250000,Mike Wallace,WR,active,baltimore-ravens,8000000,2017
3625,4000000,2950000,Terrell Suggs,OLB,active,baltimore-ravens,6950000,2017
3626,4000000,1750000,Eric Weddle,FS,active,baltimore-ravens,5750000,2017
3627,1381106,3274423,Ronnie Stanley,LT,active,baltimore-ravens,4655529,2017
3628,1040000,2990000,Tony Jefferson,SS,active,baltimore-ravens,4030000,2017
3629,775000,3045000,Brandon Williams,DT,active,baltimore-ravens,3820000,2017
3630,1000000,2500000,Jeremy Maclin,WR,active,baltimore-ravens,3500000,2017
3631,1010000,2096666,Justin Tucker,K,active,baltimore-ravens,3106666,2017
3632,2300000,800000,Sam Koch,P,active,baltimore-ravens,3100000,2017
3633,2000000,1000000,Brandon Carr,CB,active,baltimore-ravens,3000000,2017
3634,1618365,1177818,C.J. Mosley,ILB,active,baltimore-ravens,2796183,2017
3635,1525000,1000000,Austin Howard,RT,active,baltimore-ravens,2525000,2017
3636,1226392,1147785,Breshad Perriman,WR,active,baltimore-ravens,2374177,2017
3637,1250000,1000000,Benjamin Watson,TE,active,baltimore-ravens,2250000,2017
3638,465000,1689087,Marlon Humphrey,CB,active,baltimore-ravens,2154087,2017
3639,1000000,1000000,Ryan Mallett,QB,active,baltimore-ravens,2000000,2017
3640,1797000,0,Ryan Jensen,C,active,baltimore-ravens,1797000,2017
3641,1797000,0,Terrance West,RB,active,baltimore-ravens,1797000,2017
3642,1000000,750000,Danny Woodhead,RB,active,baltimore-ravens,1750000,2017
3643,711347,595388,Kamalei Correa,ILB,active,baltimore-ravens,1306735,2017
3644,900000,400000,Lardarius Webb,CB,active,baltimore-ravens,1300000,2017
3645,700000,500000,James Hurst,RT,active,baltimore-ravens,1200000,2017
3646,803431,301861,Maxx Williams,TE,active,baltimore-ravens,1105292,2017
3647,900000,140000,Morgan Cox,LS,active,baltimore-ravens,1040000,2017
3648,900000,133333,Anthony Levine,ILB,active,baltimore-ravens,1033333,2017
3649,465000,548747,Tyus Bowser,OLB,active,baltimore-ravens,1013747,2017
3650,700000,312500,Michael Campanaro,WR,active,baltimore-ravens,1012500,2017
3651,603500,211254,Bronson Kaufusi,DE,active,baltimore-ravens,814754,2017
3652,630750,156271,Carl Davis,DT,active,baltimore-ravens,787021,2017
3653,615000,120788,Za'Darius Smith,OLB,active,baltimore-ravens,735788,2017
3654,615000,118618,Javorius Allen,RB,active,baltimore-ravens,733618,2017
3655,690000,0,Luke Bowanko,C,active,baltimore-ravens,690000,2017
3656,465000,224660,Chris Wormley,DT,active,baltimore-ravens,689660,2017
3657,540000,149090,Chris Moore,WR,active,baltimore-ravens,689090,2017
3658,465000,214170,Tim Williams,OLB,active,baltimore-ravens,679170,2017
3659,615000,41563,Nick Boyle,TE,active,baltimore-ravens,656563,2017
3660,540000,95848,Willie Henry,DT,active,baltimore-ravens,635848,2017
3661,540000,63934,Matt Judon,OLB,active,baltimore-ravens,603934,2017
3662,540000,3333,Michael Pierce,DT,active,baltimore-ravens,543333,2017
3663,540000,0,Vince Mayle,WR,active,baltimore-ravens,540000,2017
3664,540000,0,Patrick Onwuasor,ILB,active,baltimore-ravens,540000,2017
3665,465000,66788,Jermaine Eluemunor,G,active,baltimore-ravens,531788,2017
3666,465000,43701,Chuck Clark,S,active,baltimore-ravens,508701,2017
3667,508235,0,Alex Collins,RB,active,baltimore-ravens,508235,2017
3668,456706,25089,Maurice Canady,CB,active,baltimore-ravens,481795,2017
3669,465000,2166,Patrick Ricard,DT,active,baltimore-ravens,467166,2017
3670,410295,0,Matt Skura,C,active,baltimore-ravens,410295,2017
3671,501471,0,Steven Johnson,ILB,active,baltimore-ravens,501471,2017
3672,253235,0,Andrew Donnal,RT,active,baltimore-ravens,253235,2017
3673,246177,0,Maurquice Shakir,G,active,baltimore-ravens,246177,2017
3674,127060,0,Stanley Jean-Baptiste,CB,active,baltimore-ravens,127060,2017
3675,27353,0,Quincy Adeboyejo,WR,active,baltimore-ravens,27353,2017
3676,6000000,3125220,Marshal Yanda,G,injured_reserve,baltimore-ravens,9125220,2017
3677,1000000,200000,Albert McClellan,OLB,injured_reserve,baltimore-ravens,1200000,2017
3678,690000,126504,Crockett Gillmore,T,injured_reserve,baltimore-ravens,816504,2017
3679,690000,75146,Brent Urban,DE,injured_reserve,baltimore-ravens,765146,2017
3680,615000,0,Chris Matthews,WR,injured_reserve,baltimore-ravens,615000,2017
3681,363000,151282,Tavon Young,CB,injured_reserve,baltimore-ravens,514282,2017
3682,348000,157344,Nico Siragusa,G,injured_reserve,baltimore-ravens,505344,2017
3683,363000,122974,Alex Lewis,G,injured_reserve,baltimore-ravens,485974,2017
3684,465000,0,Jaylen Hill,CB,injured_reserve,baltimore-ravens,465000,2017
3685,349412,95848,Kenneth Dixon,RB,injured_reserve,baltimore-ravens,445260,2017
3686,378000,0,Brandon Boykin,CB,injured_reserve,baltimore-ravens,378000,2017
3687,363000,4166,Stephane Nembot,T,injured_reserve,baltimore-ravens,367166,2017
3688,361756,666,Bam Bradley,ILB,injured_reserve,baltimore-ravens,362422,2017
3689,348000,2333,Brandon Kublanow,T,injured_reserve,baltimore-ravens,350333,2017
3690,348000,2000,Tim White,WR,injured_reserve,baltimore-ravens,350000,2017
3691,7200,0,Derrick Nelson,C,practice_squad,baltimore-ravens,7200,2017
3692,0,4400000,Eugene Monroe,LT,dead_cap,baltimore-ravens,4400000,2017
3693,0,2700000,Dennis Pitta,TE,dead_cap,baltimore-ravens,2700000,2017
3694,0,2666667,Shareece Wright,CB,dead_cap,baltimore-ravens,2666667,2017
3695,0,3250000,Elvis Dumervil,OLB,dead_cap,baltimore-ravens,3250000,2017
3696,0,2314412,Jeremy Zuttah,C,dead_cap,baltimore-ravens,2314412,2017
3697,0,3000000,Lardarius Webb,CB,dead_cap,baltimore-ravens,3000000,2017
3698,0,700000,Justin Forsett,RB,dead_cap,baltimore-ravens,700000,2017
3699,0,666668,Kyle Arrington,CB,dead_cap,baltimore-ravens,666668,2017
3700,820588,0,Tony Bergstrom,C,dead_cap,baltimore-ravens,820588,2017
3701,0,466667,Kendrick Lewis,FS,dead_cap,baltimore-ravens,466667,2017
3702,0,376891,Timmy Jernigan,DT,dead_cap,baltimore-ravens,376891,2017
3703,217056,0,Sheldon Price,CB,dead_cap,baltimore-ravens,217056,2017
3704,227941,0,Bobby Rainey,RB,dead_cap,baltimore-ravens,227941,2017
3705,171318,0,Tony McRae,CB,dead_cap,baltimore-ravens,171318,2017
3706,168459,0,Dieugot Joseph,T,dead_cap,baltimore-ravens,168459,2017
3707,0,151594,Terrence Brooks,FS,dead_cap,baltimore-ravens,151594,2017
3708,136765,0,Jonathan Freeny,OLB,dead_cap,baltimore-ravens,136765,2017
3709,136764,0,Gavin Escobar,TE,dead_cap,baltimore-ravens,136764,2017
3710,115200,0,Quincy Adeboyejo,WR,dead_cap,baltimore-ravens,115200,2017
3711,115200,0,Josh Woodrum,QB,dead_cap,baltimore-ravens,115200,2017
3712,0,109461,Keenan Reynolds,WR,dead_cap,baltimore-ravens,109461,2017
3713,108000,0,Ryan Malleck,TE,dead_cap,baltimore-ravens,108000,2017
3714,100800,0,Josh Crockett,RB,dead_cap,baltimore-ravens,100800,2017
3715,91176,0,Griff Whalen,WR,dead_cap,baltimore-ravens,91176,2017
3716,86400,0,Kapron Lewis-Moore,DE,dead_cap,baltimore-ravens,86400,2017
3717,79200,0,Ricky Ortiz,FB,dead_cap,baltimore-ravens,79200,2017
3718,0,75146,Lorenzo Taliaferro,RB,dead_cap,baltimore-ravens,75146,2017
3719,72000,0,Kenny Bell,WR,dead_cap,baltimore-ravens,72000,2017
3720,64800,0,Nicholas Grigsby,ILB,dead_cap,baltimore-ravens,64800,2017
3721,64800,0,Stanley Jean-Baptiste,CB,dead_cap,baltimore-ravens,64800,2017
3722,64800,0,Steven Moore,T,dead_cap,baltimore-ravens,64800,2017
3723,57600,0,Maurquice Shakir,G,dead_cap,baltimore-ravens,57600,2017
3724,0,36140,John Urschel,G,dead_cap,baltimore-ravens,36140,2017
3725,36000,0,Darnell Sankey,ILB,dead_cap,baltimore-ravens,36000,2017
3726,28800,0,Robertson Daniel,CB,dead_cap,baltimore-ravens,28800,2017
3727,28800,0,Arie Kouandjio,G,dead_cap,baltimore-ravens,28800,2017
3728,21600,0,Gabe Holmes,TE,dead_cap,baltimore-ravens,21600,2017
3729,21600,0,Ronald Martin,SS,dead_cap,baltimore-ravens,21600,2017
3730,14400,5000,Matt Skura,C,dead_cap,baltimore-ravens,19400,2017
3731,0,16875,Michael Campanaro,WR,dead_cap,baltimore-ravens,16875,2017
3732,14400,0,Jason King,T,dead_cap,baltimore-ravens,14400,2017
3733,14400,0,Reggie Porter,CB,dead_cap,baltimore-ravens,14400,2017
3734,14400,0,Josh Thornton,CB,dead_cap,baltimore-ravens,14400,2017
3735,14400,0,Jeremy Langford,RB,dead_cap,baltimore-ravens,14400,2017
3736,7200,0,Alex Collins,RB,dead_cap,baltimore-ravens,7200,2017
3737,7200,0,Robert Nelson,CB,dead_cap,baltimore-ravens,7200,2017
3738,0,6667,Jarell Broxton,G,dead_cap,baltimore-ravens,6667,2017
3739,0,6667,Anthony Fabiano,T,dead_cap,baltimore-ravens,6667,2017
3740,0,3000,Julian Wilson,CB,dead_cap,baltimore-ravens,3000,2017
3741,0,1667,Cavellis Luckett,ILB,dead_cap,baltimore-ravens,1667,2017
3742,12000000,17500000,Joe Flacco,QB,active,baltimore-ravens,29500000,2018
3743,7494118,5738922,Jimmy Smith,CB,active,baltimore-ravens,13233040,2018
3744,7000000,3125220,Marshal Yanda,G,active,baltimore-ravens,10125220,2018
3745,8718000,0,C.J. Mosley,ILB,active,baltimore-ravens,8718000,2018
3746,6500000,1750000,Eric Weddle,FS,active,baltimore-ravens,8250000,2018
3747,4500000,2500000,Brandon Carr,CB,active,baltimore-ravens,7000000,2018
3748,4000000,2950000,Terrell Suggs,OLB,active,baltimore-ravens,6950000,2018
3749,1000000,4920000,Brandon Williams,DT,active,baltimore-ravens,5920000,2018
3750,1000000,4656666,Tony Jefferson,SS,active,baltimore-ravens,5656666,2018
3751,2312212,3274423,Ronnie Stanley,LT,active,baltimore-ravens,5586635,2018
3752,2950000,2096666,Justin Tucker,K,active,baltimore-ravens,5046666,2018
3753,1000000,4000000,John Brown,WR,active,baltimore-ravens,5000000,2018
3754,2750000,800000,Sam Koch,P,active,baltimore-ravens,3550000,2018
3755,1000000,2333333,Michael Crabtree,WR,active,baltimore-ravens,3333333,2018
3756,1003522,1689087,Marlon Humphrey,CB,active,baltimore-ravens,2692609,2018
3757,1000000,1250000,James Hurst,RT,active,baltimore-ravens,2250000,2018
3758,1907000,120788,Za'Darius Smith,OLB,active,baltimore-ravens,2027788,2018
3759,480000,1526550,Hayden Hurst,TE,active,baltimore-ravens,2006550,2018
3760,1000000,1000000,Willie Snead,WR,active,baltimore-ravens,2000000,2018
3761,480000,1242117,Lamar Jackson,QB,active,baltimore-ravens,1722117,2018
3762,1400000,133333,Anthony Levine,ILB,active,baltimore-ravens,1533333,2018
3763,987646,301863,Maxx Williams,TE,active,baltimore-ravens,1289509,2018
3764,718437,548747,Tyus Bowser,OLB,active,baltimore-ravens,1267184,2018
3765,1000000,140000,Morgan Cox,LS,active,baltimore-ravens,1140000,2018
3766,1000000,100000,Robert Griffin III,QB,active,baltimore-ravens,1100000,2018
3767,1000000,100000,Brent Urban,DE,active,baltimore-ravens,1100000,2018
3768,626000,224660,Chris Wormley,DT,active,baltimore-ravens,850660,2018
3769,705000,118618,Javorius Allen,RB,active,baltimore-ravens,823618,2018
3770,595000,214170,Tim Williams,OLB,active,baltimore-ravens,809170,2018
3771,630000,151282,Tavon Young,CB,active,baltimore-ravens,781282,2018
3772,630000,149090,Chris Moore,WR,active,baltimore-ravens,779090,2018
3773,630000,122974,Alex Lewis,G,active,baltimore-ravens,752974,2018
3774,705000,41565,Nick Boyle,TE,active,baltimore-ravens,746565,2018
3775,630000,87391,Kenneth Dixon,RB,active,baltimore-ravens,717391,2018
3776,480000,216430,Orlando Brown Jr.,T,active,baltimore-ravens,696430,2018
3777,630000,63934,Matt Judon,OLB,active,baltimore-ravens,693934,2018
3778,480000,209165,Mark Andrews,TE,active,baltimore-ravens,689165,2018
3779,630000,25089,Maurice Canady,CB,active,baltimore-ravens,655089,2018
3780,480000,165249,Anthony Averett,CB,active,baltimore-ravens,645249,2018
3781,480000,159976,Kenny Young,ILB,active,baltimore-ravens,639976,2018
3782,630000,3334,Michael Pierce,DT,active,baltimore-ravens,633334,2018
3783,630000,0,Patrick Onwuasor,ILB,active,baltimore-ravens,630000,2018
3784,555000,43701,Chuck Clark,S,active,baltimore-ravens,598701,2018
3785,574588,0,Cyrus Jones,CB,active,baltimore-ravens,574588,2018
3786,555000,2166,Patrick Ricard,DT,active,baltimore-ravens,557166,2018
3787,555000,0,Matt Skura,C,active,baltimore-ravens,555000,2018
3788,480000,67169,Jordan Lasley,WR,active,baltimore-ravens,547169,2018
3789,480000,29602,Bradley Bozeman,C,active,baltimore-ravens,509602,2018
3790,480000,20170,Zach Sieler,DE,active,baltimore-ravens,500170,2018
3791,480000,1333,Chris Board,LB,active,baltimore-ravens,481333,2018
3792,379324,0,Ty Montgomery,RB,active,baltimore-ravens,379324,2018
3793,338824,0,Gus Edwards,RB,active,baltimore-ravens,338824,2018
3794,326471,0,Jermaine Eluemunor,G,active,baltimore-ravens,326471,2018
3795,630000,95848,Willie Henry,DT,injured_reserve,baltimore-ravens,725848,2018
3796,630000,0,Alex Collins,RB,injured_reserve,baltimore-ravens,630000,2018
3797,630000,0,Stanley Jean-Baptiste,CB,injured_reserve,baltimore-ravens,630000,2018
3798,363000,145095,Jaleel Scott,WR,injured_reserve,baltimore-ravens,508095,2018
3799,363000,39448,Deshon Elliott,S,injured_reserve,baltimore-ravens,402448,2018
3800,363000,29602,Greg Senat,T,injured_reserve,baltimore-ravens,392602,2018
3801,369164,0,De’Lance Turner,RB,injured_reserve,baltimore-ravens,369164,2018
3802,363000,0,Steven Moore,T,injured_reserve,baltimore-ravens,363000,2018
3803,439000,1333,Kaare Vedvik,K,non_fb_injury,baltimore-ravens,440333,2018
3804,0,2500000,Jeremy Maclin,WR,dead_cap,baltimore-ravens,2500000,2018
3805,0,2200000,Dennis Pitta,TE,dead_cap,baltimore-ravens,2200000,2018
3806,0,2000000,Austin Howard,RT,dead_cap,baltimore-ravens,2000000,2018
3807,0,1797269,Breshad Perriman,WR,dead_cap,baltimore-ravens,1797269,2018
3808,0,1500000,Danny Woodhead,RB,dead_cap,baltimore-ravens,1500000,2018
3809,0,800000,Lardarius Webb,CB,dead_cap,baltimore-ravens,800000,2018
3810,0,595389,Kamalei Correa,ILB,dead_cap,baltimore-ravens,595389,2018
3811,278824,200000,Albert McClellan,OLB,dead_cap,baltimore-ravens,478824,2018
3812,333530,0,Hroniss Grasu,C,dead_cap,baltimore-ravens,333530,2018
3813,106400,157345,Nico Siragusa,G,dead_cap,baltimore-ravens,263745,2018
3814,177944,66788,Jermaine Eluemunor,G,dead_cap,baltimore-ravens,244732,2018
3815,0,211254,Bronson Kaufusi,DE,dead_cap,baltimore-ravens,211254,2018
3816,197905,2000,Tim White,WR,dead_cap,baltimore-ravens,199905,2018
3817,162870,0,Janarion Grant,WR,dead_cap,baltimore-ravens,162870,2018
3818,0,156271,Carl Davis,DT,dead_cap,baltimore-ravens,156271,2018
3819,149835,0,Robertson Daniel,CB,dead_cap,baltimore-ravens,149835,2018
3820,143842,0,Darious Williams,S,dead_cap,baltimore-ravens,143842,2018
3821,121600,0,Randin Crecelius,G,dead_cap,baltimore-ravens,121600,2018
3822,91200,26183,Darren Waller,TE,dead_cap,baltimore-ravens,117383,2018
3823,0,100000,Jeremy Zuttah,C,dead_cap,baltimore-ravens,100000,2018
3824,83600,0,Alvin Jones,LB,dead_cap,baltimore-ravens,83600,2018
3825,76000,0,Kofi Amichia,C,dead_cap,baltimore-ravens,76000,2018
3826,60800,0,Makinton Dorleant,CB,dead_cap,baltimore-ravens,60800,2018
3827,53200,0,Tyler Ervin,RB,dead_cap,baltimore-ravens,53200,2018
3828,45600,0,Mark Thompson,RB,dead_cap,baltimore-ravens,45600,2018
3829,38000,0,Gus Edwards,RB,dead_cap,baltimore-ravens,38000,2018
3830,38000,0,Bennett Jackson,SS,dead_cap,baltimore-ravens,38000,2018
3831,38000,0,Nick Keizer,TE,dead_cap,baltimore-ravens,38000,2018
3832,30400,0,Christian LaCouture,DT,dead_cap,baltimore-ravens,30400,2018
3833,30400,0,Kai Nacua,S,dead_cap,baltimore-ravens,30400,2018
3834,22800,0,Myles Humphrey,DE,dead_cap,baltimore-ravens,22800,2018
3835,22800,0,Jake Rodgers,T,dead_cap,baltimore-ravens,22800,2018
3836,15200,0,Cyrus Jones,CB,dead_cap,baltimore-ravens,15200,2018
3837,15200,0,Andre Levrone,WR,dead_cap,baltimore-ravens,15200,2018
3838,7600,0,De’Lance Turner,RB,dead_cap,baltimore-ravens,7600,2018
3839,0,4667,Brandon Kublanow,T,dead_cap,baltimore-ravens,4667,2018
3840,0,4168,Stephane Nembot,T,dead_cap,baltimore-ravens,4168,2018
3841,0,1666,Jaelon Acklin,WR,dead_cap,baltimore-ravens,1666,2018
3842,0,1000,Alex Thompson,C,dead_cap,baltimore-ravens,1000,2018
3843,9500000,6350685,Jimmy Smith,CB,active,baltimore-ravens,15850685,2019
3844,9250000,4920000,Brandon Williams,DT,active,baltimore-ravens,14170000,2019
3845,2000000,7125222,Marshal Yanda,G,active,baltimore-ravens,9125222,2019
3846,5382059,2000000,Marcus Peters,CB,active,baltimore-ravens,7382059,2019
3847,4500000,2500000,Brandon Carr,CB,active,baltimore-ravens,7000000,2019
3848,2000000,5000000,Earl Thomas,FS,active,baltimore-ravens,7000000,2019
3849,3243318,3274426,Ronnie Stanley,LT,active,baltimore-ravens,6517744,2019
3850,1837941,3750000,Willie Snead,WR,active,baltimore-ravens,5587941,2019
3851,3500000,1250000,James Hurst,RT,active,baltimore-ravens,4750000,2019
3852,1000000,3696668,Justin Tucker,K,active,baltimore-ravens,4696668,2019
3853,3150000,800000,Sam Koch,P,active,baltimore-ravens,3950000,2019
3854,2000000,1333333,Mark Ingram,RB,active,baltimore-ravens,3333333,2019
3855,1000000,2333333,Nick Boyle,TE,active,baltimore-ravens,3333333,2019
3856,1542044,1689087,Marlon Humphrey,CB,active,baltimore-ravens,3231131,2019
3857,3095000,0,Patrick Onwuasor,ILB,active,baltimore-ravens,3095000,2019
3858,3095000,0,Michael Pierce,DT,active,baltimore-ravens,3095000,2019
3859,981638,1526550,Hayden Hurst,TE,active,baltimore-ravens,2508188,2019
3860,910529,1242117,Lamar Jackson,QB,active,baltimore-ravens,2152646,2019
3861,495000,1648153,Marquise Brown,WR,active,baltimore-ravens,2143153,2019
3862,2025000,63934,Matt Judon,OLB,active,baltimore-ravens,2088934,2019
3863,1700000,300000,Seth Roberts,WR,active,baltimore-ravens,2000000,2019
3864,1500000,233334,Anthony Levine,SS,active,baltimore-ravens,1733334,2019
3865,971874,548747,Tyus Bowser,OLB,active,baltimore-ravens,1520621,2019
3866,1000000,500000,Robert Griffin III,QB,active,baltimore-ravens,1500000,2019
3867,1100000,140000,Morgan Cox,LS,active,baltimore-ravens,1240000,2019
3868,645000,335501,Patrick Ricard,FB,active,baltimore-ravens,980501,2019
3869,736000,224660,Chris Wormley,DE,active,baltimore-ravens,960660,2019
3870,720000,149090,Chris Moore,WR,active,baltimore-ravens,869090,2019
3871,627000,216430,Orlando Brown Jr.,RT,active,baltimore-ravens,843430,2019
3872,624500,209165,Mark Andrews,TE,active,baltimore-ravens,833665,2019
3873,570000,165249,Anthony Averett,CB,active,baltimore-ravens,735249,2019
3874,495000,225827,Jaylon Ferguson,DE,active,baltimore-ravens,720827,2019
3875,495000,214232,Miles Boykin,WR,active,baltimore-ravens,709232,2019
3876,645000,43701,Chuck Clark,S,active,baltimore-ravens,688701,2019
3877,495000,185414,Justice Hill,RB,active,baltimore-ravens,680414,2019
3878,495000,174383,Ben Powers,G,active,baltimore-ravens,669383,2019
3879,495000,145095,Jaleel Scott,WR,active,baltimore-ravens,640095,2019
3880,615588,0,L.J. Fort,ILB,active,baltimore-ravens,615588,2019
3881,570000,29602,Bradley Bozeman,G,active,baltimore-ravens,599602,2019
3882,426174,168299,Iman Marshall,CB,active,baltimore-ravens,594473,2019
3883,570000,1333,Chris Board,ILB,active,baltimore-ravens,571333,2019
3884,570000,0,Gus Edwards,RB,active,baltimore-ravens,570000,2019
3885,495000,40172,Trace McSorley,QB,active,baltimore-ravens,535172,2019
3886,508235,0,Jihad Ward,DT,active,baltimore-ravens,508235,2019
3887,495000,2666,Patrick Mekari,G,active,baltimore-ravens,497666,2019
3888,711176,0,Josh Bynes,ILB,active,baltimore-ravens,711176,2019
3889,805000,0,Brynden Trawick,SS,active,baltimore-ravens,805000,2019
3890,473529,0,Jordan Richards,SS,active,baltimore-ravens,473529,2019
3891,378824,0,De'Anthony Thomas,WR,active,baltimore-ravens,378824,2019
3892,331471,0,Justin Ellis,DT,active,baltimore-ravens,331471,2019
3893,424118,0,Domata Peko,DT,active,baltimore-ravens,424118,2019
3894,211765,0,Parker Ehinger,G,active,baltimore-ravens,211765,2019
3895,169412,0,Hroniss Grasu,C,active,baltimore-ravens,169412,2019
3896,8000000,4656666,Tony Jefferson,SS,injured_reserve,baltimore-ravens,12656666,2019
3897,1000000,2651282,Tavon Young,CB,injured_reserve,baltimore-ravens,3651282,2019
3898,675000,100000,Pernell McPhee,OLB,injured_reserve,baltimore-ravens,775000,2019
3899,645000,0,Matt Skura,C,injured_reserve,baltimore-ravens,645000,2019
3900,570000,39448,Deshon Elliott,S,injured_reserve,baltimore-ravens,609448,2019
3901,446824,74820,Daylon Mack,DT,injured_reserve,baltimore-ravens,521644,2019
3902,398648,3333,Otaro Alaka,ILB,injured_reserve,baltimore-ravens,401981,2019
3903,378000,0,Randin Crecelius,G,injured_reserve,baltimore-ravens,378000,2019
3904,378000,0,Fish Smithson,S,injured_reserve,baltimore-ravens,378000,2019
3905,88000,0,Denzel Rice,CB,injured_reserve,baltimore-ravens,88000,2019
3906,48000,0,Marcus Applefield,T,injured_reserve,baltimore-ravens,48000,2019
3907,64000,0,Byron Marshall,RB,practice_squad,baltimore-ravens,64000,2019
3908,136000,0,Christopher Ezeala,FB,practice_squad,baltimore-ravens,136000,2019
3909,0,16000000,Joe Flacco,QB,dead_cap,baltimore-ravens,16000000,2019
3910,0,4666668,Michael Crabtree,WR,dead_cap,baltimore-ravens,4666668,2019
3911,1500000,500000,Justin Bethel,CB,dead_cap,baltimore-ravens,2000000,2019
3912,0,1750000,Eric Weddle,FS,dead_cap,baltimore-ravens,1750000,2019
3913,0,595391,Kamalei Correa,ILB,dead_cap,baltimore-ravens,595391,2019
3914,585882,0,Cyrus Jones,CB,dead_cap,baltimore-ravens,585882,2019
3915,364824,25089,Maurice Canady,CB,dead_cap,baltimore-ravens,389913,2019
3916,365765,20171,Zach Sieler,DE,dead_cap,baltimore-ravens,385936,2019
3917,162353,214170,Tim Williams,OLB,dead_cap,baltimore-ravens,376523,2019
3918,201176,159976,Kenny Young,ILB,dead_cap,baltimore-ravens,361152,2019
3919,0,314690,Nico Siragusa,G,dead_cap,baltimore-ravens,314690,2019
3920,0,211254,Bronson Kaufusi,DE,dead_cap,baltimore-ravens,211254,2019
3921,203824,0,Bennett Jackson,CB,dead_cap,baltimore-ravens,203824,2019
3922,0,200000,Shane Ray,OLB,dead_cap,baltimore-ravens,200000,2019
3923,170000,0,Aaron Adeoye,DE,dead_cap,baltimore-ravens,170000,2019
3924,169824,0,Ufomba Kamalu,DE,dead_cap,baltimore-ravens,169824,2019
3925,152000,3333,Antoine Wesley,WR,dead_cap,baltimore-ravens,155333,2019
3926,144000,0,De’Lance Turner,RB,dead_cap,baltimore-ravens,144000,2019
3927,136000,1500,Charles Scarff,TE,dead_cap,baltimore-ravens,137500,2019
3928,136000,0,R.J. Prince,G,dead_cap,baltimore-ravens,136000,2019
3929,0,133576,Jermaine Eluemunor,G,dead_cap,baltimore-ravens,133576,2019
3930,42353,87391,Kenneth Dixon,RB,dead_cap,baltimore-ravens,129744,2019
3931,128000,0,Terrell Bonds,CB,dead_cap,baltimore-ravens,128000,2019
3932,128000,0,Trevon Coley,DT,dead_cap,baltimore-ravens,128000,2019
3933,0,122975,Alex Lewis,G,dead_cap,baltimore-ravens,122975,2019
3934,0,95849,Willie Henry,DT,dead_cap,baltimore-ravens,95849,2019
3935,80000,0,Parker Ehinger,G,dead_cap,baltimore-ravens,80000,2019
3936,64000,4000,Mike Onuoha,OLB,dead_cap,baltimore-ravens,68000,2019
3937,0,67170,Jordan Lasley,WR,dead_cap,baltimore-ravens,67170,2019
3938,33529,29602,Greg Senat,T,dead_cap,baltimore-ravens,63131,2019
3939,56000,166,Sean Modster,WR,dead_cap,baltimore-ravens,56166,2019
3940,50000,3333,Gerald Willis,DT,dead_cap,baltimore-ravens,53333,2019
3941,32000,0,Demone Harris,OLB,dead_cap,baltimore-ravens,32000,2019
3942,32000,0,Will Holden,T,dead_cap,baltimore-ravens,32000,2019
3943,24000,1333,Cole Herdman,TE,dead_cap,baltimore-ravens,25333,2019
3944,24000,0,Jeremiah Ledbetter,DT,dead_cap,baltimore-ravens,24000,2019
3945,22235,0,Alvin Jones,LB,dead_cap,baltimore-ravens,22235,2019
3946,16000,0,A.J. Howard,S,dead_cap,baltimore-ravens,16000,2019
3947,16000,0,Mark Thompson,RB,dead_cap,baltimore-ravens,16000,2019
3948,10000,1666,Silas Stewart,OLB,dead_cap,baltimore-ravens,11666,2019
3949,8000,1000,Marcus Applefield,T,dead_cap,baltimore-ravens,9000,2019
3950,8000,0,Donald Payne,ILB,dead_cap,baltimore-ravens,8000,2019
3951,0,3334,Jaelon Acklin,WR,dead_cap,baltimore-ravens,3334,2019
3952,0,2000,Markus Jones,OLB,dead_cap,baltimore-ravens,2000,2019
3953,0,2000,Alex Thompson,C,dead_cap,baltimore-ravens,2000,2019
3954,0,2000,Tim White,WR,dead_cap,baltimore-ravens,2000,2019
3955,0,1666,E.J. Ejiya,ILB,dead_cap,baltimore-ravens,1666,2019
3956,0,1333,Kaare Vedvik,K,dead_cap,baltimore-ravens,1333,2019
3957,0,668,Bam Bradley,ILB,dead_cap,baltimore-ravens,668,2019
3958,0,667,Matthew Orzech,LS,dead_cap,baltimore-ravens,667,2019
3959,10000000,5000000,Marcus Peters,CB,active,baltimore-ravens,15000000,2020
3960,10000000,5000000,Earl Thomas,FS,active,baltimore-ravens,15000000,2020
3961,9250000,4920000,Brandon Williams,DT,active,baltimore-ravens,14170000,2020
3962,12866000,0,Ronnie Stanley,LT,active,baltimore-ravens,12866000,2020
3963,7000000,4656668,Tony Jefferson,SS,active,baltimore-ravens,11656668,2020
3964,7000000,4000000,Marshal Yanda,G,active,baltimore-ravens,11000000,2020
3965,5500000,2500000,Tavon Young,CB,active,baltimore-ravens,8000000,2020
3966,4500000,2500000,Brandon Carr,CB,active,baltimore-ravens,7000000,2020
3967,4500000,2333333,Nick Boyle,TE,active,baltimore-ravens,6833333,2020
3968,3662059,1750000,Willie Snead,WR,active,baltimore-ravens,5412059,2020
3969,4000000,1333333,Mark Ingram,RB,active,baltimore-ravens,5333333,2020
3970,4000000,1250000,James Hurst,RT,active,baltimore-ravens,5250000,2020
3971,3500000,1600000,Justin Tucker,K,active,baltimore-ravens,5100000,2020
3972,1000000,3633333,Patrick Ricard,FB,active,baltimore-ravens,4633333,2020
3973,2080565,1689087,Marlon Humphrey,CB,active,baltimore-ravens,3769652,2020
3974,3250000,0,Sam Koch,P,active,baltimore-ravens,3250000,2020
3975,1750000,1500000,L.J. Fort,ILB,active,baltimore-ravens,3250000,2020
3976,1483275,1526550,Hayden Hurst,TE,active,baltimore-ravens,3009825,2020
3977,1030788,1648153,Marquise Brown,WR,active,baltimore-ravens,2678941,2020
3978,1341059,1242117,Lamar Jackson,QB,active,baltimore-ravens,2583176,2020
3979,2000000,500000,Robert Griffin III,QB,active,baltimore-ravens,2500000,2020
3980,1225310,548747,Tyus Bowser,OLB,active,baltimore-ravens,1774057,2020
3981,1100000,140000,Morgan Cox,LS,active,baltimore-ravens,1240000,2020
3982,834000,224663,Chris Wormley,DE,active,baltimore-ravens,1058663,2020
3983,719000,216430,Orlando Brown Jr.,RT,active,baltimore-ravens,935430,2020
3984,716000,209165,Mark Andrews,TE,active,baltimore-ravens,925165,2020
3985,658500,225827,Jaylon Ferguson,DE,active,baltimore-ravens,884327,2020
3986,650500,214232,Miles Boykin,WR,active,baltimore-ravens,864732,2020
3987,660000,165249,Anthony Averett,CB,active,baltimore-ravens,825249,2020
3988,660000,145095,Jaleel Scott,WR,active,baltimore-ravens,805095,2020
3989,735000,43704,Chuck Clark,S,active,baltimore-ravens,778704,2020
3990,585000,185414,Justice Hill,RB,active,baltimore-ravens,770414,2020
3991,585000,174383,Ben Powers,G,active,baltimore-ravens,759383,2020
3992,585000,168299,Iman Marshall,CB,active,baltimore-ravens,753299,2020
3993,660000,39448,Deshon Elliott,S,active,baltimore-ravens,699448,2020
3994,660000,29602,Bradley Bozeman,G,active,baltimore-ravens,689602,2020
3995,660000,1334,Chris Board,ILB,active,baltimore-ravens,661334,2020
3996,660000,0,Will Holden,T,active,baltimore-ravens,660000,2020
3997,660000,0,Ufomba Kamalu,DE,active,baltimore-ravens,660000,2020
3998,585000,74820,Daylon Mack,DT,active,baltimore-ravens,659820,2020
3999,585000,40172,Trace McSorley,QB,active,baltimore-ravens,625172,2020
4000,585000,3333,Otaro Alaka,ILB,active,baltimore-ravens,588333,2020
4001,585000,2666,Patrick Mekari,G,active,baltimore-ravens,587666,2020
4002,510000,0,Aaron Adeoye,DE,active,baltimore-ravens,510000,2020
4003,510000,0,Terrell Bonds,CB,active,baltimore-ravens,510000,2020
4004,510000,0,Sean Modster,WR,active,baltimore-ravens,510000,2020
4005,510000,0,Mike Onuoha,OLB,active,baltimore-ravens,510000,2020
4006,510000,0,R.J. Prince,G,active,baltimore-ravens,510000,2020
4007,510000,0,Charles Scarff,TE,active,baltimore-ravens,510000,2020
4008,510000,0,Antoine Wesley,WR,active,baltimore-ravens,510000,2020
4009,0,500000,Justin Bethel,CB,dead_cap,baltimore-ravens,500000,2020
4010,0,319952,Kenny Young,ILB,dead_cap,baltimore-ravens,319952,2020
4011,0,214170,Tim Williams,OLB,dead_cap,baltimore-ravens,214170,2020
4012,0,134340,Jordan Lasley,WR,dead_cap,baltimore-ravens,134340,2020
4013,0,59204,Greg Senat,T,dead_cap,baltimore-ravens,59204,2020
4014,0,40341,Zach Sieler,DE,dead_cap,baltimore-ravens,40341,2020
4015,0,8000,Mike Onuoha,OLB,dead_cap,baltimore-ravens,8000,2020
4016,0,6667,Antoine Wesley,WR,dead_cap,baltimore-ravens,6667,2020
4017,0,6667,Gerald Willis,DT,dead_cap,baltimore-ravens,6667,2020
4018,0,4000,Markus Jones,OLB,dead_cap,baltimore-ravens,4000,2020
4019,0,3334,E.J. Ejiya,ILB,dead_cap,baltimore-ravens,3334,2020
4020,0,3334,Silas Stewart,OLB,dead_cap,baltimore-ravens,3334,2020
4021,0,3000,Charles Scarff,TE,dead_cap,baltimore-ravens,3000,2020
4022,0,2667,Cole Herdman,TE,dead_cap,baltimore-ravens,2667,2020
4023,0,2000,Marcus Applefield,T,dead_cap,baltimore-ravens,2000,2020
4024,0,1334,Matthew Orzech,LS,dead_cap,baltimore-ravens,1334,2020
4025,0,1334,Kaare Vedvik,K,dead_cap,baltimore-ravens,1334,2020
4026,0,334,Sean Modster,WR,dead_cap,baltimore-ravens,334,2020
4027,750000,8025000,Aaron Schobel,DE,active,buffalo-bills,8775000,2007
4028,1000000,1350000,Derrick Dockery,G,active,buffalo-bills,2350000,2007
4029,1000000,5100000,Chris Kelsay,DE,active,buffalo-bills,6100000,2007
4030,2500000,1875000,Terrence McGee,CB,active,buffalo-bills,4375000,2007
4031,285000,2994875,Marshawn Lynch,RB,active,buffalo-bills,3279875,2007
4032,750000,2510000,Rian Lindell,K,active,buffalo-bills,3260000,2007
4033,1800000,2464000,J.P. Losman,QB,active,buffalo-bills,4264000,2007
4034,1500000,1850000,Jason Peters,LT,active,buffalo-bills,3350000,2007
4035,360000,3637200,Donte Whitner,SS,active,buffalo-bills,3997200,2007
4036,773750,2215000,Lee Evans,WR,active,buffalo-bills,2988750,2007
4037,360000,1905000,John McCargo,DT,active,buffalo-bills,2265000,2007
4038,750000,576428,Brian Moorman,P,active,buffalo-bills,1326428,2007
4039,435000,550000,Roscoe Parrish,WR,active,buffalo-bills,985000,2007
4040,925000,0,Michael Gaines,TE,active,buffalo-bills,925000,2007
4041,510000,390000,Jabari Greer,CB,active,buffalo-bills,900000,2007
4042,850000,0,Anthony Hargrove,DE,active,buffalo-bills,850000,2007
4043,675000,150000,Mario Haggan,LB,active,buffalo-bills,825000,2007
4044,285000,482000,Paul Posluszny,OLB,active,buffalo-bills,767000,2007
4045,595250,0,Bryan Scott,OLB,active,buffalo-bills,595250,2007
4046,595250,0,Bryan Scott,OLB,active,buffalo-bills,595250,2007
4047,360000,196250,Ashton Youboty,CB,active,buffalo-bills,556250,2007
4048,435000,103750,Duke Preston,G,active,buffalo-bills,538750,2007
4049,360000,116250,Ko Simpson,S,active,buffalo-bills,476250,2007
4050,285000,157750,Trent Edwards,QB,active,buffalo-bills,442750,2007
4051,435000,0,Kirk Chambers,G,active,buffalo-bills,435000,2007
4052,360000,48250,Kyle Williams,DT,active,buffalo-bills,408250,2007
4053,360000,43750,Brad Butler,T,active,buffalo-bills,403750,2007
4054,285000,115250,Dwayne Wright,RB,active,buffalo-bills,400250,2007
4055,360000,26750,Keith Ellison,LB,active,buffalo-bills,386750,2007
4056,360000,8800,Aaron Merz,G,active,buffalo-bills,368800,2007
4057,360000,3333,John DiGiorgio,LB,active,buffalo-bills,363333,2007
4058,285000,24687,John Wendling,S,active,buffalo-bills,309687,2007
4059,285000,0,Fred Jackson,RB,active,buffalo-bills,285000,2007
4060,184411,0,Justin Jenkins,WR,active,buffalo-bills,184411,2007
4061,160312,0,Derek Schouman,TE,active,buffalo-bills,160312,2007
4062,117352,0,Christian Gaddis,C,active,buffalo-bills,117352,2007
4063,650000,850000,Coy Wire,LS,injured_reserve,buffalo-bills,1500000,2007
4064,435000,150000,Kevin Everett,TE,injured_reserve,buffalo-bills,585000,2007
4065,720000,40000,Jason Whittle,G,injured_reserve,buffalo-bills,760000,2007
4066,220000,0,George Wilson,S,injured_reserve,buffalo-bills,220000,2007
4067,79900,0,Jon Corto,S,practice_squad,buffalo-bills,79900,2007
4068,79900,0,Dustin Fox,CB,practice_squad,buffalo-bills,79900,2007
4069,79900,0,Christian Gaddis,C,practice_squad,buffalo-bills,79900,2007
4070,79900,0,Gibran Hamdan,QB,practice_squad,buffalo-bills,79900,2007
4071,79900,0,Felton Huggins,WR,practice_squad,buffalo-bills,79900,2007
4072,79900,0,Justin Jenkins,WR,practice_squad,buffalo-bills,79900,2007
4073,0,1000000,Kelly Holcomb,QB,dead_cap,buffalo-bills,1000000,2007
4074,887500,0,Willis McGahee,RB,dead_cap,buffalo-bills,887500,2007
4075,300000,0,Tim Anderson,DT,dead_cap,buffalo-bills,300000,2007
4076,80662,0,Eric King,CB,dead_cap,buffalo-bills,80662,2007
4077,62500,0,Mike Schneck,LS,dead_cap,buffalo-bills,62500,2007
4078,21333,0,Justin Geisinger,G,dead_cap,buffalo-bills,21333,2007
4079,14225,0,Terrance Pennington,T,dead_cap,buffalo-bills,14225,2007
4080,13762,0,Derek Schouman,TE,dead_cap,buffalo-bills,13762,2007
4081,11333,0,Lionel Gates,RB,dead_cap,buffalo-bills,11333,2007
4082,10837,0,C.J. Ah You,DE,dead_cap,buffalo-bills,10837,2007
4083,3333,0,Jim Leonhard,S,dead_cap,buffalo-bills,3333,2007
4084,1666,0,Christian Gaddis,C,dead_cap,buffalo-bills,1666,2007
4085,9500001,2207241,Lee Evans,WR,active,buffalo-bills,11707242,2008
4086,1500000,1350000,Derrick Dockery,G,active,buffalo-bills,2850000,2008
4087,3000000,0,Marcus Stroud,DT,active,buffalo-bills,3000000,2008
4088,1400000,3600000,Chris Kelsay,DE,active,buffalo-bills,5000000,2008
4089,3250000,1950000,Jason Peters,LT,active,buffalo-bills,5200000,2008
4090,520000,550000,Roscoe Parrish,WR,active,buffalo-bills,1070000,2008
4091,2750000,1375000,Terrence McGee,CB,active,buffalo-bills,4125000,2008
4092,1000000,2500000,Spencer Johnson,DT,active,buffalo-bills,3500000,2008
4093,1900000,2464000,J.P. Losman,QB,active,buffalo-bills,4364000,2008
4094,445000,3957950,Donte Whitner,SS,active,buffalo-bills,4402950,2008
4095,700000,1798250,Kyle Williams,DT,active,buffalo-bills,2498250,2008
4096,945000,1543750,Brad Butler,T,active,buffalo-bills,2488750,2008
4097,750000,1576428,Brian Moorman,P,active,buffalo-bills,2326428,2008
4098,375000,2301025,Marshawn Lynch,RB,active,buffalo-bills,2676025,2008
4099,1000000,560000,Rian Lindell,K,active,buffalo-bills,1560000,2008
4100,295000,1165834,Leodis McKelvin,CB,active,buffalo-bills,1460834,2008
4101,950000,65000,Jabari Greer,CB,active,buffalo-bills,1015000,2008
4102,500000,417000,Paul Posluszny,OLB,active,buffalo-bills,917000,2008
4103,650000,150000,Bryan Scott,OLB,active,buffalo-bills,800000,2008
4104,730017,40000,Jason Whittle,G,active,buffalo-bills,770017,2008
4105,370000,357750,Trent Edwards,QB,active,buffalo-bills,727750,2008
4106,445000,196250,Ashton Youboty,CB,active,buffalo-bills,641250,2008
4107,520000,103750,Duke Preston,G,active,buffalo-bills,623750,2008
4108,605000,0,Courtney Anderson,TE,active,buffalo-bills,605000,2008
4109,445000,116250,Ko Simpson,S,active,buffalo-bills,561250,2008
4110,520000,0,Kirk Chambers,G,active,buffalo-bills,520000,2008
4111,520000,0,Corey McIntyre,FB,active,buffalo-bills,520000,2008
4112,520000,0,George Wilson,S,active,buffalo-bills,520000,2008
4113,295000,200750,Chris Ellis,DE,active,buffalo-bills,495750,2008
4114,445000,26750,Keith Ellison,LB,active,buffalo-bills,471750,2008
4115,445000,3334,John DiGiorgio,LB,active,buffalo-bills,448334,2008
4116,445000,0,Jonathan Scott,LT,active,buffalo-bills,445000,2008
4117,435000,0,Gibran Hamdan,QB,active,buffalo-bills,435000,2008
4118,295000,116250,Reggie Corner,CB,active,buffalo-bills,411250,2008
4119,370000,24687,John Wendling,S,active,buffalo-bills,394687,2008
4120,295000,99500,Derek Fine,TE,active,buffalo-bills,394500,2008
4121,370000,0,Fred Jackson,RB,active,buffalo-bills,370000,2008
4122,370000,0,Justin Jenkins,WR,active,buffalo-bills,370000,2008
4123,370000,0,Derek Schouman,TE,active,buffalo-bills,370000,2008
4124,295000,45250,Alvin Bowen,LB,active,buffalo-bills,340250,2008
4125,295000,14125,Demetress Bell,RT,active,buffalo-bills,309125,2008
4126,295000,13507,Stevie Johnson,WR,active,buffalo-bills,308507,2008
4127,86764,0,Jonathan Stupar,TE,active,buffalo-bills,86764,2008
4128,1500000,6525000,Aaron Schobel,DE,injured_reserve,buffalo-bills,8025000,2008
4129,295000,1238000,James Hardy,WR,injured_reserve,buffalo-bills,1533000,2008
4130,465156,1955000,John McCargo,DT,injured_reserve,buffalo-bills,2420156,2008
4131,200000,0,Matt Baker,QB,injured_reserve,buffalo-bills,200000,2008
4132,88400,0,Chris Denman,T,practice_squad,buffalo-bills,88400,2008
4133,88400,0,Dustin Fox,CB,practice_squad,buffalo-bills,88400,2008
4134,88400,0,Bruce Hall,RB,practice_squad,buffalo-bills,88400,2008
4135,88400,0,Felton Huggins,WR,practice_squad,buffalo-bills,88400,2008
4136,88400,0,Marcus Smith,DE,practice_squad,buffalo-bills,88400,2008
4137,88400,0,Jonathan Stupar,TE,practice_squad,buffalo-bills,88400,2008
4138,0,4200000,Takeo Spikes,LB,dead_cap,buffalo-bills,4200000,2008
4139,295000,24812,Xavier Omon,RB,dead_cap,buffalo-bills,319812,2008
4140,150000,0,Kevin Everett,TE,dead_cap,buffalo-bills,150000,2008
4141,125000,0,Mike Schneck,LS,dead_cap,buffalo-bills,125000,2008
4142,115250,0,Dwayne Wright,RB,dead_cap,buffalo-bills,115250,2008
4143,100000,0,Coy Wire,LS,dead_cap,buffalo-bills,100000,2008
4144,41287,0,Derek Schouman,TE,dead_cap,buffalo-bills,41287,2008
4145,32511,0,C.J. Ah You,DE,dead_cap,buffalo-bills,32511,2008
4146,28450,0,Terrance Pennington,T,dead_cap,buffalo-bills,28450,2008
4147,8800,0,Aaron Merz,G,dead_cap,buffalo-bills,8800,2008
4148,8750,0,Kennard Cox,CB,dead_cap,buffalo-bills,8750,2008
4149,3334,0,Christian Gaddis,C,dead_cap,buffalo-bills,3334,2008
4150,3500000,4525000,Aaron Schobel,DE,active,buffalo-bills,8025000,2009
4151,2250000,4000000,Terrell Owens,WR,active,buffalo-bills,6250000,2009
4152,4600000,2065000,Lee Evans,WR,active,buffalo-bills,6665000,2009
4153,3000000,2600000,Chris Kelsay,DE,active,buffalo-bills,5600000,2009
4154,3400000,525000,Marcus Stroud,DT,active,buffalo-bills,3925000,2009
4155,2355000,4137200,Donte Whitner,SS,active,buffalo-bills,6492200,2009
4156,1500000,1425000,Drayton Florence,CB,active,buffalo-bills,2925000,2009
4157,1245000,1548250,Kyle Williams,DT,active,buffalo-bills,2793250,2009
4158,1900000,750000,Geoff Hangartner,G,active,buffalo-bills,2650000,2009
4159,1000000,1750000,Spencer Johnson,DT,active,buffalo-bills,2750000,2009
4160,1000000,220000,Roscoe Parrish,WR,active,buffalo-bills,1220000,2009
4161,1820000,390000,Ryan Fitzpatrick,QB,active,buffalo-bills,2210000,2009
4162,518823,2301025,Marshawn Lynch,RB,active,buffalo-bills,2819848,2009
4163,1450000,400000,Aaron Maybin,OLB,active,buffalo-bills,1850000,2009
4164,835000,1955000,John McCargo,DT,active,buffalo-bills,2790000,2009
4165,1175000,676428,Brian Moorman,P,active,buffalo-bills,1851428,2009
4166,385000,1165834,Leodis McKelvin,CB,active,buffalo-bills,1550834,2009
4167,500000,975000,Fred Jackson,RB,active,buffalo-bills,1475000,2009
4168,1090000,310000,Rian Lindell,K,active,buffalo-bills,1400000,2009
4169,310000,925000,Eric Wood,C,active,buffalo-bills,1235000,2009
4170,800000,300000,Bryan Scott,OLB,active,buffalo-bills,1100000,2009
4171,600000,417000,Paul Posluszny,OLB,active,buffalo-bills,1017000,2009
4172,1010000,0,George Wilson,S,active,buffalo-bills,1010000,2009
4173,310000,455000,Jairus Byrd,FS,active,buffalo-bills,765000,2009
4174,385000,351000,James Hardy,WR,active,buffalo-bills,736000,2009
4175,635000,100000,Corey McIntyre,FB,active,buffalo-bills,735000,2009
4176,535000,196250,Ashton Youboty,CB,active,buffalo-bills,731250,2009
4177,310000,350000,Andy Levitre,G,active,buffalo-bills,660000,2009
4178,620000,0,Kirk Chambers,G,active,buffalo-bills,620000,2009
4179,620000,0,Gibran Hamdan,QB,active,buffalo-bills,620000,2009
4180,385000,200750,Chris Ellis,DE,active,buffalo-bills,585750,2009
4181,535000,0,Justin Jenkins,WR,active,buffalo-bills,535000,2009
4182,385000,116250,Reggie Corner,CB,active,buffalo-bills,501250,2009
4183,460000,24687,John Wendling,S,active,buffalo-bills,484687,2009
4184,385000,99500,Derek Fine,TE,active,buffalo-bills,484500,2009
4185,468125,0,Joe Klopfenstein,TE,active,buffalo-bills,468125,2009
4186,460000,0,Jonathan Scott,LT,active,buffalo-bills,460000,2009
4187,310000,115000,Shawn Nelson,TE,active,buffalo-bills,425000,2009
4188,385000,13507,Stevie Johnson,WR,active,buffalo-bills,398507,2009
4189,310000,47750,Nic Harris,LB,active,buffalo-bills,357750,2009
4190,339705,0,Jonathan Stupar,TE,active,buffalo-bills,339705,2009
4191,310000,14781,Ellis Lankster,CB,active,buffalo-bills,324781,2009
4192,310000,0,Garrison Sanborn,LS,active,buffalo-bills,310000,2009
4193,310000,0,Marcus Smith,DE,active,buffalo-bills,310000,2009
4194,273529,0,Jamon Meredith,RT,active,buffalo-bills,273529,2009
4195,245000,0,Marvin Philip,C,active,buffalo-bills,245000,2009
4196,1010000,0,Richie Incognito,G,active,buffalo-bills,1010000,2009
4197,158529,0,Brian Brohm,QB,active,buffalo-bills,158529,2009
4198,135882,0,Christian Gaddis,C,active,buffalo-bills,135882,2009
4199,127647,0,Cary Harris,CB,active,buffalo-bills,127647,2009
4200,57500,0,Derek Schouman,TE,active,buffalo-bills,57500,2009
4201,3000000,1600000,Terrence McGee,CB,injured_reserve,buffalo-bills,4600000,2009
4202,1000000,1043750,Brad Butler,T,injured_reserve,buffalo-bills,2043750,2009
4203,1010000,0,Keith Ellison,LB,injured_reserve,buffalo-bills,1010000,2009
4204,460000,357750,Trent Edwards,QB,injured_reserve,buffalo-bills,817750,2009
4205,620000,50000,Seth McKinney,G,injured_reserve,buffalo-bills,670000,2009
4206,348529,14125,Demetress Bell,RT,injured_reserve,buffalo-bills,362654,2009
4207,310000,0,Kendall Simmons,G,injured_reserve,buffalo-bills,310000,2009
4208,88400,0,Christian Gaddis,C,practice_squad,buffalo-bills,88400,2009
4209,88400,0,Bruce Hall,RB,practice_squad,buffalo-bills,88400,2009
4210,88400,0,Cary Harris,CB,practice_squad,buffalo-bills,88400,2009
4211,88400,0,Felton Huggins,WR,practice_squad,buffalo-bills,88400,2009
4212,88400,0,Jonathan Stupar,TE,practice_squad,buffalo-bills,88400,2009
4213,5400000,0,Derrick Dockery,G,dead_cap,buffalo-bills,5400000,2009
4214,0,3600000,Jason Peters,LT,dead_cap,buffalo-bills,3600000,2009
4215,216562,24812,Xavier Omon,RB,dead_cap,buffalo-bills,241374,2009
4216,230500,0,Dwayne Wright,RB,dead_cap,buffalo-bills,230500,2009
4217,0,200000,Dominic Rhodes,RB,dead_cap,buffalo-bills,200000,2009
4218,116250,0,Ko Simpson,S,dead_cap,buffalo-bills,116250,2009
4219,26700,0,Cary Harris,CB,dead_cap,buffalo-bills,26700,2009
4220,26250,0,Kennard Cox,CB,dead_cap,buffalo-bills,26250,2009
4221,4500000,5666666,Lee Evans,WR,active,buffalo-bills,10166666,2010
4222,4080000,2500000,Chris Kelsay,DE,active,buffalo-bills,6580000,2010
4223,4200000,525000,Marcus Stroud,DT,active,buffalo-bills,4725000,2010
4224,3345000,3637200,Donte Whitner,SS,active,buffalo-bills,6982200,2010
4225,2300000,3700000,Terrence McGee,CB,active,buffalo-bills,6000000,2010
4226,4000000,425000,Drayton Florence,CB,active,buffalo-bills,4425000,2010
4227,2250000,1250000,Spencer Johnson,DT,active,buffalo-bills,3500000,2010
4228,2350000,750000,Geoff Hangartner,G,active,buffalo-bills,3100000,2010
4229,2365000,390000,Ryan Fitzpatrick,QB,active,buffalo-bills,2755000,2010
4230,395000,2857500,Eric Wood,C,active,buffalo-bills,3252500,2010
4231,1750000,500000,Kyle Williams,DT,active,buffalo-bills,2250000,2010
4232,395000,3235000,Aaron Maybin,OLB,active,buffalo-bills,3630000,2010
4233,320000,1803333,C.J. Spiller,RB,active,buffalo-bills,2123333,2010
4234,1000000,1000000,Andra Davis,LB,active,buffalo-bills,2000000,2010
4235,696250,1165834,Leodis McKelvin,CB,active,buffalo-bills,1862084,2010
4236,1195000,575000,Fred Jackson,RB,active,buffalo-bills,1770000,2010
4237,1759000,0,George Wilson,S,active,buffalo-bills,1759000,2010
4238,1225000,450000,Brian Moorman,P,active,buffalo-bills,1675000,2010
4239,1360000,310000,Rian Lindell,K,active,buffalo-bills,1670000,2010
4240,685000,1905000,John McCargo,DT,active,buffalo-bills,2590000,2010
4241,1025000,220000,Roscoe Parrish,WR,active,buffalo-bills,1245000,2010
4242,900000,500000,Bryan Scott,OLB,active,buffalo-bills,1400000,2010
4243,1176000,0,Ashton Youboty,CB,active,buffalo-bills,1176000,2010
4244,1000000,100000,Dwan Edwards,DT,active,buffalo-bills,1100000,2010
4245,665000,417000,Paul Posluszny,OLB,active,buffalo-bills,1082000,2010
4246,630000,410500,Corey McIntyre,FB,active,buffalo-bills,1040500,2010
4247,850000,115000,Erik Pears,RT,active,buffalo-bills,965000,2010
4248,395000,455000,Jairus Byrd,FS,active,buffalo-bills,850000,2010
4249,810000,0,David Martin,TE,active,buffalo-bills,810000,2010
4250,320000,451250,Torell Troup,DT,active,buffalo-bills,771250,2010
4251,395000,350000,Andy Levitre,G,active,buffalo-bills,745000,2010
4252,630000,0,Pierre Woods,LB,active,buffalo-bills,630000,2010
4253,470000,116250,Reggie Corner,CB,active,buffalo-bills,586250,2010
4254,320000,216000,Alex Carrington,DT,active,buffalo-bills,536000,2010
4255,470000,14125,Demetress Bell,RT,active,buffalo-bills,484125,2010
4256,470000,13507,Stevie Johnson,WR,active,buffalo-bills,483507,2010
4257,470000,0,Brian Brohm,QB,active,buffalo-bills,470000,2010
4258,470000,0,Jonathan Stupar,TE,active,buffalo-bills,470000,2010
4259,320000,129875,Marcus Easley,WR,active,buffalo-bills,449875,2010
4260,395000,47750,Nic Harris,LB,active,buffalo-bills,442750,2010
4261,421000,0,Derek Schouman,TE,active,buffalo-bills,421000,2010
4262,302058,115000,Shawn Nelson,TE,active,buffalo-bills,417058,2010
4263,405000,0,Kraig Urbik,G,active,buffalo-bills,405000,2010
4264,390000,0,Garrison Sanborn,LS,active,buffalo-bills,390000,2010
4265,320000,49625,Ed Wang,LT,active,buffalo-bills,369625,2010
4266,320000,28000,Arthur Moats,OLB,active,buffalo-bills,348000,2010
4267,320000,25417,Dan Batten,DE,active,buffalo-bills,345417,2010
4268,320000,4000,David Nelson,WR,active,buffalo-bills,324000,2010
4269,320000,3334,Kellen Heard,DE,active,buffalo-bills,323334,2010
4270,320000,3334,Donald Jones,WR,active,buffalo-bills,323334,2010
4271,263529,0,Levi Brown,QB,active,buffalo-bills,263529,2010
4272,162647,0,Cary Harris,CB,active,buffalo-bills,162647,2010
4273,148125,0,Cary Harris,CB,active,buffalo-bills,148125,2010
4274,110588,0,Chad Rinehart,G,active,buffalo-bills,110588,2010
4275,69705,0,Paul Hubbard,WR,active,buffalo-bills,69705,2010
4276,56470,0,Colin Brown,G,active,buffalo-bills,56470,2010
4277,3269200,500010,Shawne Merriman,LB,injured_reserve,buffalo-bills,3769210,2010
4278,950000,350000,Reggie Torbor,LB,injured_reserve,buffalo-bills,1300000,2010
4279,1176000,0,Keith Ellison,LB,injured_reserve,buffalo-bills,1176000,2010
4280,320000,3333,Antonio Coleman,DE,injured_reserve,buffalo-bills,323333,2010
4281,320000,2834,Cordaro Howard,G,injured_reserve,buffalo-bills,322834,2010
4282,320000,0,Felton Huggins,WR,injured_reserve,buffalo-bills,320000,2010
4283,88400,0,Jehuu Caulcrick,RB,practice_squad,buffalo-bills,88400,2010
4284,88400,0,Paul Hubbard,WR,practice_squad,buffalo-bills,88400,2010
4285,88400,0,Chad Rinehart,G,practice_squad,buffalo-bills,88400,2010
4286,88400,0,John Russell,LB,practice_squad,buffalo-bills,88400,2010
4287,6025000,0,Aaron Schobel,DE,dead_cap,buffalo-bills,6025000,2010
4288,2629412,0,Cornell Green,T,dead_cap,buffalo-bills,2629412,2010
4289,501025,1800000,Marshawn Lynch,RB,dead_cap,buffalo-bills,2301025,2010
4290,448926,0,Trent Edwards,QB,dead_cap,buffalo-bills,448926,2010
4291,351000,0,James Hardy,WR,dead_cap,buffalo-bills,351000,2010
4292,199000,0,Derek Fine,TE,dead_cap,buffalo-bills,199000,2010
4293,80100,0,Cary Harris,CB,dead_cap,buffalo-bills,80100,2010
4294,75294,0,Joe Klopfenstein,TE,dead_cap,buffalo-bills,75294,2010
4295,24812,0,Xavier Omon,RB,dead_cap,buffalo-bills,24812,2010
4296,24687,0,John Wendling,S,dead_cap,buffalo-bills,24687,2010
4297,0,17250,Levi Brown,QB,dead_cap,buffalo-bills,17250,2010
4298,0,15562,Kyle Calloway,T,dead_cap,buffalo-bills,15562,2010
4299,14781,0,Ellis Lankster,CB,dead_cap,buffalo-bills,14781,2010
4300,0,2000,Joique Bell,RB,dead_cap,buffalo-bills,2000,2010
4301,3220000,2390000,Ryan Fitzpatrick,QB,active,buffalo-bills,5610000,2011
4302,3200000,3700000,Terrence McGee,CB,active,buffalo-bills,6900000,2011
4303,2000000,2500000,Chris Kelsay,DE,active,buffalo-bills,4500000,2011
4304,2750000,1500010,Shawne Merriman,LB,active,buffalo-bills,4250010,2011
4305,3000000,1166667,Drayton Florence,CB,active,buffalo-bills,4166667,2011
4306,3000000,1250000,Spencer Johnson,DT,active,buffalo-bills,4250000,2011
4307,3000000,950000,Kyle Williams,DT,active,buffalo-bills,3950000,2011
4308,2600000,1300000,Dwan Edwards,DT,active,buffalo-bills,3900000,2011
4309,375000,3335418,Marcell Dareus,DT,active,buffalo-bills,3710418,2011
4310,2000000,1500000,Nick Barnett,ILB,active,buffalo-bills,3500000,2011
4311,2000000,1500000,Brad Smith,WR,active,buffalo-bills,3500000,2011
4312,405000,4252499,C.J. Spiller,RB,active,buffalo-bills,4657499,2011
4313,2000000,500000,Tyler Thigpen,QB,active,buffalo-bills,2500000,2011
4314,1800000,600000,Andra Davis,LB,active,buffalo-bills,2400000,2011
4315,1750000,425000,Fred Jackson,RB,active,buffalo-bills,2175000,2011
4316,1007500,1165834,Leodis McKelvin,CB,active,buffalo-bills,2173334,2011
4317,1025000,220000,Roscoe Parrish,WR,active,buffalo-bills,1245000,2011
4318,1025000,691666,George Wilson,S,active,buffalo-bills,1716666,2011
4319,1450000,250000,Rian Lindell,K,active,buffalo-bills,1700000,2011
4320,1425000,250000,Brian Moorman,P,active,buffalo-bills,1675000,2011
4321,600000,1722500,Eric Wood,C,active,buffalo-bills,2322500,2011
4322,1150000,450000,Bryan Scott,OLB,active,buffalo-bills,1600000,2011
4323,500000,900000,Erik Pears,RT,active,buffalo-bills,1400000,2011
4324,1200000,116250,Reggie Corner,CB,active,buffalo-bills,1316250,2011
4325,1300000,14125,Demetress Bell,RT,active,buffalo-bills,1314125,2011
4326,1200000,13507,Stevie Johnson,WR,active,buffalo-bills,1213507,2011
4327,1200000,0,Scott Chandler,TE,active,buffalo-bills,1200000,2011
4328,1100000,0,Kirk Morrison,LB,active,buffalo-bills,1100000,2011
4329,950000,150000,Corey McIntyre,FB,active,buffalo-bills,1100000,2011
4330,480000,455000,Jairus Byrd,FS,active,buffalo-bills,935000,2011
4331,320687,581209,Aaron Williams,SS,active,buffalo-bills,901896,2011
4332,450000,451250,Torell Troup,DT,active,buffalo-bills,901250,2011
4333,480000,350000,Andy Levitre,G,active,buffalo-bills,830000,2011
4334,405000,216000,Alex Carrington,DT,active,buffalo-bills,621000,2011
4335,480000,115000,Shawn Nelson,TE,active,buffalo-bills,595000,2011
4336,375000,202708,Kelvin Sheppard,ILB,active,buffalo-bills,577708,2011
4337,555000,0,Tashard Choice,RB,active,buffalo-bills,555000,2011
4338,555000,0,Lionel Dotson,DE,active,buffalo-bills,555000,2011
4339,555000,0,Chad Rinehart,G,active,buffalo-bills,555000,2011
4340,540000,0,Sam Young,LT,active,buffalo-bills,540000,2011
4341,405000,129875,Marcus Easley,WR,active,buffalo-bills,534875,2011
4342,375000,121106,Da'Norris Searcy,SS,active,buffalo-bills,496106,2011
4343,480000,0,Garrison Sanborn,LS,active,buffalo-bills,480000,2011
4344,480000,0,Kraig Urbik,G,active,buffalo-bills,480000,2011
4345,375000,103977,Chris Hairston,LT,active,buffalo-bills,478977,2011
4346,450000,3334,Kellen Heard,DE,active,buffalo-bills,453334,2011
4347,450000,0,Kyle Moore,DE,active,buffalo-bills,450000,2011
4348,405000,28000,Arthur Moats,OLB,active,buffalo-bills,433000,2011
4349,405000,25417,Dan Batten,DE,active,buffalo-bills,430417,2011
4350,375000,53400,Johnny White,RB,active,buffalo-bills,428400,2011
4351,405000,4000,David Nelson,WR,active,buffalo-bills,409000,2011
4352,405000,3334,Donald Jones,WR,active,buffalo-bills,408334,2011
4353,405000,2834,Cordaro Howard,G,active,buffalo-bills,407834,2011
4354,375000,30150,Chris White,ILB,active,buffalo-bills,405150,2011
4355,405000,0,Mike Caussin,TE,active,buffalo-bills,405000,2011
4356,405000,0,Fendi Onobun,TE,active,buffalo-bills,405000,2011
4357,405000,0,Naaman Roosevelt,WR,active,buffalo-bills,405000,2011
4358,375000,16875,Justin Rogers,CB,active,buffalo-bills,391875,2011
4359,375000,0,Kamar Aiken,WR,active,buffalo-bills,375000,2011
4360,375000,0,Kevin Brock,TE,active,buffalo-bills,375000,2011
4361,375000,0,Bruce Hall,RB,active,buffalo-bills,375000,2011
4362,375000,0,Michael Jasper,G,active,buffalo-bills,375000,2011
4363,950000,300000,Reggie Torbor,LB,injured_reserve,buffalo-bills,1250000,2011
4364,1002050,3600000,Marshawn Lynch,RB,dead_cap,buffalo-bills,4602050,2011
4365,2291666,0,Marcus Stroud,DT,dead_cap,buffalo-bills,2291666,2011
4366,0,3235000,Aaron Maybin,OLB,dead_cap,buffalo-bills,3235000,2011
4367,1668600,0,Donte Whitner,SS,dead_cap,buffalo-bills,1668600,2011
4368,0,2566666,Lee Evans,WR,dead_cap,buffalo-bills,2566666,2011
4369,351000,0,James Hardy,WR,dead_cap,buffalo-bills,351000,2011
4370,0,51750,Levi Brown,QB,dead_cap,buffalo-bills,51750,2011
4371,0,49625,Ed Wang,LT,dead_cap,buffalo-bills,49625,2011
4372,0,46686,Kyle Calloway,T,dead_cap,buffalo-bills,46686,2011
4373,29562,0,Ellis Lankster,CB,dead_cap,buffalo-bills,29562,2011
4374,0,28500,Michael Jasper,G,dead_cap,buffalo-bills,28500,2011
4375,24812,0,Xavier Omon,RB,dead_cap,buffalo-bills,24812,2011
4376,0,4000,Joique Bell,RB,dead_cap,buffalo-bills,4000,2011
4377,3333,0,Antonio Coleman,DE,dead_cap,buffalo-bills,3333,2011
4378,1583,0,Danny Aiken,LS,dead_cap,buffalo-bills,1583,2011
4379,5900000,3900000,Mario Williams,DE,active,buffalo-bills,9800000,2012
4380,2800000,4200000,Ryan Fitzpatrick,QB,active,buffalo-bills,7000000,2012
4381,3000000,2950000,Kyle Williams,DT,active,buffalo-bills,5950000,2012
4382,1302605,3335418,Marcell Dareus,DT,active,buffalo-bills,4638023,2012
4383,2500000,1800000,Stevie Johnson,WR,active,buffalo-bills,4300000,2012
4384,3000000,1000000,Nick Barnett,ILB,active,buffalo-bills,4000000,2012
4385,3000000,1250000,Spencer Johnson,DT,active,buffalo-bills,4250000,2012
4386,2250000,1500000,Brad Smith,WR,active,buffalo-bills,3750000,2012
4387,2205000,1475000,Fred Jackson,RB,active,buffalo-bills,3680000,2012
4388,1900000,1600000,Mark Anderson,DE,active,buffalo-bills,3500000,2012
4389,852917,4252499,C.J. Spiller,RB,active,buffalo-bills,5105416,2012
4390,1518750,1165834,Leodis McKelvin,CB,active,buffalo-bills,2684584,2012
4391,1725000,941666,George Wilson,S,active,buffalo-bills,2666666,2012
4392,1600000,900000,Erik Pears,RT,active,buffalo-bills,2500000,2012
4393,1800000,675000,Scott Chandler,TE,active,buffalo-bills,2475000,2012
4394,390000,1807120,Stephon Gilmore,CB,active,buffalo-bills,2197120,2012
4395,1260000,700000,Kraig Urbik,G,active,buffalo-bills,1960000,2012
4396,1750000,200000,Tarvaris Jackson,QB,active,buffalo-bills,1950000,2012
4397,1000000,900000,Rian Lindell,K,active,buffalo-bills,1900000,2012
4398,800000,1722500,Eric Wood,C,active,buffalo-bills,2522500,2012
4399,1000000,500000,Tyler Thigpen,QB,active,buffalo-bills,1500000,2012
4400,614052,581029,Aaron Williams,SS,active,buffalo-bills,1195081,2012
4401,771875,300000,Kirk Morrison,LB,active,buffalo-bills,1071875,2012
4402,615000,455000,Jairus Byrd,FS,active,buffalo-bills,1070000,2012
4403,900000,150000,Corey McIntyre,FB,active,buffalo-bills,1050000,2012
4404,830000,176667,Garrison Sanborn,LS,active,buffalo-bills,1006667,2012
4405,540000,451250,Torell Troup,DT,active,buffalo-bills,991250,2012
4406,615000,350000,Andy Levitre,G,active,buffalo-bills,965000,2012
4407,700000,0,Shawne Merriman,LB,active,buffalo-bills,700000,2012
4408,390000,494578,Cordy Glenn,LT,active,buffalo-bills,884578,2012
4409,540000,216000,Alex Carrington,DT,active,buffalo-bills,756000,2012
4410,700000,0,Lionel Dotson,DE,active,buffalo-bills,700000,2012
4411,480000,202708,Kelvin Sheppard,ILB,active,buffalo-bills,682708,2012
4412,615000,0,Kyle Moore,DE,active,buffalo-bills,615000,2012
4413,465000,121106,Da'Norris Searcy,SS,active,buffalo-bills,586106,2012
4414,540000,30000,Colin Brown,G,active,buffalo-bills,570000,2012
4415,465000,103977,Chris Hairston,LT,active,buffalo-bills,568977,2012
4416,540000,28000,Arthur Moats,OLB,active,buffalo-bills,568000,2012
4417,390000,167813,T.J. Graham,WR,active,buffalo-bills,557813,2012
4418,825000,0,Bryan Scott,OLB,active,buffalo-bills,825000,2012
4419,700000,0,Tashard Choice,RB,active,buffalo-bills,700000,2012
4420,700000,0,Ruvell Martin,WR,active,buffalo-bills,700000,2012
4421,540000,0,Sam Young,LT,active,buffalo-bills,540000,2012
4422,390000,114356,Nigel Bradham,OLB,active,buffalo-bills,504356,2012
4423,465000,30150,Chris White,ILB,active,buffalo-bills,495150,2012
4424,390000,100135,Ron Brooks,CB,active,buffalo-bills,490135,2012
4425,465000,16875,Justin Rogers,CB,active,buffalo-bills,481875,2012
4426,479467,0,Lee Smith,TE,active,buffalo-bills,479467,2012
4427,465000,0,Crezdon Butler,CB,active,buffalo-bills,465000,2012
4428,465000,0,Dorin Dickerson,TE,active,buffalo-bills,465000,2012
4429,465000,0,T.J. Heath,CB,active,buffalo-bills,465000,2012
4430,390000,11474,John Potter,K,active,buffalo-bills,401474,2012
4431,390000,1000,Delano Howell,S,active,buffalo-bills,391000,2012
4432,390000,1000,Shawn Powell,P,active,buffalo-bills,391000,2012
4433,390000,0,Marcus Easley,WR,active,buffalo-bills,390000,2012
4434,390000,0,Kevin Elliott,WR,active,buffalo-bills,390000,2012
4435,390000,0,Chris Hogan,WR,active,buffalo-bills,390000,2012
4436,390000,0,Jay Ross,DT,active,buffalo-bills,390000,2012
4437,390000,0,David Snow,G,active,buffalo-bills,390000,2012
4438,390000,0,Keith Williams,G,active,buffalo-bills,390000,2012
4439,540000,0,Thomas Welch,RT,active,buffalo-bills,540000,2012
4440,247324,0,Mana Silva,S,active,buffalo-bills,247324,2012
4441,67500,0,Chris Scott,G,active,buffalo-bills,67500,2012
4442,2843750,2250000,Chris Kelsay,DE,injured_reserve,buffalo-bills,5093750,2012
4443,1350000,3937500,Terrence McGee,CB,injured_reserve,buffalo-bills,5287500,2012
4444,630000,0,Chad Rinehart,G,injured_reserve,buffalo-bills,630000,2012
4445,490000,4000,David Nelson,WR,injured_reserve,buffalo-bills,494000,2012
4446,273000,49625,Zebrie Sanders,RT,injured_reserve,buffalo-bills,322625,2012
4447,0,9305000,Aaron Maybin,OLB,dead_cap,buffalo-bills,9305000,2012
4448,2383334,5133332,Lee Evans,WR,dead_cap,buffalo-bills,7516666,2012
4449,3391668,0,Marcus Stroud,DT,dead_cap,buffalo-bills,3391668,2012
4450,1750000,0,Shawne Merriman,LB,dead_cap,buffalo-bills,1750000,2012
4451,1675000,0,Brian Moorman,P,dead_cap,buffalo-bills,1675000,2012
4452,250000,1333334,Drayton Florence,CB,dead_cap,buffalo-bills,1583334,2012
4453,750000,0,Geoff Hangartner,G,dead_cap,buffalo-bills,750000,2012
4454,0,350000,Vince Young,QB,dead_cap,buffalo-bills,350000,2012
4455,275000,0,Dwan Edwards,DT,dead_cap,buffalo-bills,275000,2012
4456,230412,0,Delano Howell,S,dead_cap,buffalo-bills,230412,2012
4457,217945,0,John Potter,K,dead_cap,buffalo-bills,217945,2012
4458,193000,0,Tank Carder,ILB,dead_cap,buffalo-bills,193000,2012
4459,141177,0,Jay Ross,DT,dead_cap,buffalo-bills,141177,2012
4460,0,129875,Marcus Easley,WR,dead_cap,buffalo-bills,129875,2012
4461,115250,0,Shawn Nelson,TE,dead_cap,buffalo-bills,115250,2012
4462,100000,0,Mansfield Wrotto,G,dead_cap,buffalo-bills,100000,2012
4463,0,99250,Ed Wang,LT,dead_cap,buffalo-bills,99250,2012
4464,0,85500,Michael Jasper,G,dead_cap,buffalo-bills,85500,2012
4465,65000,0,Derek Hagan,WR,dead_cap,buffalo-bills,65000,2012
4466,63529,0,Reggie Wells,G,dead_cap,buffalo-bills,63529,2012
4467,0,53400,Johnny White,RB,dead_cap,buffalo-bills,53400,2012
4468,51441,0,David Snow,G,dead_cap,buffalo-bills,51441,2012
4469,39900,0,Reggie Stephens,C,dead_cap,buffalo-bills,39900,2012
4470,28363,0,Mark Asper,LT,dead_cap,buffalo-bills,28363,2012
4471,0,25417,Dan Batten,DE,dead_cap,buffalo-bills,25417,2012
4472,25000,0,Jon Corto,S,dead_cap,buffalo-bills,25000,2012
4473,24800,0,Kamar Aiken,WR,dead_cap,buffalo-bills,24800,2012
4474,22800,0,Lamark Brown,TE,dead_cap,buffalo-bills,22800,2012
4475,8266,0,Isaiah Green,S,dead_cap,buffalo-bills,8266,2012
4476,5334,0,Zack Pianalto,TE,dead_cap,buffalo-bills,5334,2012
4477,3334,0,Kellen Heard,DE,dead_cap,buffalo-bills,3334,2012
4478,3333,0,Antonio Coleman,DE,dead_cap,buffalo-bills,3333,2012
4479,3000,0,Aaron Corp,QB,dead_cap,buffalo-bills,3000,2012
4480,3000,0,Chris Douglas,RB,dead_cap,buffalo-bills,3000,2012
4481,3000,0,Cris Hill,CB,dead_cap,buffalo-bills,3000,2012
4482,3000,0,Paul Madsen,G,dead_cap,buffalo-bills,3000,2012
4483,3000,0,Vai Taua,RB,dead_cap,buffalo-bills,3000,2012
4484,3000,0,Ian Wild,SS,dead_cap,buffalo-bills,3000,2012
4485,3000,0,Garrick Williams,LB,dead_cap,buffalo-bills,3000,2012
4486,2834,0,Cordaro Howard,G,dead_cap,buffalo-bills,2834,2012
4487,2000,0,Jarron Gilbert,DE,dead_cap,buffalo-bills,2000,2012
4488,2000,0,T.J. Heath,CB,dead_cap,buffalo-bills,2000,2012
4489,2000,0,Johsua Nesbitt,CB,dead_cap,buffalo-bills,2000,2012
4490,1000,0,Nick Sukay,CB,dead_cap,buffalo-bills,1000,2012
4491,833,0,Vernon Kearney,CB,dead_cap,buffalo-bills,833,2012
4492,6500000,7500000,Mario Williams,DE,active,buffalo-bills,14000000,2013
4493,6916000,0,Jairus Byrd,FS,active,buffalo-bills,6916000,2013
4494,3855000,1950000,Kyle Williams,DT,active,buffalo-bills,5805000,2013
4495,2550000,4225000,Stevie Johnson,WR,active,buffalo-bills,6775000,2013
4496,2230210,3335418,Marcell Dareus,DT,active,buffalo-bills,5565628,2013
4497,2200000,3497500,Eric Wood,C,active,buffalo-bills,5697500,2013
4498,1500000,2275000,Alan Branch,DT,active,buffalo-bills,3775000,2013
4499,1300834,4252499,C.J. Spiller,RB,active,buffalo-bills,5553333,2013
4500,2150000,1550000,Fred Jackson,RB,active,buffalo-bills,3700000,2013
4501,2000000,1050000,Leodis McKelvin,CB,active,buffalo-bills,3050000,2013
4502,2050000,925000,Scott Chandler,TE,active,buffalo-bills,2975000,2013
4503,2050000,800000,Kraig Urbik,G,active,buffalo-bills,2850000,2013
4504,2100000,700000,Erik Pears,RT,active,buffalo-bills,2800000,2013
4505,939280,1807120,Stephon Gilmore,CB,active,buffalo-bills,2746400,2013
4506,1600000,800000,Manny Lawson,OLB,active,buffalo-bills,2400000,2013
4507,405000,1210509,E.J. Manuel,QB,active,buffalo-bills,1615509,2013
4508,853105,581029,Aaron Williams,SS,active,buffalo-bills,1434134,2013
4509,1323000,28000,Arthur Moats,OLB,active,buffalo-bills,1351000,2013
4510,561145,544578,Cordy Glenn,LT,active,buffalo-bills,1105723,2013
4511,885000,176667,Garrison Sanborn,LS,active,buffalo-bills,1061667,2013
4512,800000,100000,Doug Legursky,C,active,buffalo-bills,900000,2013
4513,405000,479868,Robert Woods,WR,active,buffalo-bills,884868,2013
4514,870000,0,Jerry Hughes,DE,active,buffalo-bills,870000,2013
4515,630000,216000,Alex Carrington,DT,active,buffalo-bills,846000,2013
4516,405000,376891,Kiko Alonso,OLB,active,buffalo-bills,781891,2013
4517,480000,197813,T.J. Graham,WR,active,buffalo-bills,677813,2013
4518,555000,121106,Da'Norris Searcy,SS,active,buffalo-bills,676106,2013
4519,630000,0,Thomas Welch,RT,active,buffalo-bills,630000,2013
4520,480000,114356,Nigel Bradham,OLB,active,buffalo-bills,594356,2013
4521,583934,0,Lee Smith,TE,active,buffalo-bills,583934,2013
4522,480000,100135,Ron Brooks,CB,active,buffalo-bills,580135,2013
4523,840000,0,Jim Leonhard,S,active,buffalo-bills,840000,2013
4524,715000,0,Dan Carpenter,K,active,buffalo-bills,715000,2013
4525,405000,149719,Marquise Goodwin,WR,active,buffalo-bills,554719,2013
4526,405000,117563,Duke Williams,FS,active,buffalo-bills,522563,2013
4527,480000,0,Marcus Easley,WR,active,buffalo-bills,480000,2013
4528,480000,0,Dominique Jones,TE,active,buffalo-bills,480000,2013
4529,480000,0,Frank Summers,FB,active,buffalo-bills,480000,2013
4530,405000,49500,Jonathan Meeks,FS,active,buffalo-bills,454500,2013
4531,405000,14793,Chris Gragg,TE,active,buffalo-bills,419793,2013
4532,405000,2333,Nickell Robey-Coleman,CB,active,buffalo-bills,407333,2013
4533,405000,1666,Jeff Tuel,QB,active,buffalo-bills,406666,2013
4534,405000,0,Corbin Bryant,DT,active,buffalo-bills,405000,2013
4535,405000,0,Chris Hogan,WR,active,buffalo-bills,405000,2013
4536,940000,0,Brian Moorman,P,active,buffalo-bills,940000,2013
4537,391764,0,Thaddeus Lewis,QB,active,buffalo-bills,391764,2013
4538,322412,28000,Dustin Hopkins,K,active,buffalo-bills,350412,2013
4539,480000,0,Mark Asper,LT,active,buffalo-bills,480000,2013
4540,405000,0,Ty Powell,ILB,active,buffalo-bills,405000,2013
4541,285882,0,Antoine McClain,G,active,buffalo-bills,285882,2013
4542,405000,0,Ronnie Wingo,RB,active,buffalo-bills,405000,2013
4543,480000,0,Evan Rodriguez,FB,active,buffalo-bills,480000,2013
4544,405000,0,Stefan Charles,DT,active,buffalo-bills,405000,2013
4545,650000,0,Tony Moeaki,TE,active,buffalo-bills,650000,2013
4546,405000,0,Joe Unga,G,active,buffalo-bills,405000,2013
4547,405000,0,Cordell Roberson,WR,active,buffalo-bills,405000,2013
4548,1650000,850000,Kevin Kolb,QB,injured_reserve,buffalo-bills,2500000,2013
4549,630000,0,Mike Caussin,TE,injured_reserve,buffalo-bills,630000,2013
4550,303000,0,Kevin Elliott,WR,injured_reserve,buffalo-bills,303000,2013
4551,277500,103977,Chris Hairston,LT,non_fb_injury,buffalo-bills,381477,2013
4552,42000,0,Adewale Ojomo,DE,practice_squad,buffalo-bills,42000,2013
4553,36000,0,Jamie Blatnick,DE,practice_squad,buffalo-bills,36000,2013
4554,36000,0,Bryant Browning,LT,practice_squad,buffalo-bills,36000,2013
4555,18000,0,Izaan Cross,DE,practice_squad,buffalo-bills,18000,2013
4556,6000,0,Manase Foketi,G,practice_squad,buffalo-bills,6000,2013
4557,0,4000000,Ryan Fitzpatrick,QB,dead_cap,buffalo-bills,4000000,2013
4558,2250000,0,Terrence McGee,CB,dead_cap,buffalo-bills,2250000,2013
4559,1882353,0,Brad Smith,WR,dead_cap,buffalo-bills,1882353,2013
4560,1600000,0,Mark Anderson,DE,dead_cap,buffalo-bills,1600000,2013
4561,1165832,0,Leodis McKelvin,CB,dead_cap,buffalo-bills,1165832,2013
4562,887500,0,Rian Lindell,K,dead_cap,buffalo-bills,887500,2013
4563,800000,0,Chris Kelsay,DE,dead_cap,buffalo-bills,800000,2013
4564,672500,0,Colin Brown,G,dead_cap,buffalo-bills,672500,2013
4565,666667,0,George Wilson,S,dead_cap,buffalo-bills,666667,2013
4566,555000,0,Jamaal Westerman,LB,dead_cap,buffalo-bills,555000,2013
4567,522059,0,Tashard Choice,RB,dead_cap,buffalo-bills,522059,2013
4568,0,500000,Tarvaris Jackson,QB,dead_cap,buffalo-bills,500000,2013
4569,500000,0,Nick Barnett,ILB,dead_cap,buffalo-bills,500000,2013
4570,451250,0,Torell Troup,DT,dead_cap,buffalo-bills,451250,2013
4571,375993,0,Justin Rogers,CB,dead_cap,buffalo-bills,375993,2013
4572,345416,0,Kelvin Sheppard,ILB,dead_cap,buffalo-bills,345416,2013
4573,261177,0,Brandon Burton,CB,dead_cap,buffalo-bills,261177,2013
4574,250000,0,Kirk Morrison,LB,dead_cap,buffalo-bills,250000,2013
4575,185295,0,Sam Young,LT,dead_cap,buffalo-bills,185295,2013
4576,144600,0,Tank Carder,ILB,dead_cap,buffalo-bills,144600,2013
4577,143177,0,Shawn Powell,P,dead_cap,buffalo-bills,143177,2013
4578,141175,0,Marcus Dowtin,OLB,dead_cap,buffalo-bills,141175,2013
4579,137296,0,Johnny  Adams,CB,dead_cap,buffalo-bills,137296,2013
4580,0,129875,Marcus Easley,WR,dead_cap,buffalo-bills,129875,2013
4581,126176,0,Matt Flynn,QB,dead_cap,buffalo-bills,126176,2013
4582,121089,0,Mark Asper,LT,dead_cap,buffalo-bills,121089,2013
4583,0,106800,Johnny White,RB,dead_cap,buffalo-bills,106800,2013
4584,52500,0,Tommy Streeter,WR,dead_cap,buffalo-bills,52500,2013
4585,49625,0,Zebrie Sanders,RT,dead_cap,buffalo-bills,49625,2013
4586,48000,0,Cordell Roberson,WR,dead_cap,buffalo-bills,48000,2013
4587,42000,0,Ronnie Wingo,RB,dead_cap,buffalo-bills,42000,2013
4588,34422,0,John Potter,K,dead_cap,buffalo-bills,34422,2013
4589,30150,0,Chris White,ILB,dead_cap,buffalo-bills,30150,2013
4590,30000,0,Jacob Lacey,CB,dead_cap,buffalo-bills,30000,2013
4591,30000,0,Thaddeus Lewis,QB,dead_cap,buffalo-bills,30000,2013
4592,28235,0,Jay Ross,DT,dead_cap,buffalo-bills,28235,2013
4593,0,25417,Dan Batten,DE,dead_cap,buffalo-bills,25417,2013
4594,24000,0,Brandon Smith,CB,dead_cap,buffalo-bills,24000,2013
4595,3333,0,Da'Rick Rogers,WR,dead_cap,buffalo-bills,3333,2013
4596,2666,0,Keith Pough,OLB,dead_cap,buffalo-bills,2666,2013
4597,2000,0,Nick Sukay,CB,dead_cap,buffalo-bills,2000,2013
4598,1833,0,Zack Chibane,G,dead_cap,buffalo-bills,1833,2013
4599,1833,0,Jumal Rolle,CB,dead_cap,buffalo-bills,1833,2013
4600,1667,0,Vernon Kearney,CB,dead_cap,buffalo-bills,1667,2013
4601,1666,0,Ryan Turnley,C,dead_cap,buffalo-bills,1666,2013
4602,1333,0,Kendall Gaskins,FB,dead_cap,buffalo-bills,1333,2013
4603,1166,0,Jordan Dangerfield,FS,dead_cap,buffalo-bills,1166,2013
4604,1000,0,Kip Edwards,CB,dead_cap,buffalo-bills,1000,2013
4605,1000,0,Drew Smith,RB,dead_cap,buffalo-bills,1000,2013
4606,1000,0,Aaron Tipoti,DE,dead_cap,buffalo-bills,1000,2013
4607,833,0,Brandon Kaufman,WR,dead_cap,buffalo-bills,833,2013
4608,333,0,Kevin Norrell,WR,dead_cap,buffalo-bills,333,2013
4609,166,0,Izaan Cross,DE,dead_cap,buffalo-bills,166,2013
4610,1900000,18500000,Mario Williams,DE,active,buffalo-bills,20400000,2014
4611,3157814,3335418,Marcell Dareus,DT,active,buffalo-bills,6493232,2014
4612,4650000,1600000,Kyle Williams,DT,active,buffalo-bills,6250000,2014
4613,4000000,1950000,Eric Wood,C,active,buffalo-bills,5950000,2014
4614,3498750,4252499,C.J. Spiller,RB,active,buffalo-bills,7751249,2014
4615,2100000,2475000,Leodis McKelvin,CB,active,buffalo-bills,4575000,2014
4616,2250000,1981029,Aaron Williams,SS,active,buffalo-bills,4231029,2014
4617,2500000,1500000,Kyle Orton,QB,active,buffalo-bills,4000000,2014
4618,3995000,0,Jerry Hughes,DE,active,buffalo-bills,3995000,2014
4619,2450000,1400000,Fred Jackson,RB,active,buffalo-bills,3850000,2014
4620,420000,3204655,Sammy Watkins,WR,active,buffalo-bills,3624655,2014
4621,2750000,700000,Erik Pears,RT,active,buffalo-bills,3450000,2014
4622,2275000,1100000,Kraig Urbik,G,active,buffalo-bills,3375000,2014
4623,1488559,1807120,Stephon Gilmore,CB,active,buffalo-bills,3295679,2014
4624,1250000,2000000,Brandon Spikes,ILB,active,buffalo-bills,3250000,2014
4625,1800000,1300000,Manny Lawson,OLB,active,buffalo-bills,3100000,2014
4626,1500000,1050000,Corey Graham,FS,active,buffalo-bills,2550000,2014
4627,808877,1210509,E.J. Manuel,QB,active,buffalo-bills,2019386,2014
4628,1250000,650000,Scott Chandler,TE,active,buffalo-bills,1900000,2014
4629,1250000,600000,Keith Rivers,OLB,active,buffalo-bills,1850000,2014
4630,1250000,562500,Dan Carpenter,K,active,buffalo-bills,1812500,2014
4631,1431000,121106,Da'Norris Searcy,SS,active,buffalo-bills,1552106,2014
4632,782289,544578,Cordy Glenn,LT,active,buffalo-bills,1326867,2014
4633,895000,339167,Garrison Sanborn,LS,active,buffalo-bills,1234167,2014
4634,576217,529868,Robert Woods,WR,active,buffalo-bills,1106085,2014
4635,800000,216666,Anthony Dixon,RB,active,buffalo-bills,1016666,2014
4636,420000,454331,Cyrus Kouandjio,RT,active,buffalo-bills,874331,2014
4637,645000,103977,Chris Hairston,LT,active,buffalo-bills,748977,2014
4638,730000,0,Marcus Easley,WR,active,buffalo-bills,730000,2014
4639,688401,0,Lee Smith,TE,active,buffalo-bills,688401,2014
4640,495000,179719,Marquise Goodwin,WR,active,buffalo-bills,674719,2014
4641,570000,100135,Ron Brooks,CB,active,buffalo-bills,670135,2014
4642,536471,114356,Nigel Bradham,OLB,active,buffalo-bills,650827,2014
4643,730000,65000,Jarius Wynn,OLB,active,buffalo-bills,795000,2014
4644,495000,117563,Duke Williams,FS,active,buffalo-bills,612563,2014
4645,420000,162000,Preston Brown,ILB,active,buffalo-bills,582000,2014
4646,730000,0,Stevenson Sylvester,ILB,active,buffalo-bills,730000,2014
4647,570000,0,Bryce Brown,RB,active,buffalo-bills,570000,2014
4648,645000,0,Larry Dean,OLB,active,buffalo-bills,645000,2014
4649,420000,116888,Ross Cockrell,CB,active,buffalo-bills,536888,2014
4650,495000,14793,Chris Gragg,TE,active,buffalo-bills,509793,2014
4651,495000,2333,Nickell Robey-Coleman,CB,active,buffalo-bills,497333,2014
4652,495000,0,Corbin Bryant,DT,active,buffalo-bills,495000,2014
4653,495000,0,Stefan Charles,DT,active,buffalo-bills,495000,2014
4654,495000,0,Chris Hogan,WR,active,buffalo-bills,495000,2014
4655,495000,0,Ty Powell,ILB,active,buffalo-bills,495000,2014
4656,420000,48000,Cyril Richardson,G,active,buffalo-bills,468000,2014
4657,420000,15933,Randell Johnson,OLB,active,buffalo-bills,435933,2014
4658,420000,12720,Seantrel Henderson,RT,active,buffalo-bills,432720,2014
4659,420000,0,Jordan Gay,K,active,buffalo-bills,420000,2014
4660,420000,0,Colton Schmidt,P,active,buffalo-bills,420000,2014
4661,338824,49500,Jonathan Meeks,FS,active,buffalo-bills,388324,2014
4662,420000,0,Kenny Ladler,SS,active,buffalo-bills,420000,2014
4663,495000,0,Bacarri Rambo,SS,active,buffalo-bills,495000,2014
4664,495000,0,MarQueis Gray,TE,active,buffalo-bills,495000,2014
4665,570000,0,Marcus Thigpen,WR,active,buffalo-bills,570000,2014
4666,570000,0,Deonte Thompson,WR,active,buffalo-bills,570000,2014
4667,1425000,975000,Chris Williams,G,injured_reserve,buffalo-bills,2400000,2014
4668,318000,0,Mario Butler,CB,injured_reserve,buffalo-bills,318000,2014
4669,550473,426891,Kiko Alonso,OLB,non_fb_injury,buffalo-bills,977364,2014
4670,107100,0,Deon Broomfield,S,practice_squad,buffalo-bills,107100,2014
4671,107100,0,Jimmy Gaines,ILB,practice_squad,buffalo-bills,107100,2014
4672,107100,0,Caleb Holley,WR,practice_squad,buffalo-bills,107100,2014
4673,107100,0,Ikponmwosa Igbinosun,DE,practice_squad,buffalo-bills,107100,2014
4674,107100,0,D.J. Morrell,G,practice_squad,buffalo-bills,107100,2014
4675,107100,0,Jeff Tuel,QB,practice_squad,buffalo-bills,107100,2014
4676,75600,0,William Campbell,G,practice_squad,buffalo-bills,75600,2014
4677,75600,0,Jeremy Towns,DT,practice_squad,buffalo-bills,75600,2014
4678,50400,0,Rod Sweeting,CB,practice_squad,buffalo-bills,50400,2014
4679,37800,0,Brandon Smith,CB,practice_squad,buffalo-bills,37800,2014
4680,31500,0,Bryan Johnson,DE,practice_squad,buffalo-bills,31500,2014
4681,18900,0,Tobais Palmer,WR,practice_squad,buffalo-bills,18900,2014
4682,10225000,0,Stevie Johnson,WR,dead_cap,buffalo-bills,10225000,2014
4683,0,10000000,Ryan Fitzpatrick,QB,dead_cap,buffalo-bills,10000000,2014
4684,3000000,0,Mark Anderson,DE,dead_cap,buffalo-bills,3000000,2014
4685,1600000,200000,Mike Williams,WR,dead_cap,buffalo-bills,1800000,2014
4686,1375000,0,Rian Lindell,K,dead_cap,buffalo-bills,1375000,2014
4687,0,875000,Alan Branch,DT,dead_cap,buffalo-bills,875000,2014
4688,502941,0,Frank Summers,FB,dead_cap,buffalo-bills,502941,2014
4689,500000,0,Kevin Kolb,QB,dead_cap,buffalo-bills,500000,2014
4690,500000,0,Brad Smith,WR,dead_cap,buffalo-bills,500000,2014
4691,0,197813,T.J. Graham,WR,dead_cap,buffalo-bills,197813,2014
4692,189706,0,Phillip Tanner,RB,dead_cap,buffalo-bills,189706,2014
4693,0,150000,Doug Legursky,C,dead_cap,buffalo-bills,150000,2014
4694,137117,666,Bryan Johnson,DE,dead_cap,buffalo-bills,137783,2014
4695,0,100000,Tony Moeaki,TE,dead_cap,buffalo-bills,100000,2014
4696,99250,0,Zebrie Sanders,RT,dead_cap,buffalo-bills,99250,2014
4697,44100,0,Travis Harvey,WR,dead_cap,buffalo-bills,44100,2014
4698,31500,2500,Kenny Ladler,SS,dead_cap,buffalo-bills,34000,2014
4699,31500,0,Lonnie Pryor,RB,dead_cap,buffalo-bills,31500,2014
4700,31500,0,Naaman Roosevelt,WR,dead_cap,buffalo-bills,31500,2014
4701,30150,0,Chris White,ILB,dead_cap,buffalo-bills,30150,2014
4702,0,28000,Dustin Hopkins,K,dead_cap,buffalo-bills,28000,2014
4703,25200,0,D.J. Tialavea,TE,dead_cap,buffalo-bills,25200,2014
4704,24706,0,Jerome Couplin,FS,dead_cap,buffalo-bills,24706,2014
4705,24706,0,Jacquies Smith,OLB,dead_cap,buffalo-bills,24706,2014
4706,16875,0,Justin Rogers,CB,dead_cap,buffalo-bills,16875,2014
4707,12500,0,Colin Brown,G,dead_cap,buffalo-bills,12500,2014
4708,6667,0,Da'Rick Rogers,WR,dead_cap,buffalo-bills,6667,2014
4709,6300,0,Jamie Childers,TE,dead_cap,buffalo-bills,6300,2014
4710,6300,0,Eric Thomas,WR,dead_cap,buffalo-bills,6300,2014
4711,5334,0,Keith Pough,OLB,dead_cap,buffalo-bills,5334,2014
4712,3667,0,Zack Chibane,G,dead_cap,buffalo-bills,3667,2014
4713,3667,0,Jumal Rolle,CB,dead_cap,buffalo-bills,3667,2014
4714,3334,0,Ryan Turnley,C,dead_cap,buffalo-bills,3334,2014
4715,2667,0,Kendall Gaskins,FB,dead_cap,buffalo-bills,2667,2014
4716,0,2500,Damien Jacobs,DT,dead_cap,buffalo-bills,2500,2014
4717,2334,0,Jordan Dangerfield,FS,dead_cap,buffalo-bills,2334,2014
4718,0,2000,Darrin Kitchens,DE,dead_cap,buffalo-bills,2000,2014
4719,2000,0,Kip Edwards,CB,dead_cap,buffalo-bills,2000,2014
4720,2000,0,Drew Smith,RB,dead_cap,buffalo-bills,2000,2014
4721,2000,0,Aaron Tipoti,DE,dead_cap,buffalo-bills,2000,2014
4722,1667,0,Brandon Kaufman,WR,dead_cap,buffalo-bills,1667,2014
4723,0,1666,Deon Broomfield,S,dead_cap,buffalo-bills,1666,2014
4724,0,1666,Jimmy Gaines,ILB,dead_cap,buffalo-bills,1666,2014
4725,0,1666,Jeff Tuel,QB,dead_cap,buffalo-bills,1666,2014
4726,667,0,Kevin Norrell,WR,dead_cap,buffalo-bills,667,2014
4727,0,666,Darius Robinson,CB,dead_cap,buffalo-bills,666,2014
4728,0,666,Colby Way,DT,dead_cap,buffalo-bills,666,2014
4729,334,0,Izaan Cross,DE,dead_cap,buffalo-bills,334,2014
4730,0,333,Derek Brim,CB,dead_cap,buffalo-bills,333,2014
4731,12100000,8900000,Mario Williams,DE,active,buffalo-bills,21000000,2015
4732,2823530,5000000,Marcell Dareus,DT,active,buffalo-bills,7823530,2015
4733,4700000,1950000,Eric Wood,C,active,buffalo-bills,6650000,2015
4734,4625000,1550000,Jerry Hughes,DE,active,buffalo-bills,6175000,2015
4735,2625000,2875000,LeSean McCoy,RB,active,buffalo-bills,5500000,2015
4736,3100000,1800000,Leodis McKelvin,CB,active,buffalo-bills,4900000,2015
4737,1326164,3204655,Sammy Watkins,WR,active,buffalo-bills,4530819,2015
4738,2750000,1700000,Corey Graham,FS,active,buffalo-bills,4450000,2015
4739,1800000,1300000,Manny Lawson,OLB,active,buffalo-bills,3100000,2015
4740,1212755,1210509,E.J. Manuel,QB,active,buffalo-bills,2423264,2015
4741,1300000,1062500,Dan Carpenter,K,active,buffalo-bills,2362500,2015
4742,1075000,1125000,Kraig Urbik,G,active,buffalo-bills,2200000,2015
4743,1000000,750000,Jerome Felton,FB,active,buffalo-bills,1750000,2015
4744,1542000,114356,Nigel Bradham,OLB,active,buffalo-bills,1656356,2015
4745,1003434,544578,Cordy Glenn,LT,active,buffalo-bills,1548012,2015
4746,850000,416666,Anthony Dixon,RB,active,buffalo-bills,1266666,2015
4747,900000,200000,Richie Incognito,G,active,buffalo-bills,1100000,2015
4748,588583,504331,Cyrus Kouandjio,RT,active,buffalo-bills,1092914,2015
4749,950000,125000,Jarius Wynn,OLB,active,buffalo-bills,1075000,2015
4750,910000,137500,Garrison Sanborn,LS,active,buffalo-bills,1047500,2015
4751,585000,435667,Nickell Robey-Coleman,CB,active,buffalo-bills,1020667,2015
4752,750000,133333,Tyrod Taylor,QB,active,buffalo-bills,883333,2015
4753,435000,395853,Ronald Darby,CB,active,buffalo-bills,830853,2015
4754,585000,117563,Duke Williams,FS,active,buffalo-bills,702563,2015
4755,510000,192000,Preston Brown,ILB,active,buffalo-bills,702000,2015
4756,435000,170030,John Miller,G,active,buffalo-bills,605030,2015
4757,585000,14793,Chris Gragg,TE,active,buffalo-bills,599793,2015
4758,585000,0,Corbin Bryant,DT,active,buffalo-bills,585000,2015
4759,585000,0,Mario Butler,CB,active,buffalo-bills,585000,2015
4760,585000,0,Stefan Charles,DT,active,buffalo-bills,585000,2015
4761,585000,0,Chris Hogan,WR,active,buffalo-bills,585000,2015
4762,585000,0,Bacarri Rambo,SS,active,buffalo-bills,585000,2015
4763,510000,0,Colton Schmidt,P,active,buffalo-bills,510000,2015
4764,435000,53838,Karlos Williams,RB,active,buffalo-bills,488838,2015
4765,450000,0,Jonathan Meeks,FS,active,buffalo-bills,450000,2015
4766,427058,0,Jordan Mills,RT,active,buffalo-bills,427058,2015
4767,525882,0,Josh Johnson,QB,active,buffalo-bills,525882,2015
4768,403764,0,MarQueis Gray,TE,active,buffalo-bills,403764,2015
4769,390000,0,IK Enemkpali,OLB,active,buffalo-bills,390000,2015
4770,330000,0,Jordan Gay,K,active,buffalo-bills,330000,2015
4771,180000,0,Ryan Groy,G,active,buffalo-bills,180000,2015
4772,172058,0,Lavar Edwards,DE,active,buffalo-bills,172058,2015
4773,172058,0,Mike Gillislee,RB,active,buffalo-bills,172058,2015
4774,172058,0,Kevin Reddick,ILB,active,buffalo-bills,172058,2015
4775,150000,0,T.J. Barnes,DT,active,buffalo-bills,150000,2015
4776,102352,0,Nick O'Leary,TE,active,buffalo-bills,102352,2015
4777,102352,0,A.J. Tarpley,ILB,active,buffalo-bills,102352,2015
4778,87647,0,Greg Salas,WR,active,buffalo-bills,87647,2015
4779,76764,0,Max Valles,DE,active,buffalo-bills,76764,2015
4780,68823,0,Jerel Worthy,DT,active,buffalo-bills,68823,2015
4781,60000,0,Walter Powell,WR,active,buffalo-bills,60000,2015
4782,51176,0,Dezmin Lewis,WR,active,buffalo-bills,51176,2015
4783,43823,0,Leonard Hankerson,WR,active,buffalo-bills,43823,2015
4784,30000,0,Sammy Seamster,CB,active,buffalo-bills,30000,2015
4785,25588,0,Merrill Noel,CB,active,buffalo-bills,25588,2015
4786,4500000,2450000,Kyle Williams,DT,injured_reserve,buffalo-bills,6950000,2015
4787,3000000,2000000,Charles Clay,TE,injured_reserve,buffalo-bills,5000000,2015
4788,2900000,1100000,Percy Harvin,WR,injured_reserve,buffalo-bills,4000000,2015
4789,1375000,3650000,Aaron Williams,SS,injured_reserve,buffalo-bills,5025000,2015
4790,2037839,1807120,Stephon Gilmore,CB,injured_reserve,buffalo-bills,3844959,2015
4791,825000,525000,Marcus Easley,WR,injured_reserve,buffalo-bills,1350000,2015
4792,797434,529868,Robert Woods,WR,injured_reserve,buffalo-bills,1327302,2015
4793,660000,100135,Ron Brooks,CB,injured_reserve,buffalo-bills,760135,2015
4794,745000,80000,Alex Carrington,DT,injured_reserve,buffalo-bills,825000,2015
4795,431647,179719,Marquise Goodwin,WR,injured_reserve,buffalo-bills,611366,2015
4796,585000,0,Ty Powell,ILB,injured_reserve,buffalo-bills,585000,2015
4797,489176,15933,Randell Johnson,OLB,injured_reserve,buffalo-bills,505109,2015
4798,407470,30957,Tony Steward,OLB,injured_reserve,buffalo-bills,438427,2015
4799,318000,2500,Tyson Chandler,RT,injured_reserve,buffalo-bills,320500,2015
4800,295058,0,Cierre Wood,RB,injured_reserve,buffalo-bills,295058,2015
4801,510000,12720,Seantrel Henderson,RT,non_fb_injury,buffalo-bills,522720,2015
4802,0,4002500,C.J. Spiller,RB,dead_cap,buffalo-bills,4002500,2015
4803,0,1550000,Alan Branch,DT,dead_cap,buffalo-bills,1550000,2015
4804,0,1500000,Kyle Orton,QB,dead_cap,buffalo-bills,1500000,2015
4805,0,1475000,Chris Williams,G,dead_cap,buffalo-bills,1475000,2015
4806,235294,600000,Matt Cassel,QB,dead_cap,buffalo-bills,835294,2015
4807,0,753782,Kiko Alonso,OLB,dead_cap,buffalo-bills,753782,2015
4808,0,600000,Scott Chandler,TE,dead_cap,buffalo-bills,600000,2015
4809,745000,0,Matthew Mulligan,TE,dead_cap,buffalo-bills,745000,2015
4810,0,500000,Keith Rivers,OLB,dead_cap,buffalo-bills,500000,2015
4811,313658,2500,A.J. Tarpley,ILB,dead_cap,buffalo-bills,316158,2015
4812,310588,0,Marcus Thigpen,WR,dead_cap,buffalo-bills,310588,2015
4813,307058,0,Gabe Ikard,C,dead_cap,buffalo-bills,307058,2015
4814,271764,0,Dan Herron,RB,dead_cap,buffalo-bills,271764,2015
4815,271764,0,Denarius Moore,WR,dead_cap,buffalo-bills,271764,2015
4816,0,167813,T.J. Graham,WR,dead_cap,buffalo-bills,167813,2015
4817,112200,48000,Cyril Richardson,G,dead_cap,buffalo-bills,160200,2015
4818,118800,4000,Cedric Reed,DE,dead_cap,buffalo-bills,122800,2015
4819,120000,0,Jordan Gay,K,dead_cap,buffalo-bills,120000,2015
4820,0,116888,Ross Cockrell,CB,dead_cap,buffalo-bills,116888,2015
4821,85800,29922,Nick O'Leary,TE,dead_cap,buffalo-bills,115722,2015
4822,99000,16632,Dezmin Lewis,WR,dead_cap,buffalo-bills,115632,2015
4823,105600,666,Merrill Noel,CB,dead_cap,buffalo-bills,106266,2015
4824,153529,0,Andre Fluellen,DT,dead_cap,buffalo-bills,153529,2015
4825,0,100000,Fred Jackson,RB,dead_cap,buffalo-bills,100000,2015
4826,0,80000,Red Bryant,DE,dead_cap,buffalo-bills,80000,2015
4827,79200,0,Walter Powell,WR,dead_cap,buffalo-bills,79200,2015
4828,72600,0,Kevin Reddick,ILB,dead_cap,buffalo-bills,72600,2015
4829,72600,0,Jaylen Watkins,S,dead_cap,buffalo-bills,72600,2015
4830,13200,49500,Jonathan Meeks,FS,dead_cap,buffalo-bills,62700,2015
4831,0,56000,Dustin Hopkins,K,dead_cap,buffalo-bills,56000,2015
4832,52800,0,Chris Martin,RT,dead_cap,buffalo-bills,52800,2015
4833,46200,0,Sammy Seamster,CB,dead_cap,buffalo-bills,46200,2015
4834,38824,0,Deonte Thompson,WR,dead_cap,buffalo-bills,38824,2015
4835,38823,0,Bryce Brown,RB,dead_cap,buffalo-bills,38823,2015
4836,38823,0,Josh Bush,SS,dead_cap,buffalo-bills,38823,2015
4837,51176,0,Billy Cundiff,K,dead_cap,buffalo-bills,51176,2015
4838,26400,0,Mike Gillislee,RB,dead_cap,buffalo-bills,26400,2015
4839,26400,0,Ronald Patrick,C,dead_cap,buffalo-bills,26400,2015
4840,26400,0,Dustin Vaughan,QB,dead_cap,buffalo-bills,26400,2015
4841,26400,0,Jerel Worthy,DT,dead_cap,buffalo-bills,26400,2015
4842,19800,0,Blake Annen,TE,dead_cap,buffalo-bills,19800,2015
4843,19800,0,Titus Davis,WR,dead_cap,buffalo-bills,19800,2015
4844,19800,0,Miguel Maysonet,RB,dead_cap,buffalo-bills,19800,2015
4845,19800,0,Cierre Wood,RB,dead_cap,buffalo-bills,19800,2015
4846,13200,0,Jonathan Dowling,FS,dead_cap,buffalo-bills,13200,2015
4847,13200,0,Zac Dysert,QB,dead_cap,buffalo-bills,13200,2015
4848,13200,0,Marcel Jensen,TE,dead_cap,buffalo-bills,13200,2015
4849,13200,0,Jacob Maxwell,TE,dead_cap,buffalo-bills,13200,2015
4850,6600,0,Manasseh Garner,RB,dead_cap,buffalo-bills,6600,2015
4851,6600,0,Andy Tanner,WR,dead_cap,buffalo-bills,6600,2015
4852,6600,0,Phillip Thomas,S,dead_cap,buffalo-bills,6600,2015
4853,0,5000,Damien Jacobs,DT,dead_cap,buffalo-bills,5000,2015
4854,0,5000,Kenny Ladler,SS,dead_cap,buffalo-bills,5000,2015
4855,0,4000,Darrin Kitchens,DE,dead_cap,buffalo-bills,4000,2015
4856,0,3666,B.J. Larsen,DE,dead_cap,buffalo-bills,3666,2015
4857,0,3334,Deon Broomfield,S,dead_cap,buffalo-bills,3334,2015
4858,0,3334,Jimmy Gaines,ILB,dead_cap,buffalo-bills,3334,2015
4859,0,3333,Andrew Hudson,DE,dead_cap,buffalo-bills,3333,2015
4860,0,2000,Andre Davis,WR,dead_cap,buffalo-bills,2000,2015
4861,0,1668,Jeff Tuel,QB,dead_cap,buffalo-bills,1668,2015
4862,0,1666,Spencer Roth,P,dead_cap,buffalo-bills,1666,2015
4863,0,1334,Bryan Johnson,DE,dead_cap,buffalo-bills,1334,2015
4864,0,1334,Darius Robinson,CB,dead_cap,buffalo-bills,1334,2015
4865,0,1334,Colby Way,DT,dead_cap,buffalo-bills,1334,2015
4866,0,1166,Erik Williams,DE,dead_cap,buffalo-bills,1166,2015
4867,0,1000,Clay Burton,TE,dead_cap,buffalo-bills,1000,2015
4868,0,667,Derek Brim,CB,dead_cap,buffalo-bills,667,2015
4869,0,666,Justin Hamilton,DT,dead_cap,buffalo-bills,666,2015
4870,6041176,8050000,Marcell Dareus,DT,active,buffalo-bills,14091176,2016
4871,11082000,0,Stephon Gilmore,CB,active,buffalo-bills,11082000,2016
4872,4800000,2875000,LeSean McCoy,RB,active,buffalo-bills,7675000,2016
4873,4525000,4550000,Jerry Hughes,DE,active,buffalo-bills,9075000,2016
4874,2600000,4319573,Tyrod Taylor,QB,active,buffalo-bills,6919573,2016
4875,4250000,2000000,Kyle Williams,DT,active,buffalo-bills,6250000,2016
4876,3000000,3200000,Cordy Glenn,LT,active,buffalo-bills,6200000,2016
4877,1500000,4500000,Charles Clay,TE,active,buffalo-bills,6000000,2016
4878,600000,4836983,Sammy Watkins,WR,active,buffalo-bills,5436983,2016
4879,3125000,1650000,Corey Graham,FS,active,buffalo-bills,4775000,2016
4880,2000000,1250000,Richie Incognito,G,active,buffalo-bills,3250000,2016
4881,1616632,1210509,E.J. Manuel,QB,active,buffalo-bills,2827141,2016
4882,1775000,812500,Dan Carpenter,K,active,buffalo-bills,2587500,2016
4883,450000,1418904,Shaq Lawson,DE,active,buffalo-bills,1868904,2016
4884,1671000,0,Jordan Mills,RT,active,buffalo-bills,1671000,2016
4885,1000000,658333,Nickell Robey-Coleman,CB,active,buffalo-bills,1658333,2016
4886,1018650,529868,Robert Woods,WR,active,buffalo-bills,1548518,2016
4887,1000000,500000,Reggie Bush,RB,active,buffalo-bills,1500000,2016
4888,807166,504331,Cyrus Kouandjio,RT,active,buffalo-bills,1311497,2016
4889,800000,450000,Zach Brown,ILB,active,buffalo-bills,1250000,2016
4890,920000,137500,Garrison Sanborn,LS,active,buffalo-bills,1057500,2016
4891,592713,445853,Ronald Darby,CB,active,buffalo-bills,1038566,2016
4892,800000,100000,Patrick Lewis,C,active,buffalo-bills,900000,2016
4893,675000,184719,Marquise Goodwin,WR,active,buffalo-bills,859719,2016
4894,832941,0,Jerome Felton,FB,active,buffalo-bills,832941,2016
4895,601750,192000,Preston Brown,ILB,active,buffalo-bills,793750,2016
4896,760000,0,Brandon Tate,WR,active,buffalo-bills,760000,2016
4897,525000,200030,John Miller,G,active,buffalo-bills,725030,2016
4898,760000,80000,Corey White,CB,active,buffalo-bills,840000,2016
4899,675000,0,Lerentee McCray,OLB,active,buffalo-bills,675000,2016
4900,450000,188574,Adolphus Washington,DT,active,buffalo-bills,638574,2016
4901,885000,0,Lorenzo Alexander,OLB,active,buffalo-bills,885000,2016
4902,885000,0,Leger Douzable,DT,active,buffalo-bills,885000,2016
4903,885000,0,Ramon Humber,OLB,active,buffalo-bills,885000,2016
4904,760000,0,Brandon Spikes,ILB,active,buffalo-bills,760000,2016
4905,600000,0,Mike Gillislee,RB,active,buffalo-bills,600000,2016
4906,600000,0,Ryan Groy,G,active,buffalo-bills,600000,2016
4907,600000,0,Jonathan Meeks,FS,active,buffalo-bills,600000,2016
4908,600000,0,Colton Schmidt,P,active,buffalo-bills,600000,2016
4909,600000,0,Jerel Worthy,DT,active,buffalo-bills,600000,2016
4910,555884,0,Justin Hunter,WR,active,buffalo-bills,555884,2016
4911,450000,95848,Cardale Jones,QB,active,buffalo-bills,545848,2016
4912,525000,0,Nick O'Leary,TE,active,buffalo-bills,525000,2016
4913,450000,60228,Jonathan Williams,RB,active,buffalo-bills,510228,2016
4914,450000,25089,Kevon Seymour,CB,active,buffalo-bills,475089,2016
4915,402352,0,Sergio Brown,FS,active,buffalo-bills,402352,2016
4916,200000,37500,Logan Thomas,TE,active,buffalo-bills,237500,2016
4917,176470,0,DeAndre Coleman,DT,active,buffalo-bills,176470,2016
4918,154411,0,Dezmin Lewis,WR,active,buffalo-bills,154411,2016
4919,145327,0,Marcus Roberson,CB,active,buffalo-bills,145327,2016
4920,132350,0,Gerald Christian,TE,active,buffalo-bills,132350,2016
4921,105882,0,Michael Ola,T,active,buffalo-bills,105882,2016
4922,92646,0,Shamiel Gary,S,active,buffalo-bills,92646,2016
4923,2575000,4650000,Aaron Williams,SS,injured_reserve,buffalo-bills,7225000,2016
4924,1000000,3208333,Eric Wood,C,injured_reserve,buffalo-bills,4208333,2016
4925,1671000,0,Corbin Bryant,DT,injured_reserve,buffalo-bills,1671000,2016
4926,450000,612067,Reggie Ragland,ILB,injured_reserve,buffalo-bills,1062067,2016
4927,675000,14793,Chris Gragg,TE,injured_reserve,buffalo-bills,689793,2016
4928,760000,80000,Colt Anderson,SS,injured_reserve,buffalo-bills,840000,2016
4929,760000,80000,Robert Blanton,SS,injured_reserve,buffalo-bills,840000,2016
4930,600000,0,IK Enemkpali,OLB,injured_reserve,buffalo-bills,600000,2016
4931,600000,0,Walter Powell,WR,injured_reserve,buffalo-bills,600000,2016
4932,364411,0,James Ihedigbo,SS,injured_reserve,buffalo-bills,364411,2016
4933,348000,0,Blake Annen,TE,injured_reserve,buffalo-bills,348000,2016
4934,348000,0,Jonathan Dowling,FS,injured_reserve,buffalo-bills,348000,2016
4935,333000,0,Phillip Thomas,S,injured_reserve,buffalo-bills,333000,2016
4936,825882,180000,Percy Harvin,WR,non_fb_injury,buffalo-bills,1005882,2016
4937,408699,33233,Kolby Listenbee,WR,non_fb_injury,buffalo-bills,441932,2016
4938,20700,0,Greg Townsend Jr.,DE,practice_squad,buffalo-bills,20700,2016
4939,0,10200000,Mario Williams,DE,dead_cap,buffalo-bills,10200000,2016
4940,0,2000000,Percy Harvin,WR,dead_cap,buffalo-bills,2000000,2016
4941,0,1750000,Chris Williams,G,dead_cap,buffalo-bills,1750000,2016
4942,0,1050000,Manny Lawson,OLB,dead_cap,buffalo-bills,1050000,2016
4943,0,1000000,Leodis McKelvin,CB,dead_cap,buffalo-bills,1000000,2016
4944,0,850000,Kraig Urbik,G,dead_cap,buffalo-bills,850000,2016
4945,0,750000,Jerome Felton,FB,dead_cap,buffalo-bills,750000,2016
4946,760000,25000,Greg Salas,WR,dead_cap,buffalo-bills,785000,2016
4947,397058,117563,Duke Williams,FS,dead_cap,buffalo-bills,514621,2016
4948,0,233777,Ross Cockrell,CB,dead_cap,buffalo-bills,233777,2016
4949,190270,0,Gabe Ikard,C,dead_cap,buffalo-bills,190270,2016
4950,189476,0,Michael Ola,T,dead_cap,buffalo-bills,189476,2016
4951,186420,0,Gerald Christian,TE,dead_cap,buffalo-bills,186420,2016
4952,0,166668,Anthony Dixon,RB,dead_cap,buffalo-bills,166668,2016
4953,156440,0,Bryson Albright,OLB,dead_cap,buffalo-bills,156440,2016
4954,148076,0,Jordan Gay,K,dead_cap,buffalo-bills,148076,2016
4955,82800,49896,Dezmin Lewis,WR,dead_cap,buffalo-bills,132696,2016
4956,0,125000,Jarius Wynn,OLB,dead_cap,buffalo-bills,125000,2016
4957,117300,0,Max Valles,DE,dead_cap,buffalo-bills,117300,2016
4958,102370,0,Manasseh Garner,RB,dead_cap,buffalo-bills,102370,2016
4959,97394,0,Marcus Roberson,CB,dead_cap,buffalo-bills,97394,2016
4960,0,96000,Cyril Richardson,G,dead_cap,buffalo-bills,96000,2016
4961,0,92873,Tony Steward,OLB,dead_cap,buffalo-bills,92873,2016
4962,0,89766,Nick O'Leary,TE,dead_cap,buffalo-bills,89766,2016
4963,89700,0,Ed Eagan,WR,dead_cap,buffalo-bills,89700,2016
4964,70588,15933,Randell Johnson,OLB,dead_cap,buffalo-bills,86521,2016
4965,82800,0,DeAndre Coleman,DT,dead_cap,buffalo-bills,82800,2016
4966,0,80000,Sterling Moore,CB,dead_cap,buffalo-bills,80000,2016
4967,0,80000,Fernando Velasco,G,dead_cap,buffalo-bills,80000,2016
4968,69000,0,Joe Powell,S,dead_cap,buffalo-bills,69000,2016
4969,62100,0,Reid Ferguson,LS,dead_cap,buffalo-bills,62100,2016
4970,0,53838,Karlos Williams,RB,dead_cap,buffalo-bills,53838,2016
4971,0,49500,Jonathan Meeks,FS,dead_cap,buffalo-bills,49500,2016
4972,48300,0,Dalton Freeman,C,dead_cap,buffalo-bills,48300,2016
4973,0,40000,Leonard Hankerson,WR,dead_cap,buffalo-bills,40000,2016
4974,34500,0,Isame Faciane III,DE,dead_cap,buffalo-bills,34500,2016
4975,34500,0,William Poehls,G,dead_cap,buffalo-bills,34500,2016
4976,26470,5000,Glenn Gronkowski,FB,dead_cap,buffalo-bills,31470,2016
4977,27600,0,Charles Gaines,CB,dead_cap,buffalo-bills,27600,2016
4978,27600,0,Matt Hazel,WR,dead_cap,buffalo-bills,27600,2016
4979,20700,1666,Marshall Morgan,K,dead_cap,buffalo-bills,22366,2016
4980,20700,0,Carlos Fields,OLB,dead_cap,buffalo-bills,20700,2016
4981,20700,0,Cedric O'Neal,RB,dead_cap,buffalo-bills,20700,2016
4982,20700,0,Corey Washington,WR,dead_cap,buffalo-bills,20700,2016
4983,20700,0,Damien Parms,S,dead_cap,buffalo-bills,20700,2016
4984,13800,0,Shamiel Gary,S,dead_cap,buffalo-bills,13800,2016
4985,13800,0,Doran Grant,CB,dead_cap,buffalo-bills,13800,2016
4986,0,8000,Cedric Reed,DE,dead_cap,buffalo-bills,8000,2016
4987,0,7334,B.J. Larsen,DE,dead_cap,buffalo-bills,7334,2016
4988,6900,0,Mose Frazier,WR,dead_cap,buffalo-bills,6900,2016
4989,6900,0,Chris Martin,RT,dead_cap,buffalo-bills,6900,2016
4990,6900,0,Terran Vaughn,G,dead_cap,buffalo-bills,6900,2016
4991,0,6667,Andrew Hudson,DE,dead_cap,buffalo-bills,6667,2016
4992,0,5000,Tyson Chandler,RT,dead_cap,buffalo-bills,5000,2016
4993,0,5000,A.J. Tarpley,ILB,dead_cap,buffalo-bills,5000,2016
4994,0,4000,Andre Davis,WR,dead_cap,buffalo-bills,4000,2016
4995,0,3334,Spencer Roth,P,dead_cap,buffalo-bills,3334,2016
4996,0,3333,Marquis Lucas,T,dead_cap,buffalo-bills,3333,2016
4997,0,2334,Erik Williams,DE,dead_cap,buffalo-bills,2334,2016
4998,0,2000,Clay Burton,TE,dead_cap,buffalo-bills,2000,2016
4999,0,2000,Keith Lumpkin,T,dead_cap,buffalo-bills,2000,2016
5000,0,2000,Julian Whigham,CB,dead_cap,buffalo-bills,2000,2016
5001,0,1334,Justin Hamilton,DT,dead_cap,buffalo-bills,1334,2016
5002,0,1334,Merrill Noel,CB,dead_cap,buffalo-bills,1334,2016
5003,0,1334,Cam Thomas,CB,dead_cap,buffalo-bills,1334,2016
5004,0,1333,Davonte' Allen,WR,dead_cap,buffalo-bills,1333,2016
5005,0,833,Gary Chambers,WR,dead_cap,buffalo-bills,833,2016
5006,0,833,Claudell Louis,DE,dead_cap,buffalo-bills,833,2016
5007,5400000,6550000,Jerry Hughes,DE,active,buffalo-bills,11950000,2017
5008,6000000,4375000,LeSean McCoy,RB,active,buffalo-bills,10375000,2017
5009,7500000,2213334,Tyrod Taylor,QB,active,buffalo-bills,9713334,2017
5010,4500000,4500000,Charles Clay,TE,active,buffalo-bills,9000000,2017
5011,1150000,7374999,Eric Wood,C,active,buffalo-bills,8524999,2017
5012,6300000,2000000,Kyle Williams,DT,active,buffalo-bills,8300000,2017
5013,3175000,1750000,Richie Incognito,G,active,buffalo-bills,4925000,2017
5014,2300000,1700000,Micah Hyde,SS,active,buffalo-bills,4000000,2017
5015,2000000,1000000,Lorenzo Alexander,OLB,active,buffalo-bills,3000000,2017
5016,1600000,1000000,Steven Hauschka,K,active,buffalo-bills,2600000,2017
5017,1500000,1000000,Ryan Groy,G,active,buffalo-bills,2500000,2017
5018,1500000,975000,Jordan Poyer,FS,active,buffalo-bills,2475000,2017
5019,1762000,197000,Preston Brown,ILB,active,buffalo-bills,1959000,2017
5020,1300000,550000,Patrick DiMarco,FB,active,buffalo-bills,1850000,2017
5021,465000,1369747,Tre'Davious White,CB,active,buffalo-bills,1834747,2017
5022,1797000,0,E.J. Gaines,CB,active,buffalo-bills,1797000,2017
5023,1350000,300000,Jordan Mills,RT,active,buffalo-bills,1650000,2017
5024,465000,767696,Zay Jones,WR,active,buffalo-bills,1232696,2017
5025,850000,300000,Colton Schmidt,P,active,buffalo-bills,1150000,2017
5026,800000,275000,Shareece Wright,CB,active,buffalo-bills,1075000,2017
5027,850000,83333,Vladimir Ducasse,G,active,buffalo-bills,933333,2017
5028,775000,150000,Ryan Davis,DE,active,buffalo-bills,925000,2017
5029,615000,200030,John Miller,G,active,buffalo-bills,815030,2017
5030,605806,173010,Seantrel Henderson,RT,active,buffalo-bills,778816,2017
5031,775000,0,Cedric Thornton,DT,active,buffalo-bills,775000,2017
5032,465000,295589,Dion Dawkins,T,active,buffalo-bills,760589,2017
5033,540000,218574,Adolphus Washington,DT,active,buffalo-bills,758574,2017
5034,700000,52500,Logan Thomas,TE,active,buffalo-bills,752500,2017
5035,900000,80000,Ramon Humber,OLB,active,buffalo-bills,980000,2017
5036,900000,80000,Brandon Tate,WR,active,buffalo-bills,980000,2017
5037,900000,80000,Mike Tolbert,FB,active,buffalo-bills,980000,2017
5038,775000,80000,Leonard Johnson,CB,active,buffalo-bills,855000,2017
5039,900000,0,Colt Anderson,SS,active,buffalo-bills,900000,2017
5040,900000,0,Joe Webb,QB,active,buffalo-bills,900000,2017
5041,615000,0,Khari Lee,TE,active,buffalo-bills,615000,2017
5042,615000,0,Nick O'Leary,TE,active,buffalo-bills,615000,2017
5043,465000,65376,Matt Milano,OLB,active,buffalo-bills,530376,2017
5044,465000,59874,Nathan Peterman,QB,active,buffalo-bills,524874,2017
5045,465000,38449,Tanner Vallejo,OLB,active,buffalo-bills,503449,2017
5046,592647,0,Shamarko Thomas,SS,active,buffalo-bills,592647,2017
5047,465000,0,Reid Ferguson,LS,active,buffalo-bills,465000,2017
5048,465000,0,Conor McDermott,T,active,buffalo-bills,465000,2017
5049,465000,0,Eddie Yarbrough,DE,active,buffalo-bills,465000,2017
5050,501471,0,Deonte Thompson,WR,active,buffalo-bills,501471,2017
5051,317650,0,Lafayette Pitts,CB,active,buffalo-bills,317650,2017
5052,273530,0,Deon Lacey,OLB,active,buffalo-bills,273530,2017
5053,109412,0,Nordly Capi,OLB,active,buffalo-bills,109412,2017
5054,109412,0,Brandon Reilly,WR,active,buffalo-bills,109412,2017
5055,82059,0,Breon Borders,CB,active,buffalo-bills,82059,2017
5056,36176,0,Marcus Murphy,RB,active,buffalo-bills,36176,2017
5057,27353,0,Malachi Dupre,WR,active,buffalo-bills,27353,2017
5058,27353,0,Rickey Hatley,DT,active,buffalo-bills,27353,2017
5059,9000000,5200000,Cordy Glenn,LT,injured_reserve,buffalo-bills,14200000,2017
5060,917226,1418904,Shaq Lawson,DE,injured_reserve,buffalo-bills,2336130,2017
5061,800000,600000,Andre Holmes,WR,injured_reserve,buffalo-bills,1400000,2017
5062,1094900,0,Jordan Matthews,WR,injured_reserve,buffalo-bills,1094900,2017
5063,618765,0,Taiwan Jones,RB,injured_reserve,buffalo-bills,618765,2017
5064,410294,0,Travaris Cadet,RB,injured_reserve,buffalo-bills,410294,2017
5065,378000,10000,Jeremy Butler,WR,injured_reserve,buffalo-bills,388000,2017
5066,348000,2500,Keith Towbridge,TE,injured_reserve,buffalo-bills,350500,2017
5067,4014706,8050000,Marcell Dareus,DT,dead_cap,buffalo-bills,12064706,2017
5068,0,5653146,Sammy Watkins,WR,dead_cap,buffalo-bills,5653146,2017
5069,0,3550000,Aaron Williams,SS,dead_cap,buffalo-bills,3550000,2017
5070,0,1600000,Corey Graham,FS,dead_cap,buffalo-bills,1600000,2017
5071,0,1300000,Jerome Felton,FB,dead_cap,buffalo-bills,1300000,2017
5072,0,850000,Marcus Easley,WR,dead_cap,buffalo-bills,850000,2017
5073,0,612067,Reggie Ragland,ILB,dead_cap,buffalo-bills,612067,2017
5074,0,537500,Dan Carpenter,K,dead_cap,buffalo-bills,537500,2017
5075,0,454331,Cyrus Kouandjio,RT,dead_cap,buffalo-bills,454331,2017
5076,0,445853,Ronald Darby,CB,dead_cap,buffalo-bills,445853,2017
5077,0,433334,Nickell Robey-Coleman,CB,dead_cap,buffalo-bills,433334,2017
5078,405880,0,Jerel Worthy,DT,dead_cap,buffalo-bills,405880,2017
5079,382942,0,Trae Elston,S,dead_cap,buffalo-bills,382942,2017
5080,284117,0,Joe Banyard,RB,dead_cap,buffalo-bills,284117,2017
5081,284117,0,DeAndre Coleman,DT,dead_cap,buffalo-bills,284117,2017
5082,222353,0,Kaelin Clay,WR,dead_cap,buffalo-bills,222353,2017
5083,164118,0,Deon Lacey,OLB,dead_cap,buffalo-bills,164118,2017
5084,0,137500,Garrison Sanborn,LS,dead_cap,buffalo-bills,137500,2017
5085,122400,0,De'Ondre Wesley,G,dead_cap,buffalo-bills,122400,2017
5086,108000,0,Malachi Dupre,WR,dead_cap,buffalo-bills,108000,2017
5087,0,107676,Karlos Williams,RB,dead_cap,buffalo-bills,107676,2017
5088,103659,0,Greg Mabin,CB,dead_cap,buffalo-bills,103659,2017
5089,100800,0,Marquavius Lewis,DT,dead_cap,buffalo-bills,100800,2017
5090,99352,0,Eric Lee,DE,dead_cap,buffalo-bills,99352,2017
5091,0,95848,Cardale Jones,QB,dead_cap,buffalo-bills,95848,2017
5092,93600,0,Brandon Reilly,WR,dead_cap,buffalo-bills,93600,2017
5093,86400,0,Adam Redmond,G,dead_cap,buffalo-bills,86400,2017
5094,86400,0,Will Pericak,DT,dead_cap,buffalo-bills,86400,2017
5095,45588,40000,T.J. Yates,QB,dead_cap,buffalo-bills,85588,2017
5096,0,80000,Colt Anderson,SS,dead_cap,buffalo-bills,80000,2017
5097,0,80000,Gerald Hodges,OLB,dead_cap,buffalo-bills,80000,2017
5098,79200,0,L.J. McCray,SS,dead_cap,buffalo-bills,79200,2017
5099,91176,0,Robert Blanton,SS,dead_cap,buffalo-bills,91176,2017
5100,64800,3666,Jason Croom,TE,dead_cap,buffalo-bills,68466,2017
5101,0,60229,Jonathan Williams,RB,dead_cap,buffalo-bills,60229,2017
5102,57600,0,Zach Vigil,OLB,dead_cap,buffalo-bills,57600,2017
5103,50400,0,Marcus Murphy,RB,dead_cap,buffalo-bills,50400,2017
5104,45588,0,Jelani Jenkins,OLB,dead_cap,buffalo-bills,45588,2017
5105,43200,0,Jordan Mudge,T,dead_cap,buffalo-bills,43200,2017
5106,0,33233,Kolby Listenbee,WR,dead_cap,buffalo-bills,33233,2017
5107,28800,0,Cory Carter,P,dead_cap,buffalo-bills,28800,2017
5108,28800,0,Lorenzo Doss,CB,dead_cap,buffalo-bills,28800,2017
5109,28800,0,Dean Marlowe,SS,dead_cap,buffalo-bills,28800,2017
5110,28800,0,Orion Stewart,CB,dead_cap,buffalo-bills,28800,2017
5111,0,25089,Kevon Seymour,CB,dead_cap,buffalo-bills,25089,2017
5112,21600,0,Ryan O'Malley,TE,dead_cap,buffalo-bills,21600,2017
5113,21600,0,Sammy Seamster,CB,dead_cap,buffalo-bills,21600,2017
5114,0,15933,Randell Johnson,OLB,dead_cap,buffalo-bills,15933,2017
5115,14400,0,Nordly Capi,OLB,dead_cap,buffalo-bills,14400,2017
5116,0,10000,Glenn Gronkowski,FB,dead_cap,buffalo-bills,10000,2017
5117,7200,0,Quan Bray,WR,dead_cap,buffalo-bills,7200,2017
5118,7200,0,Rickey Hatley,DT,dead_cap,buffalo-bills,7200,2017
5119,7200,0,Josh James,T,dead_cap,buffalo-bills,7200,2017
5120,7200,0,MyCole Pruitt,TE,dead_cap,buffalo-bills,7200,2017
5121,7200,0,B.T Sanders,S,dead_cap,buffalo-bills,7200,2017
5122,7200,0,Marcus Sayles,CB,dead_cap,buffalo-bills,7200,2017
5123,7200,0,Ian Seau,OLB,dead_cap,buffalo-bills,7200,2017
5124,7200,0,Daikel Shorts,WR,dead_cap,buffalo-bills,7200,2017
5125,7200,0,Xavier Woodson-Luster,ILB,dead_cap,buffalo-bills,7200,2017
5126,0,6667,Marquis Lucas,T,dead_cap,buffalo-bills,6667,2017
5127,0,4000,Keith Lumpkin,T,dead_cap,buffalo-bills,4000,2017
5128,0,4000,Julian Whigham,CB,dead_cap,buffalo-bills,4000,2017
5129,0,3334,Marshall Morgan,K,dead_cap,buffalo-bills,3334,2017
5130,0,2667,Davonte' Allen,WR,dead_cap,buffalo-bills,2667,2017
5131,0,1667,Gary Chambers,WR,dead_cap,buffalo-bills,1667,2017
5132,0,1667,Claudell Louis,DE,dead_cap,buffalo-bills,1667,2017
5133,6350000,5550000,Jerry Hughes,DE,active,buffalo-bills,11900000,2018
5134,4500000,4500000,Charles Clay,TE,active,buffalo-bills,9000000,2018
5135,6075000,2875000,LeSean McCoy,RB,active,buffalo-bills,8950000,2018
5136,3700000,3100000,Micah Hyde,SS,active,buffalo-bills,6800000,2018
5137,3500000,3200000,Star Lotulelei,DT,active,buffalo-bills,6700000,2018
5138,2250000,3250000,Kyle Williams,DT,active,buffalo-bills,5500000,2018
5139,2625000,2256250,Trent Murphy,DE,active,buffalo-bills,4881250,2018
5140,2500000,1375000,Jordan Poyer,FS,active,buffalo-bills,3875000,2018
5141,480000,3371461,Josh Allen,QB,active,buffalo-bills,3851461,2018
5142,2450000,1150000,Lorenzo Alexander,OLB,active,buffalo-bills,3600000,2018
5143,1750000,1250000,Steven Hauschka,K,active,buffalo-bills,3000000,2018
5144,1384452,1418904,Shaq Lawson,DE,active,buffalo-bills,2803356,2018
5145,1500000,1000000,Ryan Groy,G,active,buffalo-bills,2500000,2018
5146,1000000,1406250,Chris Ivory,RB,active,buffalo-bills,2406250,2018
5147,480000,1821735,Tremaine Edmunds,ILB,active,buffalo-bills,2301735,2018
5148,923687,1369747,Tre'Davious White,CB,active,buffalo-bills,2293434,2018
5149,1500000,750000,Jordan Mills,RT,active,buffalo-bills,2250000,2018
5150,1872000,205030,John Miller,G,active,buffalo-bills,2077030,2018
5151,1500000,550000,Patrick DiMarco,FB,active,buffalo-bills,2050000,2018
5152,1300000,400000,Rafael Bush,FS,active,buffalo-bills,1700000,2018
5153,773174,767696,Zay Jones,WR,active,buffalo-bills,1540870,2018
5154,1300000,233333,Vladimir Ducasse,G,active,buffalo-bills,1533333,2018
5155,1200000,275000,Julian Stanford,OLB,active,buffalo-bills,1475000,2018
5156,655147,295589,Dion Dawkins,LT,active,buffalo-bills,950736,2018
5157,787603,0,Jordan Phillips,DT,active,buffalo-bills,787603,2018
5158,480000,193760,Harrison Phillips,DT,active,buffalo-bills,673760,2018
5159,790000,0,Logan Thomas,TE,active,buffalo-bills,790000,2018
5160,630000,0,Lafayette Pitts,CB,active,buffalo-bills,630000,2018
5161,418235,200000,Matt Barkley,QB,active,buffalo-bills,618235,2018
5162,555000,0,Reid Ferguson,LS,active,buffalo-bills,555000,2018
5163,555000,0,Deon Lacey,OLB,active,buffalo-bills,555000,2018
5164,555000,0,Conor McDermott,T,active,buffalo-bills,555000,2018
5165,555000,0,Eddie Yarbrough,DE,active,buffalo-bills,555000,2018
5166,480000,71504,Siran Neal,S,active,buffalo-bills,551504,2018
5167,480000,63530,Wyatt Teller,G,active,buffalo-bills,543530,2018
5168,480000,39956,Ray-Ray McCloud,WR,active,buffalo-bills,519956,2018
5169,650588,0,Jeremiah Sirles,G,active,buffalo-bills,650588,2018
5170,716471,58530,Derek Anderson,QB,active,buffalo-bills,775001,2018
5171,480000,2000,Jason Croom,TE,active,buffalo-bills,482000,2018
5172,451760,0,Ike Boettger,G,active,buffalo-bills,451760,2018
5173,423525,0,Ryan Lewis,CB,active,buffalo-bills,423525,2018
5174,325294,0,Deonte Thompson,WR,active,buffalo-bills,325294,2018
5175,261176,0,Isaiah McKenzie,WR,active,buffalo-bills,261176,2018
5176,225880,0,Robert Foster,WR,active,buffalo-bills,225880,2018
5177,225880,0,Levi Wallace,CB,active,buffalo-bills,225880,2018
5178,185294,0,Matt Darr,P,active,buffalo-bills,185294,2018
5179,169410,0,Corey Thompson,LB,active,buffalo-bills,169410,2018
5180,148236,0,Denzel Rice,CB,active,buffalo-bills,148236,2018
5181,112940,0,Mike Love,DE,active,buffalo-bills,112940,2018
5182,112940,0,Da'Mari Scott,WR,active,buffalo-bills,112940,2018
5183,97941,0,Dean Marlowe,SS,active,buffalo-bills,97941,2018
5184,84705,0,Keith Ford,RB,active,buffalo-bills,84705,2018
5185,65294,0,Victor Bolden,WR,active,buffalo-bills,65294,2018
5186,1150000,906244,Russell Bodine,C,injured_reserve,buffalo-bills,2056244,2018
5187,459346,161517,Taron Johnson,CB,injured_reserve,buffalo-bills,620863,2018
5188,602120,0,Marcus Murphy,RB,injured_reserve,buffalo-bills,602120,2018
5189,504531,90000,Taiwan Jones,RB,injured_reserve,buffalo-bills,594531,2018
5190,523764,65376,Matt Milano,OLB,injured_reserve,buffalo-bills,589140,2018
5191,418048,0,Corey Bojorquez,P,injured_reserve,buffalo-bills,418048,2018
5192,363000,1000,Cory Carter,P,injured_reserve,buffalo-bills,364000,2018
5193,0,17129410,Marcell Dareus,DT,dead_cap,buffalo-bills,17129410,2018
5194,4800000,5591668,Eric Wood,C,dead_cap,buffalo-bills,10391668,2018
5195,0,9600000,Cordy Glenn,LT,dead_cap,buffalo-bills,9600000,2018
5196,8459000,0,Kelvin Benjamin,WR,dead_cap,buffalo-bills,8459000,2018
5197,0,7640000,Tyrod Taylor,QB,dead_cap,buffalo-bills,7640000,2018
5198,2955922,0,Corey Coleman,WR,dead_cap,buffalo-bills,2955922,2018
5199,0,3550000,Aaron Williams,SS,dead_cap,buffalo-bills,3550000,2018
5200,0,2100000,A.J. McCarron,QB,dead_cap,buffalo-bills,2100000,2018
5201,264706,1828125,Vontae Davis,CB,dead_cap,buffalo-bills,2092831,2018
5202,764706,750000,Andre Holmes,WR,dead_cap,buffalo-bills,1514706,2018
5203,0,1224135,Reggie Ragland,ILB,dead_cap,buffalo-bills,1224135,2018
5204,0,1150000,Richie Incognito,G,dead_cap,buffalo-bills,1150000,2018
5205,915000,90000,Ramon Humber,OLB,dead_cap,buffalo-bills,1005000,2018
5206,176472,500000,Marshall Newhouse,RT,dead_cap,buffalo-bills,676472,2018
5207,630000,45000,Jeremy Kerley,WR,dead_cap,buffalo-bills,675000,2018
5208,418235,90000,Phillip Gaines,CB,dead_cap,buffalo-bills,508235,2018
5209,185882,300000,Colton Schmidt,P,dead_cap,buffalo-bills,485882,2018
5210,0,395853,Ronald Darby,CB,dead_cap,buffalo-bills,395853,2018
5211,326471,59874,Nathan Peterman,QB,dead_cap,buffalo-bills,386345,2018
5212,37059,218574,Adolphus Washington,DT,dead_cap,buffalo-bills,255633,2018
5213,217576,0,Robert Thomas,DT,dead_cap,buffalo-bills,217576,2018
5214,192210,4000,Robert Foster,WR,dead_cap,buffalo-bills,196210,2018
5215,0,191696,Cardale Jones,QB,dead_cap,buffalo-bills,191696,2018
5216,191105,0,Cam Phillips,WR,dead_cap,buffalo-bills,191105,2018
5217,185882,0,Dontae Johnson,CB,dead_cap,buffalo-bills,185882,2018
5218,165884,0,Khari Lee,TE,dead_cap,buffalo-bills,165884,2018
5219,131447,0,Dean Marlowe,SS,dead_cap,buffalo-bills,131447,2018
5220,124412,0,Nate Orchard,OLB,dead_cap,buffalo-bills,124412,2018
5221,121600,0,Kyle Peko,DT,dead_cap,buffalo-bills,121600,2018
5222,0,120458,Jonathan Williams,RB,dead_cap,buffalo-bills,120458,2018
5223,106400,0,Keith Ford,RB,dead_cap,buffalo-bills,106400,2018
5224,98800,0,Mike Love,DE,dead_cap,buffalo-bills,98800,2018
5225,91200,2500,Keith Towbridge,TE,dead_cap,buffalo-bills,93700,2018
5226,0,90000,Kaelin Clay,WR,dead_cap,buffalo-bills,90000,2018
5227,0,90000,Terrence Fede,DE,dead_cap,buffalo-bills,90000,2018
5228,0,90000,Jon Ryan,P,dead_cap,buffalo-bills,90000,2018
5229,0,90000,Travaris Cadet,RB,dead_cap,buffalo-bills,90000,2018
5230,83600,0,Corey Thompson,LB,dead_cap,buffalo-bills,83600,2018
5231,92941,0,Terrelle Pryor,WR,dead_cap,buffalo-bills,92941,2018
5232,68400,0,Levi Wallace,CB,dead_cap,buffalo-bills,68400,2018
5233,0,66466,Kolby Listenbee,WR,dead_cap,buffalo-bills,66466,2018
5234,60800,0,Xavier Coleman,CB,dead_cap,buffalo-bills,60800,2018
5235,53200,0,Hunter Sharp,WR,dead_cap,buffalo-bills,53200,2018
5236,0,50178,Kevon Seymour,CB,dead_cap,buffalo-bills,50178,2018
5237,0,50000,Ryan Davis,DE,dead_cap,buffalo-bills,50000,2018
5238,45600,0,Richard Jarvis,OLB,dead_cap,buffalo-bills,45600,2018
5239,0,38449,Tanner Vallejo,OLB,dead_cap,buffalo-bills,38449,2018
5240,38000,0,Ruben Holcomb,G,dead_cap,buffalo-bills,38000,2018
5241,35835,0,Ryan Lewis,CB,dead_cap,buffalo-bills,35835,2018
5242,30400,0,Andrew Lauderdale,T,dead_cap,buffalo-bills,30400,2018
5243,22800,0,Kyle Carter,TE,dead_cap,buffalo-bills,22800,2018
5244,22800,0,Michael Hunter,CB,dead_cap,buffalo-bills,22800,2018
5245,22800,0,Tanner McEvoy,WR,dead_cap,buffalo-bills,22800,2018
5246,22800,0,Denzel Rice,CB,dead_cap,buffalo-bills,22800,2018
5247,22800,0,Josh Thornton,CB,dead_cap,buffalo-bills,22800,2018
5248,0,17267,Austin Proehl,WR,dead_cap,buffalo-bills,17267,2018
5249,7600,0,Gerhard de Beer,T,dead_cap,buffalo-bills,7600,2018
5250,7600,0,De'Ondre Wesley,G,dead_cap,buffalo-bills,7600,2018
5251,0,7334,Jason Croom,TE,dead_cap,buffalo-bills,7334,2018
5252,0,5000,Kelcie McCray,SS,dead_cap,buffalo-bills,5000,2018
5253,0,500,Quan Bray,WR,dead_cap,buffalo-bills,500,2018
5254,6800000,7650000,Jerry Hughes,DE,active,buffalo-bills,14450000,2019
5255,7150000,4350000,Star Lotulelei,DT,active,buffalo-bills,11500000,2019
5256,4400000,6850000,Mitch Morse,C,active,buffalo-bills,11250000,2019
5257,5800000,3000000,Trent Murphy,DE,active,buffalo-bills,8800000,2019
5258,3800000,3668750,John Brown,WR,active,buffalo-bills,7468750,2019
5259,2200000,4668750,Cole Beasley,WR,active,buffalo-bills,6868750,2019
5260,3950000,2668750,Micah Hyde,SS,active,buffalo-bills,6618750,2019
5261,1800000,3312500,Tyler Kroft,TE,active,buffalo-bills,5112500,2019
5262,2150000,2875000,Steven Hauschka,K,active,buffalo-bills,5025000,2019
5263,570000,4244326,Josh Allen,QB,active,buffalo-bills,4814326,2019
5264,3200000,1600000,Ty Nsekhe,RT,active,buffalo-bills,4800000,2019
5265,2250000,2250000,Jordan Phillips,DT,active,buffalo-bills,4500000,2019
5266,2950000,1375000,Jordan Poyer,FS,active,buffalo-bills,4325000,2019
5267,1350000,2625000,Spencer Long,C,active,buffalo-bills,3975000,2019
5268,2000000,1750000,Lorenzo Alexander,OLB,active,buffalo-bills,3750000,2019
5269,495000,3062301,Ed Oliver,DT,active,buffalo-bills,3557301,2019
5270,2400000,1100000,Jon Feliciano,G,active,buffalo-bills,3500000,2019
5271,1900000,1600000,Lee Smith,TE,active,buffalo-bills,3500000,2019
5272,1851679,1418907,Shaq Lawson,DE,active,buffalo-bills,3270586,2019
5273,2000000,1000000,Kevin Johnson,CB,active,buffalo-bills,3000000,2019
5274,1055434,1821735,Tremaine Edmunds,ILB,active,buffalo-bills,2877169,2019
5275,1382374,1369747,Tre'Davious White,CB,active,buffalo-bills,2752121,2019
5276,2000000,600000,Andre Roberts,WR,active,buffalo-bills,2600000,2019
5277,1600000,550000,Patrick DiMarco,FB,active,buffalo-bills,2150000,2019
5278,1750000,300000,Quinton Spain,G,active,buffalo-bills,2050000,2019
5279,1250000,750000,Frank Gore,RB,active,buffalo-bills,2000000,2019
5280,1250000,525000,Matt Barkley,QB,active,buffalo-bills,1775000,2019
5281,1250000,275000,Julian Stanford,OLB,active,buffalo-bills,1525000,2019
5282,495000,869994,Cody Ford,RT,active,buffalo-bills,1364994,2019
5283,1000000,300000,T.J. Yeldon,RB,active,buffalo-bills,1300000,2019
5284,795294,345589,Dion Dawkins,LT,active,buffalo-bills,1140883,2019
5285,700000,150000,Reid Ferguson,LS,active,buffalo-bills,850000,2019
5286,495000,258956,Devin Singletary,RB,active,buffalo-bills,753956,2019
5287,570000,161517,Taron Johnson,CB,active,buffalo-bills,731517,2019
5288,645000,65376,Matt Milano,OLB,active,buffalo-bills,710376,2019
5289,495000,205545,Dawson Knox,TE,active,buffalo-bills,700545,2019
5290,930000,0,Kurt Coleman,FS,active,buffalo-bills,930000,2019
5291,645000,0,Dean Marlowe,SS,active,buffalo-bills,645000,2019
5292,645000,0,Isaiah McKenzie,WR,active,buffalo-bills,645000,2019
5293,570000,71504,Siran Neal,CB,active,buffalo-bills,641504,2019
5294,570000,0,Ike Boettger,G,active,buffalo-bills,570000,2019
5295,570000,0,Corey Bojorquez,P,active,buffalo-bills,570000,2019
5296,570000,0,Robert Foster,WR,active,buffalo-bills,570000,2019
5297,570000,0,Corey Thompson,LB,active,buffalo-bills,570000,2019
5298,570000,0,Levi Wallace,CB,active,buffalo-bills,570000,2019
5299,495000,46085,Jaquan Johnson,S,active,buffalo-bills,541085,2019
5300,495000,24522,Darryl Johnson,DE,active,buffalo-bills,519522,2019
5301,495000,24046,Tommy Sweeney,TE,active,buffalo-bills,519046,2019
5302,508235,0,Senorise Perry,RB,active,buffalo-bills,508235,2019
5303,495000,0,Ryan Bates,G,active,buffalo-bills,495000,2019
5304,378534,0,Duke Williams,WR,active,buffalo-bills,378534,2019
5305,341471,0,Vincent Taylor,DT,active,buffalo-bills,341471,2019
5306,437647,0,Corey Liuget,DT,active,buffalo-bills,437647,2019
5307,1000000,500000,LaAdrian Waddle,RT,injured_reserve,buffalo-bills,1500000,2019
5308,850000,150000,Maurice Alexander,LB,injured_reserve,buffalo-bills,1000000,2019
5309,570000,232760,Harrison Phillips,DT,injured_reserve,buffalo-bills,802760,2019
5310,378000,80324,Vosean Joseph,LB,injured_reserve,buffalo-bills,458324,2019
5311,393000,2000,Jason Croom,TE,injured_reserve,buffalo-bills,395000,2019
5312,393000,0,Mike Love,DE,injured_reserve,buffalo-bills,393000,2019
5313,0,4500000,Charles Clay,TE,dead_cap,buffalo-bills,4500000,2019
5314,0,2875000,LeSean McCoy,RB,dead_cap,buffalo-bills,2875000,2019
5315,0,2000000,A.J. McCarron,QB,dead_cap,buffalo-bills,2000000,2019
5316,303337,817698,Zay Jones,WR,dead_cap,buffalo-bills,1121035,2019
5317,0,750000,Chris Ivory,RB,dead_cap,buffalo-bills,750000,2019
5318,0,700000,Russell Bodine,C,dead_cap,buffalo-bills,700000,2019
5319,0,550000,Andre Holmes,WR,dead_cap,buffalo-bills,550000,2019
5320,0,400000,Rafael Bush,FS,dead_cap,buffalo-bills,400000,2019
5321,0,350000,E.J. Gaines,CB,dead_cap,buffalo-bills,350000,2019
5322,329118,0,Jeremiah Sirles,G,dead_cap,buffalo-bills,329118,2019
5323,257647,0,Kyle Peko,DT,dead_cap,buffalo-bills,257647,2019
5324,204000,0,Eddie Yarbrough,DE,dead_cap,buffalo-bills,204000,2019
5325,0,188574,Adolphus Washington,DT,dead_cap,buffalo-bills,188574,2019
5326,177932,0,Garrett McGhin,T,dead_cap,buffalo-bills,177932,2019
5327,169000,0,Del'Shawn Phillips,LB,dead_cap,buffalo-bills,169000,2019
5328,162000,0,Davis Webb,QB,dead_cap,buffalo-bills,162000,2019
5329,151353,8333,Tyrel Dodson,LB,dead_cap,buffalo-bills,159686,2019
5330,151764,0,Conor McDermott,T,dead_cap,buffalo-bills,151764,2019
5331,136000,2166,Cam Lewis,CB,dead_cap,buffalo-bills,138166,2019
5332,131765,0,Robert Thomas,DT,dead_cap,buffalo-bills,131765,2019
5333,128000,0,Nate Becker,TE,dead_cap,buffalo-bills,128000,2019
5334,88000,39956,Ray-Ray McCloud,WR,dead_cap,buffalo-bills,127956,2019
5335,0,119748,Nathan Peterman,QB,dead_cap,buffalo-bills,119748,2019
5336,104000,4333,Nick Easley,WR,dead_cap,buffalo-bills,108333,2019
5337,0,90000,Derek Anderson,QB,dead_cap,buffalo-bills,90000,2019
5338,0,90000,Eli Harold,OLB,dead_cap,buffalo-bills,90000,2019
5339,0,90000,Senorise Perry,RB,dead_cap,buffalo-bills,90000,2019
5340,90000,0,Vincent Taylor,DT,dead_cap,buffalo-bills,90000,2019
5341,0,83334,Vladimir Ducasse,G,dead_cap,buffalo-bills,83334,2019
5342,0,76898,Tanner Vallejo,OLB,dead_cap,buffalo-bills,76898,2019
5343,72000,0,Victor Salako,T,dead_cap,buffalo-bills,72000,2019
5344,60000,5000,Tyree Jackson,QB,dead_cap,buffalo-bills,65000,2019
5345,64000,0,Brandon Hitner,T,dead_cap,buffalo-bills,64000,2019
5346,64000,0,Erik Magnunson,T,dead_cap,buffalo-bills,64000,2019
5347,0,63531,Wyatt Teller,G,dead_cap,buffalo-bills,63531,2019
5348,0,51803,Austin Proehl,WR,dead_cap,buffalo-bills,51803,2019
5349,50000,0,Byron Marshall,RB,dead_cap,buffalo-bills,50000,2019
5350,48000,0,Nate Hall,LB,dead_cap,buffalo-bills,48000,2019
5351,32000,0,Wyatt Ray,DE,dead_cap,buffalo-bills,32000,2019
5352,32000,0,Duke Williams,WR,dead_cap,buffalo-bills,32000,2019
5353,16000,0,Tyron Johnson,WR,dead_cap,buffalo-bills,16000,2019
5354,0,15000,Jake Fisher,TE,dead_cap,buffalo-bills,15000,2019
5355,0,11667,David Sills,WR,dead_cap,buffalo-bills,11667,2019
5356,0,8000,Robert Foster,WR,dead_cap,buffalo-bills,8000,2019
5357,8000,0,Curtis Akins,LB,dead_cap,buffalo-bills,8000,2019
5358,8000,0,Jordan Veasy,WR,dead_cap,buffalo-bills,8000,2019
5359,0,2666,Juwan Foggie,LB,dead_cap,buffalo-bills,2666,2019
5360,0,2500,Keith Towbridge,TE,dead_cap,buffalo-bills,2500,2019
5361,0,1000,Cory Carter,P,dead_cap,buffalo-bills,1000,2019
5362,0,333,Chase McLaughlin,K,dead_cap,buffalo-bills,333,2019
5363,6775000,4850000,Mitch Morse,C,active,buffalo-bills,11625000,2020
5364,6250000,3850000,Star Lotulelei,DT,active,buffalo-bills,10100000,2020
5365,6425000,3350000,Trent Murphy,DE,active,buffalo-bills,9775000,2020
5366,7050000,2668750,John Brown,WR,active,buffalo-bills,9718750,2020
5367,6650000,2850000,Jerry Hughes,DE,active,buffalo-bills,9500000,2020
5368,4400000,2668750,Cole Beasley,WR,active,buffalo-bills,7068750,2020
5369,4000000,2700000,Micah Hyde,SS,active,buffalo-bills,6700000,2020
5370,4450000,1962500,Tyler Kroft,TE,active,buffalo-bills,6412500,2020
5371,660000,5117191,Josh Allen,QB,active,buffalo-bills,5777191,2020
5372,3100000,2100000,Ty Nsekhe,RT,active,buffalo-bills,5200000,2020
5373,1384325,3062301,Ed Oliver,DT,active,buffalo-bills,4446626,2020
5374,2650000,1750000,Jon Feliciano,G,active,buffalo-bills,4400000,2020
5375,2550000,1925000,Spencer Long,C,active,buffalo-bills,4475000,2020
5376,2950000,1125000,Jordan Poyer,FS,active,buffalo-bills,4075000,2020
5377,1630868,1821735,Tremaine Edmunds,ILB,active,buffalo-bills,3452603,2020
5378,2650000,600000,Lee Smith,TE,active,buffalo-bills,3250000,2020
5379,1841060,1369748,Tre'Davious White,CB,active,buffalo-bills,3210808,2020
5380,2175000,875000,Steven Hauschka,K,active,buffalo-bills,3050000,2020
5381,1800000,550000,Patrick DiMarco,FB,active,buffalo-bills,2350000,2020
5382,1500000,525000,Matt Barkley,QB,active,buffalo-bills,2025000,2020
5383,1300000,700000,Andre Roberts,WR,active,buffalo-bills,2000000,2020
5384,1400000,500000,T.J. Yeldon,RB,active,buffalo-bills,1900000,2020
5385,835419,869994,Cody Ford,RT,active,buffalo-bills,1705413,2020
5386,985441,345589,Dion Dawkins,LT,active,buffalo-bills,1331030,2020
5387,675000,258956,Devin Singletary,RB,active,buffalo-bills,933956,2020
5388,750000,150000,Reid Ferguson,LS,active,buffalo-bills,900000,2020
5389,660000,231760,Harrison Phillips,DT,active,buffalo-bills,891760,2020
5390,613500,235545,Dawson Knox,TE,active,buffalo-bills,849045,2020
5391,660000,161517,Taron Johnson,CB,active,buffalo-bills,821517,2020
5392,735000,65378,Matt Milano,OLB,active,buffalo-bills,800378,2020
5393,735000,0,Vincent Taylor,DT,active,buffalo-bills,735000,2020
5394,660000,71504,Siran Neal,CB,active,buffalo-bills,731504,2020
5395,660000,5500,Davis Webb,QB,active,buffalo-bills,665500,2020
5396,660000,2750,Ray-Ray McCloud,WR,active,buffalo-bills,662750,2020
5397,660000,0,Ike Boettger,G,active,buffalo-bills,660000,2020
5398,660000,0,Corey Bojorquez,P,active,buffalo-bills,660000,2020
5399,660000,0,Corey Thompson,LB,active,buffalo-bills,660000,2020
5400,660000,0,Jonathan Woodard,DE,active,buffalo-bills,660000,2020
5401,585000,46085,Jaquan Johnson,S,active,buffalo-bills,631085,2020
5402,585000,24522,Darryl Johnson,DE,active,buffalo-bills,609522,2020
5403,585000,24046,Tommy Sweeney,TE,active,buffalo-bills,609046,2020
5404,510000,80324,Vosean Joseph,LB,active,buffalo-bills,590324,2020
5405,585000,0,Ryan Bates,G,active,buffalo-bills,585000,2020
5406,585000,0,Mike Love,DE,active,buffalo-bills,585000,2020
5407,585000,0,Duke Williams,WR,active,buffalo-bills,585000,2020
5408,510000,6500,Kaare Vedvik,K,active,buffalo-bills,516500,2020
5409,510000,5500,Cam Lewis,CB,active,buffalo-bills,515500,2020
5410,510000,5500,Christian Wade,RB,active,buffalo-bills,515500,2020
5411,510000,4000,Nate Becker,TE,active,buffalo-bills,514000,2020
5412,510000,3250,Nick Easley,WR,active,buffalo-bills,513250,2020
5413,510000,2250,Victor Salako,T,active,buffalo-bills,512250,2020
5414,510000,2000,Tyrel Dodson,LB,active,buffalo-bills,512000,2020
5415,510000,0,Del'Shawn Phillips,LB,active,buffalo-bills,510000,2020
5416,0,767698,Zay Jones,WR,dead_cap,buffalo-bills,767698,2020
5417,0,127062,Wyatt Teller,G,dead_cap,buffalo-bills,127062,2020
5418,0,79912,Ray-Ray McCloud,WR,dead_cap,buffalo-bills,79912,2020
5419,0,23334,David Sills,WR,dead_cap,buffalo-bills,23334,2020
5420,0,16667,Tyrel Dodson,LB,dead_cap,buffalo-bills,16667,2020
5421,0,10000,Tyree Jackson,QB,dead_cap,buffalo-bills,10000,2020
5422,0,8667,Nick Easley,WR,dead_cap,buffalo-bills,8667,2020
5423,0,5334,Juwan Foggie,LB,dead_cap,buffalo-bills,5334,2020
5424,0,4334,Cam Lewis,CB,dead_cap,buffalo-bills,4334,2020
5425,0,667,Chase McLaughlin,K,dead_cap,buffalo-bills,667,2020
5426,5535000,9227499,Julius Peppers,DE,active,carolina-panthers,14762499,2007
5427,1400000,6300000,Jake Delhomme,QB,active,carolina-panthers,7700000,2007
5428,1000000,3802157,Steve Smith,WR,active,carolina-panthers,4802157,2007
5429,900000,2675000,Maake Kemoeatu,DT,active,carolina-panthers,3575000,2007
5430,1000000,1600000,David Carr,QB,active,carolina-panthers,2600000,2007
5431,910000,2534000,Jordan Gross,LT,active,carolina-panthers,3444000,2007
5432,540000,3272500,Thomas Davis,OLB,active,carolina-panthers,3812500,2007
5433,1300000,400000,John Kasay,K,active,carolina-panthers,1700000,2007
5434,1075000,1040000,Chris Gamble,CB,active,carolina-panthers,2115000,2007
5435,617648,750000,Jeremy Bridges,G,active,carolina-panthers,1367648,2007
5436,950000,400000,Nail Diggs,LB,active,carolina-panthers,1350000,2007
5437,1300000,0,Drew Carter,WR,active,carolina-panthers,1300000,2007
5438,360000,1730000,DeAngelo Williams,RB,active,carolina-panthers,2090000,2007
5439,285000,350000,Dwayne Jarrett,WR,active,carolina-panthers,635000,2007
5440,285000,805000,Jon Beason,ILB,active,carolina-panthers,1090000,2007
5441,360000,530000,Richard Marshall,CB,active,carolina-panthers,890000,2007
5442,460000,137750,Travelle Wharton,G,active,carolina-panthers,597750,2007
5443,385000,180333,Evan Mathis,G,active,carolina-panthers,565333,2007
5444,360000,162400,James Anderson,OLB,active,carolina-panthers,522400,2007
5445,285000,232500,Ryan Kalil,C,active,carolina-panthers,517500,2007
5446,435000,42513,Adam Seward,LB,active,carolina-panthers,477513,2007
5447,285000,177500,Charles Johnson,DE,active,carolina-panthers,462500,2007
5448,435000,0,Chris Harris,S,active,carolina-panthers,435000,2007
5449,385000,35000,Geoff Hangartner,G,active,carolina-panthers,420000,2007
5450,360000,41006,Jeff King,TE,active,carolina-panthers,401006,2007
5451,285000,109576,Ryne Robinson,WR,active,carolina-panthers,394576,2007
5452,360000,10216,Stanley McClover,DE,active,carolina-panthers,370216,2007
5453,285000,42750,Dante Rosario,TE,active,carolina-panthers,327750,2007
5454,285000,39725,Tim Shaw,OLB,active,carolina-panthers,324725,2007
5455,285000,0,Matt Moore,QB,active,carolina-panthers,285000,2007
5456,285000,0,C.J. Wilson,CB,active,carolina-panthers,285000,2007
5457,13500,0,C.J. Wilson,CB,active,carolina-panthers,13500,2007
5458,510000,474200,Keary Colbert,WR,injured_reserve,carolina-panthers,984200,2007
5459,360000,0,Nate Salley,S,injured_reserve,carolina-panthers,360000,2007
5460,79900,0,DeCori Birmingham,RB,practice_squad,carolina-panthers,79900,2007
5461,79900,0,Jason Carter,WR,practice_squad,carolina-panthers,79900,2007
5462,79900,0,Chris Hannon,WR,practice_squad,carolina-panthers,79900,2007
5463,1250000,0,Keyshawn Johnson,WR,dead_cap,carolina-panthers,1250000,2007
5464,0,800000,Chris Weinke,QB,dead_cap,carolina-panthers,800000,2007
5465,341667,0,Eric Shelton,RB,dead_cap,carolina-panthers,341667,2007
5466,212000,0,Stefan LeFors,QB,dead_cap,carolina-panthers,212000,2007
5467,206666,0,Nate Salley,S,dead_cap,carolina-panthers,206666,2007
5468,159916,0,Rashad Butler,LT,dead_cap,carolina-panthers,159916,2007
5469,24916,0,Jovan Haye,DT,dead_cap,carolina-panthers,24916,2007
5470,0,11166,Will Montgomery,C,dead_cap,carolina-panthers,11166,2007
5471,6500000,8312499,Julius Peppers,DE,active,carolina-panthers,14812499,2008
5472,3690000,7300000,Jake Delhomme,QB,active,carolina-panthers,10990000,2008
5473,7455000,0,Jordan Gross,LT,active,carolina-panthers,7455000,2008
5474,1750000,6202157,Steve Smith,WR,active,carolina-panthers,7952157,2008
5475,1900000,3439999,Maake Kemoeatu,DT,active,carolina-panthers,5339999,2008
5476,1190882,3040000,Chris Gamble,CB,active,carolina-panthers,4230882,2008
5477,600000,2250000,Travelle Wharton,G,active,carolina-panthers,2850000,2008
5478,650000,3272500,Thomas Davis,OLB,active,carolina-panthers,3922500,2008
5479,1500000,800000,John Kasay,K,active,carolina-panthers,2300000,2008
5480,445000,2665000,DeAngelo Williams,RB,active,carolina-panthers,3110000,2008
5481,1950000,50000,Josh McCown,QB,active,carolina-panthers,2000000,2008
5482,1200000,525000,Jeremy Bridges,G,active,carolina-panthers,1725000,2008
5483,870000,842500,Jon Beason,ILB,active,carolina-panthers,1712500,2008
5484,800000,900000,Nail Diggs,LB,active,carolina-panthers,1700000,2008
5485,800000,725000,Tyler Brayton,DT,active,carolina-panthers,1525000,2008
5486,1395000,100000,Jonathan Stewart,RB,active,carolina-panthers,1495000,2008
5487,1417000,0,Geoff Hangartner,G,active,carolina-panthers,1417000,2008
5488,1060000,218750,Jeff Otah,T,active,carolina-panthers,1278750,2008
5489,1000000,250000,Muhsin Muhammad,WR,active,carolina-panthers,1250000,2008
5490,527000,400000,Chris Harris,S,active,carolina-panthers,927000,2008
5491,927000,0,Adam Seward,LB,active,carolina-panthers,927000,2008
5492,445000,570000,Richard Marshall,CB,active,carolina-panthers,1015000,2008
5493,370000,350000,Dwayne Jarrett,WR,active,carolina-panthers,720000,2008
5494,445000,162400,James Anderson,OLB,active,carolina-panthers,607400,2008
5495,370000,232500,Ryan Kalil,C,active,carolina-panthers,602500,2008
5496,370000,177500,Charles Johnson,DE,active,carolina-panthers,547500,2008
5497,295000,213550,Charles Godfrey,SS,active,carolina-panthers,508550,2008
5498,295000,197096,Dan Connor,ILB,active,carolina-panthers,492096,2008
5499,445000,41006,Jeff King,TE,active,carolina-panthers,486006,2008
5500,370000,109576,Ryne Robinson,WR,active,carolina-panthers,479576,2008
5501,370000,42750,Dante Rosario,TE,active,carolina-panthers,412750,2008
5502,370000,39725,Tim Shaw,OLB,active,carolina-panthers,409725,2008
5503,370000,0,Matt Moore,QB,active,carolina-panthers,370000,2008
5504,370000,0,Nate Salley,S,active,carolina-panthers,370000,2008
5505,370000,0,C.J. Wilson,CB,active,carolina-panthers,370000,2008
5506,295000,47312,Gary Barnidge,TE,active,carolina-panthers,342312,2008
5507,295000,24500,Nick Hayden,DT,active,carolina-panthers,319500,2008
5508,295000,14075,Hilee Taylor,DE,active,carolina-panthers,309075,2008
5509,295000,9250,Mackenzy Bernadeau,C,active,carolina-panthers,304250,2008
5510,40500,0,C.J. Wilson,CB,active,carolina-panthers,40500,2008
5511,370000,0,Jason Carter,WR,injured_reserve,carolina-panthers,370000,2008
5512,88400,0,DeCori Birmingham,RB,practice_squad,carolina-panthers,88400,2008
5513,88400,0,Casper Brinkley,DE,practice_squad,carolina-panthers,88400,2008
5514,88400,0,Geoff Schwartz,G,practice_squad,carolina-panthers,88400,2008
5515,88400,0,Lorenzo Williams,DT,practice_squad,carolina-panthers,88400,2008
5516,0,5068000,Jordan Gross,LT,dead_cap,carolina-panthers,5068000,2008
5517,2500000,0,Keyshawn Johnson,WR,dead_cap,carolina-panthers,2500000,2008
5518,0,1500000,David Carr,QB,dead_cap,carolina-panthers,1500000,2008
5519,341667,0,Eric Shelton,RB,dead_cap,carolina-panthers,341667,2008
5520,159916,0,Rashad Butler,LT,dead_cap,carolina-panthers,159916,2008
5521,24500,0,Nick Hayden,DT,dead_cap,carolina-panthers,24500,2008
5522,0,15000,Milford Brown,G,dead_cap,carolina-panthers,15000,2008
5523,0,11166,Will Montgomery,C,dead_cap,carolina-panthers,11166,2008
5524,10500,0,Geoff Schwartz,G,dead_cap,carolina-panthers,10500,2008
5525,10216,0,Stanley McClover,DE,dead_cap,carolina-panthers,10216,2008
5526,1000,0,Lorenzo Williams,DT,dead_cap,carolina-panthers,1000,2008
5527,16683000,0,Julius Peppers,DE,active,carolina-panthers,16683000,2009
5528,3400000,7470907,Steve Smith,WR,active,carolina-panthers,10870907,2009
5529,3200000,5925000,Jake Delhomme,QB,active,carolina-panthers,9125000,2009
5530,4000000,5000000,Chris Gamble,CB,active,carolina-panthers,9000000,2009
5531,5000000,1000000,Jordan Gross,LT,active,carolina-panthers,6000000,2009
5532,2743750,1262500,Jonathan Stewart,RB,active,carolina-panthers,4006250,2009
5533,2200000,3272500,Thomas Davis,OLB,active,carolina-panthers,5472500,2009
5534,1750000,2250000,Travelle Wharton,G,active,carolina-panthers,4000000,2009
5535,2100000,433333,Tyler Brayton,DT,active,carolina-panthers,2533333,2009
5536,1100000,1284166,Jon Beason,ILB,active,carolina-panthers,2384166,2009
5537,1500000,400000,John Kasay,K,active,carolina-panthers,1900000,2009
5538,925000,900000,Nail Diggs,LB,active,carolina-panthers,1825000,2009
5539,1750000,50000,Josh McCown,QB,active,carolina-panthers,1800000,2009
5540,1500000,250000,Muhsin Muhammad,WR,active,carolina-panthers,1750000,2009
5541,645000,1830000,DeAngelo Williams,RB,active,carolina-panthers,2475000,2009
5542,1545000,0,Jeff King,TE,active,carolina-panthers,1545000,2009
5543,700000,400000,Chris Harris,S,active,carolina-panthers,1100000,2009
5544,1010000,0,James Anderson,OLB,active,carolina-panthers,1010000,2009
5545,460000,656500,Ryan Kalil,C,active,carolina-panthers,1116500,2009
5546,535000,610000,Richard Marshall,CB,active,carolina-panthers,1145000,2009
5547,460000,350000,Dwayne Jarrett,WR,active,carolina-panthers,810000,2009
5548,310000,385000,Everette Brown,OLB,active,carolina-panthers,695000,2009
5549,460000,177500,Charles Johnson,DE,active,carolina-panthers,637500,2009
5550,385000,213550,Charles Godfrey,SS,active,carolina-panthers,598550,2009
5551,385000,197096,Dan Connor,ILB,active,carolina-panthers,582096,2009
5552,310000,236000,Sherrod Martin,SS,active,carolina-panthers,546000,2009
5553,460000,42750,Dante Rosario,TE,active,carolina-panthers,502750,2009
5554,310000,168281,Corvey Irvin,DT,active,carolina-panthers,478281,2009
5555,460000,0,Quinton Culberson,LB,active,carolina-panthers,460000,2009
5556,460000,0,Derek Landri,DT,active,carolina-panthers,460000,2009
5557,460000,0,Matt Moore,QB,active,carolina-panthers,460000,2009
5558,460000,0,Tank Tyler,DT,active,carolina-panthers,460000,2009
5559,460000,0,C.J. Wilson,CB,active,carolina-panthers,460000,2009
5560,385000,47312,Gary Barnidge,TE,active,carolina-panthers,432312,2009
5561,310000,108953,Tony Fiammetta,FB,active,carolina-panthers,418953,2009
5562,385000,14075,Hilee Taylor,DE,active,carolina-panthers,399075,2009
5563,385000,9250,Mackenzy Bernadeau,C,active,carolina-panthers,394250,2009
5564,385000,0,Dexter Jackson,WR,active,carolina-panthers,385000,2009
5565,385000,0,Jordan Senn,OLB,active,carolina-panthers,385000,2009
5566,310000,52016,Jason Phillips,ILB,active,carolina-panthers,362016,2009
5567,310000,24500,Nick Hayden,DT,active,carolina-panthers,334500,2009
5568,310000,15022,Captain Munnerlyn,CB,active,carolina-panthers,325022,2009
5569,310000,10500,Mike Goodson,RB,active,carolina-panthers,320500,2009
5570,310000,10000,Geoff Schwartz,G,active,carolina-panthers,320000,2009
5571,310000,2667,Garry Williams,G,active,carolina-panthers,312667,2009
5572,310000,0,J.J. Jansen,LS,active,carolina-panthers,310000,2009
5573,1080000,4053001,Maake Kemoeatu,DT,injured_reserve,carolina-panthers,5133001,2009
5574,1825000,1156250,Jeff Otah,T,injured_reserve,carolina-panthers,2981250,2009
5575,126250,0,Nate Salley,S,injured_reserve,carolina-panthers,126250,2009
5576,88400,0,DeCori Birmingham,RB,practice_squad,carolina-panthers,88400,2009
5577,88400,0,Marcus Walker,CB,practice_squad,carolina-panthers,88400,2009
5578,400000,0,Jeremy Bridges,G,dead_cap,carolina-panthers,400000,2009
5579,109576,0,Ryne Robinson,WR,dead_cap,carolina-panthers,109576,2009
5580,73500,0,Nick Hayden,DT,dead_cap,carolina-panthers,73500,2009
5581,31500,0,Geoff Schwartz,G,dead_cap,carolina-panthers,31500,2009
5582,5750000,4193750,Steve Smith,WR,active,carolina-panthers,9943750,2010
5583,4500000,4000000,Jordan Gross,LT,active,carolina-panthers,8500000,2010
5584,3250000,5000000,Chris Gamble,CB,active,carolina-panthers,8250000,2010
5585,3900000,2250000,Travelle Wharton,G,active,carolina-panthers,6150000,2010
5586,3268000,0,Thomas Davis,OLB,active,carolina-panthers,3268000,2010
5587,2100000,1830000,DeAngelo Williams,RB,active,carolina-panthers,3930000,2010
5588,3043000,0,Matt Moore,QB,active,carolina-panthers,3043000,2010
5589,1315000,1284166,Jon Beason,ILB,active,carolina-panthers,2599166,2010
5590,2200000,333333,Tyler Brayton,DT,active,carolina-panthers,2533333,2010
5591,1265000,1262500,Jonathan Stewart,RB,active,carolina-panthers,2527500,2010
5592,1000000,1156250,Jeff Otah,T,active,carolina-panthers,2156250,2010
5593,1750000,400000,John Kasay,K,active,carolina-panthers,2150000,2010
5594,1759000,0,Jeff King,TE,active,carolina-panthers,1759000,2010
5595,1759000,0,Richard Marshall,CB,active,carolina-panthers,1759000,2010
5596,1230000,385000,Everette Brown,OLB,active,carolina-panthers,1615000,2010
5597,1101000,177500,Charles Johnson,DE,active,carolina-panthers,1278500,2010
5598,1176000,0,James Anderson,OLB,active,carolina-panthers,1176000,2010
5599,1176000,0,Jamar Williams,LB,active,carolina-panthers,1176000,2010
5600,1101000,42750,Dante Rosario,TE,active,carolina-panthers,1143750,2010
5601,1101000,0,Tank Tyler,DT,active,carolina-panthers,1101000,2010
5602,550000,656500,Ryan Kalil,C,active,carolina-panthers,1206500,2010
5603,550000,350000,Dwayne Jarrett,WR,active,carolina-panthers,900000,2010
5604,470000,213550,Charles Godfrey,SS,active,carolina-panthers,683550,2010
5605,470000,197096,Dan Connor,ILB,active,carolina-panthers,667096,2010
5606,320000,322500,Jimmy Clausen,QB,active,carolina-panthers,642500,2010
5607,395000,236000,Sherrod Martin,SS,active,carolina-panthers,631000,2010
5608,630000,0,Marcus Hudson,CB,active,carolina-panthers,630000,2010
5609,550000,0,Gerald Alexander,S,active,carolina-panthers,550000,2010
5610,550000,0,Derek Landri,DT,active,carolina-panthers,550000,2010
5611,545000,0,C.J. Wilson,CB,active,carolina-panthers,545000,2010
5612,320000,204600,Brandon LaFell,WR,active,carolina-panthers,524600,2010
5613,470000,47312,Gary Barnidge,TE,active,carolina-panthers,517312,2010
5614,405000,108953,Tony Fiammetta,FB,active,carolina-panthers,513953,2010
5615,320000,178460,Armanti Edwards,WR,active,carolina-panthers,498460,2010
5616,470000,14075,Hilee Taylor,DE,active,carolina-panthers,484075,2010
5617,475000,0,J.J. Jansen,LS,active,carolina-panthers,475000,2010
5618,470000,0,Dexter Jackson,WR,active,carolina-panthers,470000,2010
5619,470000,0,Jordan Senn,OLB,active,carolina-panthers,470000,2010
5620,320000,114600,Eric Norwood,LB,active,carolina-panthers,434600,2010
5621,405000,10500,Mike Goodson,RB,active,carolina-panthers,415500,2010
5622,395000,15022,Captain Munnerlyn,CB,active,carolina-panthers,410022,2010
5623,395000,10000,Geoff Schwartz,G,active,carolina-panthers,405000,2010
5624,395000,2667,Garry Williams,G,active,carolina-panthers,397667,2010
5625,395000,0,Nick Hayden,DT,active,carolina-panthers,395000,2010
5626,395000,0,Jason Williams,OLB,active,carolina-panthers,395000,2010
5627,320000,52016,Jason Phillips,ILB,active,carolina-panthers,372016,2010
5628,320000,28946,Greg Hardy,DE,active,carolina-panthers,348946,2010
5629,320000,23512,David Gettis,WR,active,carolina-panthers,343512,2010
5630,320000,20818,Jordan Pugh,S,active,carolina-panthers,340818,2010
5631,320000,20286,Tony Pike,QB,active,carolina-panthers,340286,2010
5632,320000,0,Andre Neblett,DT,active,carolina-panthers,320000,2010
5633,47000,9250,Mackenzy Bernadeau,C,active,carolina-panthers,56250,2010
5634,12675000,2500000,Jake Delhomme,QB,dead_cap,carolina-panthers,15175000,2010
5635,5359002,0,Maake Kemoeatu,DT,dead_cap,carolina-panthers,5359002,2010
5636,1200000,0,Chris Harris,S,dead_cap,carolina-panthers,1200000,2010
5637,168281,0,Corvey Irvin,DT,dead_cap,carolina-panthers,168281,2010
5638,109576,0,Ryne Robinson,WR,dead_cap,carolina-panthers,109576,2010
5639,39000,0,Robert McClain,CB,dead_cap,carolina-panthers,39000,2010
5640,0,14793,R.J. Stanford,CB,dead_cap,carolina-panthers,14793,2010
5641,6000000,4000000,Jordan Gross,LT,active,carolina-panthers,10000000,2011
5642,4000000,6000000,Charles Johnson,DE,active,carolina-panthers,10000000,2011
5643,7000000,4193750,Steve Smith,WR,active,carolina-panthers,11193750,2011
5644,6244117,5000000,Chris Gamble,CB,active,carolina-panthers,11244117,2011
5645,4500000,3200000,DeAngelo Williams,RB,active,carolina-panthers,7700000,2011
5646,5400000,2000000,Travelle Wharton,G,active,carolina-panthers,7400000,2011
5647,1040000,4684168,Jon Beason,ILB,active,carolina-panthers,5724168,2011
5648,1000000,3600000,Ryan Kalil,C,active,carolina-panthers,4600000,2011
5649,375000,3629636,Cam Newton,QB,active,carolina-panthers,4004636,2011
5650,3000000,812500,Jeremy Shockey,TE,active,carolina-panthers,3812500,2011
5651,2550000,750000,Geoff Hangartner,G,active,carolina-panthers,3300000,2011
5652,1500000,1400000,James Anderson,OLB,active,carolina-panthers,2900000,2011
5653,1310000,1262500,Jonathan Stewart,RB,active,carolina-panthers,2572500,2011
5654,2000000,400000,John Kasay,K,active,carolina-panthers,2400000,2011
5655,1000000,1400000,Thomas Davis,OLB,active,carolina-panthers,2400000,2011
5656,1500000,833333,Ron Edwards,DT,active,carolina-panthers,2333333,2011
5657,1035000,1156250,Jeff Otah,T,active,carolina-panthers,2191250,2011
5658,1000000,1000000,Olindo Mare,K,active,carolina-panthers,2000000,2011
5659,600000,1000000,Charles Godfrey,SS,active,carolina-panthers,1600000,2011
5660,480000,767500,Sherrod Martin,SS,active,carolina-panthers,1247500,2011
5661,1200000,9250,Mackenzy Bernadeau,C,active,carolina-panthers,1209250,2011
5662,1200000,0,J.J. Jansen,LS,active,carolina-panthers,1200000,2011
5663,1200000,0,Jordan Senn,OLB,active,carolina-panthers,1200000,2011
5664,700000,500000,Greg Olsen,TE,active,carolina-panthers,1200000,2011
5665,810000,150000,Ben Hartsock,TE,active,carolina-panthers,960000,2011
5666,555000,197096,Dan Connor,ILB,active,carolina-panthers,752096,2011
5667,685000,50000,Derek Anderson,QB,active,carolina-panthers,735000,2011
5668,405000,322500,Jimmy Clausen,QB,active,carolina-panthers,727500,2011
5669,480000,136000,Garry Williams,G,active,carolina-panthers,616000,2011
5670,405000,204600,Brandon LaFell,WR,active,carolina-panthers,609600,2011
5671,582500,25000,Darius Butler,FS,active,carolina-panthers,607500,2011
5672,580000,25000,Gary Barnidge,TE,active,carolina-panthers,605000,2011
5673,480000,108953,Tony Fiammetta,FB,active,carolina-panthers,588953,2011
5674,405000,178460,Armanti Edwards,WR,active,carolina-panthers,583460,2011
5675,375000,175826,Terrell McClain,DE,active,carolina-panthers,550826,2011
5676,480000,52016,Jason Phillips,ILB,active,carolina-panthers,532016,2011
5677,405000,114600,Eric Norwood,LB,active,carolina-panthers,519600,2011
5678,375000,126504,Sione Fua,DT,active,carolina-panthers,501504,2011
5679,375000,124257,Brandon Hogan,CB,active,carolina-panthers,499257,2011
5680,480000,15022,Captain Munnerlyn,CB,active,carolina-panthers,495022,2011
5681,480000,10500,Mike Goodson,RB,active,carolina-panthers,490500,2011
5682,480000,10000,Geoff Schwartz,G,active,carolina-panthers,490000,2011
5683,480000,0,Richie Brockel,TE,active,carolina-panthers,480000,2011
5684,480000,0,Nick Hayden,DT,active,carolina-panthers,480000,2011
5685,480000,0,Keith Null,QB,active,carolina-panthers,480000,2011
5686,480000,0,Tyrell Sutton,RB,active,carolina-panthers,480000,2011
5687,480000,0,Jason Williams,OLB,active,carolina-panthers,480000,2011
5688,450000,0,George Selvie,DE,active,carolina-panthers,450000,2011
5689,405000,28946,Greg Hardy,DE,active,carolina-panthers,433946,2011
5690,375000,53878,Kealoha Pilares,WR,active,carolina-panthers,428878,2011
5691,405000,23512,David Gettis,WR,active,carolina-panthers,428512,2011
5692,405000,20818,Jordan Pugh,S,active,carolina-panthers,425818,2011
5693,405000,0,Andre Neblett,DT,active,carolina-panthers,405000,2011
5694,405000,0,R.J. Stanford,CB,active,carolina-panthers,405000,2011
5695,405000,0,Kion Wilson,ILB,active,carolina-panthers,405000,2011
5696,375000,19670,Zachary Williams,G,active,carolina-panthers,394670,2011
5697,375000,4667,Byron Bell,RT,active,carolina-panthers,379667,2011
5698,375000,0,Darvin Adams,WR,active,carolina-panthers,375000,2011
5699,375000,0,Bryant Browning,LT,active,carolina-panthers,375000,2011
5700,375000,0,Jeff Byers,C,active,carolina-panthers,375000,2011
5701,375000,0,James Dockery,CB,active,carolina-panthers,375000,2011
5702,375000,0,Colin Jones,FS,active,carolina-panthers,375000,2011
5703,375000,0,Thomas Keiser,OLB,active,carolina-panthers,375000,2011
5704,375000,0,Joshua Thomas,CB,active,carolina-panthers,375000,2011
5705,330000,0,Rashawn Jackson,RB,active,carolina-panthers,330000,2011
5706,172938,11475,Lee Ziemba,G,active,carolina-panthers,184413,2011
5707,770000,0,Everette Brown,OLB,dead_cap,carolina-panthers,770000,2011
5708,336562,0,Corvey Irvin,DT,dead_cap,carolina-panthers,336562,2011
5709,47312,0,Gary Barnidge,TE,dead_cap,carolina-panthers,47312,2011
5710,0,44379,R.J. Stanford,CB,dead_cap,carolina-panthers,44379,2011
5711,0,32205,Lawrence Wilson,ILB,dead_cap,carolina-panthers,32205,2011
5712,0,20286,Tony Pike,QB,dead_cap,carolina-panthers,20286,2011
5713,14075,0,Hilee Taylor,DE,dead_cap,carolina-panthers,14075,2011
5714,8500000,3000000,Jordan Gross,LT,active,carolina-panthers,11500000,2012
5715,4750000,6250000,Charles Johnson,DE,active,carolina-panthers,11000000,2012
5716,5250000,3450000,DeAngelo Williams,RB,active,carolina-panthers,8700000,2012
5717,1000000,7713111,Steve Smith,WR,active,carolina-panthers,8713111,2012
5718,1500000,3850000,Ryan Kalil,C,active,carolina-panthers,5350000,2012
5719,1376159,3629636,Cam Newton,QB,active,carolina-panthers,5005795,2012
5720,4175000,375000,Dwan Edwards,DT,active,carolina-panthers,4550000,2012
5721,2400000,1500000,James Anderson,OLB,active,carolina-panthers,3900000,2012
5722,811250,3062500,Jonathan Stewart,RB,active,carolina-panthers,3873750,2012
5723,700000,3100000,Charles Godfrey,SS,active,carolina-panthers,3800000,2012
5724,700000,2325000,Greg Olsen,TE,active,carolina-panthers,3025000,2012
5725,390000,1897018,Luke Kuechly,ILB,active,carolina-panthers,2287018,2012
5726,1125000,833333,Ron Edwards,DT,active,carolina-panthers,1958333,2012
5727,700000,1400000,Thomas Davis,OLB,active,carolina-panthers,2100000,2012
5728,1308000,15022,Captain Munnerlyn,CB,active,carolina-panthers,1323022,2012
5729,1260000,0,Louis Murphy,WR,active,carolina-panthers,1260000,2012
5730,700000,525000,Mike Tolbert,FB,active,carolina-panthers,1225000,2012
5731,840000,200000,Ben Hartsock,TE,active,carolina-panthers,1040000,2012
5732,390000,507655,Amini Silatolu,G,active,carolina-panthers,897655,2012
5733,825000,0,Geoff Hangartner,G,active,carolina-panthers,825000,2012
5734,490000,322500,Jimmy Clausen,QB,active,carolina-panthers,812500,2012
5735,550000,233333,Garry Williams,G,active,carolina-panthers,783333,2012
5736,700000,65000,Antwan Applewhite,DE,active,carolina-panthers,765000,2012
5737,615000,150000,J.J. Jansen,LS,active,carolina-panthers,765000,2012
5738,540000,204600,Brandon LaFell,WR,active,carolina-panthers,744600,2012
5739,490000,178460,Armanti Edwards,WR,active,carolina-panthers,668460,2012
5740,615000,50000,Gary Barnidge,TE,active,carolina-panthers,665000,2012
5741,615000,0,Jason Williams,OLB,active,carolina-panthers,615000,2012
5742,465000,126504,Sione Fua,DT,active,carolina-panthers,591504,2012
5743,540000,28946,Greg Hardy,DE,active,carolina-panthers,568946,2012
5744,825000,0,Derek Anderson,QB,active,carolina-panthers,825000,2012
5745,700000,65000,Jordan Senn,OLB,active,carolina-panthers,765000,2012
5746,540000,0,Richie Brockel,TE,active,carolina-panthers,540000,2012
5747,540000,0,Bruce Campbell,RT,active,carolina-panthers,540000,2012
5748,540000,0,Jason Phillips,ILB,active,carolina-panthers,540000,2012
5749,465000,53878,Kealoha Pilares,WR,active,carolina-panthers,518878,2012
5750,490000,23512,David Gettis,WR,active,carolina-panthers,513512,2012
5751,390000,117563,Frank Alexander,DE,active,carolina-panthers,507563,2012
5752,390000,116888,Joe Adams,WR,active,carolina-panthers,506888,2012
5753,490000,0,Andre Neblett,DT,active,carolina-panthers,490000,2012
5754,465000,15000,Joshua Thomas,CB,active,carolina-panthers,480000,2012
5755,465000,4667,Byron Bell,RT,active,carolina-panthers,469667,2012
5756,465000,0,Thomas Austin,C,active,carolina-panthers,465000,2012
5757,465000,0,Jeff Byers,C,active,carolina-panthers,465000,2012
5758,465000,0,James Dockery,CB,active,carolina-panthers,465000,2012
5759,465000,0,Douglas Hogue,OLB,active,carolina-panthers,465000,2012
5760,465000,0,Colin Jones,FS,active,carolina-panthers,465000,2012
5761,465000,0,Frank Kearse,DE,active,carolina-panthers,465000,2012
5762,465000,0,Armond Smith,RB,active,carolina-panthers,465000,2012
5763,390000,49750,Josh Norman,CB,active,carolina-panthers,439750,2012
5764,390000,19670,Brad Nortman,P,active,carolina-panthers,409670,2012
5765,390000,16666,Justin Medlock,K,active,carolina-panthers,406666,2012
5766,390000,15562,D.J. Campbell,S,active,carolina-panthers,405562,2012
5767,390000,0,Nate Chandler,LT,active,carolina-panthers,390000,2012
5768,390000,0,Hayworth Hicks,G,active,carolina-panthers,390000,2012
5769,390000,0,Anderson Russell,S,active,carolina-panthers,390000,2012
5770,390000,0,Zachary Williams,G,active,carolina-panthers,390000,2012
5771,465000,0,Ron Parker,FS,active,carolina-panthers,465000,2012
5772,615000,0,Graham Gano,K,active,carolina-panthers,615000,2012
5773,6750000,5000000,Chris Gamble,CB,injured_reserve,carolina-panthers,11750000,2012
5774,2639554,4250000,Jon Beason,ILB,injured_reserve,carolina-panthers,6889554,2012
5775,700000,333333,Haruki Nakamura,S,injured_reserve,carolina-panthers,1033333,2012
5776,615000,236000,Sherrod Martin,SS,injured_reserve,carolina-panthers,851000,2012
5777,700000,65000,Mike Pollak,G,injured_reserve,carolina-panthers,765000,2012
5778,615000,75000,Kenny Onatolu,LB,injured_reserve,carolina-panthers,690000,2012
5779,540000,0,Nate Ness,FS,injured_reserve,carolina-panthers,540000,2012
5780,465000,0,Thomas Keiser,OLB,injured_reserve,carolina-panthers,465000,2012
5781,390000,2500,Tauren Poole,RB,injured_reserve,carolina-panthers,392500,2012
5782,1862882,0,Travelle Wharton,G,dead_cap,carolina-panthers,1862882,2012
5783,0,1156250,Jeff Otah,T,dead_cap,carolina-panthers,1156250,2012
5784,0,1000000,Olindo Mare,K,dead_cap,carolina-panthers,1000000,2012
5785,557293,0,Jason Baker,P,dead_cap,carolina-panthers,557293,2012
5786,400000,0,John Kasay,K,dead_cap,carolina-panthers,400000,2012
5787,164117,124257,Brandon Hogan,CB,dead_cap,carolina-panthers,288374,2012
5788,175826,0,Terrell McClain,DE,dead_cap,carolina-panthers,175826,2012
5789,116250,0,Ron Parker,FS,dead_cap,carolina-panthers,116250,2012
5790,0,114600,Eric Norwood,LB,dead_cap,carolina-panthers,114600,2012
5791,108953,0,Tony Fiammetta,FB,dead_cap,carolina-panthers,108953,2012
5792,0,96615,Lawrence Wilson,ILB,dead_cap,carolina-panthers,96615,2012
5793,75000,0,Kenny Onatolu,LB,dead_cap,carolina-panthers,75000,2012
5794,0,40572,Tony Pike,QB,dead_cap,carolina-panthers,40572,2012
5795,40000,0,Reggie Smith,S,dead_cap,carolina-panthers,40000,2012
5796,0,20818,Jordan Pugh,S,dead_cap,carolina-panthers,20818,2012
5797,0,19670,Zachary Williams,G,dead_cap,carolina-panthers,19670,2012
5798,0,11475,Lee Ziemba,G,dead_cap,carolina-panthers,11475,2012
5799,10500,0,Mike Goodson,RB,dead_cap,carolina-panthers,10500,2012
5800,7500,0,Princeton McCarty,RB,dead_cap,carolina-panthers,7500,2012
5801,7500,0,Lyndon Rowells,RB,dead_cap,carolina-panthers,7500,2012
5802,2500,0,Jared Green,WR,dead_cap,carolina-panthers,2500,2012
5803,2500,0,Ryan Van Bergen,DE,dead_cap,carolina-panthers,2500,2012
5804,2500,0,Rico Wallace,WR,dead_cap,carolina-panthers,2500,2012
5805,2000,0,Nate Chandler,LT,dead_cap,carolina-panthers,2000,2012
5806,1666,0,Will Blackwell,G,dead_cap,carolina-panthers,1666,2012
5807,1333,0,Brenton Bersin,WR,dead_cap,carolina-panthers,1333,2012
5808,500,0,Matt Reynolds,G,dead_cap,carolina-panthers,500,2012
5809,1070000,7670000,Charles Johnson,DE,active,carolina-panthers,8740000,2013
5810,1500000,5483332,Thomas Davis,OLB,active,carolina-panthers,6983332,2013
5811,750000,6450000,Ryan Kalil,C,active,carolina-panthers,7200000,2013
5812,2377318,3629636,Cam Newton,QB,active,carolina-panthers,6006954,2013
5813,3750000,2000000,Steve Smith,WR,active,carolina-panthers,5750000,2013
5814,850000,4150000,DeAngelo Williams,RB,active,carolina-panthers,5000000,2013
5815,1600000,3100000,Charles Godfrey,SS,active,carolina-panthers,4700000,2013
5816,750000,3175000,Greg Olsen,TE,active,carolina-panthers,3925000,2013
5817,715000,2300000,Jonathan Stewart,RB,active,carolina-panthers,3015000,2013
5818,961755,1897018,Luke Kuechly,ILB,active,carolina-panthers,2858773,2013
5819,1000000,1525000,Mike Tolbert,FB,active,carolina-panthers,2525000,2013
5820,1000000,900000,Jordan Gross,LT,active,carolina-panthers,1900000,2013
5821,405000,1341273,Star Lotulelei,DT,active,carolina-panthers,1746273,2013
5822,850000,750000,Dwan Edwards,DT,active,carolina-panthers,1600000,2013
5823,1350000,204600,Brandon LaFell,WR,active,carolina-panthers,1554600,2013
5824,1300000,28946,Greg Hardy,DE,active,carolina-panthers,1328946,2013
5825,725000,437500,Domenik Hixon,WR,active,carolina-panthers,1162500,2013
5826,564414,557655,Amini Silatolu,G,active,carolina-panthers,1122069,2013
5827,850000,250000,Travelle Wharton,G,active,carolina-panthers,1100000,2013
5828,750000,350000,Ted Ginn Jr.,WR,active,carolina-panthers,1100000,2013
5829,750000,350000,Captain Munnerlyn,CB,active,carolina-panthers,1100000,2013
5830,850000,150000,Chase Blackburn,OLB,active,carolina-panthers,1000000,2013
5831,725000,275000,Mike Mitchell,FS,active,carolina-panthers,1000000,2013
5832,630000,322500,Jimmy Clausen,QB,active,carolina-panthers,952500,2013
5833,715000,150000,J.J. Jansen,LS,active,carolina-panthers,865000,2013
5834,405000,436879,Kawann Short,DT,active,carolina-panthers,841879,2013
5835,715000,0,Graham Gano,K,active,carolina-panthers,715000,2013
5836,630000,0,Bruce Campbell,RT,active,carolina-panthers,630000,2013
5837,630000,0,Chris Scott,G,active,carolina-panthers,630000,2013
5838,940000,65000,Quintin Mikell,S,active,carolina-panthers,1005000,2013
5839,840000,0,Colin Cole,DT,active,carolina-panthers,840000,2013
5840,840000,65000,Ben Hartsock,TE,active,carolina-panthers,905000,2013
5841,715000,65000,Jordan Senn,OLB,active,carolina-panthers,780000,2013
5842,555000,53878,Kealoha Pilares,WR,active,carolina-panthers,608878,2013
5843,480000,117563,Frank Alexander,DE,active,carolina-panthers,597563,2013
5844,555000,15000,Joshua Thomas,CB,active,carolina-panthers,570000,2013
5845,555000,4667,Byron Bell,RT,active,carolina-panthers,559667,2013
5846,840000,0,Derek Anderson,QB,active,carolina-panthers,840000,2013
5847,555000,0,Mario Addison,DE,active,carolina-panthers,555000,2013
5848,555000,0,Richie Brockel,TE,active,carolina-panthers,555000,2013
5849,555000,0,Colin Jones,FS,active,carolina-panthers,555000,2013
5850,480000,49750,Josh Norman,CB,active,carolina-panthers,529750,2013
5851,480000,19670,Brad Nortman,P,active,carolina-panthers,499670,2013
5852,940000,0,Drayton Florence,CB,active,carolina-panthers,940000,2013
5853,480000,0,Nate Chandler,LT,active,carolina-panthers,480000,2013
5854,405000,47825,A.J. Klein,ILB,active,carolina-panthers,452825,2013
5855,405000,26450,Kenjon Barner,RB,active,carolina-panthers,431450,2013
5856,405000,3333,Wes Horton,DE,active,carolina-panthers,408333,2013
5857,405000,2500,Melvin White,CB,active,carolina-panthers,407500,2013
5858,405000,0,Tavarres King,WR,active,carolina-panthers,405000,2013
5859,405000,0,Brandon Williams,TE,active,carolina-panthers,405000,2013
5860,840000,0,Geoff Hangartner,G,active,carolina-panthers,840000,2013
5861,462647,0,Jason Williams,OLB,active,carolina-panthers,462647,2013
5862,357353,0,Robert Lester,SS,active,carolina-panthers,357353,2013
5863,480000,0,Marvin McNutt,WR,active,carolina-panthers,480000,2013
5864,405000,0,Brian Folkerts,C,active,carolina-panthers,405000,2013
5865,715000,0,Dan Connor,ILB,active,carolina-panthers,715000,2013
5866,405000,0,Travis Bond,G,active,carolina-panthers,405000,2013
5867,0,23512,David Gettis,WR,active,carolina-panthers,23512,2013
5868,1025000,233333,Garry Williams,G,injured_reserve,carolina-panthers,1258333,2013
5869,555000,0,Jeff Byers,C,injured_reserve,carolina-panthers,555000,2013
5870,555000,0,James Dockery,CB,injured_reserve,carolina-panthers,555000,2013
5871,288000,114114,Edmund Kugbila,G,injured_reserve,carolina-panthers,402114,2013
5872,288000,1000,Michael Zordich,FB,injured_reserve,carolina-panthers,289000,2013
5873,288000,0,Linden Gaydosh,DT,injured_reserve,carolina-panthers,288000,2013
5874,288000,0,R.J. Webb,WR,injured_reserve,carolina-panthers,288000,2013
5875,72000,0,Tauren Poole,RB,practice_squad,carolina-panthers,72000,2013
5876,5313419,0,Jon Beason,ILB,dead_cap,carolina-panthers,5313419,2013
5877,0,5000000,Chris Gamble,CB,dead_cap,carolina-panthers,5000000,2013
5878,0,2000000,Olindo Mare,K,dead_cap,carolina-panthers,2000000,2013
5879,1862882,0,Travelle Wharton,G,dead_cap,carolina-panthers,1862882,2013
5880,0,1400000,James Anderson,OLB,dead_cap,carolina-panthers,1400000,2013
5881,833334,0,Ron Edwards,DT,dead_cap,carolina-panthers,833334,2013
5882,716666,0,Geoff Hangartner,G,dead_cap,carolina-panthers,716666,2013
5883,620000,0,D.J. Moore,CB,dead_cap,carolina-panthers,620000,2013
5884,365833,0,Haruki Nakamura,S,dead_cap,carolina-panthers,365833,2013
5885,363755,0,Armanti Edwards,WR,dead_cap,carolina-panthers,363755,2013
5886,351652,0,Terrell McClain,DE,dead_cap,carolina-panthers,351652,2013
5887,293824,0,Armond Smith,RB,dead_cap,carolina-panthers,293824,2013
5888,126504,146912,Sione Fua,DT,dead_cap,carolina-panthers,273416,2013
5889,0,248514,Brandon Hogan,CB,dead_cap,carolina-panthers,248514,2013
5890,150000,0,Kenny Onatolu,LB,dead_cap,carolina-panthers,150000,2013
5891,116888,0,Joe Adams,WR,dead_cap,carolina-panthers,116888,2013
5892,0,114600,Eric Norwood,LB,dead_cap,carolina-panthers,114600,2013
5893,83471,0,Brian Folkerts,C,dead_cap,carolina-panthers,83471,2013
5894,65000,0,Drayton Florence,CB,dead_cap,carolina-panthers,65000,2013
5895,52235,0,Ben Jacobs,ILB,dead_cap,carolina-panthers,52235,2013
5896,48000,0,Casey Walker,DT,dead_cap,carolina-panthers,48000,2013
5897,44527,0,Douglas Hogue,OLB,dead_cap,carolina-panthers,44527,2013
5898,43797,0,D.J. Campbell,S,dead_cap,carolina-panthers,43797,2013
5899,42000,0,Toney Clemons,WR,dead_cap,carolina-panthers,42000,2013
5900,0,39340,Zachary Williams,G,dead_cap,carolina-panthers,39340,2013
5901,33334,0,Justin Medlock,K,dead_cap,carolina-panthers,33334,2013
5902,0,22950,Lee Ziemba,G,dead_cap,carolina-panthers,22950,2013
5903,0,20818,Jordan Pugh,S,dead_cap,carolina-panthers,20818,2013
5904,12000,2500,Robert Lester,SS,dead_cap,carolina-panthers,14500,2013
5905,12000,0,James Shaw,WR,dead_cap,carolina-panthers,12000,2013
5906,12000,0,Jeff Tarpinian,OLB,dead_cap,carolina-panthers,12000,2013
5907,6000,0,Greg Gatson,CB,dead_cap,carolina-panthers,6000,2013
5908,6000,0,Cordell Roberson,WR,dead_cap,carolina-panthers,6000,2013
5909,5000,0,Jared Green,WR,dead_cap,carolina-panthers,5000,2013
5910,5000,0,Ryan Van Bergen,DE,dead_cap,carolina-panthers,5000,2013
5911,5000,0,Rico Wallace,WR,dead_cap,carolina-panthers,5000,2013
5912,4000,0,Nate Chandler,LT,dead_cap,carolina-panthers,4000,2013
5913,3334,0,Will Blackwell,G,dead_cap,carolina-panthers,3334,2013
5914,3000,0,Robert Jones,T,dead_cap,carolina-panthers,3000,2013
5915,2667,0,Brenton Bersin,WR,dead_cap,carolina-panthers,2667,2013
5916,2667,0,Wes Kemp,WR,dead_cap,carolina-panthers,2667,2013
5917,2333,0,Craig Roh,DE,dead_cap,carolina-panthers,2333,2013
5918,1000,0,Colby Cameron,QB,dead_cap,carolina-panthers,1000,2013
5919,1000,0,Tori Mobley,G,dead_cap,carolina-panthers,1000,2013
5920,1000,0,Matt Reynolds,G,dead_cap,carolina-panthers,1000,2013
5921,667,0,Morgan Lineberry,K,dead_cap,carolina-panthers,667,2013
5922,950000,10270000,Charles Johnson,DE,active,carolina-panthers,11220000,2014
5923,5250000,3175000,Greg Olsen,TE,active,carolina-panthers,8425000,2014
5924,855000,7229000,Ryan Kalil,C,active,carolina-panthers,8084000,2014
5925,3378477,3629636,Cam Newton,QB,active,carolina-panthers,7008113,2014
5926,1850000,4150000,DeAngelo Williams,RB,active,carolina-panthers,6000000,2014
5927,785000,5157000,Jonathan Stewart,RB,active,carolina-panthers,5942000,2014
5928,1533510,1897018,Luke Kuechly,ILB,active,carolina-panthers,3430528,2014
5929,950000,2450000,Thomas Davis,OLB,active,carolina-panthers,3400000,2014
5930,2325000,1525000,Mike Tolbert,FB,active,carolina-panthers,3850000,2014
5931,2187000,0,Byron Bell,RT,active,carolina-panthers,2187000,2014
5932,841568,1341273,Star Lotulelei,DT,active,carolina-panthers,2182841,2014
5933,1250000,787500,Dwan Edwards,DT,active,carolina-panthers,2037500,2014
5934,950000,800000,Graham Gano,K,active,carolina-panthers,1750000,2014
5935,1250000,450000,Jerricho Cotchery,WR,active,carolina-panthers,1700000,2014
5936,950000,568750,Roman Harper,SS,active,carolina-panthers,1518750,2014
5937,420000,973500,Kelvin Benjamin,WR,active,carolina-panthers,1393500,2014
5938,900000,453750,Thomas DeCoud,S,active,carolina-panthers,1353750,2014
5939,738828,607655,Amini Silatolu,G,active,carolina-panthers,1346483,2014
5940,855000,266875,Colin Cole,DT,active,carolina-panthers,1121875,2014
5941,875000,225000,Derek Anderson,QB,active,carolina-panthers,1100000,2014
5942,615470,436879,Kawann Short,DT,active,carolina-panthers,1052349,2014
5943,900000,150000,Chase Blackburn,OLB,active,carolina-panthers,1050000,2014
5944,830000,150000,J.J. Jansen,LS,active,carolina-panthers,980000,2014
5945,645000,220000,Mario Addison,DE,active,carolina-panthers,865000,2014
5946,645000,100000,Colin Jones,FS,active,carolina-panthers,745000,2014
5947,420000,224878,Kony Ealy,DE,active,carolina-panthers,644878,2014
5948,730000,65000,Ed Dickson,TE,active,carolina-panthers,795000,2014
5949,730000,65000,Fernando Velasco,G,active,carolina-panthers,795000,2014
5950,730000,65000,Joe Webb,QB,active,carolina-panthers,795000,2014
5951,570000,49750,Josh Norman,CB,active,carolina-panthers,619750,2014
5952,570000,19670,Brad Nortman,P,active,carolina-panthers,589670,2014
5953,420000,134950,Trai Turner,G,active,carolina-panthers,554950,2014
5954,495000,47825,A.J. Klein,ILB,active,carolina-panthers,542825,2014
5955,420000,101367,Tre Boston,FS,active,carolina-panthers,521367,2014
5956,495000,9000,Ben Jacobs,ILB,active,carolina-panthers,504000,2014
5957,495000,3333,Wes Horton,DE,active,carolina-panthers,498333,2014
5958,495000,2500,Melvin White,CB,active,carolina-panthers,497500,2014
5959,495000,0,Brian Folkerts,C,active,carolina-panthers,495000,2014
5960,495000,0,Fozzy Whittaker,RB,active,carolina-panthers,495000,2014
5961,495000,0,Brandon Williams,TE,active,carolina-panthers,495000,2014
5962,420000,49750,Bene Benwikere,CB,active,carolina-panthers,469750,2014
5963,645000,0,James Dockery,CB,active,carolina-panthers,645000,2014
5964,420000,9500,Brenton Bersin,WR,active,carolina-panthers,429500,2014
5965,420000,5000,Corey Brown,WR,active,carolina-panthers,425000,2014
5966,420000,4000,Andrew Norwell,G,active,carolina-panthers,424000,2014
5967,420000,0,David Foucault,T,active,carolina-panthers,420000,2014
5968,730000,0,Chris Scott,G,active,carolina-panthers,730000,2014
5969,420000,0,Adarius Taylor,OLB,active,carolina-panthers,420000,2014
5970,495000,0,Robert Lester,SS,active,carolina-panthers,495000,2014
5971,262058,0,Mike Remmers,RT,active,carolina-panthers,262058,2014
5972,100588,117563,Frank Alexander,DE,active,carolina-panthers,218151,2014
5973,420000,0,Carrington Byndom,CB,active,carolina-panthers,420000,2014
5974,495000,0,Kevin Reddick,ILB,active,carolina-panthers,495000,2014
5975,730000,0,Kyle Love,DT,active,carolina-panthers,730000,2014
5976,570000,200000,Nate Chandler,LT,injured_reserve,carolina-panthers,770000,2014
5977,650000,105000,Richie Brockel,TE,injured_reserve,carolina-panthers,755000,2014
5978,730000,0,Kevin Matthews,C,injured_reserve,carolina-panthers,730000,2014
5979,421882,130000,Garry Williams,G,injured_reserve,carolina-panthers,551882,2014
5980,318000,114114,Edmund Kugbila,G,injured_reserve,carolina-panthers,432114,2014
5981,318000,0,Kevin Hughes,T,injured_reserve,carolina-panthers,318000,2014
5982,495000,0,De'Andre Presley,WR,injured_reserve,carolina-panthers,495000,2014
5983,107100,0,Derek Dennis,G,practice_squad,carolina-panthers,107100,2014
5984,107100,0,Stephen Hill,WR,practice_squad,carolina-panthers,107100,2014
5985,107100,0,Marcus Lucas,TE,practice_squad,carolina-panthers,107100,2014
5986,63000,0,Martin Wallace,LT,practice_squad,carolina-panthers,63000,2014
5987,56700,0,Darrin Reaves,RB,practice_squad,carolina-panthers,56700,2014
5988,31500,0,Louis Young,CB,practice_squad,carolina-panthers,31500,2014
5989,25200,0,Kevin Greene,TE,practice_squad,carolina-panthers,25200,2014
5990,25200,0,Kimario McFadden,SS,practice_squad,carolina-panthers,25200,2014
5991,12600,0,Horace Miller,OLB,practice_squad,carolina-panthers,12600,2014
5992,12600,0,Micanor Regis,DT,practice_squad,carolina-panthers,12600,2014
5993,8000000,0,Jon Beason,ILB,dead_cap,carolina-panthers,8000000,2014
5994,3000000,2000000,Steve Smith,WR,dead_cap,carolina-panthers,5000000,2014
5995,1256250,3231250,Charles Godfrey,SS,dead_cap,carolina-panthers,4487500,2014
5996,0,2800000,James Anderson,OLB,dead_cap,carolina-panthers,2800000,2014
5997,0,1725000,Jordan Gross,LT,dead_cap,carolina-panthers,1725000,2014
5998,855000,195000,Jason Avant,WR,dead_cap,carolina-panthers,1050000,2014
5999,666668,0,Geoff Hangartner,G,dead_cap,carolina-panthers,666668,2014
6000,730000,65000,Antoine Cason,CB,dead_cap,carolina-panthers,795000,2014
6001,635000,0,Jason Williams,OLB,dead_cap,carolina-panthers,635000,2014
6002,365833,0,Haruki Nakamura,S,dead_cap,carolina-panthers,365833,2014
6003,301764,0,Chris Ogbonnaya,RB,dead_cap,carolina-panthers,301764,2014
6004,126504,146912,Sione Fua,DT,dead_cap,carolina-panthers,273416,2014
6005,249529,5500,Matt Blanchard,QB,dead_cap,carolina-panthers,255029,2014
6006,233776,0,Joe Adams,WR,dead_cap,carolina-panthers,233776,2014
6007,180953,8500,De'Andre Presley,WR,dead_cap,carolina-panthers,189453,2014
6008,0,175000,Tiquan Underwood,WR,dead_cap,carolina-panthers,175000,2014
6009,160835,166,Darrin Reaves,RB,dead_cap,carolina-panthers,161001,2014
6010,149717,0,Micanor Regis,DT,dead_cap,carolina-panthers,149717,2014
6011,106888,0,D.J. Smith,ILB,dead_cap,carolina-panthers,106888,2014
6012,105112,1000,Horace Miller,OLB,dead_cap,carolina-panthers,106112,2014
6013,81900,3333,Carrington Byndom,CB,dead_cap,carolina-panthers,85233,2014
6014,73218,5000,Robert Lester,SS,dead_cap,carolina-panthers,78218,2014
6015,0,65000,Mike McNeill,TE,dead_cap,carolina-panthers,65000,2014
6016,63840,0,Tauren Poole,RB,dead_cap,carolina-panthers,63840,2014
6017,56700,0,Kevin Reddick,ILB,dead_cap,carolina-panthers,56700,2014
6018,56118,0,Anderson Russell,S,dead_cap,carolina-panthers,56118,2014
6019,0,53878,Kealoha Pilares,WR,dead_cap,carolina-panthers,53878,2014
6020,44100,0,Willie Snead,WR,dead_cap,carolina-panthers,44100,2014
6021,37800,5333,Adarius Taylor,OLB,dead_cap,carolina-panthers,43133,2014
6022,31124,0,D.J. Campbell,S,dead_cap,carolina-panthers,31124,2014
6023,0,26450,Kenjon Barner,RB,dead_cap,carolina-panthers,26450,2014
6024,25200,0,Tavarres King,WR,dead_cap,carolina-panthers,25200,2014
6025,0,24150,Tyler Gaffney,RB,dead_cap,carolina-panthers,24150,2014
6026,18900,0,Casey Walker,DT,dead_cap,carolina-panthers,18900,2014
6027,0,15000,James Dockery,CB,dead_cap,carolina-panthers,15000,2014
6028,0,15000,Joshua Thomas,CB,dead_cap,carolina-panthers,15000,2014
6029,4667,9500,Craig Roh,DE,dead_cap,carolina-panthers,14167,2014
6030,12600,0,Lache Seastrunk,RB,dead_cap,carolina-panthers,12600,2014
6031,0,10000,Alex Hall,OLB,dead_cap,carolina-panthers,10000,2014
6032,9000,0,Michael Jasper,G,dead_cap,carolina-panthers,9000,2014
6033,6300,0,Andrew McDonald,RT,dead_cap,carolina-panthers,6300,2014
6034,6300,0,Chris Scott,G,dead_cap,carolina-panthers,6300,2014
6035,0,4166,Denicos Allen,OLB,dead_cap,carolina-panthers,4166,2014
6036,0,2500,Jared Wheeler,G,dead_cap,carolina-panthers,2500,2014
6037,2000,0,Colby Cameron,QB,dead_cap,carolina-panthers,2000,2014
6038,2000,0,Tori Mobley,G,dead_cap,carolina-panthers,2000,2014
6039,1334,0,Morgan Lineberry,K,dead_cap,carolina-panthers,1334,2014
6040,0,1333,Shaq Rowell,DT,dead_cap,carolina-panthers,1333,2014
6041,0,1000,D.C. Jefferson,TE,dead_cap,carolina-panthers,1000,2014
6042,0,1000,Michael Zordich,FB,dead_cap,carolina-panthers,1000,2014
6043,0,833,Marcus Lucas,TE,dead_cap,carolina-panthers,833,2014
6044,9750000,10270000,Charles Johnson,DE,active,carolina-panthers,20020000,2015
6045,1000000,12000000,Cam Newton,QB,active,carolina-panthers,13000000,2015
6046,5366000,7229000,Ryan Kalil,C,active,carolina-panthers,12595000,2015
6047,4250000,5407000,Jonathan Stewart,RB,active,carolina-panthers,9657000,2015
6048,1000000,6650000,Thomas Davis,OLB,active,carolina-panthers,7650000,2015
6049,1000000,5697018,Luke Kuechly,ILB,active,carolina-panthers,6697018,2015
6050,900000,6025000,Greg Olsen,TE,active,carolina-panthers,6925000,2015
6051,2400000,1525000,Mike Tolbert,FB,active,carolina-panthers,3925000,2015
6052,2300000,800000,Graham Gano,K,active,carolina-panthers,3100000,2015
6053,1278136,1341273,Star Lotulelei,DT,active,carolina-panthers,2619409,2015
6054,850000,1571875,Michael Oher,RT,active,carolina-panthers,2421875,2015
6055,1450000,500000,Jerricho Cotchery,WR,active,carolina-panthers,1950000,2015
6056,900000,950000,Ted Ginn Jr.,WR,active,carolina-panthers,1850000,2015
6057,1200000,600000,Roman Harper,SS,active,carolina-panthers,1800000,2015
6058,975000,789000,Derek Anderson,QB,active,carolina-panthers,1764000,2015
6059,1000000,750000,Dwan Edwards,DT,active,carolina-panthers,1750000,2015
6060,768375,973500,Kelvin Benjamin,WR,active,carolina-panthers,1741875,2015
6061,435000,1166586,Shaq Thompson,OLB,active,carolina-panthers,1601586,2015
6062,1542000,49750,Josh Norman,CB,active,carolina-panthers,1591750,2015
6063,750000,766666,Ed Dickson,TE,active,carolina-panthers,1516666,2015
6064,750000,590625,Kurt Coleman,FS,active,carolina-panthers,1340625,2015
6065,825875,436879,Kawann Short,DT,active,carolina-panthers,1262754,2015
6066,750000,270000,Mario Addison,DE,active,carolina-panthers,1020000,2015
6067,435000,568797,Devin Funchess,WR,active,carolina-panthers,1003797,2015
6068,845000,150000,J.J. Jansen,LS,active,carolina-panthers,995000,2015
6069,745000,125000,Colin Jones,FS,active,carolina-panthers,870000,2015
6070,823529,0,Jared Allen,DE,active,carolina-panthers,823529,2015
6071,581220,224878,Kony Ealy,DE,active,carolina-panthers,806098,2015
6072,660000,130000,Teddy Williams,CB,active,carolina-panthers,790000,2015
6073,745000,0,Kyle Love,DT,active,carolina-panthers,745000,2015
6074,660000,19670,Brad Nortman,P,active,carolina-panthers,679670,2015
6075,745000,80000,Chris Scott,G,active,carolina-panthers,825000,2015
6076,745000,80000,Joe Webb,QB,active,carolina-panthers,825000,2015
6077,510000,134950,Trai Turner,G,active,carolina-panthers,644950,2015
6078,585000,50000,Fozzy Whittaker,RB,active,carolina-panthers,635000,2015
6079,585000,47825,A.J. Klein,ILB,active,carolina-panthers,632825,2015
6080,510000,101367,Tre Boston,FS,active,carolina-panthers,611367,2015
6081,600000,0,Brenton Bersin,WR,active,carolina-panthers,600000,2015
6082,585000,0,Ben Jacobs,ILB,active,carolina-panthers,585000,2015
6083,585000,0,Mike Remmers,RT,active,carolina-panthers,585000,2015
6084,435000,139280,Daryl Williams,RT,active,carolina-panthers,574280,2015
6085,701176,0,Fernando Velasco,G,active,carolina-panthers,701176,2015
6086,510000,5000,Corey Brown,WR,active,carolina-panthers,515000,2015
6087,510000,4000,Andrew Norwell,G,active,carolina-panthers,514000,2015
6088,510000,0,Kevin Norwood,WR,active,carolina-panthers,510000,2015
6089,435000,41563,Cameron Artis-Payne,RB,active,carolina-panthers,476563,2015
6090,435000,41563,David Mayo,OLB,active,carolina-panthers,476563,2015
6091,435000,5000,Dean Marlowe,SS,active,carolina-panthers,440000,2015
6092,435000,833,Brandon Wegher,RB,active,carolina-panthers,435833,2015
6093,435000,0,Louis Young,CB,active,carolina-panthers,435000,2015
6094,358235,0,Ryan Delaire,DE,active,carolina-panthers,358235,2015
6095,330000,0,Scott Simonson,TE,active,carolina-panthers,330000,2015
6096,318000,5000,Arthur Miley,DE,active,carolina-panthers,323000,2015
6097,255882,0,Cortland Finnegan,CB,active,carolina-panthers,255882,2015
6098,131470,0,Robert McClain,CB,active,carolina-panthers,131470,2015
6099,963242,607655,Amini Silatolu,G,injured_reserve,carolina-panthers,1570897,2015
6100,1000000,531250,Charles Tillman,CB,injured_reserve,carolina-panthers,1531250,2015
6101,900000,250000,Nate Chandler,LT,injured_reserve,carolina-panthers,1150000,2015
6102,660000,100272,Frank Alexander,DE,injured_reserve,carolina-panthers,760272,2015
6103,585000,9500,Stephen Hill,WR,injured_reserve,carolina-panthers,594500,2015
6104,745000,0,Tyronne Green,G,injured_reserve,carolina-panthers,745000,2015
6105,478764,49750,Bene Benwikere,CB,injured_reserve,carolina-panthers,528514,2015
6106,66000,0,Nate Askew,OLB,practice_squad,carolina-panthers,66000,2015
6107,0,4666666,DeAngelo Williams,RB,dead_cap,carolina-panthers,4666666,2015
6108,0,4000000,Steve Smith,WR,dead_cap,carolina-panthers,4000000,2015
6109,0,5000000,Charles Godfrey,SS,dead_cap,carolina-panthers,5000000,2015
6110,750000,105000,Richie Brockel,TE,dead_cap,carolina-panthers,855000,2015
6111,389115,3334,Wes Horton,DE,dead_cap,carolina-panthers,392449,2015
6112,171176,80000,Colin Cole,DT,dead_cap,carolina-panthers,251176,2015
6113,0,250000,Thomas DeCoud,S,dead_cap,carolina-panthers,250000,2015
6114,0,228228,Edmund Kugbila,G,dead_cap,carolina-panthers,228228,2015
6115,187058,0,Davonte Wallace,G,dead_cap,carolina-panthers,187058,2015
6116,0,150000,Tiquan Underwood,WR,dead_cap,carolina-panthers,150000,2015
6117,112200,1666,Damiere Byrd,WR,dead_cap,carolina-panthers,113866,2015
6118,112200,1000,Chas Alecxih,DT,dead_cap,carolina-panthers,113200,2015
6119,112200,1000,Rakim Cox,DE,dead_cap,carolina-panthers,113200,2015
6120,112200,0,David Foucault,T,dead_cap,carolina-panthers,112200,2015
6121,112200,0,Louis Young,CB,dead_cap,carolina-panthers,112200,2015
6122,0,100272,Frank Alexander,DE,dead_cap,carolina-panthers,100272,2015
6123,92400,0,Marcus Ball,FS,dead_cap,carolina-panthers,92400,2015
6124,79200,10667,Adarius Taylor,OLB,dead_cap,carolina-panthers,89867,2015
6125,0,80000,Jason Trusnik,ILB,dead_cap,carolina-panthers,80000,2015
6126,0,72450,Tyler Gaffney,RB,dead_cap,carolina-panthers,72450,2015
6127,68823,0,Brandon Williams,TE,dead_cap,carolina-panthers,68823,2015
6128,66000,0,Pierce Burton,RT,dead_cap,carolina-panthers,66000,2015
6129,66000,0,Reese Dismukes,G,dead_cap,carolina-panthers,66000,2015
6130,58765,2000,Micanor Regis,DT,dead_cap,carolina-panthers,60765,2015
6131,0,52900,Kenjon Barner,RB,dead_cap,carolina-panthers,52900,2015
6132,0,50000,Mike McNeill,TE,dead_cap,carolina-panthers,50000,2015
6133,46200,833,Brian Blechen,OLB,dead_cap,carolina-panthers,47033,2015
6134,46200,0,Scott Simonson,TE,dead_cap,carolina-panthers,46200,2015
6135,0,40000,Jarrett Boykin,WR,dead_cap,carolina-panthers,40000,2015
6136,39600,0,Ras-I Dowling,CB,dead_cap,carolina-panthers,39600,2015
6137,39600,0,Eric Kush,G,dead_cap,carolina-panthers,39600,2015
6138,48823,0,Danny Aiken,LS,dead_cap,carolina-panthers,48823,2015
6139,0,20000,Jordan Todman,RB,dead_cap,carolina-panthers,20000,2015
6140,13200,0,Brenton Bersin,WR,dead_cap,carolina-panthers,13200,2015
6141,1667,11167,Marcus Lucas,TE,dead_cap,carolina-panthers,12834,2015
6142,0,9000,Derek Dennis,G,dead_cap,carolina-panthers,9000,2015
6143,0,8334,Denicos Allen,OLB,dead_cap,carolina-panthers,8334,2015
6144,0,6667,Carrington Byndom,CB,dead_cap,carolina-panthers,6667,2015
6145,6600,0,Shane McDermott,C,dead_cap,carolina-panthers,6600,2015
6146,0,5834,Darrin Reaves,RB,dead_cap,carolina-panthers,5834,2015
6147,0,5000,Darious Cummings,DT,dead_cap,carolina-panthers,5000,2015
6148,0,5000,Kimario McFadden,SS,dead_cap,carolina-panthers,5000,2015
6149,0,5000,Garry Peters,CB,dead_cap,carolina-panthers,5000,2015
6150,0,5000,Jared Wheeler,G,dead_cap,carolina-panthers,5000,2015
6151,0,2667,Shaq Rowell,DT,dead_cap,carolina-panthers,2667,2015
6152,0,2500,Melvin White,CB,dead_cap,carolina-panthers,2500,2015
6153,0,2000,Horace Miller,OLB,dead_cap,carolina-panthers,2000,2015
6154,0,1666,Steve Miller,DE,dead_cap,carolina-panthers,1666,2015
6155,0,1000,Jamie Childers,TE,dead_cap,carolina-panthers,1000,2015
6156,0,1000,Jordan McCray,G,dead_cap,carolina-panthers,1000,2015
6157,0,1000,Ronald Patrick,C,dead_cap,carolina-panthers,1000,2015
6158,0,1000,Michael Zordich,FB,dead_cap,carolina-panthers,1000,2015
6159,0,666,Terry Redden,DT,dead_cap,carolina-panthers,666,2015
6160,0,333,Lee Ward,FB,dead_cap,carolina-panthers,333,2015
6161,0,333,Matt Wile,P,dead_cap,carolina-panthers,333,2015
6162,13000000,8500000,Cam Newton,QB,active,carolina-panthers,21500000,2016
6163,5000000,5907000,Jonathan Stewart,RB,active,carolina-panthers,10907000,2016
6164,2750000,4750000,Thomas Davis,OLB,active,carolina-panthers,7500000,2016
6165,1000000,6200000,Luke Kuechly,ILB,active,carolina-panthers,7200000,2016
6166,1250000,3850000,Greg Olsen,TE,active,carolina-panthers,5100000,2016
6167,3050000,800000,Graham Gano,K,active,carolina-panthers,3850000,2016
6168,1714704,1341273,Star Lotulelei,DT,active,carolina-panthers,3055977,2016
6169,1000000,1906250,Paul Soliai,DT,active,carolina-panthers,2906250,2016
6170,1400000,1375000,Ted Ginn Jr.,WR,active,carolina-panthers,2775000,2016
6171,1000000,1600000,Kurt Coleman,FS,active,carolina-panthers,2600000,2016
6172,1800000,766666,Ed Dickson,TE,active,carolina-panthers,2566666,2016
6173,2000000,562500,Charles Johnson,DE,active,carolina-panthers,2562500,2016
6174,2553000,0,Mike Remmers,RT,active,carolina-panthers,2553000,2016
6175,1116750,973500,Kelvin Benjamin,WR,active,carolina-panthers,2090250,2016
6176,835397,1166586,Shaq Thompson,OLB,active,carolina-panthers,2001983,2016
6177,1250000,700000,Derek Anderson,QB,active,carolina-panthers,1950000,2016
6178,1350000,270000,Mario Addison,DE,active,carolina-panthers,1620000,2016
6179,450000,1076639,Vernon Butler,DT,active,carolina-panthers,1526639,2016
6180,900000,575000,Mike Tolbert,FB,active,carolina-panthers,1475000,2016
6181,1036313,436879,Kawann Short,DT,active,carolina-panthers,1473192,2016
6182,885000,140000,J.J. Jansen,LS,active,carolina-panthers,1025000,2016
6183,742439,224878,Kony Ealy,DE,active,carolina-panthers,967317,2016
6184,760000,125000,Colin Jones,FS,active,carolina-panthers,885000,2016
6185,760000,100000,Joe Webb,QB,active,carolina-panthers,860000,2016
6186,605670,147950,Trai Turner,G,active,carolina-panthers,753620,2016
6187,728823,0,Michael Griffin,FS,active,carolina-panthers,728823,2016
6188,675000,50000,Fozzy Whittaker,RB,active,carolina-panthers,725000,2016
6189,675000,47825,A.J. Klein,ILB,active,carolina-panthers,722825,2016
6190,450000,270152,James Bradberry,CB,active,carolina-panthers,720152,2016
6191,525000,139280,Daryl Williams,RT,active,carolina-panthers,664280,2016
6192,450000,195921,Daryl Worley,CB,active,carolina-panthers,645921,2016
6193,625882,0,Kyle Love,DT,active,carolina-panthers,625882,2016
6194,600000,5000,Corey Brown,WR,active,carolina-panthers,605000,2016
6195,600000,4000,Andrew Norwell,G,active,carolina-panthers,604000,2016
6196,760000,0,Leonard Johnson,CB,active,carolina-panthers,760000,2016
6197,525000,41563,Cameron Artis-Payne,RB,active,carolina-panthers,566563,2016
6198,525000,41563,David Mayo,OLB,active,carolina-panthers,566563,2016
6199,642352,80000,Chris Scott,G,active,carolina-panthers,722352,2016
6200,476472,0,Wes Horton,DE,active,carolina-panthers,476472,2016
6201,458822,0,Brenton Bersin,WR,active,carolina-panthers,458822,2016
6202,450000,6666,Jeremy Cash,OLB,active,carolina-panthers,456666,2016
6203,450000,6666,Jared Norris,OLB,active,carolina-panthers,456666,2016
6204,291170,0,Chris Manhertz,TE,active,carolina-panthers,291170,2016
6205,260294,0,Ryan Wendell,C,active,carolina-panthers,260294,2016
6206,238230,0,Tyler Larsen,C,active,carolina-panthers,238230,2016
6207,185292,0,David Yankey,G,active,carolina-panthers,185292,2016
6208,185290,0,Michael Palardy,K,active,carolina-panthers,185290,2016
6209,158824,0,Ben Jacobs,ILB,active,carolina-panthers,158824,2016
6210,158823,0,Louis Young,CB,active,carolina-panthers,158823,2016
6211,132350,0,Dan France,G,active,carolina-panthers,132350,2016
6212,26470,0,Damiere Byrd,WR,active,carolina-panthers,26470,2016
6213,26470,0,Travell Dixon,CB,active,carolina-panthers,26470,2016
6214,26470,0,Larry Webster,DE,active,carolina-panthers,26470,2016
6215,2000000,10629000,Ryan Kalil,C,injured_reserve,carolina-panthers,12629000,2016
6216,1100000,4900000,Michael Oher,RT,injured_reserve,carolina-panthers,6000000,2016
6217,2833000,0,Andy Lee,P,injured_reserve,carolina-panthers,2833000,2016
6218,685950,568797,Devin Funchess,WR,injured_reserve,carolina-panthers,1254747,2016
6219,860000,150000,Teddy Williams,CB,injured_reserve,carolina-panthers,1010000,2016
6220,775000,175000,Gino Gradkowski,C,injured_reserve,carolina-panthers,950000,2016
6221,600000,101367,Tre Boston,FS,injured_reserve,carolina-panthers,701367,2016
6222,379234,0,Ryan Delaire,DE,injured_reserve,carolina-panthers,379234,2016
6223,368823,5000,Dean Marlowe,SS,injured_reserve,carolina-panthers,373823,2016
6224,363000,0,Laron Byrd,WR,injured_reserve,carolina-panthers,363000,2016
6225,344110,0,Zack Sanchez,CB,injured_reserve,carolina-panthers,344110,2016
6226,333000,8500,Chas Alecxih,DT,injured_reserve,carolina-panthers,341500,2016
6227,333000,0,Devon Johnson,RB,injured_reserve,carolina-panthers,333000,2016
6228,333000,0,Jordan Rigsbee,T,injured_reserve,carolina-panthers,333000,2016
6229,0,4020000,Charles Johnson,DE,dead_cap,carolina-panthers,4020000,2016
6230,0,2933334,DeAngelo Williams,RB,dead_cap,carolina-panthers,2933334,2016
6231,0,1350000,Jerricho Cotchery,WR,dead_cap,carolina-panthers,1350000,2016
6232,0,900000,Roman Harper,SS,dead_cap,carolina-panthers,900000,2016
6233,625882,50000,Robert McClain,CB,dead_cap,carolina-panthers,675882,2016
6234,0,500000,Dwan Edwards,DT,dead_cap,carolina-panthers,500000,2016
6235,0,400000,Nate Chandler,LT,dead_cap,carolina-panthers,400000,2016
6236,339702,0,Donald Hawkins,G,dead_cap,carolina-panthers,339702,2016
6237,293344,0,Scott Simonson,TE,dead_cap,carolina-panthers,293344,2016
6238,238235,0,Lavar Edwards,DE,dead_cap,carolina-panthers,238235,2016
6239,208250,11334,Damiere Byrd,WR,dead_cap,carolina-panthers,219584,2016
6240,141176,49750,Bene Benwikere,CB,dead_cap,carolina-panthers,190926,2016
6241,134382,0,Larry Webster,DE,dead_cap,carolina-panthers,134382,2016
6242,122400,0,Efe Obada,DE,dead_cap,carolina-panthers,122400,2016
6243,117300,3000,Keyarris Garrett,WR,dead_cap,carolina-panthers,120300,2016
6244,117300,0,Jalen Simmons,RB,dead_cap,carolina-panthers,117300,2016
6245,110400,0,Travell Dixon,CB,dead_cap,carolina-panthers,110400,2016
6246,105882,0,Brenton Bersin,WR,dead_cap,carolina-panthers,105882,2016
6247,105880,0,Tyler Larsen,C,dead_cap,carolina-panthers,105880,2016
6248,27600,68115,Zack Sanchez,CB,dead_cap,carolina-panthers,95715,2016
6249,0,80000,Brandon Boykin,CB,dead_cap,carolina-panthers,80000,2016
6250,0,80000,Kyle Love,DT,dead_cap,carolina-panthers,80000,2016
6251,0,80000,Trenton Robinson,FS,dead_cap,carolina-panthers,80000,2016
6252,62100,14831,Beau Sandland,TE,dead_cap,carolina-panthers,76931,2016
6253,75900,0,David Yankey,G,dead_cap,carolina-panthers,75900,2016
6254,58482,7000,Marcus Ball,FS,dead_cap,carolina-panthers,65482,2016
6255,62100,0,Eric Crume,DT,dead_cap,carolina-panthers,62100,2016
6256,55200,5167,Brian Blechen,OLB,dead_cap,carolina-panthers,60367,2016
6257,55200,0,Pearce Slater,T,dead_cap,carolina-panthers,55200,2016
6258,47170,0,Louis Young,CB,dead_cap,carolina-panthers,47170,2016
6259,41400,0,Tyler Patmon,CB,dead_cap,carolina-panthers,41400,2016
6260,34500,0,Tyrus Thompson,T,dead_cap,carolina-panthers,34500,2016
6261,20700,0,Blaine Clausell,T,dead_cap,carolina-panthers,20700,2016
6262,13800,0,Bruce Gaston,DT,dead_cap,carolina-panthers,13800,2016
6263,13800,0,Jake Rodgers,T,dead_cap,carolina-panthers,13800,2016
6264,0,10000,Garry Peters,CB,dead_cap,carolina-panthers,10000,2016
6265,0,8500,Rakim Cox,DE,dead_cap,carolina-panthers,8500,2016
6266,0,8000,Jake McGee,TE,dead_cap,carolina-panthers,8000,2016
6267,6900,0,Dezmen Southward,CB,dead_cap,carolina-panthers,6900,2016
6268,6900,0,Eric Wallace,TE,dead_cap,carolina-panthers,6900,2016
6269,0,6500,David Foucault,T,dead_cap,carolina-panthers,6500,2016
6270,0,5000,Andrew Bonnet,FB,dead_cap,carolina-panthers,5000,2016
6271,0,5000,Reese Dismukes,G,dead_cap,carolina-panthers,5000,2016
6272,0,5000,Arthur Miley,DE,dead_cap,carolina-panthers,5000,2016
6273,0,3334,Steve Miller,DE,dead_cap,carolina-panthers,3334,2016
6274,0,3000,Ras-I Dowling,CB,dead_cap,carolina-panthers,3000,2016
6275,0,1334,Terry Redden,DT,dead_cap,carolina-panthers,1334,2016
6276,0,1000,Jenson Stoshak,WR,dead_cap,carolina-panthers,1000,2016
6277,0,833,Brandon Wegher,RB,dead_cap,carolina-panthers,833,2016
6278,0,667,Lee Ward,FB,dead_cap,carolina-panthers,667,2016
6279,0,667,Matt Wile,P,dead_cap,carolina-panthers,667,2016
6280,13166666,9000000,Cam Newton,QB,active,carolina-panthers,22166666,2017
6281,7363324,6600000,Luke Kuechly,ILB,active,carolina-panthers,13963324,2017
6282,6500000,5600000,Greg Olsen,TE,active,carolina-panthers,12100000,2017
6283,6000000,4000000,Kawann Short,DT,active,carolina-panthers,10000000,2017
6284,3000000,5879000,Ryan Kalil,C,active,carolina-panthers,8879000,2017
6285,6757000,0,Star Lotulelei,DT,active,carolina-panthers,6757000,2017
6286,1100000,6432000,Jonathan Stewart,RB,active,carolina-panthers,7532000,2017
6287,1000000,3354166,Mario Addison,DE,active,carolina-panthers,4354166,2017
6288,764706,3359375,Charles Johnson,DE,active,carolina-panthers,4124081,2017
6289,3200000,800000,Graham Gano,K,active,carolina-panthers,4000000,2017
6290,797000,3134950,Trai Turner,G,active,carolina-panthers,3931950,2017
6291,1000000,2750000,Julius Peppers,DE,active,carolina-panthers,3750000,2017
6292,1900000,1750000,Kurt Coleman,FS,active,carolina-panthers,3650000,2017
6293,1000000,2550000,Matt Kalil,LT,active,carolina-panthers,3550000,2017
6294,465000,2669782,Christian McCaffrey,RB,active,carolina-panthers,3134782,2017
6295,2746000,0,Andrew Norwell,G,active,carolina-panthers,2746000,2017
6296,1950000,766668,Ed Dickson,TE,active,carolina-panthers,2716668,2017
6297,900000,1600000,Captain Munnerlyn,CB,active,carolina-panthers,2500000,2017
6298,1235793,1166586,Shaq Thompson,OLB,active,carolina-panthers,2402379,2017
6299,1100000,1200000,Russell Shepard,WR,active,carolina-panthers,2300000,2017
6300,1550000,693750,Derek Anderson,QB,active,carolina-panthers,2243750,2017
6301,831660,1076639,Vernon Butler,DT,active,carolina-panthers,1908299,2017
6302,1000000,775000,Mike Adams,SS,active,carolina-panthers,1775000,2017
6303,836900,668797,Devin Funchess,WR,active,carolina-panthers,1505697,2017
6304,775000,662500,Wes Horton,DE,active,carolina-panthers,1437500,2017
6305,850000,500000,Fozzy Whittaker,RB,active,carolina-panthers,1350000,2017
6306,775000,450000,Colin Jones,FS,active,carolina-panthers,1225000,2017
6307,900000,140000,J.J. Jansen,LS,active,carolina-panthers,1040000,2017
6308,775000,187500,Kyle Love,DT,active,carolina-panthers,962500,2017
6309,630038,270152,James Bradberry,CB,active,carolina-panthers,900190,2017
6310,775000,50000,Ben Jacobs,ILB,active,carolina-panthers,825000,2017
6311,560000,215921,Daryl Worley,CB,active,carolina-panthers,775921,2017
6312,465000,291028,Taylor Moton,T,active,carolina-panthers,756028,2017
6313,615000,139280,Daryl Williams,RT,active,carolina-panthers,754280,2017
6314,775000,80000,Amini Silatolu,G,active,carolina-panthers,855000,2017
6315,615000,41563,Cameron Artis-Payne,RB,active,carolina-panthers,656563,2017
6316,615000,41563,David Mayo,OLB,active,carolina-panthers,656563,2017
6317,615000,0,Greg Van Roten,G,active,carolina-panthers,615000,2017
6318,615000,0,LaDarius Gunter,CB,active,carolina-panthers,615000,2017
6319,540000,0,Tyler Larsen,C,active,carolina-panthers,540000,2017
6320,540000,0,Michael Palardy,K,active,carolina-panthers,540000,2017
6321,540000,0,Kevon Seymour,CB,active,carolina-panthers,540000,2017
6322,688235,0,Jairus Byrd,FS,active,carolina-panthers,688235,2017
6323,410294,0,Alex Armah,FB,active,carolina-panthers,410294,2017
6324,501471,0,Andrew Gachkar,OLB,active,carolina-panthers,501471,2017
6325,382941,0,Bryan Cox Jr.,DE,active,carolina-panthers,382941,2017
6326,365292,0,Brenton Bersin,WR,active,carolina-panthers,365292,2017
6327,317650,0,Kaelin Clay,WR,active,carolina-panthers,317650,2017
6328,300883,0,Garrett Gilbert,QB,active,carolina-panthers,300883,2017
6329,180882,0,Zach Moore,DE,active,carolina-panthers,180882,2017
6330,54706,0,Mose Frazier,WR,active,carolina-panthers,54706,2017
6331,1100000,575000,Charles Johnson,WR,injured_reserve,carolina-panthers,1675000,2017
6332,423703,708397,Curtis Samuel,WR,injured_reserve,carolina-panthers,1132100,2017
6333,375522,215438,Daeshon Hall,DE,injured_reserve,carolina-panthers,590960,2017
6334,540000,0,Chris Manhertz,TE,injured_reserve,carolina-panthers,540000,2017
6335,508240,0,John Theus,T,injured_reserve,carolina-panthers,508240,2017
6336,498357,6666,Jared Norris,OLB,injured_reserve,carolina-panthers,505023,2017
6337,378000,80000,Teddy Williams,CB,injured_reserve,carolina-panthers,458000,2017
6338,456706,0,Damiere Byrd,WR,injured_reserve,carolina-panthers,456706,2017
6339,418000,0,Scott Simonson,TE,injured_reserve,carolina-panthers,418000,2017
6340,348000,69474,Corn Elder,CB,injured_reserve,carolina-panthers,417474,2017
6341,396171,0,Demetrious Cox,S,injured_reserve,carolina-panthers,396171,2017
6342,378000,0,David Yankey,G,injured_reserve,carolina-panthers,378000,2017
6343,363000,0,Dan France,G,injured_reserve,carolina-panthers,363000,2017
6344,354873,3333,Cole Luke,CB,injured_reserve,carolina-panthers,358206,2017
6345,348000,3333,Fred Ross,WR,injured_reserve,carolina-panthers,351333,2017
6346,348000,0,Drew Iddings,DE,injured_reserve,carolina-panthers,348000,2017
6347,0,3250000,Michael Oher,RT,dead_cap,carolina-panthers,3250000,2017
6348,1000000,1400000,Andy Lee,P,dead_cap,carolina-panthers,2400000,2017
6349,470588,1438625,Kelvin Benjamin,WR,dead_cap,carolina-panthers,1909213,2017
6350,0,1000000,Paul Soliai,DT,dead_cap,carolina-panthers,1000000,2017
6351,0,350000,Mike Tolbert,FB,dead_cap,carolina-panthers,350000,2017
6352,79200,204346,Zack Sanchez,CB,dead_cap,carolina-panthers,283546,2017
6353,105882,160000,Chris Scott,G,dead_cap,carolina-panthers,265882,2017
6354,0,224878,Kony Ealy,DE,dead_cap,carolina-panthers,224878,2017
6355,180353,0,Dezmen Southward,CB,dead_cap,carolina-panthers,180353,2017
6356,0,175000,Gino Gradkowski,C,dead_cap,carolina-panthers,175000,2017
6357,164118,0,Brad Kaaya,QB,dead_cap,carolina-panthers,164118,2017
6358,136765,0,Spencer Paysinger,ILB,dead_cap,carolina-panthers,136765,2017
6359,122400,0,Blaine Clausell,T,dead_cap,carolina-panthers,122400,2017
6360,122400,0,Efe Obada,DE,dead_cap,carolina-panthers,122400,2017
6361,122400,0,Damien Parms,S,dead_cap,carolina-panthers,122400,2017
6362,36176,80000,L.J. McCray,SS,dead_cap,carolina-panthers,116176,2017
6363,108000,0,Mose Frazier,WR,dead_cap,carolina-panthers,108000,2017
6364,0,101367,Tre Boston,FS,dead_cap,carolina-panthers,101367,2017
6365,100800,0,Jamaal Jones,WR,dead_cap,carolina-panthers,100800,2017
6366,0,100000,Joe Webb,QB,dead_cap,carolina-panthers,100000,2017
6367,85412,3333,Jeremy Cash,OLB,dead_cap,carolina-panthers,88745,2017
6368,86400,0,Zach Moore,DE,dead_cap,carolina-panthers,86400,2017
6369,64800,0,Evan Baylis,TE,dead_cap,carolina-panthers,64800,2017
6370,41753,20778,Harrison Butker,K,dead_cap,carolina-panthers,62531,2017
6371,57600,0,Jalen Simmons,RB,dead_cap,carolina-panthers,57600,2017
6372,14400,39633,Alex Armah,FB,dead_cap,carolina-panthers,54033,2017
6373,50400,0,Roberto Aguayo,K,dead_cap,carolina-panthers,50400,2017
6374,50400,0,Bucky Hodges,TE,dead_cap,carolina-panthers,50400,2017
6375,0,49750,Bene Benwikere,CB,dead_cap,carolina-panthers,49750,2017
6376,0,44495,Beau Sandland,TE,dead_cap,carolina-panthers,44495,2017
6377,43200,0,Garrett Gilbert,QB,dead_cap,carolina-panthers,43200,2017
6378,40588,0,Brenton Bersin,WR,dead_cap,carolina-panthers,40588,2017
6379,36000,0,Austin Duke,WR,dead_cap,carolina-panthers,36000,2017
6380,28800,0,Richie Brown,ILB,dead_cap,carolina-panthers,28800,2017
6381,21600,6000,Keyarris Garrett,WR,dead_cap,carolina-panthers,27600,2017
6382,21600,0,Rasheed Bailey,WR,dead_cap,carolina-panthers,21600,2017
6383,21600,0,Bryan Cox Jr.,DE,dead_cap,carolina-panthers,21600,2017
6384,21600,0,Kent Taylor,TE,dead_cap,carolina-panthers,21600,2017
6385,14400,0,Zeek Bigger,OLB,dead_cap,carolina-panthers,14400,2017
6386,14400,0,E.J. Biggers,CB,dead_cap,carolina-panthers,14400,2017
6387,7200,0,Eric Crume,DT,dead_cap,carolina-panthers,7200,2017
6388,0,5000,Dean Marlowe,SS,dead_cap,carolina-panthers,5000,2017
6389,0,5000,Arthur Miley,DE,dead_cap,carolina-panthers,5000,2017
6390,0,834,Brandon Wegher,RB,dead_cap,carolina-panthers,834,2017
6391,14500000,9000000,Cam Newton,QB,active,carolina-panthers,23500000,2018
6392,12500000,4500000,Kawann Short,DT,active,carolina-panthers,17000000,2018
6393,4500000,8029000,Ryan Kalil,C,active,carolina-panthers,12529000,2018
6394,5250000,3916666,Mario Addison,DE,active,carolina-panthers,9166666,2018
6395,790000,8402514,Luke Kuechly,ILB,active,carolina-panthers,9192514,2018
6396,4703000,3000000,Trai Turner,G,active,carolina-panthers,7703000,2018
6397,800000,4533333,Dontari Poe,DT,active,carolina-panthers,5333333,2018
6398,5000000,0,Torrey Smith,WR,active,carolina-panthers,5000000,2018
6399,2250000,2750000,Julius Peppers,DE,active,carolina-panthers,5000000,2018
6400,1900000,2100000,Captain Munnerlyn,CB,active,carolina-panthers,4000000,2018
6401,1248695,2669782,Christian McCaffrey,RB,active,carolina-panthers,3918477,2018
6402,2676471,1125000,Thomas Davis,OLB,active,carolina-panthers,3801471,2018
6403,1500000,925000,Mike Adams,FS,active,carolina-panthers,2425000,2018
6404,1213319,1076639,Vernon Butler,DT,active,carolina-panthers,2289958,2018
6405,480000,1551148,D.J. Moore,WR,active,carolina-panthers,2031148,2018
6406,800000,966666,Jarius Wright,WR,active,carolina-panthers,1766666,2018
6407,1087850,668799,Devin Funchess,WR,active,carolina-panthers,1756649,2018
6408,1000000,690000,Eric Reid,SS,active,carolina-panthers,1690000,2018
6409,758349,708397,Curtis Samuel,WR,active,carolina-panthers,1466746,2018
6410,915000,385000,Kyle Love,DT,active,carolina-panthers,1300000,2018
6411,900000,400000,Wes Horton,DE,active,carolina-panthers,1300000,2018
6412,630000,600000,Michael Palardy,P,active,carolina-panthers,1230000,2018
6413,1100000,75000,Colin Jones,SS,active,carolina-panthers,1175000,2018
6414,630000,466666,Tyler Larsen,C,active,carolina-panthers,1096666,2018
6415,810076,270152,James Bradberry,CB,active,carolina-panthers,1080228,2018
6416,823529,250000,Marshall Newhouse,RT,active,carolina-panthers,1073529,2018
6417,915000,140000,J.J. Jansen,LS,active,carolina-panthers,1055000,2018
6418,654007,291028,Taylor Moton,RT,active,carolina-panthers,945035,2018
6419,790000,100000,Ben Jacobs,ILB,active,carolina-panthers,890000,2018
6420,480000,395004,Donte Jackson,CB,active,carolina-panthers,875004,2018
6421,705000,75000,Greg Van Roten,G,active,carolina-panthers,780000,2018
6422,705000,41565,Cameron Artis-Payne,RB,active,carolina-panthers,746565,2018
6423,705000,41565,David Mayo,OLB,active,carolina-panthers,746565,2018
6424,480000,211914,Rashaan Gaulden,S,active,carolina-panthers,691914,2018
6425,480000,186998,Ian Thomas,TE,active,carolina-panthers,666998,2018
6426,630000,0,Chris Manhertz,TE,active,carolina-panthers,630000,2018
6427,480000,113089,Marquis Haynes,DE,active,carolina-panthers,593089,2018
6428,861176,0,Chris Clark,LT,active,carolina-panthers,861176,2018
6429,555000,0,Alex Armah,FB,active,carolina-panthers,555000,2018
6430,555000,0,Bryan Cox Jr.,DE,active,carolina-panthers,555000,2018
6431,480000,69474,Corn Elder,CB,active,carolina-panthers,549474,2018
6432,480000,68343,Jermaine Carter,ILB,active,carolina-panthers,548343,2018
6433,480000,22264,Andre Smith,ILB,active,carolina-panthers,502264,2018
6434,480000,0,Efe Obada,DE,active,carolina-panthers,480000,2018
6435,325294,0,Travaris Cadet,RB,active,carolina-panthers,325294,2018
6436,207355,0,Lorenzo Doss,CB,active,carolina-panthers,207355,2018
6437,185882,0,Chandler Catanzaro,K,active,carolina-panthers,185882,2018
6438,112940,0,Mose Frazier,WR,active,carolina-panthers,112940,2018
6439,112940,0,Taylor Hearn,G,active,carolina-panthers,112940,2018
6440,65294,0,Jason Vander Laan,TE,active,carolina-panthers,65294,2018
6441,56470,0,Kyle Allen,QB,active,carolina-panthers,56470,2018
6442,32647,0,Garrett Gilbert,QB,active,carolina-panthers,32647,2018
6443,28235,0,Dorian Johnson,G,active,carolina-panthers,28235,2018
6444,1015000,6935000,Greg Olsen,TE,injured_reserve,carolina-panthers,7950000,2018
6445,1000000,5900000,Matt Kalil,LT,injured_reserve,carolina-panthers,6900000,2018
6446,1850000,1587500,Graham Gano,K,injured_reserve,carolina-panthers,3437500,2018
6447,936000,1866776,Shaq Thompson,OLB,injured_reserve,carolina-panthers,2802776,2018
6448,900000,1700000,Ross Cockrell,CB,injured_reserve,carolina-panthers,2600000,2018
6449,1907000,139280,Daryl Williams,RT,injured_reserve,carolina-panthers,2046280,2018
6450,1000000,800000,Da'Norris Searcy,SS,injured_reserve,carolina-panthers,1800000,2018
6451,1100000,50000,Fozzy Whittaker,RB,injured_reserve,carolina-panthers,1150000,2018
6452,689000,0,Taylor Heinicke,QB,injured_reserve,carolina-panthers,689000,2018
6453,790000,90000,Amini Silatolu,G,injured_reserve,carolina-panthers,880000,2018
6454,630000,6668,Jared Norris,OLB,injured_reserve,carolina-panthers,636668,2018
6455,630000,0,Damiere Byrd,WR,injured_reserve,carolina-panthers,630000,2018
6456,630000,0,Kevon Seymour,CB,injured_reserve,carolina-panthers,630000,2018
6457,452463,4166,Brendan Mahon,G,injured_reserve,carolina-panthers,456629,2018
6458,363000,0,Elijah Hood,RB,injured_reserve,carolina-panthers,363000,2018
6459,363000,0,Jamaal Jones,WR,injured_reserve,carolina-panthers,363000,2018
6460,363000,0,Damien Parms,S,injured_reserve,carolina-panthers,363000,2018
6461,325294,0,Kenjon Barner,RB,injured_reserve,carolina-panthers,325294,2018
6462,0,2500000,Kurt Coleman,FS,dead_cap,carolina-panthers,2500000,2018
6463,0,2000000,Michael Oher,RT,dead_cap,carolina-panthers,2000000,2018
6464,800000,796875,C.J. Anderson,RB,dead_cap,carolina-panthers,1596875,2018
6465,0,2857000,Jonathan Stewart,RB,dead_cap,carolina-panthers,2857000,2018
6466,0,1400000,Russell Shepard,WR,dead_cap,carolina-panthers,1400000,2018
6467,0,391842,Daryl Worley,CB,dead_cap,carolina-panthers,391842,2018
6468,348729,0,Josh Hawkins,CB,dead_cap,carolina-panthers,348729,2018
6469,0,300000,Andy Lee,P,dead_cap,carolina-panthers,300000,2018
6470,0,260438,Daeshon Hall,DE,dead_cap,carolina-panthers,260438,2018
6471,226682,0,Lorenzo Doss,CB,dead_cap,carolina-panthers,226682,2018
6472,0,150000,Gino Gradkowski,C,dead_cap,carolina-panthers,150000,2018
6473,0,145000,LaDarius Gunter,CB,dead_cap,carolina-panthers,145000,2018
6474,114000,18745,Kendrick Norton,DT,dead_cap,carolina-panthers,132745,2018
6475,129200,3333,Cole Luke,CB,dead_cap,carolina-panthers,132533,2018
6476,129200,0,Reggie Bonnafon,RB,dead_cap,carolina-panthers,129200,2018
6477,124413,0,Corey Robinson,LT,dead_cap,carolina-panthers,124413,2018
6478,121600,0,Dorian Johnson,G,dead_cap,carolina-panthers,121600,2018
6479,0,118899,Alex Armah,FB,dead_cap,carolina-panthers,118899,2018
6480,114000,0,Jason Vander Laan,TE,dead_cap,carolina-panthers,114000,2018
6481,98800,0,Mose Frazier,WR,dead_cap,carolina-panthers,98800,2018
6482,98800,0,Taylor Hearn,G,dead_cap,carolina-panthers,98800,2018
6483,91200,0,Brandon Chubb,ILB,dead_cap,carolina-panthers,91200,2018
6484,0,90000,Jeremiah Sirles,G,dead_cap,carolina-panthers,90000,2018
6485,64059,3333,Fred Ross,WR,dead_cap,carolina-panthers,67392,2018
6486,0,65000,Kenjon Barner,RB,dead_cap,carolina-panthers,65000,2018
6487,0,62334,Harrison Butker,K,dead_cap,carolina-panthers,62334,2018
6488,60800,0,Kyle Allen,QB,dead_cap,carolina-panthers,60800,2018
6489,53200,0,DeAndrew White,WR,dead_cap,carolina-panthers,53200,2018
6490,45600,0,Dezmen Southward,CB,dead_cap,carolina-panthers,45600,2018
6491,38000,0,Connor Cook,QB,dead_cap,carolina-panthers,38000,2018
6492,30400,0,Kai Nacua,S,dead_cap,carolina-panthers,30400,2018
6493,30400,0,Ian Silberman,G,dead_cap,carolina-panthers,30400,2018
6494,15200,0,Elijah Qualls,DT,dead_cap,carolina-panthers,15200,2018
6495,15200,0,Landon Turner,G,dead_cap,carolina-panthers,15200,2018
6496,15200,0,Antwione Williams,OLB,dead_cap,carolina-panthers,15200,2018
6497,7600,0,Kiante Anderson,DE,dead_cap,carolina-panthers,7600,2018
6498,7600,0,Josh Thornton,CB,dead_cap,carolina-panthers,7600,2018
6499,0,1000,Quinterrius Eatmon,T,dead_cap,carolina-panthers,1000,2018
6500,0,1000,Kyle Friend,T,dead_cap,carolina-panthers,1000,2018
6501,0,1000,Karter Schult,DE,dead_cap,carolina-panthers,1000,2018
6502,7525000,3200000,Shaq Thompson,OLB,active,carolina-panthers,10725000,2019
6503,6500000,4135418,Mario Addison,OLB,active,carolina-panthers,10635418,2019
6504,950059,10212514,Luke Kuechly,ILB,active,carolina-panthers,11162573,2019
6505,3000000,5000000,Gerald McCoy,DE,active,carolina-panthers,8000000,2019
6506,1900000,5075000,Greg Olsen,TE,active,carolina-panthers,6975000,2019
6507,2250000,3750000,Daryl Williams,RT,active,carolina-panthers,6000000,2019
6508,805000,4304650,Trai Turner,G,active,carolina-panthers,5109650,2019
6509,2032390,2669782,Christian McCaffrey,RB,active,carolina-panthers,4702172,2019
6510,1500000,3000000,Eric Reid,SS,active,carolina-panthers,4500000,2019
6511,1000000,3300000,Matt Paradis,C,active,carolina-panthers,4300000,2019
6512,2300000,1650000,Ross Cockrell,CB,active,carolina-panthers,3950000,2019
6513,1250000,2562500,Bruce Irvin,OLB,active,carolina-panthers,3812500,2019
6514,1144980,1526639,Vernon Butler,DT,active,carolina-panthers,2671619,2019
6515,987787,1551148,D.J. Moore,WR,active,carolina-panthers,2538935,2019
6516,1500000,966666,Jarius Wright,WR,active,carolina-panthers,2466666,2019
6517,495000,1966851,Brian Burns,OLB,active,carolina-panthers,2461851,2019
6518,1125000,1150000,Tre Boston,FS,active,carolina-panthers,2275000,2019
6519,926696,833397,Curtis Samuel,WR,active,carolina-panthers,1760093,2019
6520,900000,816666,Tyler Larsen,C,active,carolina-panthers,1716666,2019
6521,800000,600000,Michael Palardy,P,active,carolina-panthers,1400000,2019
6522,930000,407500,Kyle Love,DT,active,carolina-panthers,1337500,2019
6523,930000,360000,Colin Jones,FS,active,carolina-panthers,1290000,2019
6524,825000,456250,Chris Hogan,WR,active,carolina-panthers,1281250,2019
6525,940114,320152,James Bradberry,CB,active,carolina-panthers,1260266,2019
6526,1030000,140000,J.J. Jansen,LS,active,carolina-panthers,1170000,2019
6527,843014,291028,Taylor Moton,LT,active,carolina-panthers,1134042,2019
6528,698751,395004,Donte Jackson,CB,active,carolina-panthers,1093755,2019
6529,720000,370000,Chris Manhertz,TE,active,carolina-panthers,1090000,2019
6530,570000,186998,Ian Thomas,TE,active,carolina-panthers,756998,2019
6531,720000,0,Javien Elliott,CB,active,carolina-panthers,720000,2019
6532,495000,205545,Will Grier,QB,active,carolina-panthers,700545,2019
6533,570000,113089,Marquis Haynes,OLB,active,carolina-panthers,683089,2019
6534,495000,183552,Christian Miller,DE,active,carolina-panthers,678552,2019
6535,645000,0,Alex Armah,FB,active,carolina-panthers,645000,2019
6536,570000,68343,Jermaine Carter,ILB,active,carolina-panthers,638343,2019
6537,570000,22264,Andre Smith,ILB,active,carolina-panthers,592264,2019
6538,570000,0,Efe Obada,DE,active,carolina-panthers,570000,2019
6539,570000,0,Brandon Zylstra,WR,active,carolina-panthers,570000,2019
6540,495000,31838,Dennis Daley,T,active,carolina-panthers,526838,2019
6541,495000,3333,Jordan Kunaszyk,LB,active,carolina-panthers,498333,2019
6542,495000,0,Kyle Allen,QB,active,carolina-panthers,495000,2019
6543,495000,0,Reggie Bonnafon,RB,active,carolina-panthers,495000,2019
6544,495000,0,Joey Slye,K,active,carolina-panthers,495000,2019
6545,411765,0,Mike Davis,RB,active,carolina-panthers,411765,2019
6546,235296,150000,Chris Reed,C,active,carolina-panthers,385296,2019
6547,379410,0,DeAndrew White,WR,active,carolina-panthers,379410,2019
6548,378824,0,Wes Horton,DE,active,carolina-panthers,378824,2019
6549,234706,0,Corn Elder,CB,active,carolina-panthers,234706,2019
6550,232944,0,Cole Luke,CB,active,carolina-panthers,232944,2019
6551,189412,0,Stacy McGee,DT,active,carolina-panthers,189412,2019
6552,167645,0,Woodrow Hamilton,DT,active,carolina-panthers,167645,2019
6553,84706,0,T.J. Green,S,active,carolina-panthers,84706,2019
6554,58235,0,Matt Kaskey,T,active,carolina-panthers,58235,2019
6555,16200000,9000000,Cam Newton,QB,injured_reserve,carolina-panthers,25200000,2019
6556,4500000,7183333,Dontari Poe,DT,injured_reserve,carolina-panthers,11683333,2019
6557,930000,6814000,Kawann Short,DE,injured_reserve,carolina-panthers,7744000,2019
6558,1950000,1587500,Graham Gano,K,injured_reserve,carolina-panthers,3537500,2019
6559,495000,893895,Greg Little,T,injured_reserve,carolina-panthers,1388895,2019
6560,805000,275000,Greg Van Roten,G,injured_reserve,carolina-panthers,1080000,2019
6561,460592,77353,Jordan Scarlett,RB,injured_reserve,carolina-panthers,537945,2019
6562,465174,0,Natrell Jamerson,S,injured_reserve,carolina-panthers,465174,2019
6563,398648,10000,Brandon Greene,G,injured_reserve,carolina-panthers,408648,2019
6564,393000,0,Dillon Gordon,TE,injured_reserve,carolina-panthers,393000,2019
6565,378000,5000,Marcus Baugh,TE,injured_reserve,carolina-panthers,383000,2019
6566,378000,5000,Kitt O'Brien,G,injured_reserve,carolina-panthers,383000,2019
6567,145588,0,Garrett McGhin,T,injured_reserve,carolina-panthers,145588,2019
6568,136000,0,Bijhon Jackson,DT,injured_reserve,carolina-panthers,136000,2019
6569,80000,0,Braxton Miller,WR,injured_reserve,carolina-panthers,80000,2019
6570,96000,0,Greg Gilmore,DE,practice_squad,carolina-panthers,96000,2019
6571,24000,0,Bobo Wilson,WR,practice_squad,carolina-panthers,24000,2019
6572,0,4900000,Matt Kalil,LT,dead_cap,carolina-panthers,4900000,2019
6573,0,3000000,Captain Munnerlyn,CB,dead_cap,carolina-panthers,3000000,2019
6574,1000000,0,Torrey Smith,WR,dead_cap,carolina-panthers,1000000,2019
6575,705880,0,Donte Moncrief,WR,dead_cap,carolina-panthers,705880,2019
6576,420176,241914,Rashaan Gaulden,S,dead_cap,carolina-panthers,662090,2019
6577,0,650000,Da'Norris Searcy,SS,dead_cap,carolina-panthers,650000,2019
6578,0,430876,Daeshon Hall,DE,dead_cap,carolina-panthers,430876,2019
6579,296471,0,Bryan Witzmann,G,dead_cap,carolina-panthers,296471,2019
6580,235000,0,Caleb Benenoch,RT,dead_cap,carolina-panthers,235000,2019
6581,232944,0,Ray-Ray McCloud,WR,dead_cap,carolina-panthers,232944,2019
6582,221706,0,Bryan Cox Jr.,DE,dead_cap,carolina-panthers,221706,2019
6583,200115,0,Damien Parms,S,dead_cap,carolina-panthers,200115,2019
6584,175000,0,Aldrick Robinson,WR,dead_cap,carolina-panthers,175000,2019
6585,169589,0,Greg Dortch,WR,dead_cap,carolina-panthers,169589,2019
6586,136000,6666,Elijah Holyfield,RB,dead_cap,carolina-panthers,142666,2019
6587,136000,0,Quin Blanding,S,dead_cap,carolina-panthers,136000,2019
6588,136000,0,Temarrick Hemingway,TE,dead_cap,carolina-panthers,136000,2019
6589,136000,0,Sione Teuhema,LB,dead_cap,carolina-panthers,136000,2019
6590,125118,0,Brad Lundblade,C,dead_cap,carolina-panthers,125118,2019
6591,0,90000,Cameron Artis-Payne,RB,dead_cap,carolina-panthers,90000,2019
6592,79059,5000,Destiny Vaeao,DT,dead_cap,carolina-panthers,84059,2019
6593,72000,3334,Cole Luke,CB,dead_cap,carolina-panthers,75334,2019
6594,0,75000,Jared Norris,OLB,dead_cap,carolina-panthers,75000,2019
6595,72000,0,Matt Kaskey,T,dead_cap,carolina-panthers,72000,2019
6596,0,69475,Corn Elder,CB,dead_cap,carolina-panthers,69475,2019
6597,66705,0,Kofi Amichia,C,dead_cap,carolina-panthers,66705,2019
6598,64000,0,Andre Chachere,CB,dead_cap,carolina-panthers,64000,2019
6599,0,56235,Kendrick Norton,DT,dead_cap,carolina-panthers,56235,2019
6600,56000,0,Aaron Monteiro,T,dead_cap,carolina-panthers,56000,2019
6601,56000,0,DeAndrew White,WR,dead_cap,carolina-panthers,56000,2019
6602,47353,0,Ramik Wilson,ILB,dead_cap,carolina-panthers,47353,2019
6603,24000,0,Rishard Cook,G,dead_cap,carolina-panthers,24000,2019
6604,24000,0,Greg Joseph,K,dead_cap,carolina-panthers,24000,2019
6605,0,20375,Terry Godwin,WR,dead_cap,carolina-panthers,20375,2019
6606,16000,0,Dominique Hatfield,CB,dead_cap,carolina-panthers,16000,2019
6607,16000,0,Quadree Henderson,WR,dead_cap,carolina-panthers,16000,2019
6608,16000,0,Tyron Johnson,WR,dead_cap,carolina-panthers,16000,2019
6609,16000,0,Tyler Marz,T,dead_cap,carolina-panthers,16000,2019
6610,16000,0,Garrett McGhin,T,dead_cap,carolina-panthers,16000,2019
6611,0,10000,Rashad Ross,WR,dead_cap,carolina-panthers,10000,2019
6612,0,6666,Corrion Ballard,CB,dead_cap,carolina-panthers,6666,2019
6613,0,6666,Damion Jeanpiere,WR,dead_cap,carolina-panthers,6666,2019
6614,0,5000,T.J. Barnes,DT,dead_cap,carolina-panthers,5000,2019
6615,0,5000,Jonathan Celestin,LB,dead_cap,carolina-panthers,5000,2019
6616,0,5000,Parker Collins,G,dead_cap,carolina-panthers,5000,2019
6617,0,5000,Thomas Duarte,TE,dead_cap,carolina-panthers,5000,2019
6618,0,4166,Brendan Mahon,G,dead_cap,carolina-panthers,4166,2019
6619,0,3334,Fred Ross,WR,dead_cap,carolina-panthers,3334,2019
6620,18600000,4500000,Cam Newton,QB,active,carolina-panthers,23100000,2020
6621,12000000,8314000,Kawann Short,DE,active,carolina-panthers,20314000,2020
6622,6000000,7145834,Dontari Poe,DT,active,carolina-panthers,13145834,2020
6623,8500000,4304650,Trai Turner,G,active,carolina-panthers,12804650,2020
6624,6600000,5075000,Greg Olsen,TE,active,carolina-panthers,11675000,2020
6625,5500000,3300000,Matt Paradis,C,active,carolina-panthers,8800000,2020
6626,4560000,3440000,Eric Reid,SS,active,carolina-panthers,8000000,2020
6627,4000000,3200000,Shaq Thompson,OLB,active,carolina-panthers,7200000,2020
6628,2816090,2669782,Christian McCaffrey,RB,active,carolina-panthers,5485872,2020
6629,2750000,1587500,Graham Gano,K,active,carolina-panthers,4337500,2020
6630,1900000,1766668,Jarius Wright,WR,active,carolina-panthers,3666668,2020
6631,1110463,1966851,Brian Burns,OLB,active,carolina-panthers,3077314,2020
6632,1495574,1551148,D.J. Moore,WR,active,carolina-panthers,3046722,2020
6633,2950000,50000,Mike Davis,RB,active,carolina-panthers,3000000,2020
6634,1840000,760000,Michael Palardy,P,active,carolina-panthers,2600000,2020
6635,1300000,816668,Tyler Larsen,C,active,carolina-panthers,2116668,2020
6636,1220044,833397,Curtis Samuel,WR,active,carolina-panthers,2053441,2020
6637,842224,893895,Greg Little,T,active,carolina-panthers,1736119,2020
6638,0,1500000,Mario Addison,OLB,active,carolina-panthers,1500000,2020
6639,1375000,50000,Chris Reed,C,active,carolina-panthers,1425000,2020
6640,1032021,291028,Taylor Moton,LT,active,carolina-panthers,1323049,2020
6641,917502,395004,Donte Jackson,CB,active,carolina-panthers,1312506,2020
6642,950000,360000,Colin Jones,FS,active,carolina-panthers,1310000,2020
6643,820000,390000,Chris Manhertz,TE,active,carolina-panthers,1210000,2020
6644,1045000,140000,J.J. Jansen,LS,active,carolina-panthers,1185000,2020
6645,670136,205545,Will Grier,QB,active,carolina-panthers,875681,2020
6646,660000,186998,Ian Thomas,TE,active,carolina-panthers,846998,2020
6647,660000,113089,Marquis Haynes,OLB,active,carolina-panthers,773089,2020
6648,585000,183552,Christian Miller,DE,active,carolina-panthers,768552,2020
6649,735000,6000,Marcus Murphy,RB,active,carolina-panthers,741000,2020
6650,735000,0,Alex Armah,FB,active,carolina-panthers,735000,2020
6651,735000,0,T.J. Green,S,active,carolina-panthers,735000,2020
6652,660000,68343,Jermaine Carter,ILB,active,carolina-panthers,728343,2020
6653,660000,22264,Andre Smith,ILB,active,carolina-panthers,682264,2020
6654,585000,77353,Jordan Scarlett,RB,active,carolina-panthers,662353,2020
6655,660000,0,Corn Elder,CB,active,carolina-panthers,660000,2020
6656,660000,0,Woodrow Hamilton,DT,active,carolina-panthers,660000,2020
6657,660000,0,Dominique Hatfield,CB,active,carolina-panthers,660000,2020
6658,660000,0,Temarrick Hemingway,TE,active,carolina-panthers,660000,2020
6659,660000,0,Natrell Jamerson,S,active,carolina-panthers,660000,2020
6660,660000,0,Tyler Marz,T,active,carolina-panthers,660000,2020
6661,660000,0,Efe Obada,DE,active,carolina-panthers,660000,2020
6662,660000,0,Brandon Zylstra,WR,active,carolina-panthers,660000,2020
6663,585000,31838,Dennis Daley,T,active,carolina-panthers,616838,2020
6664,585000,3333,Jordan Kunaszyk,LB,active,carolina-panthers,588333,2020
6665,585000,0,Matt Kaskey,T,active,carolina-panthers,585000,2020
6666,585000,0,Garrett McGhin,T,active,carolina-panthers,585000,2020
6667,510000,6500,Elliott Fry,K,active,carolina-panthers,516500,2020
6668,510000,6500,Ishmael Hyman,WR,active,carolina-panthers,516500,2020
6669,510000,0,Quin Blanding,S,active,carolina-panthers,510000,2020
6670,510000,0,Damion Jeanpiere,WR,active,carolina-panthers,510000,2020
6671,510000,0,Aaron Monteiro,T,active,carolina-panthers,510000,2020
6672,510000,0,Sione Teuhema,LB,active,carolina-panthers,510000,2020
6673,0,11845028,Luke Kuechly,ILB,dead_cap,carolina-panthers,11845028,2020
6674,0,9800000,Matt Kalil,LT,dead_cap,carolina-panthers,9800000,2020
6675,0,211914,Rashaan Gaulden,S,dead_cap,carolina-panthers,211914,2020
6676,0,75000,Jared Norris,OLB,dead_cap,carolina-panthers,75000,2020
6677,0,69477,Corn Elder,CB,dead_cap,carolina-panthers,69477,2020
6678,0,61125,Terry Godwin,WR,dead_cap,carolina-panthers,61125,2020
6679,0,13337,Damion Jeanpiere,WR,dead_cap,carolina-panthers,13337,2020
6680,0,13334,Corrion Ballard,CB,dead_cap,carolina-panthers,13334,2020
6681,0,13334,Elijah Holyfield,RB,dead_cap,carolina-panthers,13334,2020
6682,0,4168,Brendan Mahon,G,dead_cap,carolina-panthers,4168,2020
6683,7206000,0,Lance Briggs,OLB,active,chicago-bears,7206000,2007
6684,3950000,1907142,Brian Urlacher,LB,active,chicago-bears,5857142,2007
6685,3900000,1666666,Adewale Ogunleye,DE,active,chicago-bears,5566666,2007
6686,1045000,4327666,Charles Tillman,CB,active,chicago-bears,5372666,2007
6687,620000,4350000,Cedric Benson,RB,active,chicago-bears,4970000,2007
6688,765000,3155000,Tommie Harris,DT,active,chicago-bears,3920000,2007
6689,1915000,1200000,Muhsin Muhammad,WR,active,chicago-bears,3115000,2007
6690,2035000,1400000,Rex Grossman,QB,active,chicago-bears,3435000,2007
6691,1300000,400000,Israel Idonije,DE,active,chicago-bears,1700000,2007
6692,350000,1250000,Devin Hester,WR,active,chicago-bears,1600000,2007
6693,691250,820000,Roberto Garza,C,active,chicago-bears,1511250,2007
6694,750000,187500,Anthony Adams,DT,active,chicago-bears,937500,2007
6695,285000,770000,Greg Olsen,TE,active,chicago-bears,1055000,2007
6696,850000,168000,Bernard Berrian,WR,active,chicago-bears,1018000,2007
6697,285000,191000,Dan Bazuin,DE,active,chicago-bears,476000,2007
6698,435000,310000,Mark Bradley,WR,active,chicago-bears,745000,2007
6699,360000,485000,Danieal Manning,S,active,chicago-bears,845000,2007
6700,595000,0,Jimmy Kennedy,DT,active,chicago-bears,595000,2007
6701,435000,114500,Kyle Orton,QB,active,chicago-bears,549500,2007
6702,360000,188625,Dusty Dvoracek,DT,active,chicago-bears,548625,2007
6703,435000,35000,Darrell McClover,LB,active,chicago-bears,470000,2007
6704,360000,103750,Jamar Williams,LB,active,chicago-bears,463750,2007
6705,285000,155625,Garrett Wolfe,RB,active,chicago-bears,440625,2007
6706,285000,154375,Michael Okwo,LB,active,chicago-bears,439375,2007
6707,435000,0,Rashied Davis,WR,active,chicago-bears,435000,2007
6708,435000,0,Robbie Gould,K,active,chicago-bears,435000,2007
6709,435000,0,Lousaka Polite,RB,active,chicago-bears,435000,2007
6710,285000,98125,Josh Beekman,G,active,chicago-bears,383125,2007
6711,360000,0,Rod Wilson,LB,active,chicago-bears,360000,2007
6712,285000,37500,Kevin Payne,S,active,chicago-bears,322500,2007
6713,285000,37375,Corey Graham,FS,active,chicago-bears,322375,2007
6714,310000,4680,Matt Toeaina,DT,active,chicago-bears,314680,2007
6715,285000,13812,Trumaine McBride,CB,active,chicago-bears,298812,2007
6716,205000,0,J.D. Runnels,RB,active,chicago-bears,205000,2007
6717,100588,0,Nick Roach,ILB,active,chicago-bears,100588,2007
6718,45000,0,Babatunde Oshinowo,DT,active,chicago-bears,45000,2007
6719,850000,2014166,Nathan Vasher,CB,injured_reserve,chicago-bears,2864166,2007
6720,360000,39137,Mark Anderson,DE,injured_reserve,chicago-bears,399137,2007
6721,0,875000,Thomas Jones,RB,dead_cap,chicago-bears,875000,2007
6722,345000,0,Tank Johnson,DT,dead_cap,chicago-bears,345000,2007
6723,139200,0,Airese Currie,WR,dead_cap,chicago-bears,139200,2007
6724,61101,0,Tyler Reed,G,dead_cap,chicago-bears,61101,2007
6725,25000,0,Chris Harris,S,dead_cap,chicago-bears,25000,2007
6726,21250,0,J.D. Runnels,RB,dead_cap,chicago-bears,21250,2007
6727,10525,0,Aaron Brant,T,dead_cap,chicago-bears,10525,2007
6728,2250000,7466666,Charles Tillman,CB,active,chicago-bears,9716666,2008
6729,605000,6735000,Tommie Harris,DT,active,chicago-bears,7340000,2008
6730,4700000,1666666,Adewale Ogunleye,DE,active,chicago-bears,6366666,2008
6731,2124999,3607142,Brian Urlacher,LB,active,chicago-bears,5732141,2008
6732,805000,4666667,Lance Briggs,OLB,active,chicago-bears,5471667,2008
6733,295000,3452000,Chris Williams,G,active,chicago-bears,3747000,2008
6734,520000,2100000,Robbie Gould,K,active,chicago-bears,2620000,2008
6735,1500000,1000000,Rex Grossman,QB,active,chicago-bears,2500000,2008
6736,1300000,914500,Kyle Orton,QB,active,chicago-bears,2214500,2008
6737,1500000,400000,Israel Idonije,DE,active,chicago-bears,1900000,2008
6738,445000,1250000,Devin Hester,WR,active,chicago-bears,1695000,2008
6739,730000,820000,Roberto Garza,C,active,chicago-bears,1550000,2008
6740,370000,1822500,Greg Olsen,TE,active,chicago-bears,2192500,2008
6741,295000,911500,Matt Forte,RB,active,chicago-bears,1206500,2008
6742,800000,187500,Anthony Adams,DT,active,chicago-bears,987500,2008
6743,520000,366667,Rashied Davis,WR,active,chicago-bears,886667,2008
6744,800000,0,Dan Buenning,G,active,chicago-bears,800000,2008
6745,445000,485000,Danieal Manning,S,active,chicago-bears,930000,2008
6746,295000,418985,Kellen Davis,TE,active,chicago-bears,713985,2008
6747,605000,40000,Brandon Lloyd,WR,active,chicago-bears,645000,2008
6748,445000,188625,Dusty Dvoracek,DT,active,chicago-bears,633625,2008
6749,445000,103750,Jamar Williams,LB,active,chicago-bears,548750,2008
6750,510000,35000,Darrell McClover,LB,active,chicago-bears,545000,2008
6751,370000,155625,Garrett Wolfe,RB,active,chicago-bears,525625,2008
6752,295000,205209,Earl Bennett,WR,active,chicago-bears,500209,2008
6753,445000,39137,Mark Anderson,DE,active,chicago-bears,484137,2008
6754,370000,98125,Josh Beekman,G,active,chicago-bears,468125,2008
6755,295000,163651,Marcus Harrison,DT,active,chicago-bears,458651,2008
6756,605000,0,Kevin Jones,RB,active,chicago-bears,605000,2008
6757,370000,37500,Kevin Payne,S,active,chicago-bears,407500,2008
6758,370000,37375,Corey Graham,FS,active,chicago-bears,407375,2008
6759,295000,111476,Craig Steltz,S,active,chicago-bears,406476,2008
6760,370000,13812,Trumaine McBride,CB,active,chicago-bears,383812,2008
6761,370000,4680,Matt Toeaina,DT,active,chicago-bears,374680,2008
6762,370000,0,Devin Aromashodu,WR,active,chicago-bears,370000,2008
6763,370000,0,Nick Roach,ILB,active,chicago-bears,370000,2008
6764,295000,1666,Caleb Hanie,QB,active,chicago-bears,296666,2008
6765,295000,0,Ervin Baldwin,DE,active,chicago-bears,295000,2008
6766,295000,0,Zackary Bowman,CB,active,chicago-bears,295000,2008
6767,295000,0,Joey LaRocque,LB,active,chicago-bears,295000,2008
6768,750000,4466666,Nathan Vasher,CB,injured_reserve,chicago-bears,5216666,2008
6769,3600000,0,Muhsin Muhammad,WR,dead_cap,chicago-bears,3600000,2008
6770,0,4350000,Cedric Benson,RB,dead_cap,chicago-bears,4350000,2008
6771,460000,0,Mark Bradley,WR,dead_cap,chicago-bears,460000,2008
6772,345000,0,Tank Johnson,DT,dead_cap,chicago-bears,345000,2008
6773,191000,0,Dan Bazuin,DE,dead_cap,chicago-bears,191000,2008
6774,154375,0,Michael Okwo,LB,dead_cap,chicago-bears,154375,2008
6775,42500,0,J.D. Runnels,RB,dead_cap,chicago-bears,42500,2008
6776,31575,0,Aaron Brant,T,dead_cap,chicago-bears,31575,2008
6777,25000,0,Chris Harris,S,dead_cap,chicago-bears,25000,2008
6778,18906,0,Kirk Barton,T,dead_cap,chicago-bears,18906,2008
6779,16250,0,Ervin Baldwin,DE,dead_cap,chicago-bears,16250,2008
6780,13875,0,Chester Adams,G,dead_cap,chicago-bears,13875,2008
6781,9250,0,Marcus Monk,WR,dead_cap,chicago-bears,9250,2008
6782,10034999,1500000,Jay Cutler,QB,active,chicago-bears,11534999,2009
6783,620000,8795000,Tommie Harris,DT,active,chicago-bears,9415000,2009
6784,4950000,4057142,Brian Urlacher,LB,active,chicago-bears,9007142,2009
6785,1100000,5666667,Lance Briggs,OLB,active,chicago-bears,6766667,2009
6786,620000,450000,Frank Omiyale,T,active,chicago-bears,1070000,2009
6787,2900000,1966666,Nathan Vasher,CB,active,chicago-bears,4866666,2009
6788,2250000,2466666,Charles Tillman,CB,active,chicago-bears,4716666,2009
6789,750000,2150000,Robbie Gould,K,active,chicago-bears,2900000,2009
6790,1750000,400000,Israel Idonije,DE,active,chicago-bears,2150000,2009
6791,550000,1250000,Devin Hester,WR,active,chicago-bears,1800000,2009
6792,385000,2326000,Chris Williams,G,active,chicago-bears,2711000,2009
6793,765000,366667,Rashied Davis,WR,active,chicago-bears,1131667,2009
6794,745000,820000,Roberto Garza,C,active,chicago-bears,1565000,2009
6795,460000,1922500,Greg Olsen,TE,active,chicago-bears,2382500,2009
6796,675000,500000,Josh Bullocks,S,active,chicago-bears,1175000,2009
6797,850000,187500,Anthony Adams,DT,active,chicago-bears,1037500,2009
6798,1010000,39137,Mark Anderson,DE,active,chicago-bears,1049137,2009
6799,650000,350000,Michael Gaines,TE,active,chicago-bears,1000000,2009
6800,900000,0,Gaines Adams,DE,active,chicago-bears,900000,2009
6801,535000,485000,Danieal Manning,S,active,chicago-bears,1020000,2009
6802,385000,418985,Kellen Davis,TE,active,chicago-bears,803985,2009
6803,385000,383333,Matt Forte,RB,active,chicago-bears,768333,2009
6804,310000,331510,Jarron Gilbert,DE,active,chicago-bears,641510,2009
6805,535000,103750,Jamar Williams,LB,active,chicago-bears,638750,2009
6806,460000,155625,Garrett Wolfe,RB,active,chicago-bears,615625,2009
6807,385000,205209,Earl Bennett,WR,active,chicago-bears,590209,2009
6808,460000,98125,Josh Beekman,G,active,chicago-bears,558125,2009
6809,385000,163651,Marcus Harrison,DT,active,chicago-bears,548651,2009
6810,310000,201666,Juaquin Iglesias,WR,active,chicago-bears,511666,2009
6811,460000,37500,Kevin Payne,S,active,chicago-bears,497500,2009
6812,460000,37375,Corey Graham,FS,active,chicago-bears,497375,2009
6813,385000,111476,Craig Steltz,S,active,chicago-bears,496476,2009
6814,470000,4680,Matt Toeaina,DT,active,chicago-bears,474680,2009
6815,620000,0,Darrell McClover,LB,active,chicago-bears,620000,2009
6816,460000,0,Devin Aromashodu,WR,active,chicago-bears,460000,2009
6817,460000,0,James Marten,T,active,chicago-bears,460000,2009
6818,460000,0,Trumaine McBride,CB,active,chicago-bears,460000,2009
6819,460000,0,Nick Roach,ILB,active,chicago-bears,460000,2009
6820,460000,0,Tim Shaw,OLB,active,chicago-bears,460000,2009
6821,310000,127807,Henry Melton,DT,active,chicago-bears,437807,2009
6822,310000,116688,D.J. Moore,CB,active,chicago-bears,426688,2009
6823,395000,0,Kahlil Bell,RB,active,chicago-bears,395000,2009
6824,385000,1666,Caleb Hanie,QB,active,chicago-bears,386666,2009
6825,310000,51060,Johnny Knox,WR,active,chicago-bears,361060,2009
6826,310000,45425,Marcus Freeman,LB,active,chicago-bears,355425,2009
6827,310000,25150,Al Afalava,S,active,chicago-bears,335150,2009
6828,310000,10495,Lance Louis,G,active,chicago-bears,320495,2009
6829,310000,0,Zackary Bowman,CB,active,chicago-bears,310000,2009
6830,88840,0,Ervin Baldwin,DE,active,chicago-bears,88840,2009
6831,4800000,1666668,Adewale Ogunleye,DE,injured_reserve,chicago-bears,6466668,2009
6832,900000,850000,Kevin Jones,RB,injured_reserve,chicago-bears,1750000,2009
6833,0,4350000,Cedric Benson,RB,dead_cap,chicago-bears,4350000,2009
6834,700000,0,Kyle Orton,QB,dead_cap,chicago-bears,700000,2009
6835,460000,0,Mark Bradley,WR,dead_cap,chicago-bears,460000,2009
6836,382000,0,Dan Bazuin,DE,dead_cap,chicago-bears,382000,2009
6837,308750,0,Michael Okwo,LB,dead_cap,chicago-bears,308750,2009
6838,188625,0,Dusty Dvoracek,DT,dead_cap,chicago-bears,188625,2009
6839,56718,0,Kirk Barton,T,dead_cap,chicago-bears,56718,2009
6840,48750,0,Ervin Baldwin,DE,dead_cap,chicago-bears,48750,2009
6841,45425,0,Marcus Freeman,LB,dead_cap,chicago-bears,45425,2009
6842,41625,0,Chester Adams,G,dead_cap,chicago-bears,41625,2009
6843,41100,0,Joey LaRocque,LB,dead_cap,chicago-bears,41100,2009
6844,27750,0,Marcus Monk,WR,dead_cap,chicago-bears,27750,2009
6845,13812,0,Trumaine McBride,CB,dead_cap,chicago-bears,13812,2009
6846,900000,13883333,Julius Peppers,DE,active,chicago-bears,14783333,2010
6847,6150000,3500000,Brian Urlacher,LB,active,chicago-bears,9650000,2010
6848,7000000,1900000,Jay Cutler,QB,active,chicago-bears,8900000,2010
6849,3145000,4216667,Lance Briggs,OLB,active,chicago-bears,7361667,2010
6850,750000,6083333,Devin Hester,WR,active,chicago-bears,6833333,2010
6851,2200000,4545000,Chester Taylor,RB,active,chicago-bears,6745000,2010
6852,1235000,4625000,Tommie Harris,DT,active,chicago-bears,5860000,2010
6853,3350000,1466666,Charles Tillman,CB,active,chicago-bears,4816666,2010
6854,1055000,400000,Brandon Manumaleuna,TE,active,chicago-bears,1455000,2010
6855,2400000,0,Israel Idonije,DE,active,chicago-bears,2400000,2010
6856,1310000,820000,Roberto Garza,C,active,chicago-bears,2130000,2010
6857,740000,2326000,Chris Williams,G,active,chicago-bears,3066000,2010
6858,1250000,450000,Frank Omiyale,T,active,chicago-bears,1700000,2010
6859,1600000,150000,Robbie Gould,K,active,chicago-bears,1750000,2010
6860,1684000,0,Nick Roach,ILB,active,chicago-bears,1684000,2010
6861,550000,1962500,Greg Olsen,TE,active,chicago-bears,2512500,2010
6862,800000,0,Chris Harris,S,active,chicago-bears,800000,2010
6863,935000,366667,Rashied Davis,WR,active,chicago-bears,1301667,2010
6864,1050000,187500,Anthony Adams,DT,active,chicago-bears,1237500,2010
6865,742500,500000,Josh Bullocks,S,active,chicago-bears,1242500,2010
6866,1176000,0,Danieal Manning,S,active,chicago-bears,1176000,2010
6867,1101000,37375,Corey Graham,FS,active,chicago-bears,1138375,2010
6868,1000000,0,Todd Collins,QB,active,chicago-bears,1000000,2010
6869,770000,186666,Patrick Mannelly,LS,active,chicago-bears,956666,2010
6870,470000,418985,Kellen Davis,TE,active,chicago-bears,888985,2010
6871,470000,400000,Matt Toeaina,DT,active,chicago-bears,870000,2010
6872,470000,383333,Matt Forte,RB,active,chicago-bears,853333,2010
6873,550000,155625,Garrett Wolfe,RB,active,chicago-bears,705625,2010
6874,470000,205209,Earl Bennett,WR,active,chicago-bears,675209,2010
6875,470000,163651,Marcus Harrison,DT,active,chicago-bears,633651,2010
6876,475000,111476,Craig Steltz,S,active,chicago-bears,586476,2010
6877,545000,0,Devin Aromashodu,WR,active,chicago-bears,545000,2010
6878,545000,0,Rod Wilson,LB,active,chicago-bears,545000,2010
6879,538640,0,Tim Jennings,CB,active,chicago-bears,538640,2010
6880,395000,116688,D.J. Moore,CB,active,chicago-bears,511688,2010
6881,320000,169825,Major Wright,S,active,chicago-bears,489825,2010
6882,475000,1666,Caleb Hanie,QB,active,chicago-bears,476666,2010
6883,320000,127807,Henry Melton,DT,active,chicago-bears,447807,2010
6884,320000,126793,Corey Wootton,DT,active,chicago-bears,446793,2010
6885,395000,51060,Johnny Knox,WR,active,chicago-bears,446060,2010
6886,395000,10495,Lance Louis,G,active,chicago-bears,405495,2010
6887,395000,0,Zackary Bowman,CB,active,chicago-bears,395000,2010
6888,320000,49500,Joshua Moore,CB,active,chicago-bears,369500,2010
6889,320000,15153,J'Marcus Webb,RT,active,chicago-bears,335153,2010
6890,310000,14062,Harvey Unga,FB,active,chicago-bears,324062,2010
6891,88840,0,Ervin Baldwin,DE,active,chicago-bears,88840,2010
6892,225000,0,Averell Spicer,DT,injured_reserve,chicago-bears,225000,2010
6893,0,5750007,Nathan Vasher,CB,dead_cap,chicago-bears,5750007,2010
6894,0,250000,Kevin Jones,RB,dead_cap,chicago-bears,250000,2010
6895,185000,0,Jarron Gilbert,DE,dead_cap,chicago-bears,185000,2010
6896,90850,0,Marcus Freeman,LB,dead_cap,chicago-bears,90850,2010
6897,82200,0,Joey LaRocque,LB,dead_cap,chicago-bears,82200,2010
6898,75450,0,Al Afalava,S,dead_cap,chicago-bears,75450,2010
6899,37500,0,Kevin Payne,S,dead_cap,chicago-bears,37500,2010
6900,0,26918,Dan LeFevour,QB,dead_cap,chicago-bears,26918,2010
6901,13812,0,Trumaine McBride,CB,dead_cap,chicago-bears,13812,2010
6902,8025000,3800000,Brian Urlacher,LB,active,chicago-bears,11825000,2011
6903,7600000,1900000,Jay Cutler,QB,active,chicago-bears,9500000,2011
6904,3400000,1716666,Charles Tillman,CB,active,chicago-bears,5116666,2011
6905,4775000,0,Roberto Garza,C,active,chicago-bears,4775000,2011
6906,3650000,916667,Lance Briggs,OLB,active,chicago-bears,4566667,2011
6907,900000,3483333,Julius Peppers,DE,active,chicago-bears,4383333,2011
6908,2250000,1000000,Brandon Meriweather,SS,active,chicago-bears,3250000,2011
6909,1000000,1900000,Adam Podlesh,P,active,chicago-bears,2900000,2011
6910,2100000,450000,Frank Omiyale,T,active,chicago-bears,2550000,2011
6911,1583500,1083333,Devin Hester,WR,active,chicago-bears,2666833,2011
6912,1200000,1405210,Earl Bennett,WR,active,chicago-bears,2605210,2011
6913,2400000,100000,Israel Idonije,DE,active,chicago-bears,2500000,2011
6914,1000000,1333333,Matt Spaeth,TE,active,chicago-bears,2333333,2011
6915,1095250,2326000,Chris Williams,G,active,chicago-bears,3421250,2011
6916,2000000,250000,Marion Barber,RB,active,chicago-bears,2250000,2011
6917,1250000,1000000,Chris Spencer,G,active,chicago-bears,2250000,2011
6918,1650000,500000,Robbie Gould,K,active,chicago-bears,2150000,2011
6919,1500000,500000,Roy Williams,WR,active,chicago-bears,2000000,2011
6920,1100000,750000,Anthony Adams,DT,active,chicago-bears,1850000,2011
6921,1095000,0,Chris Harris,S,active,chicago-bears,1095000,2011
6922,685000,1000000,Nick Roach,ILB,active,chicago-bears,1685000,2011
6923,1400000,0,Tim Jennings,CB,active,chicago-bears,1400000,2011
6924,1300000,82500,Amobi Okoye,DT,active,chicago-bears,1382500,2011
6925,1300000,82500,Amobi Okoye,DT,active,chicago-bears,1382500,2011
6926,1200000,163651,Marcus Harrison,DT,active,chicago-bears,1363651,2011
6927,1300000,0,Corey Graham,FS,active,chicago-bears,1300000,2011
6928,375000,907918,Gabe Carimi,G,active,chicago-bears,1282918,2011
6929,1200000,0,Zackary Bowman,CB,active,chicago-bears,1200000,2011
6930,1200000,0,Caleb Hanie,QB,active,chicago-bears,1200000,2011
6931,640000,500000,Matt Toeaina,DT,active,chicago-bears,1140000,2011
6932,865000,186666,Patrick Mannelly,LS,active,chicago-bears,1051666,2011
6933,600000,383333,Matt Forte,RB,active,chicago-bears,983333,2011
6934,555000,418985,Kellen Davis,TE,active,chicago-bears,973985,2011
6935,564117,0,Sam Hurd,WR,active,chicago-bears,564117,2011
6936,450000,335225,Major Wright,S,active,chicago-bears,785225,2011
6937,565000,111476,Craig Steltz,S,active,chicago-bears,676476,2011
6938,375000,295164,Stephen Paea,DT,active,chicago-bears,670164,2011
6939,480000,127807,Henry Melton,DT,active,chicago-bears,607807,2011
6940,480000,116688,D.J. Moore,CB,active,chicago-bears,596688,2011
6941,555000,0,Xavier Adibi,LB,active,chicago-bears,555000,2011
6942,405000,126793,Corey Wootton,DT,active,chicago-bears,531793,2011
6943,480000,51060,Johnny Knox,WR,active,chicago-bears,531060,2011
6944,375000,133400,Christopher Conte,FS,active,chicago-bears,508400,2011
6945,480000,10495,Lance Louis,G,active,chicago-bears,490495,2011
6946,480000,0,Kahlil Bell,RB,active,chicago-bears,480000,2011
6947,480000,0,Edwin Williams,C,active,chicago-bears,480000,2011
6948,450000,15153,J'Marcus Webb,RT,active,chicago-bears,465153,2011
6949,375000,42215,Nathan Enderle,QB,active,chicago-bears,417215,2011
6950,405000,1500,Max Komar,WR,active,chicago-bears,406500,2011
6951,375000,23129,J.T. Thomas,OLB,active,chicago-bears,398129,2011
6952,390000,0,Max Komar,WR,active,chicago-bears,390000,2011
6953,375000,1668,Kyle Adams,TE,active,chicago-bears,376668,2011
6954,375000,0,Armando Allen,RB,active,chicago-bears,375000,2011
6955,375000,0,Tyler Clutts,FB,active,chicago-bears,375000,2011
6956,375000,0,Dom DeCicco,ILB,active,chicago-bears,375000,2011
6957,375000,0,Thaddeus Gibson,DE,active,chicago-bears,375000,2011
6958,375000,0,Ricky Henry,G,active,chicago-bears,375000,2011
6959,375000,0,Levi Horn,T,active,chicago-bears,375000,2011
6960,375000,0,Anthony Walters,SS,active,chicago-bears,375000,2011
6961,375000,0,Jabara Williams,OLB,active,chicago-bears,375000,2011
6962,330000,14062,Harvey Unga,FB,active,chicago-bears,344062,2011
6963,0,3250000,Tommie Harris,DT,dead_cap,chicago-bears,3250000,2011
6964,936250,0,Greg Olsen,TE,dead_cap,chicago-bears,936250,2011
6965,750000,0,Chester Taylor,RB,dead_cap,chicago-bears,750000,2011
6966,450000,0,Sam Hurd,WR,dead_cap,chicago-bears,450000,2011
6967,400000,0,Brandon Manumaleuna,TE,dead_cap,chicago-bears,400000,2011
6968,370000,0,Jarron Gilbert,DE,dead_cap,chicago-bears,370000,2011
6969,0,250000,Vernon Gholston,LB,dead_cap,chicago-bears,250000,2011
6970,98125,0,Josh Beekman,G,dead_cap,chicago-bears,98125,2011
6971,0,80754,Dan LeFevour,QB,dead_cap,chicago-bears,80754,2011
6972,0,49500,Joshua Moore,CB,dead_cap,chicago-bears,49500,2011
6973,0,1750,Mario Addison,DE,dead_cap,chicago-bears,1750,2011
6974,8900000,3283333,Julius Peppers,DE,active,chicago-bears,12183333,2012
6975,7500000,2200000,Brian Urlacher,LB,active,chicago-bears,9700000,2012
6976,7700000,1900000,Jay Cutler,QB,active,chicago-bears,9600000,2012
6977,9300000,200000,Brandon Marshall,WR,active,chicago-bears,9500000,2012
6978,800000,6000000,Matt Forte,RB,active,chicago-bears,6800000,2012
6979,3500000,1716668,Charles Tillman,CB,active,chicago-bears,5216668,2012
6980,3000000,1666666,Lance Briggs,OLB,active,chicago-bears,4666666,2012
6981,2750000,1500000,Chris Spencer,G,active,chicago-bears,4250000,2012
6982,1400000,2100000,Jason Campbell,QB,active,chicago-bears,3500000,2012
6983,2325000,500000,Robbie Gould,K,active,chicago-bears,2825000,2012
6984,1715000,1100000,Nick Roach,ILB,active,chicago-bears,2815000,2012
6985,1000000,1800000,Earl Bennett,WR,active,chicago-bears,2800000,2012
6986,1646000,1083333,Devin Hester,WR,active,chicago-bears,2729333,2012
6987,900000,1600000,Israel Idonije,DE,active,chicago-bears,2500000,2012
6988,900000,1600000,Tim Jennings,CB,active,chicago-bears,2500000,2012
6989,700000,1450000,Kellen Davis,TE,active,chicago-bears,2150000,2012
6990,950000,1000000,Michael Bush,RB,active,chicago-bears,1950000,2012
6991,1750000,75000,Roberto Garza,C,active,chicago-bears,1825000,2012
6992,1275000,433333,Matt Spaeth,TE,active,chicago-bears,1708333,2012
6993,1000000,675000,Adam Podlesh,P,active,chicago-bears,1675000,2012
6994,695729,907918,Gabe Carimi,G,active,chicago-bears,1603647,2012
6995,700000,500000,Matt Toeaina,DT,active,chicago-bears,1200000,2012
6996,390000,1112436,Shea McClellin,OLB,active,chicago-bears,1502436,2012
6997,1260000,51060,Johnny Knox,WR,active,chicago-bears,1311060,2012
6998,700000,525000,Eric Weems,WR,active,chicago-bears,1225000,2012
6999,825000,236666,Patrick Mannelly,LS,active,chicago-bears,1061666,2012
7000,700000,300000,Blake Costanzo,OLB,active,chicago-bears,1000000,2012
7001,542541,295164,Stephen Paea,DT,active,chicago-bears,837705,2012
7002,390000,436879,Alshon Jeffery,WR,active,chicago-bears,826879,2012
7003,540000,169825,Major Wright,S,active,chicago-bears,709825,2012
7004,700000,0,Amobi Okoye,DT,active,chicago-bears,700000,2012
7005,700000,0,Devin Thomas,WR,active,chicago-bears,700000,2012
7006,565000,127807,Henry Melton,DT,active,chicago-bears,692807,2012
7007,565000,116688,D.J. Moore,CB,active,chicago-bears,681688,2012
7008,490000,126793,Corey Wootton,DT,active,chicago-bears,616793,2012
7009,615000,0,Kahlil Bell,RB,active,chicago-bears,615000,2012
7010,465000,143400,Christopher Conte,FS,active,chicago-bears,608400,2012
7011,540000,15153,J'Marcus Webb,RT,active,chicago-bears,555153,2012
7012,825000,65000,Kelvin Hayden,CB,active,chicago-bears,890000,2012
7013,825000,50000,Josh McCown,QB,active,chicago-bears,875000,2012
7014,700000,0,Lorenzo Booker,RB,active,chicago-bears,700000,2012
7015,700000,120000,Geno Hayes,OLB,active,chicago-bears,820000,2012
7016,700000,0,Jonathan Scott,LT,active,chicago-bears,700000,2012
7017,700000,0,Mansfield Wrotto,G,active,chicago-bears,700000,2012
7018,540000,0,Nate Collins,DT,active,chicago-bears,540000,2012
7019,540000,0,Brody Eldridge,TE,active,chicago-bears,540000,2012
7020,540000,0,Sherrick McManis,CB,active,chicago-bears,540000,2012
7021,540000,0,Troy Nolan,S,active,chicago-bears,540000,2012
7022,540000,0,DeMario Pressley,DT,active,chicago-bears,540000,2012
7023,390000,111300,Evan Rodriguez,FB,active,chicago-bears,501300,2012
7024,490000,0,Edwin Williams,C,active,chicago-bears,490000,2012
7025,465000,1668,Kyle Adams,TE,active,chicago-bears,466668,2012
7026,465000,0,Dom DeCicco,ILB,active,chicago-bears,465000,2012
7027,465000,0,Jeremy Ware,CB,active,chicago-bears,465000,2012
7028,390000,23129,J.T. Thomas,OLB,active,chicago-bears,413129,2012
7029,390000,0,Armando Allen,RB,active,chicago-bears,390000,2012
7030,390000,0,Joseph Anderson,WR,active,chicago-bears,390000,2012
7031,390000,0,Cory Brandon,RT,active,chicago-bears,390000,2012
7032,390000,0,Cheta Ozougwu,DE,active,chicago-bears,390000,2012
7033,390000,0,Nick Pieschel,G,active,chicago-bears,390000,2012
7034,390000,0,Harvey Unga,FB,active,chicago-bears,390000,2012
7035,390000,0,Donovan Warren,CB,active,chicago-bears,390000,2012
7036,384375,0,Zackary Bowman,CB,active,chicago-bears,384375,2012
7037,170625,0,James Brown,G,active,chicago-bears,170625,2012
7038,925000,0,Olindo Mare,K,active,chicago-bears,925000,2012
7039,1260000,10495,Lance Louis,G,injured_reserve,chicago-bears,1270495,2012
7040,700000,112500,Craig Steltz,S,injured_reserve,chicago-bears,812500,2012
7041,390000,147844,Brandon Hardin,S,injured_reserve,chicago-bears,537844,2012
7042,465000,0,Patrick Trahan,OLB,injured_reserve,chicago-bears,465000,2012
7043,465000,0,Anthony Walters,SS,injured_reserve,chicago-bears,465000,2012
7044,368000,0,Chilo Rachal,G,non_fb_injury,chicago-bears,368000,2012
7045,1200000,0,Brandon Manumaleuna,TE,dead_cap,chicago-bears,1200000,2012
7046,900000,0,Sam Hurd,WR,dead_cap,chicago-bears,900000,2012
7047,750000,0,Anthony Adams,DT,dead_cap,chicago-bears,750000,2012
7048,750000,0,Chester Taylor,RB,dead_cap,chicago-bears,750000,2012
7049,680000,0,Frank Omiyale,T,dead_cap,chicago-bears,680000,2012
7050,472500,0,Kahlil Bell,RB,dead_cap,chicago-bears,472500,2012
7051,384750,0,Chris Williams,G,dead_cap,chicago-bears,384750,2012
7052,250000,0,Marion Barber,RB,dead_cap,chicago-bears,250000,2012
7053,0,99000,Joshua Moore,CB,dead_cap,chicago-bears,99000,2012
7054,0,42215,Nathan Enderle,QB,dead_cap,chicago-bears,42215,2012
7055,39675,0,Isaiah Frey,CB,dead_cap,chicago-bears,39675,2012
7056,25000,0,Jonathan Wilhite,CB,dead_cap,chicago-bears,25000,2012
7057,0,22593,Greg McCoy,CB,dead_cap,chicago-bears,22593,2012
7058,14062,0,Harvey Unga,FB,dead_cap,chicago-bears,14062,2012
7059,5500,0,Jeremy Jones,S,dead_cap,chicago-bears,5500,2012
7060,5000,0,James Brown,G,dead_cap,chicago-bears,5000,2012
7061,0,1750,Mario Addison,DE,dead_cap,chicago-bears,1750,2012
7062,833,0,Dane Sanzenbacher,WR,dead_cap,chicago-bears,833,2012
7063,333,0,Dom DeCicco,ILB,dead_cap,chicago-bears,333,2012
7064,9900000,4483333,Julius Peppers,DE,active,chicago-bears,14383333,2013
7065,8470000,1900000,Jay Cutler,QB,active,chicago-bears,10370000,2013
7066,9100000,200000,Brandon Marshall,WR,active,chicago-bears,9300000,2013
7067,8450000,0,Henry Melton,DT,active,chicago-bears,8450000,2013
7068,7950000,50000,Charles Tillman,CB,active,chicago-bears,8000000,2013
7069,4500000,2916670,Lance Briggs,OLB,active,chicago-bears,7416670,2013
7070,1700000,5568750,Matt Forte,RB,active,chicago-bears,7268750,2013
7071,4250000,850000,Tim Jennings,CB,active,chicago-bears,5100000,2013
7072,2425000,1100000,Robbie Gould,K,active,chicago-bears,3525000,2013
7073,715000,2300000,Jermon Bushrod,G,active,chicago-bears,3015000,2013
7074,1857523,1083333,Devin Hester,WR,active,chicago-bears,2940856,2013
7075,1250000,1300000,Earl Bennett,WR,active,chicago-bears,2550000,2013
7076,1500000,1000000,Michael Bush,RB,active,chicago-bears,2500000,2013
7077,2050000,75000,Roberto Garza,C,active,chicago-bears,2125000,2013
7078,715000,1225000,Martellus Bennett,TE,active,chicago-bears,1940000,2013
7079,765609,1112436,Shea McClellin,OLB,active,chicago-bears,1878045,2013
7080,1300000,425000,Adam Podlesh,P,active,chicago-bears,1725000,2013
7081,405000,1104264,Kyle Long,G,active,chicago-bears,1509264,2013
7082,1323000,169825,Major Wright,S,active,chicago-bears,1492825,2013
7083,1323000,126793,Corey Wootton,DT,active,chicago-bears,1449793,2013
7084,865000,550000,Eric Weems,WR,active,chicago-bears,1415000,2013
7085,900000,428125,D.J. Williams,ILB,active,chicago-bears,1328125,2013
7086,950000,300000,James Anderson,OLB,active,chicago-bears,1250000,2013
7087,940000,100000,Patrick Mannelly,LS,active,chicago-bears,1040000,2013
7088,596719,436879,Alshon Jeffery,WR,active,chicago-bears,1033598,2013
7089,660082,345164,Stephen Paea,DT,active,chicago-bears,1005246,2013
7090,715000,225000,Blake Costanzo,OLB,active,chicago-bears,940000,2013
7091,715000,112500,Craig Steltz,S,active,chicago-bears,827500,2013
7092,715000,100000,Matt Slauson,G,active,chicago-bears,815000,2013
7093,630000,150000,Tony Fiammetta,FB,active,chicago-bears,780000,2013
7094,405000,311509,Jon Bostic,ILB,active,chicago-bears,716509,2013
7095,555000,143400,Christopher Conte,FS,active,chicago-bears,698400,2013
7096,715000,0,Jonathan Scott,LT,active,chicago-bears,715000,2013
7097,630000,0,Sherrick McManis,CB,active,chicago-bears,630000,2013
7098,715000,65000,Zackary Bowman,CB,active,chicago-bears,780000,2013
7099,715000,65000,Dante Rosario,TE,active,chicago-bears,780000,2013
7100,840000,25000,Josh McCown,QB,active,chicago-bears,865000,2013
7101,715000,0,Eben Britton,RT,active,chicago-bears,715000,2013
7102,555000,0,Anthony Walters,SS,active,chicago-bears,555000,2013
7103,518823,0,Landon Cohen,DT,active,chicago-bears,518823,2013
7104,405000,108023,Khaseem Greene,OLB,active,chicago-bears,513023,2013
7105,480000,0,James Brown,G,active,chicago-bears,480000,2013
7106,480000,0,Graham Pocic,RT,active,chicago-bears,480000,2013
7107,405000,41200,Jordan Mills,RT,active,chicago-bears,446200,2013
7108,405000,25947,Cornelius Washington,DE,active,chicago-bears,430947,2013
7109,405000,11787,Marquess Wilson,WR,active,chicago-bears,416787,2013
7110,405000,1166,Michael Ford,RB,active,chicago-bears,406166,2013
7111,405000,0,David Bass,DE,active,chicago-bears,405000,2013
7112,405000,0,Taylor Boggs,G,active,chicago-bears,405000,2013
7113,840000,0,Jay Ratliff,DT,active,chicago-bears,840000,2013
7114,715000,0,Jordan Palmer,QB,active,chicago-bears,715000,2013
7115,310588,0,Jerry Franklin,OLB,active,chicago-bears,310588,2013
7116,228529,0,Derrick Martin,CB,active,chicago-bears,228529,2013
7117,480000,0,Cheta Ozougwu,DE,active,chicago-bears,480000,2013
7118,405000,100000,Chris Williams,WR,active,chicago-bears,505000,2013
7119,119117,0,Sean Cattouse,S,active,chicago-bears,119117,2013
7120,47647,0,Joe Long,LT,active,chicago-bears,47647,2013
7121,630000,0,Nate Collins,DT,injured_reserve,chicago-bears,630000,2013
7122,840000,65000,Kelvin Hayden,CB,injured_reserve,chicago-bears,905000,2013
7123,42000,0,Ricardo Lockette,WR,practice_squad,chicago-bears,42000,2013
7124,1350000,0,Kellen Davis,TE,dead_cap,chicago-bears,1350000,2013
7125,907918,0,Gabe Carimi,G,dead_cap,chicago-bears,907918,2013
7126,500000,0,Matt Toeaina,DT,dead_cap,chicago-bears,500000,2013
7127,383726,0,Brandon Hardin,S,dead_cap,chicago-bears,383726,2013
7128,333334,0,Matt Spaeth,TE,dead_cap,chicago-bears,333334,2013
7129,325413,0,Joseph Anderson,WR,dead_cap,chicago-bears,325413,2013
7130,302212,0,Steve Maneri,TE,dead_cap,chicago-bears,302212,2013
7131,285882,0,Christian Tupou,DT,dead_cap,chicago-bears,285882,2013
7132,0,285000,Sedrick Ellis,DT,dead_cap,chicago-bears,285000,2013
7133,215412,0,Zach Minter,DT,dead_cap,chicago-bears,215412,2013
7134,166931,0,C.J. Wilson,CB,dead_cap,chicago-bears,166931,2013
7135,165000,0,Jonathan Scott,LT,dead_cap,chicago-bears,165000,2013
7136,130588,0,Larry Grant,LB,dead_cap,chicago-bears,130588,2013
7137,129471,0,Sean Cattouse,S,dead_cap,chicago-bears,129471,2013
7138,111300,0,Evan Rodriguez,FB,dead_cap,chicago-bears,111300,2013
7139,0,84430,Nathan Enderle,QB,dead_cap,chicago-bears,84430,2013
7140,79350,0,Isaiah Frey,CB,dead_cap,chicago-bears,79350,2013
7141,77647,0,Tracy Robertson,DT,dead_cap,chicago-bears,77647,2013
7142,65294,0,Jeremy Cain,LS,dead_cap,chicago-bears,65294,2013
7143,0,45186,Greg McCoy,CB,dead_cap,chicago-bears,45186,2013
7144,42000,0,Cheta Ozougwu,DE,dead_cap,chicago-bears,42000,2013
7145,38062,0,Harvey Unga,FB,dead_cap,chicago-bears,38062,2013
7146,36000,0,Jerry Franklin,OLB,dead_cap,chicago-bears,36000,2013
7147,32647,0,Kyle Adams,TE,dead_cap,chicago-bears,32647,2013
7148,30000,0,Aston Whiteside,DT,dead_cap,chicago-bears,30000,2013
7149,23129,0,J.T. Thomas,OLB,dead_cap,chicago-bears,23129,2013
7150,18000,0,Jamaal Johnson-Webb,LT,dead_cap,chicago-bears,18000,2013
7151,15153,0,J'Marcus Webb,RT,dead_cap,chicago-bears,15153,2013
7152,12000,0,Jerrod Johnson,QB,dead_cap,chicago-bears,12000,2013
7153,2000,0,Josh Lenz,WR,dead_cap,chicago-bears,2000,2013
7154,1667,0,Dane Sanzenbacher,WR,dead_cap,chicago-bears,1667,2013
7155,1666,0,P.J. Lonergan,C,dead_cap,chicago-bears,1666,2013
7156,1666,0,Brent Russell,DT,dead_cap,chicago-bears,1666,2013
7157,667,0,Dom DeCicco,ILB,dead_cap,chicago-bears,667,2013
7158,500,0,Demontre Hurst,CB,dead_cap,chicago-bears,500,2013
7159,500,0,Marcus Rucker,WR,dead_cap,chicago-bears,500,2013
7160,17500000,1000000,Jay Cutler,QB,active,chicago-bears,18500000,2014
7161,7300000,2075000,Brandon Marshall,WR,active,chicago-bears,9375000,2014
7162,5950000,1950000,Matt Forte,RB,active,chicago-bears,7900000,2014
7163,5000000,2300000,Jermon Bushrod,G,active,chicago-bears,7300000,2014
7164,4800000,1225000,Martellus Bennett,TE,active,chicago-bears,6025000,2014
7165,1355000,3895000,Tim Jennings,CB,active,chicago-bears,5250000,2014
7166,1000000,4040000,Lamarr Houston,OLB,active,chicago-bears,5040000,2014
7167,2250000,800000,Charles Tillman,CB,active,chicago-bears,3050000,2014
7168,3000000,0,Jared Allen,DE,active,chicago-bears,3000000,2014
7169,730000,2017500,Matt Slauson,G,active,chicago-bears,2747500,2014
7170,950000,1716666,Willie Young,OLB,active,chicago-bears,2666666,2014
7171,1900000,700000,Robbie Gould,K,active,chicago-bears,2600000,2014
7172,1141218,1112436,Shea McClellin,OLB,active,chicago-bears,2253654,2014
7173,782316,1104264,Kyle Long,G,active,chicago-bears,1886580,2014
7174,420000,1341273,Kyle Fuller,CB,active,chicago-bears,1761273,2014
7175,855000,770000,Jay Ratliff,DT,active,chicago-bears,1625000,2014
7176,1421000,143400,Christopher Conte,FS,active,chicago-bears,1564400,2014
7177,955000,595000,Roberto Garza,C,active,chicago-bears,1550000,2014
7178,800000,700000,Ryan Mundy,SS,active,chicago-bears,1500000,2014
7179,753438,486879,Alshon Jeffery,WR,active,chicago-bears,1240317,2014
7180,827623,345164,Stephen Paea,DT,active,chicago-bears,1172787,2014
7181,584127,311509,Jon Bostic,ILB,active,chicago-bears,895636,2014
7182,420000,327855,Ego Ferguson,DT,active,chicago-bears,747855,2014
7183,645000,0,Jimmy Clausen,QB,active,chicago-bears,645000,2014
7184,730000,0,Sherrick McManis,CB,active,chicago-bears,730000,2014
7185,730000,60938,Danny McCray,SS,active,chicago-bears,790938,2014
7186,495000,108023,Khaseem Greene,OLB,active,chicago-bears,603023,2014
7187,855000,0,Jeremy Cain,LS,active,chicago-bears,855000,2014
7188,855000,0,Dante Rosario,TE,active,chicago-bears,855000,2014
7189,730000,0,Josh Morgan,WR,active,chicago-bears,730000,2014
7190,730000,0,Trevor Scott,DE,active,chicago-bears,730000,2014
7191,420000,146517,Will Sutton,DT,active,chicago-bears,566517,2014
7192,730000,0,Darryl Sharpton,ILB,active,chicago-bears,730000,2014
7193,730000,0,Eben Britton,RT,active,chicago-bears,730000,2014
7194,495000,41200,Jordan Mills,RT,active,chicago-bears,536200,2014
7195,420000,110845,Ka'Deem Carey,RB,active,chicago-bears,530845,2014
7196,495000,25947,Cornelius Washington,DE,active,chicago-bears,520947,2014
7197,420000,97875,Brock Vereen,FS,active,chicago-bears,517875,2014
7198,495000,11787,Marquess Wilson,WR,active,chicago-bears,506787,2014
7199,420000,26327,Pat O'Donnell,P,active,chicago-bears,446327,2014
7200,420000,11628,Charles Leno,LT,active,chicago-bears,431628,2014
7201,420000,2333,Christian Jones,ILB,active,chicago-bears,422333,2014
7202,420000,1666,Michael Ola,T,active,chicago-bears,421666,2014
7203,420000,0,Senorise Perry,RB,active,chicago-bears,420000,2014
7204,373000,0,Zach Miller,TE,active,chicago-bears,373000,2014
7205,420000,0,Demontre Hurst,CB,active,chicago-bears,420000,2014
7206,420000,0,DeDe Lattimore,ILB,active,chicago-bears,420000,2014
7207,420000,0,Al Louis-Jean,CB,active,chicago-bears,420000,2014
7208,420000,0,Terrance Mitchell,CB,active,chicago-bears,420000,2014
7209,232941,0,David Bass,DE,active,chicago-bears,232941,2014
7210,570000,0,Marc Mariani,WR,active,chicago-bears,570000,2014
7211,420000,0,Blake Annen,TE,active,chicago-bears,420000,2014
7212,420000,0,Ryan Groy,G,active,chicago-bears,420000,2014
7213,645000,0,Anthony Walters,SS,active,chicago-bears,645000,2014
7214,855000,0,Montell Owens,FB,active,chicago-bears,855000,2014
7215,955000,0,Jay Feely,K,active,chicago-bears,955000,2014
7216,420000,0,Brandon Dunn,DE,active,chicago-bears,420000,2014
7217,570000,0,Josh Bellamy,WR,active,chicago-bears,570000,2014
7218,420000,0,David Fales,QB,active,chicago-bears,420000,2014
7219,730000,0,Austen Lane,DE,active,chicago-bears,730000,2014
7220,4750000,1750000,Lance Briggs,OLB,injured_reserve,chicago-bears,6500000,2014
7221,955000,406250,D.J. Williams,ILB,injured_reserve,chicago-bears,1361250,2014
7222,730001,65000,Brian De La Puente,C,injured_reserve,chicago-bears,795001,2014
7223,81900,0,Conor Bofeli,G,practice_squad,chicago-bears,81900,2014
7224,69300,0,Shamiel Gary,S,practice_squad,chicago-bears,69300,2014
7225,69300,0,Jacob Maxwell,TE,practice_squad,chicago-bears,69300,2014
7226,50400,0,Jason Weaver,LT,practice_squad,chicago-bears,50400,2014
7227,44100,0,Rashad Lawrence,WR,practice_squad,chicago-bears,44100,2014
7228,44100,0,Antoine McClain,G,practice_squad,chicago-bears,44100,2014
7229,31500,0,Jamil Merrell,DE,practice_squad,chicago-bears,31500,2014
7230,18900,0,Jonathan Brown,OLB,practice_squad,chicago-bears,18900,2014
7231,12600,0,Taylor Boggs,G,practice_squad,chicago-bears,12600,2014
7232,8366668,0,Julius Peppers,DE,dead_cap,chicago-bears,8366668,2014
7233,2000000,0,Michael Bush,RB,dead_cap,chicago-bears,2000000,2014
7234,907918,0,Gabe Carimi,G,dead_cap,chicago-bears,907918,2014
7235,0,800000,Adam Podlesh,P,dead_cap,chicago-bears,800000,2014
7236,730000,0,Domenik Hixon,WR,dead_cap,chicago-bears,730000,2014
7237,0,600000,Eric Weems,WR,dead_cap,chicago-bears,600000,2014
7238,855000,0,Santonio Holmes,WR,dead_cap,chicago-bears,855000,2014
7239,570000,0,Kelvin Hayden,CB,dead_cap,chicago-bears,570000,2014
7240,570000,0,Matthew Mulligan,TE,dead_cap,chicago-bears,570000,2014
7241,295688,0,Brandon Hardin,S,dead_cap,chicago-bears,295688,2014
7242,283782,0,Chris Williams,WR,dead_cap,chicago-bears,283782,2014
7243,247059,0,Ahmad Dixon,S,dead_cap,chicago-bears,247059,2014
7244,222600,0,Evan Rodriguez,FB,dead_cap,chicago-bears,222600,2014
7245,208006,0,Taylor Boggs,G,dead_cap,chicago-bears,208006,2014
7246,201176,0,Teddy Williams,CB,dead_cap,chicago-bears,201176,2014
7247,175294,0,Tony Fiammetta,FB,dead_cap,chicago-bears,175294,2014
7248,170788,0,David Bass,DE,dead_cap,chicago-bears,170788,2014
7249,124962,28606,David Fales,QB,dead_cap,chicago-bears,153568,2014
7250,142659,0,Josh Bellamy,WR,dead_cap,chicago-bears,142659,2014
7251,125788,0,Terrell Manning,ILB,dead_cap,chicago-bears,125788,2014
7252,0,99953,Isaiah Frey,CB,dead_cap,chicago-bears,99953,2014
7253,75600,2666,Brandon Dunn,DE,dead_cap,chicago-bears,78266,2014
7254,68312,0,Rashad Ross,WR,dead_cap,chicago-bears,68312,2014
7255,67059,0,Shaun Draughn,RB,dead_cap,chicago-bears,67059,2014
7256,63000,2666,Ryan Groy,G,dead_cap,chicago-bears,65666,2014
7257,0,65000,Eben Britton,RT,dead_cap,chicago-bears,65000,2014
7258,0,65000,Jordan Senn,OLB,dead_cap,chicago-bears,65000,2014
7259,0,65000,Craig Steltz,S,dead_cap,chicago-bears,65000,2014
7260,44100,0,Blake Annen,TE,dead_cap,chicago-bears,44100,2014
7261,44100,0,B.J Cunningham,WR,dead_cap,chicago-bears,44100,2014
7262,37800,0,Terrance Mitchell,CB,dead_cap,chicago-bears,37800,2014
7263,33529,0,Micheal Spurlock,WR,dead_cap,chicago-bears,33529,2014
7264,31500,0,Al Louis-Jean,CB,dead_cap,chicago-bears,31500,2014
7265,24706,1000,Demontre Hurst,CB,dead_cap,chicago-bears,25706,2014
7266,25200,0,Roy Philon,DE,dead_cap,chicago-bears,25200,2014
7267,24706,0,Shamiel Gary,S,dead_cap,chicago-bears,24706,2014
7268,23129,0,J.T. Thomas,OLB,dead_cap,chicago-bears,23129,2014
7269,18900,0,Jordan Sullen,FS,dead_cap,chicago-bears,18900,2014
7270,12600,500,DeDe Lattimore,ILB,dead_cap,chicago-bears,13100,2014
7271,12600,0,Greg Herd,WR,dead_cap,chicago-bears,12600,2014
7272,10000,0,Steve Maneri,TE,dead_cap,chicago-bears,10000,2014
7273,4000,0,Josh Lenz,WR,dead_cap,chicago-bears,4000,2014
7274,3334,0,P.J. Lonergan,C,dead_cap,chicago-bears,3334,2014
7275,3334,0,Brent Russell,DT,dead_cap,chicago-bears,3334,2014
7276,0,2334,Tress Way,P,dead_cap,chicago-bears,2334,2014
7277,2000,0,Zach Minter,DT,dead_cap,chicago-bears,2000,2014
7278,0,1166,Michael Ford,RB,dead_cap,chicago-bears,1166,2014
7279,0,1166,Lee Pegues,DT,dead_cap,chicago-bears,1166,2014
7280,0,1000,Jordan Lynch,RB,dead_cap,chicago-bears,1000,2014
7281,1000,0,Marcus Rucker,WR,dead_cap,chicago-bears,1000,2014
7282,0,500,James Dunbar,RT,dead_cap,chicago-bears,500,2014
7283,334,0,C.J. Wilson,CB,dead_cap,chicago-bears,334,2014
7284,0,333,Cody Booth,TE,dead_cap,chicago-bears,333,2014
7285,0,250,Tana Patrick,OLB,dead_cap,chicago-bears,250,2014
7286,15500000,1000000,Jay Cutler,QB,active,chicago-bears,16500000,2015
7287,7050000,2150000,Matt Forte,RB,active,chicago-bears,9200000,2015
7288,5750000,2300000,Jermon Bushrod,G,active,chicago-bears,8050000,2015
7289,5950000,1040000,Lamarr Houston,OLB,active,chicago-bears,6990000,2015
7290,1000000,5675000,Pernell McPhee,OLB,active,chicago-bears,6675000,2015
7291,1500000,4000000,Eddie Royal,WR,active,chicago-bears,5500000,2015
7292,2900000,700000,Robbie Gould,K,active,chicago-bears,3600000,2015
7293,2750000,517500,Matt Slauson,G,active,chicago-bears,3267500,2015
7294,2450000,716666,Willie Young,OLB,active,chicago-bears,3166666,2015
7295,1950000,1050000,Alan Ball,CB,active,chicago-bears,3000000,2015
7296,775600,1853663,Shea McClellin,OLB,active,chicago-bears,2629263,2015
7297,1159632,1104264,Kyle Long,G,active,chicago-bears,2263896,2015
7298,860318,1341273,Kyle Fuller,CB,active,chicago-bears,2201591,2015
7299,745000,80000,Jarvis Jenkins,DE,active,chicago-bears,825000,2015
7300,525000,146517,Will Sutton,DT,active,chicago-bears,671517,2015
7301,870000,80000,Will Montgomery,C,active,chicago-bears,950000,2015
7302,745000,80000,Vladimir Ducasse,G,active,chicago-bears,825000,2015
7303,745000,80000,Sherrick McManis,CB,active,chicago-bears,825000,2015
7304,660000,0,Josh Bellamy,WR,active,chicago-bears,660000,2015
7305,660000,0,Marc Mariani,WR,active,chicago-bears,660000,2015
7306,660000,0,Zach Miller,TE,active,chicago-bears,660000,2015
7307,435000,190479,Hroniss Grasu,C,active,chicago-bears,625479,2015
7308,510000,110845,Ka'Deem Carey,RB,active,chicago-bears,620845,2015
7309,585000,25947,Cornelius Washington,DE,active,chicago-bears,610947,2015
7310,870000,0,Tracy Porter,CB,active,chicago-bears,870000,2015
7311,585000,0,Patrick Omameh,G,active,chicago-bears,585000,2015
7312,435000,135906,Jeremy Langford,RB,active,chicago-bears,570906,2015
7313,701176,0,Sam Acho,OLB,active,chicago-bears,701176,2015
7314,510000,26327,Pat O'Donnell,P,active,chicago-bears,536327,2015
7315,510000,11628,Charles Leno,LT,active,chicago-bears,521628,2015
7316,657352,0,Mitch Unrein,DE,active,chicago-bears,657352,2015
7317,510000,2333,Christian Jones,ILB,active,chicago-bears,512333,2015
7318,510000,0,Lamin Barrow,ILB,active,chicago-bears,510000,2015
7319,435000,58070,Adrian Amos,FS,active,chicago-bears,493070,2015
7320,613529,0,Chris Prosinski,SS,active,chicago-bears,613529,2015
7321,481764,0,LaRoy Reynolds,ILB,active,chicago-bears,481764,2015
7322,569705,0,Sherrod Martin,SS,active,chicago-bears,569705,2015
7323,447352,0,Nick Becton,LT,active,chicago-bears,447352,2015
7324,435000,2000,Cameron Meredith,WR,active,chicago-bears,437000,2015
7325,435000,0,Harold Jones-Quartey,SS,active,chicago-bears,435000,2015
7326,435000,0,Khari Lee,TE,active,chicago-bears,435000,2015
7327,360000,0,Bruce Gaston,DT,active,chicago-bears,360000,2015
7328,333000,0,Senorise Perry,RB,active,chicago-bears,333000,2015
7329,318000,0,Jason Weaver,LT,active,chicago-bears,318000,2015
7330,310588,0,Deonte Thompson,WR,active,chicago-bears,310588,2015
7331,307058,0,Jonathan Anderson,ILB,active,chicago-bears,307058,2015
7332,281470,0,Bryce Callahan,CB,active,chicago-bears,281470,2015
7333,180000,0,David Fales,QB,active,chicago-bears,180000,2015
7334,179117,0,Jacoby Glenn,CB,active,chicago-bears,179117,2015
7335,175294,0,Robert Housler,TE,active,chicago-bears,175294,2015
7336,153529,0,Patrick Scales,LS,active,chicago-bears,153529,2015
7337,120000,0,Demontre Hurst,CB,active,chicago-bears,120000,2015
7338,76764,0,John Timu,ILB,active,chicago-bears,76764,2015
7339,32647,32841,Tayo Fabuluje,RT,active,chicago-bears,65488,2015
7340,60000,0,D'Anthony Smith,DT,active,chicago-bears,60000,2015
7341,51176,0,DeVante Bausby,CB,active,chicago-bears,51176,2015
7342,38823,0,Greg Scruggs,DE,active,chicago-bears,38823,2015
7343,25588,0,Terry Williams,DT,active,chicago-bears,25588,2015
7344,4900000,1225000,Martellus Bennett,TE,injured_reserve,chicago-bears,6125000,2015
7345,1000000,4000000,Antrel Rolle,SS,injured_reserve,chicago-bears,5000000,2015
7346,1450000,50000,Ryan Mundy,SS,injured_reserve,chicago-bears,1500000,2015
7347,960157,486879,Alshon Jeffery,WR,injured_reserve,chicago-bears,1447036,2015
7348,428117,598875,Eddie Goldman,DT,injured_reserve,chicago-bears,1026992,2015
7349,606964,327855,Ego Ferguson,DT,injured_reserve,chicago-bears,934819,2015
7350,745000,40000,Jacquizz Rodgers,RB,injured_reserve,chicago-bears,785000,2015
7351,585000,11787,Marquess Wilson,WR,injured_reserve,chicago-bears,596787,2015
7352,318000,1666,Anthony Jefferson,FS,injured_reserve,chicago-bears,319666,2015
7353,85800,0,Jalen Saunders,WR,injured_reserve,chicago-bears,85800,2015
7354,176470,11500000,Jared Allen,DE,dead_cap,chicago-bears,11676470,2015
7355,0,5625000,Brandon Marshall,WR,dead_cap,chicago-bears,5625000,2015
7356,3530000,850000,Tim Jennings,CB,dead_cap,chicago-bears,4380000,2015
7357,1235294,218750,Jay Ratliff,DT,dead_cap,chicago-bears,1454044,2015
7358,870000,80000,Thomas Gafford,LS,dead_cap,chicago-bears,950000,2015
7359,482058,380000,Jimmy Clausen,QB,dead_cap,chicago-bears,862058,2015
7360,117045,411509,Jon Bostic,ILB,dead_cap,chicago-bears,528554,2015
7361,438235,0,Antone Smith,RB,dead_cap,chicago-bears,438235,2015
7362,306600,0,Terrance Mitchell,CB,dead_cap,chicago-bears,306600,2015
7363,409411,0,Evander Hood,DE,dead_cap,chicago-bears,409411,2015
7364,166200,85818,David Fales,QB,dead_cap,chicago-bears,252018,2015
7365,0,216046,Khaseem Greene,OLB,dead_cap,chicago-bears,216046,2015
7366,90000,97875,Brock Vereen,FS,dead_cap,chicago-bears,187875,2015
7367,179400,0,Demontre Hurst,CB,dead_cap,chicago-bears,179400,2015
7368,168352,1666,John Timu,ILB,dead_cap,chicago-bears,170018,2015
7369,149647,0,John Chiles,WR,dead_cap,chicago-bears,149647,2015
7370,34411,80000,Sam Acho,OLB,dead_cap,chicago-bears,114411,2015
7371,112200,0,Gannon Sinclair,TE,dead_cap,chicago-bears,112200,2015
7372,99000,0,Paul Lasike,RB,dead_cap,chicago-bears,99000,2015
7373,85800,0,Jalen Saunders,WR,dead_cap,chicago-bears,85800,2015
7374,77576,2500,Bryce Callahan,CB,dead_cap,chicago-bears,80076,2015
7375,0,80000,Mason Foster,ILB,dead_cap,chicago-bears,80000,2015
7376,79200,0,Nathan Palmer,WR,dead_cap,chicago-bears,79200,2015
7377,73200,5334,Brandon Dunn,DE,dead_cap,chicago-bears,78534,2015
7378,66000,1666,Jacoby Glenn,CB,dead_cap,chicago-bears,67666,2015
7379,66000,0,D'Anthony Smith,DT,dead_cap,chicago-bears,66000,2015
7380,52800,0,Barrett Jones,G,dead_cap,chicago-bears,52800,2015
7381,52800,0,Martin Wallace,LT,dead_cap,chicago-bears,52800,2015
7382,46200,0,Deonte Thompson,WR,dead_cap,chicago-bears,46200,2015
7383,0,41200,Jordan Mills,RT,dead_cap,chicago-bears,41200,2015
7384,39600,0,Danny Mason,OLB,dead_cap,chicago-bears,39600,2015
7385,0,37500,Roberto Garza,C,dead_cap,chicago-bears,37500,2015
7386,33000,1666,Jonathan Anderson,ILB,dead_cap,chicago-bears,34666,2015
7387,34411,0,Lavar Edwards,DE,dead_cap,chicago-bears,34411,2015
7388,34411,0,Spencer Lanning,P,dead_cap,chicago-bears,34411,2015
7389,33000,0,Cornelius Edison,C,dead_cap,chicago-bears,33000,2015
7390,26400,0,Nick Becton,LT,dead_cap,chicago-bears,26400,2015
7391,26400,0,Matt Blanchard,QB,dead_cap,chicago-bears,26400,2015
7392,26400,0,Terry Williams,DT,dead_cap,chicago-bears,26400,2015
7393,19800,0,Marcus Lucas,TE,dead_cap,chicago-bears,19800,2015
7394,13200,0,Davon Coleman,DE,dead_cap,chicago-bears,13200,2015
7395,13200,0,Bronson Hill,RB,dead_cap,chicago-bears,13200,2015
7396,13200,0,Ify Umodu,WR,dead_cap,chicago-bears,13200,2015
7397,13200,0,Justin Worley,QB,dead_cap,chicago-bears,13200,2015
7398,6600,0,Toby Johnson,DT,dead_cap,chicago-bears,6600,2015
7399,6600,0,Ryan Seymour,G,dead_cap,chicago-bears,6600,2015
7400,0,5334,Ryan Groy,G,dead_cap,chicago-bears,5334,2015
7401,0,3333,Shane Carden,QB,dead_cap,chicago-bears,3333,2015
7402,0,2334,Lee Pegues,DT,dead_cap,chicago-bears,2334,2015
7403,0,2000,Jordan Lynch,RB,dead_cap,chicago-bears,2000,2015
7404,0,1666,Qumain Black,CB,dead_cap,chicago-bears,1666,2015
7405,0,1666,Chad Hamilton,T,dead_cap,chicago-bears,1666,2015
7406,0,1666,Levi Norwood,WR,dead_cap,chicago-bears,1666,2015
7407,0,1666,Michael Ola,T,dead_cap,chicago-bears,1666,2015
7408,0,1666,Olsen Pierre,DT,dead_cap,chicago-bears,1666,2015
7409,0,1500,Cameron Jefferson,T,dead_cap,chicago-bears,1500,2015
7410,0,1500,Rick Lovato,LS,dead_cap,chicago-bears,1500,2015
7411,0,1500,Brian Vogler,TE,dead_cap,chicago-bears,1500,2015
7412,0,1168,Michael Ford,RB,dead_cap,chicago-bears,1168,2015
7413,0,1000,James Dunbar,RT,dead_cap,chicago-bears,1000,2015
7414,0,1000,DeDe Lattimore,ILB,dead_cap,chicago-bears,1000,2015
7415,0,667,Cody Booth,TE,dead_cap,chicago-bears,667,2015
7416,0,500,Jerimiah Detmer,K,dead_cap,chicago-bears,500,2015
7417,0,500,Tana Patrick,OLB,dead_cap,chicago-bears,500,2015
7418,11163940,0,Alshon Jeffery,WR,active,chicago-bears,11163940,2016
7419,7000000,675000,Pernell McPhee,OLB,active,chicago-bears,7675000,2016
7420,3000000,2818750,Bobby Massie,RT,active,chicago-bears,5818750,2016
7421,4750000,666666,Josh Sitton,G,active,chicago-bears,5416666,2016
7422,800000,3916668,Willie Young,OLB,active,chicago-bears,4716668,2016
7423,1000000,3500000,Akiem Hicks,DE,active,chicago-bears,4500000,2016
7424,1750000,2118750,Tracy Porter,CB,active,chicago-bears,3868750,2016
7425,764706,3000000,Jerrell Freeman,ILB,active,chicago-bears,3764706,2016
7426,450000,2419611,Leonard Floyd,OLB,active,chicago-bears,2869611,2016
7427,1050000,562500,Ted Larsen,G,active,chicago-bears,1612500,2016
7428,800000,600000,Sherrick McManis,CB,active,chicago-bears,1400000,2016
7429,760000,350000,Mitch Unrein,DE,active,chicago-bears,1110000,2016
7430,450000,318103,Cody Whitehair,G,active,chicago-bears,768103,2016
7431,760000,0,Logan Paulsen,TE,active,chicago-bears,760000,2016
7432,600000,110845,Ka'Deem Carey,RB,active,chicago-bears,710845,2016
7433,675000,25947,Cornelius Washington,DE,active,chicago-bears,700947,2016
7434,760000,80000,Sam Acho,OLB,active,chicago-bears,840000,2016
7435,760000,80000,Chris Prosinski,SS,active,chicago-bears,840000,2016
7436,760000,80000,Deonte Thompson,WR,active,chicago-bears,840000,2016
7437,675000,0,Eric Kush,G,active,chicago-bears,675000,2016
7438,525000,135906,Jeremy Langford,RB,active,chicago-bears,660906,2016
7439,450000,206630,Jonathan Bullard,DE,active,chicago-bears,656630,2016
7440,600000,26327,Pat O'Donnell,P,active,chicago-bears,626327,2016
7441,600000,11628,Charles Leno,LT,active,chicago-bears,611628,2016
7442,600000,2334,Christian Jones,ILB,active,chicago-bears,602334,2016
7443,885000,0,Connor Barth,K,active,chicago-bears,885000,2016
7444,760000,0,Josh Bellamy,WR,active,chicago-bears,760000,2016
7445,595588,0,Matt Barkley,QB,active,chicago-bears,595588,2016
7446,450000,143780,Nick Kwiatkoski,ILB,active,chicago-bears,593780,2016
7447,525000,58070,Adrian Amos,FS,active,chicago-bears,583070,2016
7448,450000,131554,Deon Bush,S,active,chicago-bears,581554,2016
7449,450000,127722,Deiondre' Hall,CB,active,chicago-bears,577722,2016
7450,525000,2000,Cameron Meredith,WR,active,chicago-bears,527000,2016
7451,525000,0,Bryce Callahan,CB,active,chicago-bears,525000,2016
7452,525000,0,Harold Jones-Quartey,SS,active,chicago-bears,525000,2016
7453,525000,0,Patrick Scales,LS,active,chicago-bears,525000,2016
7454,450000,62005,Jordan Howard,RB,active,chicago-bears,512005,2016
7455,450000,35235,DeAndre Houston-Carson,S,active,chicago-bears,485235,2016
7456,450000,0,Crevon LeBlanc,CB,active,chicago-bears,450000,2016
7457,432348,0,John Timu,ILB,active,chicago-bears,432348,2016
7458,370580,0,Ben Braunecker,TE,active,chicago-bears,370580,2016
7459,352941,0,Demontre Hurst,CB,active,chicago-bears,352941,2016
7460,312941,0,C.J. Wilson,DT,active,chicago-bears,312941,2016
7461,308820,0,Daniel Brown,TE,active,chicago-bears,308820,2016
7462,246912,0,Johnthan Banks,CB,active,chicago-bears,246912,2016
7463,211764,0,David Fales,QB,active,chicago-bears,211764,2016
7464,211760,0,Paul Lasike,RB,active,chicago-bears,211760,2016
7465,185294,0,Jonathan Anderson,ILB,active,chicago-bears,185294,2016
7466,132350,0,Daniel Braverman,WR,active,chicago-bears,132350,2016
7467,119117,0,Matt McCants,RT,active,chicago-bears,119117,2016
7468,92647,0,MyCole Pruitt,TE,active,chicago-bears,92647,2016
7469,52940,0,Bralon Addison,WR,active,chicago-bears,52940,2016
7470,30882,0,Josh Shirley,OLB,active,chicago-bears,30882,2016
7471,16000000,1000000,Jay Cutler,QB,injured_reserve,chicago-bears,17000000,2016
7472,4250000,3364054,Kyle Long,G,injured_reserve,chicago-bears,7614054,2016
7473,5950000,1040000,Lamarr Houston,OLB,injured_reserve,chicago-bears,6990000,2016
7474,1500000,4850000,Danny Trevathan,ILB,injured_reserve,chicago-bears,6350000,2016
7475,4500000,0,Eddie Royal,WR,injured_reserve,chicago-bears,4500000,2016
7476,389639,3239329,Kevin White,WR,injured_reserve,chicago-bears,3628968,2016
7477,1500000,1468750,Zach Miller,TE,injured_reserve,chicago-bears,2968750,2016
7478,1300637,1341273,Kyle Fuller,CB,injured_reserve,chicago-bears,2641910,2016
7479,1500000,500000,Brian Hoyer,QB,injured_reserve,chicago-bears,2000000,2016
7480,1671000,11787,Marquess Wilson,WR,injured_reserve,chicago-bears,1682787,2016
7481,693469,598875,Eddie Goldman,DT,injured_reserve,chicago-bears,1292344,2016
7482,793928,308570,Ego Ferguson,DT,injured_reserve,chicago-bears,1102498,2016
7483,575000,190480,Hroniss Grasu,C,injured_reserve,chicago-bears,765480,2016
7484,615000,146517,Will Sutton,DT,injured_reserve,chicago-bears,761517,2016
7485,675000,0,Nick Becton,LT,injured_reserve,chicago-bears,675000,2016
7486,760000,0,Mike Adams,LT,injured_reserve,chicago-bears,760000,2016
7487,428000,0,Brandon Boykin,CB,injured_reserve,chicago-bears,428000,2016
7488,333000,0,Danny Mason,OLB,injured_reserve,chicago-bears,333000,2016
7489,333000,0,Connor Shaw,QB,injured_reserve,chicago-bears,333000,2016
7490,0,4400000,Jermon Bushrod,G,dead_cap,chicago-bears,4400000,2016
7491,0,1500000,Tim Jennings,CB,dead_cap,chicago-bears,1500000,2016
7492,0,1125000,Martellus Bennett,TE,dead_cap,chicago-bears,1125000,2016
7493,0,1100000,Robbie Gould,K,dead_cap,chicago-bears,1100000,2016
7494,0,835000,Matt Slauson,G,dead_cap,chicago-bears,835000,2016
7495,0,311509,Jon Bostic,ILB,dead_cap,chicago-bears,311509,2016
7496,285174,3334,Jacoby Glenn,CB,dead_cap,chicago-bears,288508,2016
7497,277589,0,Lamin Barrow,ILB,dead_cap,chicago-bears,277589,2016
7498,266960,0,DeVante Bausby,CB,dead_cap,chicago-bears,266960,2016
7499,266960,0,Cornelius Edison,C,dead_cap,chicago-bears,266960,2016
7500,0,195750,Brock Vereen,FS,dead_cap,chicago-bears,195750,2016
7501,178823,0,Joique Bell,RB,dead_cap,chicago-bears,178823,2016
7502,147846,3334,Jonathan Anderson,ILB,dead_cap,chicago-bears,151180,2016
7503,140382,0,Paul Lasike,RB,dead_cap,chicago-bears,140382,2016
7504,123070,0,Jimmy Staten,DT,dead_cap,chicago-bears,123070,2016
7505,119118,0,Greg Scruggs,DE,dead_cap,chicago-bears,119118,2016
7506,108140,0,Raheem Mostert,RB,dead_cap,chicago-bears,108140,2016
7507,82800,19849,Daniel Braverman,WR,dead_cap,chicago-bears,102649,2016
7508,20000,80000,Amini Silatolu,G,dead_cap,chicago-bears,100000,2016
7509,89700,0,Rory Anderson,TE,dead_cap,chicago-bears,89700,2016
7510,82800,0,Ronald Powell,OLB,dead_cap,chicago-bears,82800,2016
7511,0,80000,Omar Bolden,FS,dead_cap,chicago-bears,80000,2016
7512,0,80000,Marc Mariani,WR,dead_cap,chicago-bears,80000,2016
7513,0,80000,Manuel Ramirez,G,dead_cap,chicago-bears,80000,2016
7514,0,80000,Jacquizz Rodgers,RB,dead_cap,chicago-bears,80000,2016
7515,69000,0,David Cobb,RB,dead_cap,chicago-bears,69000,2016
7516,62894,0,Demontre Hurst,CB,dead_cap,chicago-bears,62894,2016
7517,62100,0,William Poehls,G,dead_cap,chicago-bears,62100,2016
7518,48300,0,Cyril Richardson,G,dead_cap,chicago-bears,48300,2016
7519,41400,0,Dres Anderson,WR,dead_cap,chicago-bears,41400,2016
7520,41400,0,Colin Kelly,RT,dead_cap,chicago-bears,41400,2016
7521,41400,0,Lawrence Okoye,DT,dead_cap,chicago-bears,41400,2016
7522,0,41200,Jordan Mills,RT,dead_cap,chicago-bears,41200,2016
7523,34500,0,Justin Perillo,TE,dead_cap,chicago-bears,34500,2016
7524,0,32841,Tayo Fabuluje,RT,dead_cap,chicago-bears,32841,2016
7525,28800,0,Matt Barkley,QB,dead_cap,chicago-bears,28800,2016
7526,20700,3334,John Timu,ILB,dead_cap,chicago-bears,24034,2016
7527,20700,0,Ben Braunecker,TE,dead_cap,chicago-bears,20700,2016
7528,20700,0,Jason Weaver,LT,dead_cap,chicago-bears,20700,2016
7529,20700,0,Josh Woodrum,QB,dead_cap,chicago-bears,20700,2016
7530,13800,0,Bralon Addison,WR,dead_cap,chicago-bears,13800,2016
7531,13800,0,Marcel Jensen,TE,dead_cap,chicago-bears,13800,2016
7532,13800,0,Josh Shirley,OLB,dead_cap,chicago-bears,13800,2016
7533,6900,0,Laurence Gibson,T,dead_cap,chicago-bears,6900,2016
7534,6900,0,Darius Jennings,WR,dead_cap,chicago-bears,6900,2016
7535,6900,0,Senorise Perry,RB,dead_cap,chicago-bears,6900,2016
7536,6900,0,Rashaad Reynolds,CB,dead_cap,chicago-bears,6900,2016
7537,6900,0,Arturo Uzdavinis,T,dead_cap,chicago-bears,6900,2016
7538,0,6667,Shane Carden,QB,dead_cap,chicago-bears,6667,2016
7539,0,5000,Bryce Callahan,CB,dead_cap,chicago-bears,5000,2016
7540,0,3334,Qumain Black,CB,dead_cap,chicago-bears,3334,2016
7541,0,3334,Chad Hamilton,T,dead_cap,chicago-bears,3334,2016
7542,0,3334,Anthony Jefferson,FS,dead_cap,chicago-bears,3334,2016
7543,0,3334,Levi Norwood,WR,dead_cap,chicago-bears,3334,2016
7544,0,3334,Olsen Pierre,DT,dead_cap,chicago-bears,3334,2016
7545,0,3000,Cameron Jefferson,T,dead_cap,chicago-bears,3000,2016
7546,0,3000,Rick Lovato,LS,dead_cap,chicago-bears,3000,2016
7547,0,3000,Brian Vogler,TE,dead_cap,chicago-bears,3000,2016
7548,0,2507,Joe Sommers,TE,dead_cap,chicago-bears,2507,2016
7549,0,2500,Don Cherry,ILB,dead_cap,chicago-bears,2500,2016
7550,0,2333,Adrian Bellard,T,dead_cap,chicago-bears,2333,2016
7551,0,1667,Michael Ola,T,dead_cap,chicago-bears,1667,2016
7552,0,1000,Jerimiah Detmer,K,dead_cap,chicago-bears,1000,2016
7553,0,1000,Derek Keaton,WR,dead_cap,chicago-bears,1000,2016
7554,8000000,6000000,Mike Glennon,QB,active,chicago-bears,14000000,2017
7555,7000000,3700000,Akiem Hicks,DE,active,chicago-bears,10700000,2017
7556,3500000,3500000,Prince Amukamara,CB,active,chicago-bears,7000000,2017
7557,4650000,2172916,Josh Sitton,G,active,chicago-bears,6822916,2017
7558,1882353,4850000,Danny Trevathan,ILB,active,chicago-bears,6732353,2017
7559,4200000,1834375,Bobby Massie,RT,active,chicago-bears,6034375,2017
7560,2000000,3333333,Dion Sims,TE,active,chicago-bears,5333333,2017
7561,465000,4813622,Mitchell Trubisky,QB,active,chicago-bears,5278622,2017
7562,3000000,2250000,Markus Wheaton,WR,active,chicago-bears,5250000,2017
7563,1797000,3411628,Charles Leno,LT,active,chicago-bears,5208628,2017
7564,3000000,2000000,Marcus Cooper,CB,active,chicago-bears,5000000,2017
7565,1740955,1341273,Kyle Fuller,CB,active,chicago-bears,3082228,2017
7566,1000000,906250,Mark Sanchez,QB,active,chicago-bears,1906250,2017
7567,1000000,850000,Tom Compton,T,active,chicago-bears,1850000,2017
7568,1250000,593750,Kendall Wright,WR,active,chicago-bears,1843750,2017
7569,1615290,0,Dontrelle Inman,WR,active,chicago-bears,1615290,2017
7570,951938,598875,Eddie Goldman,DT,active,chicago-bears,1550813,2017
7571,1000000,500000,Christian Jones,ILB,active,chicago-bears,1500000,2017
7572,1000000,450000,Sherrick McManis,CB,active,chicago-bears,1450000,2017
7573,465000,609643,Adam Shaheen,TE,active,chicago-bears,1074643,2017
7574,642026,318103,Cody Whitehair,G,active,chicago-bears,960129,2017
7575,687500,190480,Hroniss Grasu,C,active,chicago-bears,877980,2017
7576,599000,206630,Jonathan Bullard,DE,active,chicago-bears,805630,2017
7577,800000,0,John Jenkins,DE,active,chicago-bears,800000,2017
7578,690000,26327,Pat O'Donnell,P,active,chicago-bears,716327,2017
7579,775000,80000,Sam Acho,OLB,active,chicago-bears,855000,2017
7580,775000,80000,Benny Cunningham,RB,active,chicago-bears,855000,2017
7581,690000,0,Andrew DePaola,LS,active,chicago-bears,690000,2017
7582,540000,143780,Nick Kwiatkoski,ILB,active,chicago-bears,683780,2017
7583,615000,58070,Adrian Amos,FS,active,chicago-bears,673070,2017
7584,540000,131554,Deon Bush,S,active,chicago-bears,671554,2017
7585,465000,166449,Eddie Jackson,S,active,chicago-bears,631449,2017
7586,465000,158914,Tarik Cohen,RB,active,chicago-bears,623914,2017
7587,775000,0,Josh Bellamy,WR,active,chicago-bears,775000,2017
7588,775000,0,Bradley Sowell,LT,active,chicago-bears,775000,2017
7589,615000,0,Daniel Brown,TE,active,chicago-bears,615000,2017
7590,615000,0,Michael Burton,FB,active,chicago-bears,615000,2017
7591,615000,0,Bryce Callahan,CB,active,chicago-bears,615000,2017
7592,540000,62005,Jordan Howard,RB,active,chicago-bears,602005,2017
7593,415060,127722,Deiondre' Hall,CB,active,chicago-bears,542782,2017
7594,542647,0,John Timu,ILB,active,chicago-bears,542647,2017
7595,540000,0,Crevon LeBlanc,CB,active,chicago-bears,540000,2017
7596,476471,0,DeAndre Houston-Carson,S,active,chicago-bears,476471,2017
7597,465000,2333,Roy Robertson-Harris,DE,active,chicago-bears,467333,2017
7598,465000,0,Taquan Mizzell,RB,active,chicago-bears,465000,2017
7599,254120,0,Ben Braunecker,TE,active,chicago-bears,254120,2017
7600,235294,0,Mike Nugent,K,active,chicago-bears,235294,2017
7601,264705,0,Lamarr Houston,OLB,active,chicago-bears,264705,2017
7602,144706,0,Howard Jones,OLB,active,chicago-bears,144706,2017
7603,109412,0,Rashaad Coward,DT,active,chicago-bears,109412,2017
7604,109412,0,Cameron Lee,G,active,chicago-bears,109412,2017
7605,72353,0,Jonathan Anderson,ILB,active,chicago-bears,72353,2017
7606,54706,0,Brandon Greene,T,active,chicago-bears,54706,2017
7607,6250000,1750000,Kyle Long,G,injured_reserve,chicago-bears,8000000,2017
7608,6950000,875000,Pernell McPhee,OLB,injured_reserve,chicago-bears,7825000,2017
7609,615000,3902195,Kevin White,WR,injured_reserve,chicago-bears,4517195,2017
7610,3750000,500000,Jerrell Freeman,ILB,injured_reserve,chicago-bears,4250000,2017
7611,2500000,1739583,Quintin Demps,SS,injured_reserve,chicago-bears,4239583,2017
7612,1000000,3100000,Willie Young,OLB,injured_reserve,chicago-bears,4100000,2017
7613,1167403,2419611,Leonard Floyd,OLB,injured_reserve,chicago-bears,3587014,2017
7614,1500000,1125000,Zach Miller,TE,injured_reserve,chicago-bears,2625000,2017
7615,800000,500000,Eric Kush,G,injured_reserve,chicago-bears,1300000,2017
7616,1000000,150000,Mitch Unrein,DE,injured_reserve,chicago-bears,1150000,2017
7617,615000,2000,Cameron Meredith,WR,injured_reserve,chicago-bears,617000,2017
7618,615000,0,Patrick Scales,LS,injured_reserve,chicago-bears,615000,2017
7619,348000,74009,Jordan Morgan,G,injured_reserve,chicago-bears,422009,2017
7620,355588,0,Isaiah Irving,OLB,injured_reserve,chicago-bears,355588,2017
7621,243529,0,Cairo Santos,K,injured_reserve,chicago-bears,243529,2017
7622,7200,0,D.J. Tialavea,TE,practice_squad,chicago-bears,7200,2017
7623,0,2000000,Jay Cutler,QB,dead_cap,chicago-bears,2000000,2017
7624,700000,1040000,Lamarr Houston,OLB,dead_cap,chicago-bears,1740000,2017
7625,1000000,500000,Victor Cruz,WR,dead_cap,chicago-bears,1500000,2017
7626,900000,80000,Connor Barth,K,dead_cap,chicago-bears,980000,2017
7627,900000,0,Kelvin Sheppard,ILB,dead_cap,chicago-bears,900000,2017
7628,0,600000,Robbie Gould,K,dead_cap,chicago-bears,600000,2017
7629,0,600000,Tracy Porter,CB,dead_cap,chicago-bears,600000,2017
7630,441316,0,Tre McBride,WR,dead_cap,chicago-bears,441316,2017
7631,428000,0,Roberto Aguayo,K,dead_cap,chicago-bears,428000,2017
7632,426738,0,Jonathan Anderson,ILB,dead_cap,chicago-bears,426738,2017
7633,0,400000,B.W. Webb,CB,dead_cap,chicago-bears,400000,2017
7634,273529,110845,Ka'Deem Carey,RB,dead_cap,chicago-bears,384374,2017
7635,0,308570,Ego Ferguson,DT,dead_cap,chicago-bears,308570,2017
7636,227941,80000,Deonte Thompson,WR,dead_cap,chicago-bears,307941,2017
7637,227941,80000,Chris Prosinski,SS,dead_cap,chicago-bears,307941,2017
7638,243318,0,Tanner Gentry,WR,dead_cap,chicago-bears,243318,2017
7639,100000,80000,C.J. Wilson,DT,dead_cap,chicago-bears,180000,2017
7640,0,146517,Will Sutton,DT,dead_cap,chicago-bears,146517,2017
7641,0,135907,Jeremy Langford,RB,dead_cap,chicago-bears,135907,2017
7642,108000,0,Brandon Greene,T,dead_cap,chicago-bears,108000,2017
7643,100800,0,Doran Grant,CB,dead_cap,chicago-bears,100800,2017
7644,0,100000,John Jenkins,DE,dead_cap,chicago-bears,100000,2017
7645,93776,0,Howard Jones,OLB,dead_cap,chicago-bears,93776,2017
7646,93600,0,Rashaad Coward,DT,dead_cap,chicago-bears,93600,2017
7647,93600,0,Cameron Lee,G,dead_cap,chicago-bears,93600,2017
7648,0,80000,Johnthan Banks,CB,dead_cap,chicago-bears,80000,2017
7649,79200,0,Mario Alford,WR,dead_cap,chicago-bears,79200,2017
7650,79200,0,Nelson Spruce,WR,dead_cap,chicago-bears,79200,2017
7651,64800,0,Ben Braunecker,TE,dead_cap,chicago-bears,64800,2017
7652,0,61817,Tayo Fabuluje,RT,dead_cap,chicago-bears,61817,2017
7653,0,59548,Daniel Braverman,WR,dead_cap,chicago-bears,59548,2017
7654,50400,0,Colin Thompson,TE,dead_cap,chicago-bears,50400,2017
7655,14400,35235,DeAndre Houston-Carson,S,dead_cap,chicago-bears,49635,2017
7656,45588,0,Rueben Randle,WR,dead_cap,chicago-bears,45588,2017
7657,43200,0,Demarcus Ayers,WR,dead_cap,chicago-bears,43200,2017
7658,36000,0,Darreus Rogers,WR,dead_cap,chicago-bears,36000,2017
7659,28800,0,Isaiah Irving,OLB,dead_cap,chicago-bears,28800,2017
7660,28800,0,Will Pericak,DT,dead_cap,chicago-bears,28800,2017
7661,21900,3333,Dieugot Joseph,T,dead_cap,chicago-bears,25233,2017
7662,21600,0,Caushaud Lyons,DE,dead_cap,chicago-bears,21600,2017
7663,14500,2833,Freddie Stevenson,FB,dead_cap,chicago-bears,17333,2017
7664,7500,7500,Jhajuan Seales,WR,dead_cap,chicago-bears,15000,2017
7665,14400,0,Carl Bradford,OLB,dead_cap,chicago-bears,14400,2017
7666,14400,0,Alex Carter,S,dead_cap,chicago-bears,14400,2017
7667,14400,0,MeKale McKay,WR,dead_cap,chicago-bears,14400,2017
7668,14400,0,Mike Purcell,DT,dead_cap,chicago-bears,14400,2017
7669,14400,0,Jason Thompson,OLB,dead_cap,chicago-bears,14400,2017
7670,14400,0,John Timu,ILB,dead_cap,chicago-bears,14400,2017
7671,7200,0,Josh Rounds,RB,dead_cap,chicago-bears,7200,2017
7672,7200,0,D.J. Tialavea,TE,dead_cap,chicago-bears,7200,2017
7673,0,5014,Joe Sommers,TE,dead_cap,chicago-bears,5014,2017
7674,0,5000,Don Cherry,ILB,dead_cap,chicago-bears,5000,2017
7675,0,4667,Adrian Bellard,T,dead_cap,chicago-bears,4667,2017
7676,0,2000,Derek Keaton,WR,dead_cap,chicago-bears,2000,2017
7677,7000000,6800000,Khalil Mack,OLB,active,chicago-bears,13800000,2018
7678,4000000,7812500,Allen Robinson,WR,active,chicago-bears,11812500,2018
7679,4500000,5100000,Akiem Hicks,DE,active,chicago-bears,9600000,2018
7680,2248158,6600000,Kyle Long,G,active,chicago-bears,8848158,2018
7681,3500000,4000000,Prince Amukamara,CB,active,chicago-bears,7500000,2018
7682,5800000,1350000,Danny Trevathan,ILB,active,chicago-bears,7150000,2018
7683,555000,6043278,Mitchell Trubisky,QB,active,chicago-bears,6598278,2018
7684,1000000,5500000,Kyle Fuller,CB,active,chicago-bears,6500000,2018
7685,2800000,3125000,Trey Burton,TE,active,chicago-bears,5925000,2018
7686,4900000,1000000,Charles Leno,LT,active,chicago-bears,5900000,2018
7687,2500000,3000000,Taylor Gabriel,WR,active,chicago-bears,5500000,2018
7688,2693597,2576463,Kevin White,WR,active,chicago-bears,5270060,2018
7689,4250000,850000,Bobby Massie,RT,active,chicago-bears,5100000,2018
7690,1884806,2419611,Leonard Floyd,OLB,active,chicago-bears,4304417,2018
7691,2000000,2000000,Chase Daniel,QB,active,chicago-bears,4000000,2018
7692,2200000,1706250,Aaron Lynch,DE,active,chicago-bears,3906250,2018
7693,1250000,2562500,Cody Parkey,K,active,chicago-bears,3812500,2018
7694,1000000,2798876,Eddie Goldman,DT,active,chicago-bears,3798876,2018
7695,480000,2879485,Roquan Smith,LB,active,chicago-bears,3359485,2018
7696,1907000,58070,Adrian Amos,SS,active,chicago-bears,1965070,2018
7697,1907000,0,Josh Bellamy,WR,active,chicago-bears,1907000,2018
7698,1000000,500000,Pat O'Donnell,P,active,chicago-bears,1500000,2018
7699,1100000,381250,Sherrick McManis,CB,active,chicago-bears,1481250,2018
7700,1400000,0,Eric Kush,G,active,chicago-bears,1400000,2018
7701,733661,609643,Adam Shaheen,TE,active,chicago-bears,1343304,2018
7702,480000,783665,James Daniels,C,active,chicago-bears,1263665,2018
7703,850000,350000,Bradley Sowell,LT,active,chicago-bears,1200000,2018
7704,834051,318103,Cody Whitehair,C,active,chicago-bears,1152154,2018
7705,800000,243750,Benny Cunningham,RB,active,chicago-bears,1043750,2018
7706,480000,493400,Anthony Miller,WR,active,chicago-bears,973400,2018
7707,718000,206630,Jonathan Bullard,DE,active,chicago-bears,924630,2018
7708,705000,207500,Daniel Brown,TE,active,chicago-bears,912500,2018
7709,630000,143780,Nick Kwiatkoski,ILB,active,chicago-bears,773780,2018
7710,630000,131554,Deon Bush,S,active,chicago-bears,761554,2018
7711,555000,166449,Eddie Jackson,FS,active,chicago-bears,721449,2018
7712,555000,158914,Tarik Cohen,RB,active,chicago-bears,713914,2018
7713,705000,0,Michael Burton,FB,active,chicago-bears,705000,2018
7714,705000,0,Nick Williams,DE,active,chicago-bears,705000,2018
7715,630000,62005,Jordan Howard,RB,active,chicago-bears,692005,2018
7716,480000,169643,Joel Iyiegbuniwe,ILB,active,chicago-bears,649643,2018
7717,630000,0,Ben Braunecker,TE,active,chicago-bears,630000,2018
7718,630000,0,DeAndre Houston-Carson,S,active,chicago-bears,630000,2018
7719,630000,0,Patrick Scales,LS,active,chicago-bears,630000,2018
7720,555000,2334,Roy Robertson-Harris,DE,active,chicago-bears,557334,2018
7721,555000,0,Rashaad Coward,G,active,chicago-bears,555000,2018
7722,555000,0,Isaiah Irving,OLB,active,chicago-bears,555000,2018
7723,480000,74870,Bilal Nichols,DT,active,chicago-bears,554870,2018
7724,480000,43050,Kylie Fitts,DE,active,chicago-bears,523050,2018
7725,480000,23978,Javon Wims,WR,active,chicago-bears,503978,2018
7726,480000,5000,Kevin Toliver,CB,active,chicago-bears,485000,2018
7727,557647,0,Bryan Witzmann,G,active,chicago-bears,557647,2018
7728,293824,0,Taquan Mizzell,RB,active,chicago-bears,293824,2018
7729,139412,0,Marcus Williams,CB,active,chicago-bears,139412,2018
7730,6000000,333333,Dion Sims,TE,injured_reserve,chicago-bears,6333333,2018
7731,1450000,1300000,Sam Acho,OLB,injured_reserve,chicago-bears,2750000,2018
7732,1907000,0,Bryce Callahan,CB,injured_reserve,chicago-bears,1907000,2018
7733,363000,333,Rashard Fant,CB,injured_reserve,chicago-bears,363333,2018
7734,363000,333,Andrew Trumbetti,DE,injured_reserve,chicago-bears,363333,2018
7735,0,4500000,Mike Glennon,QB,dead_cap,chicago-bears,4500000,2018
7736,247059,1487500,Marcus Cooper,CB,dead_cap,chicago-bears,1734559,2018
7737,0,1166667,Quintin Demps,SS,dead_cap,chicago-bears,1166667,2018
7738,0,1000000,Pernell McPhee,OLB,dead_cap,chicago-bears,1000000,2018
7739,0,990000,Lamarr Houston,OLB,dead_cap,chicago-bears,990000,2018
7740,0,900000,Willie Young,OLB,dead_cap,chicago-bears,900000,2018
7741,0,750000,Markus Wheaton,WR,dead_cap,chicago-bears,750000,2018
7742,0,635418,Josh Sitton,G,dead_cap,chicago-bears,635418,2018
7743,250000,300000,Earl Watford,RT,dead_cap,chicago-bears,550000,2018
7744,369853,45000,Tyler Bray,QB,dead_cap,chicago-bears,414853,2018
7745,0,362743,Jerrell Freeman,ILB,dead_cap,chicago-bears,362743,2018
7746,0,200000,Bennie Fowler,WR,dead_cap,chicago-bears,200000,2018
7747,0,191584,Deiondre' Hall,CB,dead_cap,chicago-bears,191584,2018
7748,0,190480,Hroniss Grasu,C,dead_cap,chicago-bears,190480,2018
7749,152824,0,Marlon Brown,WR,dead_cap,chicago-bears,152824,2018
7750,144200,5000,Jonathan Mincy,CB,dead_cap,chicago-bears,149200,2018
7751,0,135907,Jeremy Langford,RB,dead_cap,chicago-bears,135907,2018
7752,129200,0,Dejon Allen,C,dead_cap,chicago-bears,129200,2018
7753,129200,0,Abdullah Anderson,DT,dead_cap,chicago-bears,129200,2018
7754,129200,0,Tanner Gentry,WR,dead_cap,chicago-bears,129200,2018
7755,129200,0,Michael Joseph,CB,dead_cap,chicago-bears,129200,2018
7756,129200,0,Ryan Nall,RB,dead_cap,chicago-bears,129200,2018
7757,129200,0,Josh Woods,LB,dead_cap,chicago-bears,129200,2018
7758,0,90000,John Jenkins,DE,dead_cap,chicago-bears,90000,2018
7759,76413,0,Jonathan Anderson,ILB,dead_cap,chicago-bears,76413,2018
7760,76000,0,James Stone,C,dead_cap,chicago-bears,76000,2018
7761,0,74009,Jordan Morgan,G,dead_cap,chicago-bears,74009,2018
7762,0,70471,DeAndre Houston-Carson,S,dead_cap,chicago-bears,70471,2018
7763,60800,0,Willie Beavers,T,dead_cap,chicago-bears,60800,2018
7764,60800,0,Taquan Mizzell,RB,dead_cap,chicago-bears,60800,2018
7765,0,45000,John Timu,ILB,dead_cap,chicago-bears,45000,2018
7766,38000,0,Cyril Grayson,WR,dead_cap,chicago-bears,38000,2018
7767,0,6667,Dieugot Joseph,T,dead_cap,chicago-bears,6667,2018
7768,0,5667,Freddie Stevenson,FB,dead_cap,chicago-bears,5667,2018
7769,1000000,18500000,Kyle Fuller,CB,active,chicago-bears,19500000,2019
7770,9900000,6100000,Allen Robinson,WR,active,chicago-bears,16000000,2019
7771,2300000,9600000,Khalil Mack,OLB,active,chicago-bears,11900000,2019
7772,8000000,2100000,Akiem Hicks,DT,active,chicago-bears,10100000,2019
7773,8500000,1000000,Prince Amukamara,CB,active,chicago-bears,9500000,2019
7774,645000,7272933,Mitchell Trubisky,QB,active,chicago-bears,7917933,2019
7775,5500000,1000000,Taylor Gabriel,WR,active,chicago-bears,6500000,2019
7776,4000000,2000000,Chase Daniel,QB,active,chicago-bears,6000000,2019
7777,2250000,3050000,Eddie Goldman,DT,active,chicago-bears,5300000,2019
7778,2602208,2419611,Leonard Floyd,OLB,active,chicago-bears,5021819,2019
7779,3000000,1250000,Cordarrelle Patterson,WR,active,chicago-bears,4250000,2019
7780,2400000,1400000,Bobby Massie,RT,active,chicago-bears,3800000,2019
7781,930000,2394000,Charles Leno,LT,active,chicago-bears,3324000,2019
7782,2000000,1250000,HaHa Clinton-Dix,FS,active,chicago-bears,3250000,2019
7783,926078,1518103,Cody Whitehair,G,active,chicago-bears,2444181,2019
7784,2025000,143780,Nick Kwiatkoski,ILB,active,chicago-bears,2168780,2019
7785,1000000,1100000,Buster Skrine,CB,active,chicago-bears,2100000,2019
7786,1250000,400000,Pat O'Donnell,P,active,chicago-bears,1650000,2019
7787,795916,783665,James Daniels,C,active,chicago-bears,1579581,2019
7788,1000000,500000,Aaron Lynch,OLB,active,chicago-bears,1500000,2019
7789,723350,493400,Anthony Miller,WR,active,chicago-bears,1216750,2019
7790,720000,131556,Deon Bush,S,active,chicago-bears,851556,2019
7791,645000,166449,Eddie Jackson,S,active,chicago-bears,811449,2019
7792,720000,90000,Patrick Scales,LS,active,chicago-bears,810000,2019
7793,645000,158914,Tarik Cohen,RB,active,chicago-bears,803914,2019
7794,720000,50000,DeAndre Houston-Carson,S,active,chicago-bears,770000,2019
7795,495000,261545,David Montgomery,RB,active,chicago-bears,756545,2019
7796,570000,169643,Joel Iyiegbuniwe,ILB,active,chicago-bears,739643,2019
7797,930000,90000,Ted Larsen,G,active,chicago-bears,1020000,2019
7798,805000,90000,Nick Williams,DT,active,chicago-bears,895000,2019
7799,495000,170649,Riley Ridley,WR,active,chicago-bears,665649,2019
7800,805000,10000,Cornelius Lucas,LT,active,chicago-bears,815000,2019
7801,805000,0,Kevin Pierre-Louis,OLB,active,chicago-bears,805000,2019
7802,645000,0,Rashaad Coward,RT,active,chicago-bears,645000,2019
7803,645000,0,Isaiah Irving,OLB,active,chicago-bears,645000,2019
7804,645000,0,Roy Robertson-Harris,DT,active,chicago-bears,645000,2019
7805,570000,74870,Bilal Nichols,DE,active,chicago-bears,644870,2019
7806,597059,0,Bradley Sowell,TE,active,chicago-bears,597059,2019
7807,570000,23978,Javon Wims,WR,active,chicago-bears,593978,2019
7808,570000,5000,Kevin Toliver,CB,active,chicago-bears,575000,2019
7809,495000,31960,Duke Shelley,S,active,chicago-bears,526960,2019
7810,495000,15100,Josh Woods,LB,active,chicago-bears,510100,2019
7811,495000,0,Eddy Piniero,K,active,chicago-bears,495000,2019
7812,473529,0,Brent Urban,DE,active,chicago-bears,473529,2019
7813,465888,0,J.P. Holtz,TE,active,chicago-bears,465888,2019
7814,320294,0,Abdullah Anderson,DE,active,chicago-bears,320294,2019
7815,320294,0,Alex Bars,G,active,chicago-bears,320294,2019
7816,232944,0,Ryan Nall,RB,active,chicago-bears,232944,2019
7817,189706,0,Corey Levin,C,active,chicago-bears,189706,2019
7818,189706,0,Eric Saubert,TE,active,chicago-bears,189706,2019
7819,174706,0,Jesper Horsted,WR,active,chicago-bears,174706,2019
7820,113823,0,Devante Bond,OLB,active,chicago-bears,113823,2019
7821,58236,0,Michael Joseph,CB,active,chicago-bears,58236,2019
7822,6700000,1850000,Trey Burton,TE,injured_reserve,chicago-bears,8550000,2019
7823,5800000,1850000,Danny Trevathan,ILB,injured_reserve,chicago-bears,7650000,2019
7824,2500000,3100000,Kyle Long,G,injured_reserve,chicago-bears,5600000,2019
7825,1319871,2879485,Roquan Smith,LB,injured_reserve,chicago-bears,4199356,2019
7826,1500000,412500,Sherrick McManis,S,injured_reserve,chicago-bears,1912500,2019
7827,1002322,609643,Adam Shaheen,TE,injured_reserve,chicago-bears,1611965,2019
7828,750000,268750,Ben Braunecker,TE,injured_reserve,chicago-bears,1018750,2019
7829,805000,0,T.J. Clemmings,RT,injured_reserve,chicago-bears,805000,2019
7830,378000,0,Josh Simmons,CB,injured_reserve,chicago-bears,378000,2019
7831,88000,0,Fadol Brown,DE,injured_reserve,chicago-bears,88000,2019
7832,137500,0,Tyler Bray,QB,practice_squad,chicago-bears,137500,2019
7833,3500000,562500,Cody Parkey,K,dead_cap,chicago-bears,4062500,2019
7834,588235,1000000,Mike Davis,RB,dead_cap,chicago-bears,1588235,2019
7835,1117646,0,Bradley Sowell,TE,dead_cap,chicago-bears,1117646,2019
7836,0,333334,Dion Sims,TE,dead_cap,chicago-bears,333334,2019
7837,0,250000,Sam Acho,OLB,dead_cap,chicago-bears,250000,2019
7838,0,230000,Quintin Demps,SS,dead_cap,chicago-bears,230000,2019
7839,201764,21400,Tyler Bray,QB,dead_cap,chicago-bears,223164,2019
7840,0,206630,Jonathan Bullard,DE,dead_cap,chicago-bears,206630,2019
7841,172568,25270,Kerrith Whyte,RB,dead_cap,chicago-bears,197838,2019
7842,0,191586,Deiondre' Hall,CB,dead_cap,chicago-bears,191586,2019
7843,165000,0,Jesper Horsted,WR,dead_cap,chicago-bears,165000,2019
7844,136000,20162,Stephen Denmark,CB,dead_cap,chicago-bears,156162,2019
7845,0,148018,Jordan Morgan,G,dead_cap,chicago-bears,148018,2019
7846,143500,1166,Sam Mustipher,C,dead_cap,chicago-bears,144666,2019
7847,142971,833,Jonathan Harris,DT,dead_cap,chicago-bears,143804,2019
7848,143354,0,James Vaughters,DE,dead_cap,chicago-bears,143354,2019
7849,136000,0,Thomas Ives,WR,dead_cap,chicago-bears,136000,2019
7850,127353,0,Abdullah Anderson,DE,dead_cap,chicago-bears,127353,2019
7851,120000,0,Michael Joseph,CB,dead_cap,chicago-bears,120000,2019
7852,118000,1666,Alex Bars,G,dead_cap,chicago-bears,119666,2019
7853,111177,833,Blake Blackmar,G,dead_cap,chicago-bears,112010,2019
7854,72000,0,Ryan Nall,RB,dead_cap,chicago-bears,72000,2019
7855,0,62007,Jordan Howard,RB,dead_cap,chicago-bears,62007,2019
7856,56000,0,Dino Boyd,T,dead_cap,chicago-bears,56000,2019
7857,0,43050,Kylie Fitts,DE,dead_cap,chicago-bears,43050,2019
7858,25000,4166,Chuck Harris,DE,dead_cap,chicago-bears,29166,2019
7859,24000,0,Xavier Crawford,CB,dead_cap,chicago-bears,24000,2019
7860,24000,0,Reggie Davis,WR,dead_cap,chicago-bears,24000,2019
7861,24000,0,Dewayne Hendrix,DE,dead_cap,chicago-bears,24000,2019
7862,24000,0,Jeremy McNichols,RB,dead_cap,chicago-bears,24000,2019
7863,16000,0,Alex Wesley,WR,dead_cap,chicago-bears,16000,2019
7864,12000,3333,Mathieu Betts,DE,dead_cap,chicago-bears,15333,2019
7865,10000,1666,Ian Bunting,TE,dead_cap,chicago-bears,11666,2019
7866,0,10000,Jonathan Mincy,CB,dead_cap,chicago-bears,10000,2019
7867,7500,1666,Doyin Jibowu,CB,dead_cap,chicago-bears,9166,2019
7868,5000,1666,Marquez Tucker,G,dead_cap,chicago-bears,6666,2019
7869,5000,833,John Wirtel,LS,dead_cap,chicago-bears,5833,2019
7870,0,4000,Emanuel Hall,WR,dead_cap,chicago-bears,4000,2019
7871,2500,833,Joe Lowery,T,dead_cap,chicago-bears,3333,2019
7872,0,1666,Jomon Dotson,S,dead_cap,chicago-bears,1666,2019
7873,0,1500,Daryle Banfield,DT,dead_cap,chicago-bears,1500,2019
7874,0,1500,Ellis Richardson,TE,dead_cap,chicago-bears,1500,2019
7875,0,1000,Rashard Fant,CB,dead_cap,chicago-bears,1000,2019
7876,0,667,Andrew Trumbetti,DE,dead_cap,chicago-bears,667,2019
7877,13300000,13300000,Khalil Mack,OLB,active,chicago-bears,26600000,2020
7878,10900000,4100000,Allen Robinson,WR,active,chicago-bears,15000000,2020
7879,13222000,0,Leonard Floyd,OLB,active,chicago-bears,13222000,2020
7880,10200000,1600000,Akiem Hicks,DT,active,chicago-bears,11800000,2020
7881,4500000,8500000,Kyle Fuller,CB,active,chicago-bears,13000000,2020
7882,4750000,6050000,Eddie Goldman,DT,active,chicago-bears,10800000,2020
7883,7900000,2394000,Charles Leno,LT,active,chicago-bears,10294000,2020
7884,9000000,1000000,Prince Amukamara,CB,active,chicago-bears,10000000,2020
7885,735000,8502591,Mitchell Trubisky,QB,active,chicago-bears,9237591,2020
7886,6700000,1850000,Trey Burton,TE,active,chicago-bears,8550000,2020
7887,6900000,1400000,Bobby Massie,RT,active,chicago-bears,8300000,2020
7888,5100000,3400000,Cody Whitehair,G,active,chicago-bears,8500000,2020
7889,5500000,1000000,Taylor Gabriel,WR,active,chicago-bears,6500000,2020
7890,4650000,1450000,Buster Skrine,CB,active,chicago-bears,6100000,2020
7891,4250000,1500000,Cordarrelle Patterson,WR,active,chicago-bears,5750000,2020
7892,2159743,2879485,Roquan Smith,LB,active,chicago-bears,5039228,2020
7893,1050000,2666450,Eddie Jackson,FS,active,chicago-bears,3716450,2020
7894,1111833,783665,James Daniels,C,active,chicago-bears,1895498,2020
7895,1270982,609644,Adam Shaheen,TE,active,chicago-bears,1880626,2020
7896,1750000,100000,Pat O'Donnell,P,active,chicago-bears,1850000,2020
7897,1350000,268750,Ben Braunecker,TE,active,chicago-bears,1618750,2020
7898,966700,493400,Anthony Miller,WR,active,chicago-bears,1460100,2020
7899,684136,261545,David Montgomery,RB,active,chicago-bears,945681,2020
7900,735000,158916,Tarik Cohen,RB,active,chicago-bears,893916,2020
7901,660000,169643,Joel Iyiegbuniwe,ILB,active,chicago-bears,829643,2020
7902,585000,170649,Riley Ridley,WR,active,chicago-bears,755649,2020
7903,735000,0,Kentrell Brice,S,active,chicago-bears,735000,2020
7904,735000,0,Corey Levin,C,active,chicago-bears,735000,2020
7905,735000,0,Eric Saubert,TE,active,chicago-bears,735000,2020
7906,660000,74870,Bilal Nichols,DE,active,chicago-bears,734870,2020
7907,660000,23978,Javon Wims,WR,active,chicago-bears,683978,2020
7908,660000,5000,Kevin Toliver,CB,active,chicago-bears,665000,2020
7909,660000,0,Eddy Piniero,K,active,chicago-bears,660000,2020
7910,585000,31960,Duke Shelley,S,active,chicago-bears,616960,2020
7911,585000,21117,Xavier Crawford,CB,active,chicago-bears,606117,2020
7912,585000,15100,Josh Woods,LB,active,chicago-bears,600100,2020
7913,585000,0,Abdullah Anderson,DE,active,chicago-bears,585000,2020
7914,585000,0,Alex Bars,G,active,chicago-bears,585000,2020
7915,585000,0,Jesper Horsted,WR,active,chicago-bears,585000,2020
7916,585000,0,Ryan Nall,RB,active,chicago-bears,585000,2020
7917,585000,0,James Vaughters,DE,active,chicago-bears,585000,2020
7918,510000,0,Dino Boyd,T,active,chicago-bears,510000,2020
7919,510000,0,Darion Clark,TE,active,chicago-bears,510000,2020
7920,510000,0,Reggie Davis,WR,active,chicago-bears,510000,2020
7921,510000,0,Stephen Denmark,CB,active,chicago-bears,510000,2020
7922,510000,0,Thomas Ives,WR,active,chicago-bears,510000,2020
7923,510000,0,Michael Joseph,CB,active,chicago-bears,510000,2020
7924,510000,0,Sam Mustipher,C,active,chicago-bears,510000,2020
7925,510000,0,Dax Raymond,TE,active,chicago-bears,510000,2020
7926,510000,0,Josh Simmons,CB,active,chicago-bears,510000,2020
7927,510000,0,Alex Wesley,WR,active,chicago-bears,510000,2020
7928,0,1500000,Kyle Long,G,dead_cap,chicago-bears,1500000,2020
7929,0,1125000,Cody Parkey,K,dead_cap,chicago-bears,1125000,2020
7930,0,1000000,Mike Davis,RB,dead_cap,chicago-bears,1000000,2020
7931,0,86100,Kylie Fitts,DE,dead_cap,chicago-bears,86100,2020
7932,0,75810,Kerrith Whyte,RB,dead_cap,chicago-bears,75810,2020
7933,0,60486,Stephen Denmark,CB,dead_cap,chicago-bears,60486,2020
7934,0,8334,Chuck Harris,DE,dead_cap,chicago-bears,8334,2020
7935,0,8000,Emanuel Hall,WR,dead_cap,chicago-bears,8000,2020
7936,0,6667,Mathieu Betts,DE,dead_cap,chicago-bears,6667,2020
7937,0,3334,Alex Bars,G,dead_cap,chicago-bears,3334,2020
7938,0,3334,Ian Bunting,TE,dead_cap,chicago-bears,3334,2020
7939,0,3334,Jomon Dotson,S,dead_cap,chicago-bears,3334,2020
7940,0,3334,Doyin Jibowu,CB,dead_cap,chicago-bears,3334,2020
7941,0,3334,Marquez Tucker,G,dead_cap,chicago-bears,3334,2020
7942,0,3000,Daryle Banfield,DT,dead_cap,chicago-bears,3000,2020
7943,0,3000,Ellis Richardson,TE,dead_cap,chicago-bears,3000,2020
7944,0,2334,Sam Mustipher,C,dead_cap,chicago-bears,2334,2020
7945,0,1667,Blake Blackmar,G,dead_cap,chicago-bears,1667,2020
7946,0,1667,Jonathan Harris,DT,dead_cap,chicago-bears,1667,2020
7947,0,1667,Joe Lowery,T,dead_cap,chicago-bears,1667,2020
7948,0,1667,John Wirtel,LS,dead_cap,chicago-bears,1667,2020
7949,0,334,Rashard Fant,CB,dead_cap,chicago-bears,334,2020
7950,7250000,8030000,Carson Palmer,QB,active,cincinnati-bengals,15280000,2007
7951,8644000,0,Justin Smith,DE,active,cincinnati-bengals,8644000,2007
7952,2500000,2000000,Chad Johnson,WR,active,cincinnati-bengals,4500000,2007
7953,1300000,3783333,Robert Geathers,DE,active,cincinnati-bengals,5083333,2007
7954,1000000,4683332,Levi Jones,T,active,cincinnati-bengals,5683332,2007
7955,3550000,1000000,Rudi Johnson,RB,active,cincinnati-bengals,4550000,2007
7956,2250000,1037500,T.J. Houshmandzadeh,WR,active,cincinnati-bengals,3287500,2007
7957,2400000,571250,Deltha O'Neal,CB,active,cincinnati-bengals,2971250,2007
7958,1400000,1200000,Reggie Kelly,TE,active,cincinnati-bengals,2600000,2007
7959,1700000,825000,Bobbie Williams,G,active,cincinnati-bengals,2525000,2007
7960,535000,2630000,David Pollack,LB,active,cincinnati-bengals,3165000,2007
7961,667000,1112500,Chris Perry,RB,active,cincinnati-bengals,1779500,2007
7962,360000,2005000,Johnathan Joseph,CB,active,cincinnati-bengals,2365000,2007
7963,595000,733333,Scott Kooistra,T,active,cincinnati-bengals,1328333,2007
7964,285000,965000,Leon Hall,CB,active,cincinnati-bengals,1250000,2007
7965,595000,597000,Shayne Graham,K,active,cincinnati-bengals,1192000,2007
7966,510000,300000,Madieu Williams,S,active,cincinnati-bengals,810000,2007
7967,385000,416668,Adam Kieft,T,active,cincinnati-bengals,801668,2007
7968,360000,275000,Andrew Whitworth,LT,active,cincinnati-bengals,635000,2007
7969,510000,100000,Alex Stepanovich,C,active,cincinnati-bengals,610000,2007
7970,435000,173000,Chris Henry,WR,active,cincinnati-bengals,608000,2007
7971,285000,320000,Kenny Irons,RB,active,cincinnati-bengals,605000,2007
7972,360000,160187,Ahmad Brooks,OLB,active,cincinnati-bengals,520187,2007
7973,360000,155000,Frostee Rucker,DT,active,cincinnati-bengals,515000,2007
7974,360000,101750,Domata Peko,DT,active,cincinnati-bengals,461750,2007
7975,435000,11758,Jonathan Fanene,DE,active,cincinnati-bengals,446758,2007
7976,435000,0,Ryan Fitzpatrick,QB,active,cincinnati-bengals,435000,2007
7977,285000,111875,Marvin White,S,active,cincinnati-bengals,396875,2007
7978,360000,21875,Bruce Gradkowski,QB,active,cincinnati-bengals,381875,2007
7979,360000,15500,Ethan Kilmer,S,active,cincinnati-bengals,375500,2007
7980,360000,10500,Ryan Plackemeier,P,active,cincinnati-bengals,370500,2007
7981,360000,0,Titus Adams,DT,active,cincinnati-bengals,360000,2007
7982,360000,0,Corey Mays,LB,active,cincinnati-bengals,360000,2007
7983,360000,0,Anthony Schlegel,LB,active,cincinnati-bengals,360000,2007
7984,285000,43500,Jeff Rowe,QB,active,cincinnati-bengals,328500,2007
7985,295000,8837,Chinedum Ndukwe,S,active,cincinnati-bengals,303837,2007
7986,285000,0,David Jones,CB,active,cincinnati-bengals,285000,2007
7987,285000,0,Dan Santucci,C,active,cincinnati-bengals,285000,2007
7988,435000,24333,Tab Perry,WR,active,cincinnati-bengals,459333,2007
7989,25588,0,Quincy Wilson,RB,active,cincinnati-bengals,25588,2007
7990,435000,106250,Eric Ghiaciuc,C,injured_reserve,cincinnati-bengals,541250,2007
7991,360000,0,Herana-Daze Jones,S,injured_reserve,cincinnati-bengals,360000,2007
7992,113429,0,Nate Livings,G,practice_squad,cincinnati-bengals,113429,2007
7993,79900,0,Kyle Cook,C,practice_squad,cincinnati-bengals,79900,2007
7994,0,1200000,Brian Simmons,ILB,dead_cap,cincinnati-bengals,1200000,2007
7995,64875,0,Reggie McNeal,QB,dead_cap,cincinnati-bengals,64875,2007
7996,39750,0,A.J. Nicholson,LB,dead_cap,cincinnati-bengals,39750,2007
7997,12075,0,Dan Santucci,C,dead_cap,cincinnati-bengals,12075,2007
7998,11375,0,Bennie Brazell,WR,dead_cap,cincinnati-bengals,11375,2007
7999,7750000,8030000,Carson Palmer,QB,active,cincinnati-bengals,15780000,2008
8000,3000000,2000000,Chad Johnson,WR,active,cincinnati-bengals,5000000,2008
8001,3000000,2933332,Levi Jones,T,active,cincinnati-bengals,5933332,2008
8002,2200000,2283333,Robert Geathers,DE,active,cincinnati-bengals,4483333,2008
8003,2650000,1037500,T.J. Houshmandzadeh,WR,active,cincinnati-bengals,3687500,2008
8004,2000000,1200000,Reggie Kelly,TE,active,cincinnati-bengals,3200000,2008
8005,2000000,925000,Bobbie Williams,G,active,cincinnati-bengals,2925000,2008
8006,2000000,666666,Ben Utecht,TE,active,cincinnati-bengals,2666666,2008
8007,295000,1609166,Keith Rivers,OLB,active,cincinnati-bengals,1904166,2008
8008,600000,1275000,Andrew Whitworth,LT,active,cincinnati-bengals,1875000,2008
8009,650000,1101750,Domata Peko,DT,active,cincinnati-bengals,1751750,2008
8010,530000,2055000,Johnathan Joseph,CB,active,cincinnati-bengals,2585000,2008
8011,822000,1112500,Chris Perry,RB,active,cincinnati-bengals,1934500,2008
8012,370000,2385000,Leon Hall,CB,active,cincinnati-bengals,2755000,2008
8013,900000,250000,Jonathan Fanene,DE,active,cincinnati-bengals,1150000,2008
8014,730000,597000,Shayne Graham,K,active,cincinnati-bengals,1327000,2008
8015,285000,796750,Jerome Simpson,WR,active,cincinnati-bengals,1081750,2008
8016,927000,106250,Eric Ghiaciuc,C,active,cincinnati-bengals,1033250,2008
8017,927000,0,Ryan Fitzpatrick,QB,active,cincinnati-bengals,927000,2008
8018,445000,155000,Frostee Rucker,DT,active,cincinnati-bengals,600000,2008
8019,525000,0,Cedric Benson,RB,active,cincinnati-bengals,525000,2008
8020,520000,0,Darryl Blackstock,LB,active,cincinnati-bengals,520000,2008
8021,295000,192050,Pat Sims,DT,active,cincinnati-bengals,487050,2008
8022,370000,111875,Marvin White,S,active,cincinnati-bengals,481875,2008
8023,295000,150250,Andre Caldwell,WR,active,cincinnati-bengals,445250,2008
8024,445000,0,Brandon Johnson,LB,active,cincinnati-bengals,445000,2008
8025,445000,0,Corey Mays,LB,active,cincinnati-bengals,445000,2008
8026,295000,117625,Anthony Collins,LT,active,cincinnati-bengals,412625,2008
8027,520000,5000,Chris Henry,WR,active,cincinnati-bengals,525000,2008
8028,370000,8837,Chinedum Ndukwe,S,active,cincinnati-bengals,378837,2008
8029,370000,0,Orien Harris,DT,active,cincinnati-bengals,370000,2008
8030,370000,0,Abdul Hodge,LB,active,cincinnati-bengals,370000,2008
8031,370000,0,David Jones,CB,active,cincinnati-bengals,370000,2008
8032,370000,0,Reagan Maui'a,RB,active,cincinnati-bengals,370000,2008
8033,295000,25625,Corey Lynch,S,active,cincinnati-bengals,320625,2008
8034,295000,0,Kyle Cook,C,active,cincinnati-bengals,295000,2008
8035,295000,0,Jordan Palmer,QB,active,cincinnati-bengals,295000,2008
8036,200000,17500,Matt Sherry,TE,active,cincinnati-bengals,217500,2008
8037,215000,0,Dan Santucci,C,active,cincinnati-bengals,215000,2008
8038,130882,0,Ethan Kilmer,S,active,cincinnati-bengals,130882,2008
8039,104118,0,Nate Livings,G,active,cincinnati-bengals,104118,2008
8040,605000,733333,Scott Kooistra,T,injured_reserve,cincinnati-bengals,1338333,2008
8041,88400,0,Maurice Purify,WR,practice_squad,cincinnati-bengals,88400,2008
8042,57200,0,Nate Livings,G,practice_squad,cincinnati-bengals,57200,2008
8043,0,2630000,David Pollack,LB,dead_cap,cincinnati-bengals,2630000,2008
8044,1000000,0,Rudi Johnson,RB,dead_cap,cincinnati-bengals,1000000,2008
8045,0,400000,Deltha O'Neal,CB,dead_cap,cincinnati-bengals,400000,2008
8046,346000,0,Chris Henry,WR,dead_cap,cincinnati-bengals,346000,2008
8047,320374,0,Ahmad Brooks,OLB,dead_cap,cincinnati-bengals,320374,2008
8048,320000,0,Kenny Irons,RB,dead_cap,cincinnati-bengals,320000,2008
8049,79500,0,A.J. Nicholson,LB,dead_cap,cincinnati-bengals,79500,2008
8050,43500,0,Jeff Rowe,QB,dead_cap,cincinnati-bengals,43500,2008
8051,36225,0,Dan Santucci,C,dead_cap,cincinnati-bengals,36225,2008
8052,22750,0,Bennie Brazell,WR,dead_cap,cincinnati-bengals,22750,2008
8053,19500,0,Mario Urrutia,WR,dead_cap,cincinnati-bengals,19500,2008
8054,15600,0,Marcus Brown,CB,dead_cap,cincinnati-bengals,15600,2008
8055,15500,0,Ethan Kilmer,S,dead_cap,cincinnati-bengals,15500,2008
8056,10175,0,Angelo Craig,DE,dead_cap,cincinnati-bengals,10175,2008
8057,9500000,6600000,Carson Palmer,QB,active,cincinnati-bengals,16100000,2009
8058,4500000,2000000,Chad Johnson,WR,active,cincinnati-bengals,6500000,2009
8059,1900000,750000,Laveranues Coles,WR,active,cincinnati-bengals,2650000,2009
8060,2200000,3475000,Andrew Whitworth,LT,active,cincinnati-bengals,5675000,2009
8061,700000,3801750,Domata Peko,DT,active,cincinnati-bengals,4501750,2009
8062,2400000,2033333,Robert Geathers,DE,active,cincinnati-bengals,4433333,2009
8063,385000,3684166,Keith Rivers,OLB,active,cincinnati-bengals,4069166,2009
8064,2400000,925000,Bobbie Williams,G,active,cincinnati-bengals,3325000,2009
8065,2500000,537500,Chris Crocker,S,active,cincinnati-bengals,3037500,2009
8066,1400000,1600000,Cedric Benson,RB,active,cincinnati-bengals,3000000,2009
8067,2483000,0,Shayne Graham,K,active,cincinnati-bengals,2483000,2009
8068,1000000,1375000,Andre Smith,G,active,cincinnati-bengals,2375000,2009
8069,2250000,0,Ben Utecht,TE,active,cincinnati-bengals,2250000,2009
8070,682500,2385000,Leon Hall,CB,active,cincinnati-bengals,3067500,2009
8071,660000,2055000,Johnathan Joseph,CB,active,cincinnati-bengals,2715000,2009
8072,1545000,0,Brandon Johnson,LB,active,cincinnati-bengals,1545000,2009
8073,1150000,250000,Jonathan Fanene,DE,active,cincinnati-bengals,1400000,2009
8074,310000,509000,Rey Maualuga,ILB,active,cincinnati-bengals,819000,2009
8075,385000,371750,Jerome Simpson,WR,active,cincinnati-bengals,756750,2009
8076,535000,155000,Frostee Rucker,DT,active,cincinnati-bengals,690000,2009
8077,620000,5000,Chris Henry,WR,active,cincinnati-bengals,625000,2009
8078,620000,0,Evan Mathis,G,active,cincinnati-bengals,620000,2009
8079,385000,192050,Pat Sims,DT,active,cincinnati-bengals,577050,2009
8080,385000,150250,Andre Caldwell,WR,active,cincinnati-bengals,535250,2009
8081,310000,215755,Michael Johnson,DE,active,cincinnati-bengals,525755,2009
8082,385000,117625,Anthony Collins,LT,active,cincinnati-bengals,502625,2009
8083,460000,8837,Chinedum Ndukwe,S,active,cincinnati-bengals,468837,2009
8084,310000,155500,Chase Coffman,TE,active,cincinnati-bengals,465500,2009
8085,620000,50000,Tank Johnson,DT,active,cincinnati-bengals,670000,2009
8086,620000,0,Larry Johnson,RB,active,cincinnati-bengals,620000,2009
8087,620000,0,Scott Kooistra,T,active,cincinnati-bengals,620000,2009
8088,460000,0,Orien Harris,DT,active,cincinnati-bengals,460000,2009
8089,460000,0,Abdul Hodge,LB,active,cincinnati-bengals,460000,2009
8090,460000,0,David Jones,CB,active,cincinnati-bengals,460000,2009
8091,310000,127255,Jonathan Luigs,C,active,cincinnati-bengals,437255,2009
8092,385000,0,Kyle Cook,C,active,cincinnati-bengals,385000,2009
8093,385000,0,Clark Harris,LS,active,cincinnati-bengals,385000,2009
8094,385000,0,Nate Livings,G,active,cincinnati-bengals,385000,2009
8095,385000,0,Jordan Palmer,QB,active,cincinnati-bengals,385000,2009
8096,310000,48750,Kevin Huber,P,active,cincinnati-bengals,358750,2009
8097,310000,28000,Morgan Trent,CB,active,cincinnati-bengals,338000,2009
8098,310000,19377,Bernard Scott,RB,active,cincinnati-bengals,329377,2009
8099,310000,17500,Matt Sherry,TE,active,cincinnati-bengals,327500,2009
8100,310000,15419,Fui Vakapuna,RB,active,cincinnati-bengals,325419,2009
8101,310000,9758,Clinton McDonald,DT,active,cincinnati-bengals,319758,2009
8102,310000,3750,Dan Skuta,OLB,active,cincinnati-bengals,313750,2009
8103,310000,0,Tom Nelson,WR,active,cincinnati-bengals,310000,2009
8104,2000000,1200000,Reggie Kelly,TE,injured_reserve,cincinnati-bengals,3200000,2009
8105,750000,150000,Roy Williams,S,injured_reserve,cincinnati-bengals,900000,2009
8106,88400,0,Corey Lynch,S,practice_squad,cincinnati-bengals,88400,2009
8107,88400,0,Clinton McDonald,DT,practice_squad,cincinnati-bengals,88400,2009
8108,88400,0,Maurice Purify,WR,practice_squad,cincinnati-bengals,88400,2009
8109,0,9533336,Levi Jones,T,dead_cap,cincinnati-bengals,9533336,2009
8110,0,2630000,David Pollack,LB,dead_cap,cincinnati-bengals,2630000,2009
8111,1000000,0,Rudi Johnson,RB,dead_cap,cincinnati-bengals,1000000,2009
8112,750000,0,Laveranues Coles,WR,dead_cap,cincinnati-bengals,750000,2009
8113,0,1070000,Chris Perry,RB,dead_cap,cincinnati-bengals,1070000,2009
8114,0,666666,Ben Utecht,TE,dead_cap,cincinnati-bengals,666666,2009
8115,640000,0,Kenny Irons,RB,dead_cap,cincinnati-bengals,640000,2009
8116,401569,0,Scott Kooistra,T,dead_cap,cincinnati-bengals,401569,2009
8117,310000,0,Odell Thurman,LB,dead_cap,cincinnati-bengals,310000,2009
8118,111875,0,Marvin White,S,dead_cap,cincinnati-bengals,111875,2009
8119,87000,0,Jeff Rowe,QB,dead_cap,cincinnati-bengals,87000,2009
8120,58500,0,Mario Urrutia,WR,dead_cap,cincinnati-bengals,58500,2009
8121,46800,0,Marcus Brown,CB,dead_cap,cincinnati-bengals,46800,2009
8122,30525,0,Angelo Craig,DE,dead_cap,cincinnati-bengals,30525,2009
8123,25625,0,Corey Lynch,S,dead_cap,cincinnati-bengals,25625,2009
8124,15500,0,Ethan Kilmer,S,dead_cap,cincinnati-bengals,15500,2009
8125,10500000,3600000,Carson Palmer,QB,active,cincinnati-bengals,14100000,2010
8126,5000000,1000000,Chad Johnson,WR,active,cincinnati-bengals,6000000,2010
8127,810000,6794166,Keith Rivers,OLB,active,cincinnati-bengals,7604166,2010
8128,1550000,900000,Antonio Bryant,WR,active,cincinnati-bengals,2450000,2010
8129,3250000,2033333,Robert Geathers,DE,active,cincinnati-bengals,5283333,2010
8130,3440000,1200000,Andrew Whitworth,LT,active,cincinnati-bengals,4640000,2010
8131,2950000,1200000,Domata Peko,DT,active,cincinnati-bengals,4150000,2010
8132,2650000,850000,Cedric Benson,RB,active,cincinnati-bengals,3500000,2010
8133,2500000,537500,Chris Crocker,S,active,cincinnati-bengals,3037500,2010
8134,1000000,1700000,Bobbie Williams,G,active,cincinnati-bengals,2700000,2010
8135,1625000,2055000,Johnathan Joseph,CB,active,cincinnati-bengals,3680000,2010
8136,1083750,3016000,Andre Smith,G,active,cincinnati-bengals,4099750,2010
8137,995000,2385000,Leon Hall,CB,active,cincinnati-bengals,3380000,2010
8138,1759000,0,Brandon Johnson,LB,active,cincinnati-bengals,1759000,2010
8139,876000,602222,Frostee Rucker,DT,active,cincinnati-bengals,1478222,2010
8140,1150000,250000,Jonathan Fanene,DE,active,cincinnati-bengals,1400000,2010
8141,745000,622000,Reggie Nelson,FS,active,cincinnati-bengals,1367000,2010
8142,1226000,0,Evan Mathis,G,active,cincinnati-bengals,1226000,2010
8143,325000,821000,Jermaine Gresham,TE,active,cincinnati-bengals,1146000,2010
8144,855000,150000,Reggie Kelly,TE,active,cincinnati-bengals,1005000,2010
8145,755000,250000,Roy Williams,S,active,cincinnati-bengals,1005000,2010
8146,395000,534000,Rey Maualuga,ILB,active,cincinnati-bengals,929000,2010
8147,470000,371750,Jerome Simpson,WR,active,cincinnati-bengals,841750,2010
8148,470000,192050,Pat Sims,DT,active,cincinnati-bengals,662050,2010
8149,630000,0,Kirk Chambers,G,active,cincinnati-bengals,630000,2010
8150,320000,307000,Carlos Dunlap,DE,active,cincinnati-bengals,627000,2010
8151,470000,150250,Andre Caldwell,WR,active,cincinnati-bengals,620250,2010
8152,395000,215755,Michael Johnson,DE,active,cincinnati-bengals,610755,2010
8153,470000,117625,Anthony Collins,LT,active,cincinnati-bengals,587625,2010
8154,550000,0,Marvin White,S,active,cincinnati-bengals,550000,2010
8155,545000,0,Adam-Pacman Jones,CB,active,cincinnati-bengals,545000,2010
8156,395000,127255,Jonathan Luigs,C,active,cincinnati-bengals,522255,2010
8157,320000,189186,Jordan Shipley,WR,active,cincinnati-bengals,509186,2010
8158,502352,0,Mike Nugent,K,active,cincinnati-bengals,502352,2010
8159,470000,0,Kyle Cook,C,active,cincinnati-bengals,470000,2010
8160,470000,0,Clark Harris,LS,active,cincinnati-bengals,470000,2010
8161,470000,0,Nate Livings,G,active,cincinnati-bengals,470000,2010
8162,470000,0,Jordan Palmer,QB,active,cincinnati-bengals,470000,2010
8163,470000,0,Dennis Roland,RT,active,cincinnati-bengals,470000,2010
8164,395000,48750,Kevin Huber,P,active,cincinnati-bengals,443750,2010
8165,320000,118112,Geno Atkins,DT,active,cincinnati-bengals,438112,2010
8166,320000,105895,Roddrick Muckelroy,ILB,active,cincinnati-bengals,425895,2010
8167,390000,28000,Morgan Trent,CB,active,cincinnati-bengals,418000,2010
8168,395000,19377,Bernard Scott,RB,active,cincinnati-bengals,414377,2010
8169,395000,15419,Fui Vakapuna,RB,active,cincinnati-bengals,410419,2010
8170,395000,3750,Dan Skuta,OLB,active,cincinnati-bengals,398750,2010
8171,396000,0,Tom Nelson,WR,active,cincinnati-bengals,396000,2010
8172,395000,0,Chase Coffman,TE,active,cincinnati-bengals,395000,2010
8173,395000,0,Chris Pressley,FB,active,cincinnati-bengals,395000,2010
8174,225000,163275,Brandon Ghee,CB,active,cincinnati-bengals,388275,2010
8175,385000,0,Cedric Peerman,RB,active,cincinnati-bengals,385000,2010
8176,320000,12848,Reggie Stephens,C,active,cincinnati-bengals,332848,2010
8177,320000,0,Dan LeFevour,QB,active,cincinnati-bengals,320000,2010
8178,169411,0,Clinton McDonald,DT,active,cincinnati-bengals,169411,2010
8179,75294,3000,Vincent Rey,ILB,active,cincinnati-bengals,78294,2010
8180,2000000,1166666,Terrell Owens,WR,injured_reserve,cincinnati-bengals,3166666,2010
8181,2000000,800000,Tank Johnson,DT,injured_reserve,cincinnati-bengals,2800000,2010
8182,88400,0,James Develin,FB,practice_squad,cincinnati-bengals,88400,2010
8183,88400,0,Cary Harris,CB,practice_squad,cincinnati-bengals,88400,2010
8184,88400,0,Clinton McDonald,DT,practice_squad,cincinnati-bengals,88400,2010
8185,1500000,0,Laveranues Coles,WR,dead_cap,cincinnati-bengals,1500000,2010
8186,0,666668,Ben Utecht,TE,dead_cap,cincinnati-bengals,666668,2010
8187,155500,0,Chase Coffman,TE,dead_cap,cincinnati-bengals,155500,2010
8188,127255,0,Jonathan Luigs,C,dead_cap,cincinnati-bengals,127255,2010
8189,111875,0,Marvin White,S,dead_cap,cincinnati-bengals,111875,2010
8190,51250,0,Corey Lynch,S,dead_cap,cincinnati-bengals,51250,2010
8191,0,46250,Otis Hudson,G,dead_cap,cincinnati-bengals,46250,2010
8192,0,25625,Dezmon Briscoe,WR,dead_cap,cincinnati-bengals,25625,2010
8193,17500,0,Matt Sherry,TE,dead_cap,cincinnati-bengals,17500,2010
8194,0,1250,Mike Windt,LS,dead_cap,cincinnati-bengals,1250,2010
8195,1677500,8517250,Andre Smith,G,active,cincinnati-bengals,10194750,2011
8196,3690000,4700000,Andrew Whitworth,LT,active,cincinnati-bengals,8390000,2011
8197,5037500,1800000,Leon Hall,CB,active,cincinnati-bengals,6837500,2011
8198,3950000,2033333,Robert Geathers,DE,active,cincinnati-bengals,5983333,2011
8199,1400000,1000000,Nate Clements,CB,active,cincinnati-bengals,2400000,2011
8200,3300000,1200000,Domata Peko,DT,active,cincinnati-bengals,4500000,2011
8201,2823353,1500000,Cedric Benson,RB,active,cincinnati-bengals,4323353,2011
8202,3037500,2385000,Leon Hall,CB,active,cincinnati-bengals,5422500,2011
8203,1735000,3834166,Keith Rivers,OLB,active,cincinnati-bengals,5569166,2011
8204,375000,3204655,A.J. Green,WR,active,cincinnati-bengals,3579655,2011
8205,3500000,0,Manny Lawson,OLB,active,cincinnati-bengals,3500000,2011
8206,1500000,1000000,Thomas Howard,LB,active,cincinnati-bengals,2500000,2011
8207,1835000,640000,Kyle Cook,C,active,cincinnati-bengals,2475000,2011
8208,1750000,537500,Chris Crocker,S,active,cincinnati-bengals,2287500,2011
8209,1000000,1000000,Bruce Gradkowski,QB,active,cincinnati-bengals,2000000,2011
8210,1800000,0,Kelly Jennings,CB,active,cincinnati-bengals,1800000,2011
8211,450000,2542500,Jermaine Gresham,TE,active,cincinnati-bengals,2992500,2011
8212,1150000,500000,Brandon Johnson,LB,active,cincinnati-bengals,1650000,2011
8213,1000000,350000,Jonathan Fanene,DE,active,cincinnati-bengals,1350000,2011
8214,957500,622000,Reggie Nelson,FS,active,cincinnati-bengals,1579500,2011
8215,1250000,302222,Frostee Rucker,DT,active,cincinnati-bengals,1552222,2011
8216,1200000,192050,Pat Sims,DT,active,cincinnati-bengals,1392050,2011
8217,1200000,0,Nate Livings,G,active,cincinnati-bengals,1200000,2011
8218,525000,534000,Rey Maualuga,ILB,active,cincinnati-bengals,1059000,2011
8219,1000000,0,Bo Scaife,TE,active,cincinnati-bengals,1000000,2011
8220,600000,371750,Jerome Simpson,WR,active,cincinnati-bengals,971750,2011
8221,375000,573036,Andy Dalton,QB,active,cincinnati-bengals,948036,2011
8222,810000,40000,Donald Lee,TE,active,cincinnati-bengals,850000,2011
8223,450000,307000,Carlos Dunlap,DE,active,cincinnati-bengals,757000,2011
8224,600000,150250,Andre Caldwell,WR,active,cincinnati-bengals,750250,2011
8225,525000,215755,Michael Johnson,DE,active,cincinnati-bengals,740755,2011
8226,600000,117625,Anthony Collins,LT,active,cincinnati-bengals,717625,2011
8227,685000,0,Mike Nugent,K,active,cincinnati-bengals,685000,2011
8228,640000,0,Victor Adeyanju,DT,active,cincinnati-bengals,640000,2011
8229,640000,0,Adam-Pacman Jones,CB,active,cincinnati-bengals,640000,2011
8230,640000,0,Jonathan Wade,CB,active,cincinnati-bengals,640000,2011
8231,600000,0,Clark Harris,LS,active,cincinnati-bengals,600000,2011
8232,405000,189186,Jordan Shipley,WR,active,cincinnati-bengals,594186,2011
8233,525000,48750,Kevin Huber,P,active,cincinnati-bengals,573750,2011
8234,450000,118112,Geno Atkins,DT,active,cincinnati-bengals,568112,2011
8235,450000,105895,Roddrick Muckelroy,ILB,active,cincinnati-bengals,555895,2011
8236,555000,0,Mike McGlynn,G,active,cincinnati-bengals,555000,2011
8237,375000,174394,Dontay Moch,DE,active,cincinnati-bengals,549394,2011
8238,525000,19377,Bernard Scott,RB,active,cincinnati-bengals,544377,2011
8239,525000,0,Chris Pressley,FB,active,cincinnati-bengals,525000,2011
8240,375000,120362,Clint Boling,G,active,cincinnati-bengals,495362,2011
8241,480000,0,Chase Coffman,TE,active,cincinnati-bengals,480000,2011
8242,450000,3000,Vincent Rey,ILB,active,cincinnati-bengals,453000,2011
8243,450000,0,Taylor Mays,SS,active,cincinnati-bengals,450000,2011
8244,450000,0,Jeromy Miles,SS,active,cincinnati-bengals,450000,2011
8245,375000,53000,Robert Sands,S,active,cincinnati-bengals,428000,2011
8246,375000,31278,Ryan Whalen,WR,active,cincinnati-bengals,406278,2011
8247,375000,0,Otis Hudson,G,active,cincinnati-bengals,375000,2011
8248,375000,0,Dane Sanzenbacher,WR,active,cincinnati-bengals,375000,2011
8249,330000,0,Andrew Mitchell,T,active,cincinnati-bengals,330000,2011
8250,185294,0,Brandon Ghee,CB,active,cincinnati-bengals,185294,2011
8251,44117,0,Armon Binns,WR,active,cincinnati-bengals,44117,2011
8252,1988236,400000,Bobbie Williams,G,injured_reserve,cincinnati-bengals,2388236,2011
8253,96900,0,Armon Binns,WR,practice_squad,cincinnati-bengals,96900,2011
8254,96900,0,James Develin,FB,practice_squad,cincinnati-bengals,96900,2011
8255,96900,0,Brandon Ghee,CB,practice_squad,cincinnati-bengals,96900,2011
8256,2700000,0,Antonio Bryant,WR,dead_cap,cincinnati-bengals,2700000,2011
8257,500000,0,Tank Johnson,DT,dead_cap,cincinnati-bengals,500000,2011
8258,311000,0,Chase Coffman,TE,dead_cap,cincinnati-bengals,311000,2011
8259,260000,0,Cedric Peerman,RB,dead_cap,cincinnati-bengals,260000,2011
8260,0,163275,Brandon Ghee,CB,dead_cap,cincinnati-bengals,163275,2011
8261,150000,0,Max Jean-Giles,G,dead_cap,cincinnati-bengals,150000,2011
8262,0,138750,Otis Hudson,G,dead_cap,cincinnati-bengals,138750,2011
8263,127255,0,Jonathan Luigs,C,dead_cap,cincinnati-bengals,127255,2011
8264,120500,0,Mike McGlynn,G,dead_cap,cincinnati-bengals,120500,2011
8265,0,76875,Dezmon Briscoe,WR,dead_cap,cincinnati-bengals,76875,2011
8266,28000,0,Morgan Trent,CB,dead_cap,cincinnati-bengals,28000,2011
8267,17500,0,Matt Sherry,TE,dead_cap,cincinnati-bengals,17500,2011
8268,0,16741,Korey Lindsey,CB,dead_cap,cincinnati-bengals,16741,2011
8269,0,12848,Reggie Stephens,C,dead_cap,cincinnati-bengals,12848,2011
8270,0,11473,Jay Finley,RB,dead_cap,cincinnati-bengals,11473,2011
8271,0,1666,Matthew O'Donnell,T,dead_cap,cincinnati-bengals,1666,2011
8272,0,1250,Mike Windt,LS,dead_cap,cincinnati-bengals,1250,2011
8273,1600000,6900000,Leon Hall,CB,active,cincinnati-bengals,8500000,2012
8274,4550000,2200000,Andrew Whitworth,LT,active,cincinnati-bengals,6750000,2012
8275,4500000,3516000,Andre Smith,G,active,cincinnati-bengals,8016000,2012
8276,4200000,2033333,Robert Geathers,DE,active,cincinnati-bengals,6233333,2012
8277,4300000,1000000,Nate Clements,CB,active,cincinnati-bengals,5300000,2012
8278,1450000,3175000,Reggie Nelson,FS,active,cincinnati-bengals,4625000,2012
8279,3375000,1200000,Domata Peko,DT,active,cincinnati-bengals,4575000,2012
8280,1269913,3204655,A.J. Green,WR,active,cincinnati-bengals,4474568,2012
8281,1800000,1825000,Jason Allen,CB,active,cincinnati-bengals,3625000,2012
8282,2500000,840000,Kyle Cook,C,active,cincinnati-bengals,3340000,2012
8283,800000,2200000,BenJarvus Green-Ellis,RB,active,cincinnati-bengals,3000000,2012
8284,2100000,0,Manny Lawson,OLB,active,cincinnati-bengals,2100000,2012
8285,690250,2542500,Jermaine Gresham,TE,active,cincinnati-bengals,3232750,2012
8286,1800000,200000,Bruce Gradkowski,QB,active,cincinnati-bengals,2000000,2012
8287,1408000,215755,Michael Johnson,DE,active,cincinnati-bengals,1623755,2012
8288,390000,1177818,Dre Kirkpatrick,CB,active,cincinnati-bengals,1567818,2012
8289,390000,981673,Kevin Zeitler,G,active,cincinnati-bengals,1371673,2012
8290,1260000,48750,Kevin Huber,P,active,cincinnati-bengals,1308750,2012
8291,1260000,0,Clark Harris,LS,active,cincinnati-bengals,1260000,2012
8292,1260000,0,Dan Skuta,OLB,active,cincinnati-bengals,1260000,2012
8293,700000,500000,Pat Sims,DT,active,cincinnati-bengals,1200000,2012
8294,612009,573036,Andy Dalton,QB,active,cincinnati-bengals,1185045,2012
8295,615000,534000,Rey Maualuga,ILB,active,cincinnati-bengals,1149000,2012
8296,700000,325000,Anthony Collins,LT,active,cincinnati-bengals,1025000,2012
8297,700000,250000,Adam-Pacman Jones,CB,active,cincinnati-bengals,950000,2012
8298,825000,65000,Jacob Bell,G,active,cincinnati-bengals,890000,2012
8299,540000,307000,Carlos Dunlap,DE,active,cincinnati-bengals,847000,2012
8300,825000,0,Terence Newman,CB,active,cincinnati-bengals,825000,2012
8301,700000,65000,Dennis Roland,RT,active,cincinnati-bengals,765000,2012
8302,390000,345164,Devon Still,DT,active,cincinnati-bengals,735164,2012
8303,512348,174394,Dontay Moch,DE,active,cincinnati-bengals,686742,2012
8304,540000,118112,Geno Atkins,DT,active,cincinnati-bengals,658112,2012
8305,615000,0,Richard Quinn,TE,active,cincinnati-bengals,615000,2012
8306,465000,120362,Clint Boling,G,active,cincinnati-bengals,585362,2012
8307,565000,8120,Brandon Tate,WR,active,cincinnati-bengals,573120,2012
8308,540000,15000,Taylor Mays,SS,active,cincinnati-bengals,555000,2012
8309,825000,0,Chris Crocker,S,active,cincinnati-bengals,825000,2012
8310,700000,0,Wallace Gilberry,DE,active,cincinnati-bengals,700000,2012
8311,540000,0,John Conner,FB,active,cincinnati-bengals,540000,2012
8312,540000,0,Brandon Ghee,CB,active,cincinnati-bengals,540000,2012
8313,540000,0,Jeromy Miles,SS,active,cincinnati-bengals,540000,2012
8314,540000,0,Rico Murray,CB,active,cincinnati-bengals,540000,2012
8315,540000,0,Cedric Peerman,RB,active,cincinnati-bengals,540000,2012
8316,540000,0,Vincent Rey,ILB,active,cincinnati-bengals,540000,2012
8317,390000,140813,Mohamed Sanu,WR,active,cincinnati-bengals,530813,2012
8318,390000,130300,Brandon Thompson,DT,active,cincinnati-bengals,520300,2012
8319,465000,53000,Robert Sands,S,active,cincinnati-bengals,518000,2012
8320,390000,107325,Orson Charles,FB,active,cincinnati-bengals,497325,2012
8321,465000,31278,Ryan Whalen,WR,active,cincinnati-bengals,496278,2012
8322,465000,0,Andrew Hawkins,WR,active,cincinnati-bengals,465000,2012
8323,465000,0,Dane Sanzenbacher,WR,active,cincinnati-bengals,465000,2012
8324,390000,40700,Marvin Jones,WR,active,cincinnati-bengals,430700,2012
8325,390000,40075,George Iloka,FS,active,cincinnati-bengals,430075,2012
8326,390000,2000,Trevor Robinson,C,active,cincinnati-bengals,392000,2012
8327,390000,1000,Brandon Joiner,OLB,active,cincinnati-bengals,391000,2012
8328,390000,333,Vontaze Burfict,OLB,active,cincinnati-bengals,390333,2012
8329,390000,0,Chris Lewis-Harris,CB,active,cincinnati-bengals,390000,2012
8330,390000,0,Chris Riley,G,active,cincinnati-bengals,390000,2012
8331,390000,0,Emmanuel Lamur,OLB,active,cincinnati-bengals,390000,2012
8332,825000,0,Josh Brown,K,active,cincinnati-bengals,825000,2012
8333,73125,0,Dan Herron,RB,active,cincinnati-bengals,73125,2012
8334,825000,2200000,Travelle Wharton,G,injured_reserve,cincinnati-bengals,3025000,2012
8335,1600000,1200000,Jamaal Anderson,DE,injured_reserve,cincinnati-bengals,2800000,2012
8336,2654000,0,Mike Nugent,K,injured_reserve,cincinnati-bengals,2654000,2012
8337,2400000,100000,Thomas Howard,LB,injured_reserve,cincinnati-bengals,2500000,2012
8338,615000,19377,Bernard Scott,RB,injured_reserve,cincinnati-bengals,634377,2012
8339,615000,0,Chris Pressley,FB,injured_reserve,cincinnati-bengals,615000,2012
8340,390000,3333,Taveon Rogers,CB,injured_reserve,cincinnati-bengals,393333,2012
8341,390000,333,Tony Dye,S,injured_reserve,cincinnati-bengals,390333,2012
8342,273000,46250,Shaun Prater,CB,injured_reserve,cincinnati-bengals,319250,2012
8343,96900,0,Bryce Davis,LS,practice_squad,cincinnati-bengals,96900,2012
8344,96900,0,Dan Herron,RB,practice_squad,cincinnati-bengals,96900,2012
8345,0,3684166,Keith Rivers,OLB,dead_cap,cincinnati-bengals,3684166,2012
8346,1508000,0,Andre Smith,G,dead_cap,cincinnati-bengals,1508000,2012
8347,1000000,0,Tank Johnson,DT,dead_cap,cincinnati-bengals,1000000,2012
8348,437500,0,Chris Crocker,S,dead_cap,cincinnati-bengals,437500,2012
8349,329412,0,Jeff Faine,C,dead_cap,cincinnati-bengals,329412,2012
8350,0,326550,Brandon Ghee,CB,dead_cap,cincinnati-bengals,326550,2012
8351,189186,0,Jordan Shipley,WR,dead_cap,cincinnati-bengals,189186,2012
8352,0,105895,Roddrick Muckelroy,ILB,dead_cap,cincinnati-bengals,105895,2012
8353,100000,0,Thomas Howard,LB,dead_cap,cincinnati-bengals,100000,2012
8354,0,60000,Derrick Harvey,DE,dead_cap,cincinnati-bengals,60000,2012
8355,0,50223,Korey Lindsey,CB,dead_cap,cincinnati-bengals,50223,2012
8356,0,34419,Jay Finley,RB,dead_cap,cincinnati-bengals,34419,2012
8357,28000,0,Morgan Trent,CB,dead_cap,cincinnati-bengals,28000,2012
8358,25788,0,Dan Herron,RB,dead_cap,cincinnati-bengals,25788,2012
8359,0,25696,Reggie Stephens,C,dead_cap,cincinnati-bengals,25696,2012
8360,0,3334,Matthew O'Donnell,T,dead_cap,cincinnati-bengals,3334,2012
8361,11175000,0,Michael Johnson,DE,active,cincinnati-bengals,11175000,2013
8362,6500000,1900000,Leon Hall,CB,active,cincinnati-bengals,8400000,2013
8363,4000000,3118114,Geno Atkins,DT,active,cincinnati-bengals,7118114,2013
8364,1300000,5607000,Carlos Dunlap,DE,active,cincinnati-bengals,6907000,2013
8365,4550000,2200000,Andrew Whitworth,LT,active,cincinnati-bengals,6750000,2013
8366,2164826,3204655,A.J. Green,WR,active,cincinnati-bengals,5369481,2013
8367,3900000,1200000,Domata Peko,DT,active,cincinnati-bengals,5100000,2013
8368,1900000,3100000,Andre Smith,G,active,cincinnati-bengals,5000000,2013
8369,2450000,1675000,Reggie Nelson,FS,active,cincinnati-bengals,4125000,2013
8370,2500000,840000,Kyle Cook,C,active,cincinnati-bengals,3340000,2013
8371,2300000,950000,BenJarvus Green-Ellis,RB,active,cincinnati-bengals,3250000,2013
8372,1500000,1500000,Terence Newman,CB,active,cincinnati-bengals,3000000,2013
8373,750000,1970000,Kevin Huber,P,active,cincinnati-bengals,2720000,2013
8374,1000000,1625000,Rey Maualuga,ILB,active,cincinnati-bengals,2625000,2013
8375,1100000,1450000,Wallace Gilberry,DE,active,cincinnati-bengals,2550000,2013
8376,975500,2542500,Jermaine Gresham,TE,active,cincinnati-bengals,3518000,2013
8377,1800000,325000,Anthony Collins,LT,active,cincinnati-bengals,2125000,2013
8378,1400000,600000,James Harrison,OLB,active,cincinnati-bengals,2000000,2013
8379,781954,1177818,Dre Kirkpatrick,CB,active,cincinnati-bengals,1959772,2013
8380,732918,981673,Kevin Zeitler,G,active,cincinnati-bengals,1714591,2013
8381,1000000,600000,Mike Nugent,K,active,cincinnati-bengals,1600000,2013
8382,750000,850000,Adam-Pacman Jones,CB,active,cincinnati-bengals,1600000,2013
8383,405000,1096091,Tyler Eifert,TE,active,cincinnati-bengals,1501091,2013
8384,749018,673036,Andy Dalton,QB,active,cincinnati-bengals,1422054,2013
8385,715000,625000,Clark Harris,LS,active,cincinnati-bengals,1340000,2013
8386,715000,400000,Cedric Peerman,RB,active,cincinnati-bengals,1115000,2013
8387,715000,251000,Brandon Tate,WR,active,cincinnati-bengals,966000,2013
8388,405000,550153,Giovani Bernard,RB,active,cincinnati-bengals,955153,2013
8389,715000,206250,Josh Johnson,QB,active,cincinnati-bengals,921250,2013
8390,561455,295164,Devon Still,DT,active,cincinnati-bengals,856619,2013
8391,555000,120362,Clint Boling,G,active,cincinnati-bengals,675362,2013
8392,405000,262473,Margus Hunt,DT,active,cincinnati-bengals,667473,2013
8393,630000,15000,Taylor Mays,SS,active,cincinnati-bengals,645000,2013
8394,840000,0,Michael Boley,LB,active,cincinnati-bengals,840000,2013
8395,490000,140813,Mohamed Sanu,WR,active,cincinnati-bengals,630813,2013
8396,630000,0,Brandon Ghee,CB,active,cincinnati-bengals,630000,2013
8397,630000,0,Ogemdi Nwaguo,DT,active,cincinnati-bengals,630000,2013
8398,630000,0,Vincent Rey,ILB,active,cincinnati-bengals,630000,2013
8399,840000,65000,Alex Smith,TE,active,cincinnati-bengals,905000,2013
8400,715000,65000,Mike Pollak,G,active,cincinnati-bengals,780000,2013
8401,485000,130300,Brandon Thompson,DT,active,cincinnati-bengals,615300,2013
8402,480000,107325,Orson Charles,FB,active,cincinnati-bengals,587325,2013
8403,555000,31278,Ryan Whalen,WR,active,cincinnati-bengals,586278,2013
8404,555000,0,Andrew Hawkins,WR,active,cincinnati-bengals,555000,2013
8405,555000,0,Dane Sanzenbacher,WR,active,cincinnati-bengals,555000,2013
8406,405000,138986,Shawn Williams,SS,active,cincinnati-bengals,543986,2013
8407,480000,40700,Marvin Jones,WR,active,cincinnati-bengals,520700,2013
8408,480000,40075,George Iloka,FS,active,cincinnati-bengals,520075,2013
8409,480000,2000,Trevor Robinson,C,active,cincinnati-bengals,482000,2013
8410,480000,333,Vontaze Burfict,OLB,active,cincinnati-bengals,480333,2013
8411,940000,0,Chris Crocker,S,active,cincinnati-bengals,940000,2013
8412,405000,45606,Tanner Hawkinson,G,active,cincinnati-bengals,450606,2013
8413,405000,25550,Rex Burkhead,RB,active,cincinnati-bengals,430550,2013
8414,405000,5000,Jayson Dimanche,ILB,active,cincinnati-bengals,410000,2013
8415,288000,107325,Sean Porter,ILB,active,cincinnati-bengals,395325,2013
8416,303000,0,Emmanuel Lamur,OLB,active,cincinnati-bengals,303000,2013
8417,405000,0,J.K. Schaffer,OLB,active,cincinnati-bengals,405000,2013
8418,480000,0,Christo Bilukidi,DT,active,cincinnati-bengals,480000,2013
8419,715000,0,Dennis Roland,RT,active,cincinnati-bengals,715000,2013
8420,405000,0,Chris Lewis-Harris,CB,active,cincinnati-bengals,405000,2013
8421,630000,0,Zoltan Mesko,P,active,cincinnati-bengals,630000,2013
8422,1800000,1450000,Robert Geathers,DE,injured_reserve,cincinnati-bengals,3250000,2013
8423,288000,2000,Larry Black,DT,injured_reserve,cincinnati-bengals,290000,2013
8424,480000,1000,Brandon Joiner,OLB,injured_reserve,cincinnati-bengals,481000,2013
8425,6000,0,Kendrick Adams,OLB,practice_squad,cincinnati-bengals,6000,2013
8426,0,3684168,Keith Rivers,OLB,dead_cap,cincinnati-bengals,3684168,2013
8427,1508000,0,Andre Smith,G,dead_cap,cincinnati-bengals,1508000,2013
8428,841177,0,Chris Pressley,FB,dead_cap,cincinnati-bengals,841177,2013
8429,700000,0,Travelle Wharton,G,dead_cap,cincinnati-bengals,700000,2013
8430,620000,0,Dennis Roland,RT,dead_cap,cincinnati-bengals,620000,2013
8431,0,500000,Jason Allen,CB,dead_cap,cincinnati-bengals,500000,2013
8432,233471,0,Jeromy Miles,SS,dead_cap,cincinnati-bengals,233471,2013
8433,226492,0,Chris Lewis-Harris,CB,dead_cap,cincinnati-bengals,226492,2013
8434,0,200000,Jamaal Anderson,DE,dead_cap,cincinnati-bengals,200000,2013
8435,189186,0,Jordan Shipley,WR,dead_cap,cincinnati-bengals,189186,2013
8436,0,174394,Dontay Moch,DE,dead_cap,cincinnati-bengals,174394,2013
8437,161451,0,Tony Dye,S,dead_cap,cincinnati-bengals,161451,2013
8438,146046,0,Dan Herron,RB,dead_cap,cincinnati-bengals,146046,2013
8439,0,105895,Roddrick Muckelroy,ILB,dead_cap,cincinnati-bengals,105895,2013
8440,84706,0,Kheeston Randall,DT,dead_cap,cincinnati-bengals,84706,2013
8441,83647,0,J.K. Schaffer,OLB,dead_cap,cincinnati-bengals,83647,2013
8442,65294,0,Curtis Marsh,CB,dead_cap,cincinnati-bengals,65294,2013
8443,59474,0,Reid Fragel,RT,dead_cap,cincinnati-bengals,59474,2013
8444,56741,0,Shawn Powell,P,dead_cap,cincinnati-bengals,56741,2013
8445,53000,0,Robert Sands,S,dead_cap,cincinnati-bengals,53000,2013
8446,46250,0,Shaun Prater,CB,dead_cap,cincinnati-bengals,46250,2013
8447,45048,0,Bernard Scott,RB,dead_cap,cincinnati-bengals,45048,2013
8448,0,23513,Cobi Hamilton,WR,dead_cap,cincinnati-bengals,23513,2013
8449,18000,0,Aston Whiteside,DT,dead_cap,cincinnati-bengals,18000,2013
8450,12000,0,DeQuin Evans,DE,dead_cap,cincinnati-bengals,12000,2013
8451,11474,0,T.J. Johnson,C,dead_cap,cincinnati-bengals,11474,2013
8452,10000,0,Richard Quinn,TE,dead_cap,cincinnati-bengals,10000,2013
8453,8000,0,Travis Chappelear,DT,dead_cap,cincinnati-bengals,8000,2013
8454,3333,0,Taveon Rogers,CB,dead_cap,cincinnati-bengals,3333,2013
8455,2000,0,John Sullen,G,dead_cap,cincinnati-bengals,2000,2013
8456,1666,0,Terrence Brown,CB,dead_cap,cincinnati-bengals,1666,2013
8457,1666,0,Tyrone Goard,WR,dead_cap,cincinnati-bengals,1666,2013
8458,1666,0,Roy Roundtree,WR,dead_cap,cincinnati-bengals,1666,2013
8459,0,1166,Onterio McCalebb,WR,dead_cap,cincinnati-bengals,1166,2013
8460,833,0,Jordan Campbell,OLB,dead_cap,cincinnati-bengals,833,2013
8461,833,0,Quinn Sharp,P,dead_cap,cincinnati-bengals,833,2013
8462,666,0,Bruce Taylor,ILB,dead_cap,cincinnati-bengals,666,2013
8463,166,0,Troy Stoudermire,WR,dead_cap,cincinnati-bengals,166,2013
8464,986027,8073036,Andy Dalton,QB,active,cincinnati-bengals,9059063,2014
8465,2700000,6300000,Geno Atkins,DT,active,cincinnati-bengals,9000000,2014
8466,6800000,1900000,Leon Hall,CB,active,cincinnati-bengals,8700000,2014
8467,1000000,7600000,Carlos Dunlap,DE,active,cincinnati-bengals,8600000,2014
8468,3059739,3204655,A.J. Green,WR,active,cincinnati-bengals,6264394,2014
8469,5000000,1200000,Andrew Whitworth,LT,active,cincinnati-bengals,6200000,2014
8470,1300000,4600000,Domata Peko,DT,active,cincinnati-bengals,5900000,2014
8471,700000,4575334,Vontaze Burfict,OLB,active,cincinnati-bengals,5275334,2014
8472,3000000,2200000,Andre Smith,G,active,cincinnati-bengals,5200000,2014
8473,3410750,2642500,Jermaine Gresham,TE,active,cincinnati-bengals,6053250,2014
8474,3800000,675000,Reggie Nelson,FS,active,cincinnati-bengals,4475000,2014
8475,2250000,1578125,Rey Maualuga,ILB,active,cincinnati-bengals,3828125,2014
8476,1700000,1100000,Adam-Pacman Jones,CB,active,cincinnati-bengals,2800000,2014
8477,2500000,200000,Robert Geathers,DE,active,cincinnati-bengals,2700000,2014
8478,1173908,1177818,Dre Kirkpatrick,CB,active,cincinnati-bengals,2351726,2014
8479,1950000,370000,Kevin Huber,P,active,cincinnati-bengals,2320000,2014
8480,1000000,1100000,Vincent Rey,ILB,active,cincinnati-bengals,2100000,2014
8481,1075836,981673,Kevin Zeitler,G,active,cincinnati-bengals,2057509,2014
8482,1900000,100000,Terence Newman,CB,active,cincinnati-bengals,2000000,2014
8483,780273,1096091,Tyler Eifert,TE,active,cincinnati-bengals,1876364,2014
8484,1500000,300000,Wallace Gilberry,DE,active,cincinnati-bengals,1800000,2014
8485,1025000,741666,Mike Pollak,G,active,cincinnati-bengals,1766666,2014
8486,1431000,120362,Clint Boling,G,active,cincinnati-bengals,1551362,2014
8487,1000000,500000,Jason Campbell,QB,active,cincinnati-bengals,1500000,2014
8488,420000,1030708,Darqueze Dennard,CB,active,cincinnati-bengals,1450708,2014
8489,1300000,100000,Mike Nugent,K,active,cincinnati-bengals,1400000,2014
8490,643788,550153,Giovani Bernard,RB,active,cincinnati-bengals,1193941,2014
8491,1000000,50000,Cedric Peerman,RB,active,cincinnati-bengals,1050000,2014
8492,730000,294000,Brandon Tate,WR,active,cincinnati-bengals,1024000,2014
8493,571868,262473,Margus Hunt,DT,active,cincinnati-bengals,834341,2014
8494,730000,75000,Marshall Newhouse,RT,active,cincinnati-bengals,805000,2014
8495,755000,40000,Taylor Mays,SS,active,cincinnati-bengals,795000,2014
8496,730000,30000,Clark Harris,LS,active,cincinnati-bengals,760000,2014
8497,590000,140813,Mohamed Sanu,WR,active,cincinnati-bengals,730813,2014
8498,575000,130300,Brandon Thompson,DT,active,cincinnati-bengals,705300,2014
8499,420000,262473,Jeremy Hill,RB,active,cincinnati-bengals,682473,2014
8500,515000,138986,Shawn Williams,SS,active,cincinnati-bengals,653986,2014
8501,570000,40700,Marvin Jones,WR,active,cincinnati-bengals,610700,2014
8502,570000,40075,George Iloka,FS,active,cincinnati-bengals,610075,2014
8503,495000,107325,Sean Porter,ILB,active,cincinnati-bengals,602325,2014
8504,420000,136345,Will Clarke,DE,active,cincinnati-bengals,556345,2014
8505,495000,45606,Tanner Hawkinson,G,active,cincinnati-bengals,540606,2014
8506,570000,0,Devon Still,DT,active,cincinnati-bengals,570000,2014
8507,420000,114114,Russell Bodine,C,active,cincinnati-bengals,534114,2014
8508,495000,25550,Rex Burkhead,RB,active,cincinnati-bengals,520550,2014
8509,495000,0,Emmanuel Lamur,OLB,active,cincinnati-bengals,495000,2014
8510,495000,5000,Jayson Dimanche,ILB,active,cincinnati-bengals,500000,2014
8511,420000,19670,Marquis Flowers,OLB,active,cincinnati-bengals,439670,2014
8512,436765,0,Chris Lewis-Harris,CB,active,cincinnati-bengals,436765,2014
8513,495000,0,Kevin Brock,TE,active,cincinnati-bengals,495000,2014
8514,420000,12456,James Wright,WR,active,cincinnati-bengals,432456,2014
8515,420000,3333,Ryan Hewitt,FB,active,cincinnati-bengals,423333,2014
8516,420000,0,T.J. Johnson,C,active,cincinnati-bengals,420000,2014
8517,645000,0,Greg Little,WR,active,cincinnati-bengals,645000,2014
8518,420000,45413,A.J. McCarron,QB,active,cincinnati-bengals,465413,2014
8519,495000,0,Nico Johnson,ILB,active,cincinnati-bengals,495000,2014
8520,303000,5000,Trey Hopkins,G,active,cincinnati-bengals,308000,2014
8521,645000,0,Chris Carter,ILB,active,cincinnati-bengals,645000,2014
8522,855000,0,Eric Winston,RT,active,cincinnati-bengals,855000,2014
8523,950000,250000,Dane Sanzenbacher,WR,injured_reserve,cincinnati-bengals,1200000,2014
8524,855000,60000,Alex Smith,TE,injured_reserve,cincinnati-bengals,915000,2014
8525,107100,0,Dan France,G,practice_squad,cincinnati-bengals,107100,2014
8526,107100,0,Sam Montgomery,DE,practice_squad,cincinnati-bengals,107100,2014
8527,107100,0,James Wilder Jr.,RB,practice_squad,cincinnati-bengals,107100,2014
8528,100800,0,Onterio McCalebb,WR,practice_squad,cincinnati-bengals,100800,2014
8529,94500,0,Emmett Cleary,RT,practice_squad,cincinnati-bengals,94500,2014
8530,69300,0,Tevin Reese,WR,practice_squad,cincinnati-bengals,69300,2014
8531,50400,0,Jake Murphy,TE,practice_squad,cincinnati-bengals,50400,2014
8532,31500,0,L.J. Fort,ILB,practice_squad,cincinnati-bengals,31500,2014
8533,0,1280000,Kyle Cook,C,dead_cap,cincinnati-bengals,1280000,2014
8534,0,700000,BenJarvus Green-Ellis,RB,dead_cap,cincinnati-bengals,700000,2014
8535,0,600000,James Harrison,OLB,dead_cap,cincinnati-bengals,600000,2014
8536,500000,0,Travelle Wharton,G,dead_cap,cincinnati-bengals,500000,2014
8537,56300,345164,Devon Still,DT,dead_cap,cincinnati-bengals,401464,2014
8538,243176,0,J.K. Schaffer,OLB,dead_cap,cincinnati-bengals,243176,2014
8539,0,174394,Dontay Moch,DE,dead_cap,cincinnati-bengals,174394,2014
8540,150000,0,Danieal Manning,S,dead_cap,cincinnati-bengals,150000,2014
8541,75600,70539,Cobi Hamilton,WR,dead_cap,cincinnati-bengals,146139,2014
8542,0,107325,Orson Charles,FB,dead_cap,cincinnati-bengals,107325,2014
8543,92500,0,Shaun Prater,CB,dead_cap,cincinnati-bengals,92500,2014
8544,88200,0,David King,DE,dead_cap,cincinnati-bengals,88200,2014
8545,0,75000,Josh Johnson,QB,dead_cap,cincinnati-bengals,75000,2014
8546,0,75000,R.J. Stanford,CB,dead_cap,cincinnati-bengals,75000,2014
8547,56700,0,Kevin Greene,TE,dead_cap,cincinnati-bengals,56700,2014
8548,53000,0,Robert Sands,S,dead_cap,cincinnati-bengals,53000,2014
8549,42941,0,Jamon Meredith,RT,dead_cap,cincinnati-bengals,42941,2014
8550,37800,2666,Colin Lockett,TE,dead_cap,cincinnati-bengals,40466,2014
8551,37306,0,Khairi Fortt,OLB,dead_cap,cincinnati-bengals,37306,2014
8552,34422,0,Reid Fragel,RT,dead_cap,cincinnati-bengals,34422,2014
8553,34422,0,T.J. Johnson,C,dead_cap,cincinnati-bengals,34422,2014
8554,33529,0,Christo Bilukidi,DT,dead_cap,cincinnati-bengals,33529,2014
8555,31500,2000,Trevor Robinson,C,dead_cap,cincinnati-bengals,33500,2014
8556,0,31280,Ryan Whalen,WR,dead_cap,cincinnati-bengals,31280,2014
8557,24706,2334,Onterio McCalebb,WR,dead_cap,cincinnati-bengals,27040,2014
8558,12600,0,Jeff Baca,G,dead_cap,cincinnati-bengals,12600,2014
8559,12600,0,Justin Jackson,OLB,dead_cap,cincinnati-bengals,12600,2014
8560,0,11474,Lavelle Westbrooks,CB,dead_cap,cincinnati-bengals,11474,2014
8561,6300,0,Terrell Manning,ILB,dead_cap,cincinnati-bengals,6300,2014
8562,6300,0,Ryan Otten,TE,dead_cap,cincinnati-bengals,6300,2014
8563,4000,0,John Sullen,G,dead_cap,cincinnati-bengals,4000,2014
8564,3334,0,Terrence Brown,CB,dead_cap,cincinnati-bengals,3334,2014
8565,3334,0,Tyrone Goard,WR,dead_cap,cincinnati-bengals,3334,2014
8566,3334,0,Taveon Rogers,CB,dead_cap,cincinnati-bengals,3334,2014
8567,3334,0,Roy Roundtree,WR,dead_cap,cincinnati-bengals,3334,2014
8568,0,2000,Larry Black,DT,dead_cap,cincinnati-bengals,2000,2014
8569,0,2000,Nikita Whitlock,FB,dead_cap,cincinnati-bengals,2000,2014
8570,0,2000,James Wilder Jr.,RB,dead_cap,cincinnati-bengals,2000,2014
8571,0,1833,Isaiah Lewis,S,dead_cap,cincinnati-bengals,1833,2014
8572,1667,0,Jordan Campbell,OLB,dead_cap,cincinnati-bengals,1667,2014
8573,1667,0,Quinn Sharp,P,dead_cap,cincinnati-bengals,1667,2014
8574,0,1666,Curtis Feigt,RT,dead_cap,cincinnati-bengals,1666,2014
8575,1334,0,Bruce Taylor,ILB,dead_cap,cincinnati-bengals,1334,2014
8576,0,1333,Alex Neutz,WR,dead_cap,cincinnati-bengals,1333,2014
8577,0,833,Dan France,G,dead_cap,cincinnati-bengals,833,2014
8578,0,666,Jeff Scott,RB,dead_cap,cincinnati-bengals,666,2014
8579,334,0,Tony Dye,S,dead_cap,cincinnati-bengals,334,2014
8580,334,0,Troy Stoudermire,WR,dead_cap,cincinnati-bengals,334,2014
8581,11750000,3000000,A.J. Green,WR,active,cincinnati-bengals,14750000,2015
8582,7700000,1900000,Leon Hall,CB,active,cincinnati-bengals,9600000,2015
8583,3000000,6600000,Andy Dalton,QB,active,cincinnati-bengals,9600000,2015
8584,5700000,3300000,Geno Atkins,DT,active,cincinnati-bengals,9000000,2015
8585,5000000,2200000,Andrew Whitworth,LT,active,cincinnati-bengals,7200000,2015
8586,2150000,4987500,Rey Maualuga,ILB,active,cincinnati-bengals,7137500,2015
8587,4600000,1762500,Andre Smith,G,active,cincinnati-bengals,6362500,2015
8588,1050000,4125000,Vontaze Burfict,OLB,active,cincinnati-bengals,5175000,2015
8589,1700000,3400000,Clint Boling,G,active,cincinnati-bengals,5100000,2015
8590,3000000,1900000,Carlos Dunlap,DE,active,cincinnati-bengals,4900000,2015
8591,4100000,675000,Reggie Nelson,FS,active,cincinnati-bengals,4775000,2015
8592,2000000,1700000,Domata Peko,DT,active,cincinnati-bengals,3700000,2015
8593,2500000,600000,Vincent Rey,ILB,active,cincinnati-bengals,3100000,2015
8594,2400000,370000,Kevin Huber,P,active,cincinnati-bengals,2770000,2015
8595,782931,1960749,Dre Kirkpatrick,CB,active,cincinnati-bengals,2743680,2015
8596,1300000,1300000,Michael Johnson,DE,active,cincinnati-bengals,2600000,2015
8597,1550000,1000000,Adam-Pacman Jones,CB,active,cincinnati-bengals,2550000,2015
8598,1418754,981673,Kevin Zeitler,G,active,cincinnati-bengals,2400427,2015
8599,1155546,1096091,Tyler Eifert,TE,active,cincinnati-bengals,2251637,2015
8600,1850000,200000,Wallace Gilberry,DE,active,cincinnati-bengals,2050000,2015
8601,1000000,950000,Mike Nugent,K,active,cincinnati-bengals,1950000,2015
8602,1100000,750000,A.J. Hawk,OLB,active,cincinnati-bengals,1850000,2015
8603,435000,1260577,Cedric Ogbuehi,LT,active,cincinnati-bengals,1695577,2015
8604,1542000,140813,Mohamed Sanu,WR,active,cincinnati-bengals,1682813,2015
8605,1542000,40075,George Iloka,FS,active,cincinnati-bengals,1582075,2015
8606,832576,600153,Giovani Bernard,RB,active,cincinnati-bengals,1432729,2015
8607,688736,312473,Margus Hunt,DT,active,cincinnati-bengals,1001209,2015
8608,870000,80000,Eric Winston,RT,active,cincinnati-bengals,950000,2015
8609,745000,175000,Cedric Peerman,RB,active,cincinnati-bengals,920000,2015
8610,870000,30000,Clark Harris,LS,active,cincinnati-bengals,900000,2015
8611,590618,262473,Jeremy Hill,RB,active,cincinnati-bengals,853091,2015
8612,435000,339458,Jake Fisher,LT,active,cincinnati-bengals,774458,2015
8613,600000,138986,Shawn Williams,SS,active,cincinnati-bengals,738986,2015
8614,660000,40700,Marvin Jones,WR,active,cincinnati-bengals,700700,2015
8615,870000,80000,Pat Sims,DT,active,cincinnati-bengals,950000,2015
8616,745000,80000,Brandon Tate,WR,active,cincinnati-bengals,825000,2015
8617,510000,146345,Will Clarke,DE,active,cincinnati-bengals,656345,2015
8618,510000,114114,Russell Bodine,C,active,cincinnati-bengals,624114,2015
8619,585000,25550,Rex Burkhead,RB,active,cincinnati-bengals,610550,2015
8620,435000,161944,Tyler Kroft,TE,active,cincinnati-bengals,596944,2015
8621,435000,145488,Paul Dawson,OLB,active,cincinnati-bengals,580488,2015
8622,435000,123431,Josh Shaw,CB,active,cincinnati-bengals,558431,2015
8623,510000,45413,A.J. McCarron,QB,active,cincinnati-bengals,555413,2015
8624,435000,86423,Marcus Hardison,DT,active,cincinnati-bengals,521423,2015
8625,510000,3333,Ryan Hewitt,FB,active,cincinnati-bengals,513333,2015
8626,510000,0,T.J. Johnson,C,active,cincinnati-bengals,510000,2015
8627,435000,53190,C.J. Uzomah,TE,active,cincinnati-bengals,488190,2015
8628,435000,29658,Derron Smith,SS,active,cincinnati-bengals,464658,2015
8629,435000,14776,Mario Alford,WR,active,cincinnati-bengals,449776,2015
8630,333000,19670,Marquis Flowers,OLB,active,cincinnati-bengals,352670,2015
8631,333000,12456,James Wright,WR,active,cincinnati-bengals,345456,2015
8632,76764,0,Keith Wenning,QB,active,cincinnati-bengals,76764,2015
8633,68823,0,Chris Lewis-Harris,CB,active,cincinnati-bengals,68823,2015
8634,2356000,0,Emmanuel Lamur,OLB,injured_reserve,cincinnati-bengals,2356000,2015
8635,782678,1030708,Darqueze Dennard,CB,injured_reserve,cincinnati-bengals,1813386,2015
8636,665000,130300,Brandon Thompson,DT,injured_reserve,cincinnati-bengals,795300,2015
8637,745000,0,Chris Carter,ILB,dead_cap,cincinnati-bengals,745000,2015
8638,295164,375164,Devon Still,DT,dead_cap,cincinnati-bengals,670328,2015
8639,745000,0,Greg Little,WR,dead_cap,cincinnati-bengals,745000,2015
8640,412941,107325,Sean Porter,ILB,dead_cap,cincinnati-bengals,520266,2015
8641,426141,0,Chris Lewis-Harris,CB,dead_cap,cincinnati-bengals,426141,2015
8642,0,333334,Mike Pollak,G,dead_cap,cincinnati-bengals,333334,2015
8643,155964,1833,Troy Hill,CB,dead_cap,cincinnati-bengals,157797,2015
8644,112200,5000,Trey Hopkins,G,dead_cap,cincinnati-bengals,117200,2015
8645,112200,4000,James Wilder Jr.,RB,dead_cap,cincinnati-bengals,116200,2015
8646,112200,2000,Terrell Watson,RB,dead_cap,cincinnati-bengals,114200,2015
8647,112200,1666,Jake Kumerow,WR,dead_cap,cincinnati-bengals,113866,2015
8648,112200,1666,Matt Lengel,TE,dead_cap,cincinnati-bengals,113866,2015
8649,112200,1666,DeShawn Williams,DT,dead_cap,cincinnati-bengals,113866,2015
8650,112200,833,Trevor Roach,ILB,dead_cap,cincinnati-bengals,113033,2015
8651,0,107325,Orson Charles,FB,dead_cap,cincinnati-bengals,107325,2015
8652,92400,0,Keith Wenning,QB,dead_cap,cincinnati-bengals,92400,2015
8653,79200,1667,Dan France,G,dead_cap,cincinnati-bengals,80867,2015
8654,0,80000,Josh Johnson,QB,dead_cap,cincinnati-bengals,80000,2015
8655,0,50000,Denarius Moore,WR,dead_cap,cincinnati-bengals,50000,2015
8656,0,45606,Tanner Hawkinson,G,dead_cap,cincinnati-bengals,45606,2015
8657,34411,5000,Jayson Dimanche,ILB,dead_cap,cincinnati-bengals,39411,2015
8658,0,34422,Lavelle Westbrooks,CB,dead_cap,cincinnati-bengals,34422,2015
8659,18705,1166,Mark Weisman,RB,dead_cap,cincinnati-bengals,19871,2015
8660,19800,0,Michael Bennett,WR,dead_cap,cincinnati-bengals,19800,2015
8661,6600,0,Mike Kafka,QB,dead_cap,cincinnati-bengals,6600,2015
8662,0,5334,Colin Lockett,TE,dead_cap,cincinnati-bengals,5334,2015
8663,0,5000,Matthew O'Donnell,T,dead_cap,cincinnati-bengals,5000,2015
8664,0,4000,Nikita Whitlock,FB,dead_cap,cincinnati-bengals,4000,2015
8665,0,3667,Isaiah Lewis,S,dead_cap,cincinnati-bengals,3667,2015
8666,0,3334,Curtis Feigt,RT,dead_cap,cincinnati-bengals,3334,2015
8667,0,2667,Alex Neutz,WR,dead_cap,cincinnati-bengals,2667,2015
8668,0,2000,Larry Black,DT,dead_cap,cincinnati-bengals,2000,2015
8669,0,1833,Floyd Raven,SS,dead_cap,cincinnati-bengals,1833,2015
8670,0,1334,Jeff Scott,RB,dead_cap,cincinnati-bengals,1334,2015
8671,0,1000,Jake Smith,C,dead_cap,cincinnati-bengals,1000,2015
8672,0,833,Tom Obarski,K,dead_cap,cincinnati-bengals,833,2015
8673,0,166,Erick Dargan,FS,dead_cap,cincinnati-bengals,166,2015
8674,0,166,Chris Jasperse,C,dead_cap,cincinnati-bengals,166,2015
8675,0,166,John Peters,TE,dead_cap,cincinnati-bengals,166,2015
8676,0,166,Kalafitoni Pole,DT,dead_cap,cincinnati-bengals,166,2015
8677,10500000,2600000,Andy Dalton,QB,active,cincinnati-bengals,13100000,2016
8678,6300000,3300000,Geno Atkins,DT,active,cincinnati-bengals,9600000,2016
8679,8070000,0,Kevin Zeitler,G,active,cincinnati-bengals,8070000,2016
8680,5800000,2200000,Andrew Whitworth,LT,active,cincinnati-bengals,8000000,2016
8681,2300000,5304166,Adam-Pacman Jones,CB,active,cincinnati-bengals,7604166,2016
8682,7507000,0,Dre Kirkpatrick,CB,active,cincinnati-bengals,7507000,2016
8683,2550000,3575000,Michael Johnson,DE,active,cincinnati-bengals,6125000,2016
8684,4050000,1900000,Carlos Dunlap,DE,active,cincinnati-bengals,5950000,2016
8685,1800000,3275000,George Iloka,FS,active,cincinnati-bengals,5075000,2016
8686,1000000,3500000,Vincent Rey,ILB,active,cincinnati-bengals,4500000,2016
8687,1100000,3088986,Shawn Williams,SS,active,cincinnati-bengals,4188986,2016
8688,2650000,1434375,Rey Maualuga,ILB,active,cincinnati-bengals,4084375,2016
8689,3525000,200000,Domata Peko,DT,active,cincinnati-bengals,3725000,2016
8690,2347059,975000,Vontaze Burfict,OLB,active,cincinnati-bengals,3322059,2016
8691,2650000,370000,Kevin Huber,P,active,cincinnati-bengals,3020000,2016
8692,1100000,1337500,Brandon LaFell,WR,active,cincinnati-bengals,2437500,2016
8693,1145355,1030708,Darqueze Dennard,CB,active,cincinnati-bengals,2176063,2016
8694,1000000,1000000,Karlos Dansby,ILB,active,cincinnati-bengals,2000000,2016
8695,900000,325000,Pat Sims,DT,active,cincinnati-bengals,1225000,2016
8696,885000,325000,Cedric Peerman,RB,active,cincinnati-bengals,1210000,2016
8697,855604,312473,Margus Hunt,DT,active,cincinnati-bengals,1168077,2016
8698,985000,105000,Eric Winston,RT,active,cincinnati-bengals,1090000,2016
8699,711237,312473,Jeremy Hill,RB,active,cincinnati-bengals,1023710,2016
8700,600000,378334,Ryan Hewitt,FB,active,cincinnati-bengals,978334,2016
8701,628615,339458,Jake Fisher,LT,active,cincinnati-bengals,968073,2016
8702,900000,50000,Clark Harris,LS,active,cincinnati-bengals,950000,2016
8703,450000,324358,Tyler Boyd,WR,active,cincinnati-bengals,774358,2016
8704,605000,151345,Will Clarke,DE,active,cincinnati-bengals,756345,2016
8705,600000,114114,Russell Bodine,C,active,cincinnati-bengals,714114,2016
8706,540500,171944,Tyler Kroft,TE,active,cincinnati-bengals,712444,2016
8707,675000,25550,Rex Burkhead,RB,active,cincinnati-bengals,700550,2016
8708,525000,123431,Josh Shaw,CB,active,cincinnati-bengals,648431,2016
8709,600000,45413,A.J. McCarron,QB,active,cincinnati-bengals,645413,2016
8710,450000,173907,Nick Vigil,OLB,active,cincinnati-bengals,623907,2016
8711,600000,19670,Marquis Flowers,OLB,active,cincinnati-bengals,619670,2016
8712,600000,12456,James Wright,WR,active,cincinnati-bengals,612456,2016
8713,600000,0,T.J. Johnson,C,active,cincinnati-bengals,600000,2016
8714,525000,53190,C.J. Uzomah,TE,active,cincinnati-bengals,578190,2016
8715,525000,29658,Derron Smith,SS,active,cincinnati-bengals,554658,2016
8716,450000,57924,Christian Westerman,G,active,cincinnati-bengals,507924,2016
8717,450000,31983,Cody Core,WR,active,cincinnati-bengals,481983,2016
8718,468529,0,Wallace Gilberry,DE,active,cincinnati-bengals,468529,2016
8719,450000,15887,Clayton Fejedelem,S,active,cincinnati-bengals,465887,2016
8720,450000,0,Jeff Driskel,QB,active,cincinnati-bengals,450000,2016
8721,450000,0,Alex Erickson,WR,active,cincinnati-bengals,450000,2016
8722,423529,0,Keivarae Russell,CB,active,cincinnati-bengals,423529,2016
8723,134117,0,Randy Bullock,K,active,cincinnati-bengals,134117,2016
8724,132350,0,DeShawn Williams,DT,active,cincinnati-bengals,132350,2016
8725,61764,0,Paul Dawson,OLB,active,cincinnati-bengals,61764,2016
8726,26470,0,Tra Carson,RB,active,cincinnati-bengals,26470,2016
8727,26470,0,Trey Hopkins,G,active,cincinnati-bengals,26470,2016
8728,26470,0,Jake Kumerow,WR,active,cincinnati-bengals,26470,2016
8729,26470,0,Trevor Roach,ILB,active,cincinnati-bengals,26470,2016
8730,3800000,9200000,A.J. Green,WR,injured_reserve,cincinnati-bengals,13000000,2016
8731,2350000,2400000,Clint Boling,G,injured_reserve,cincinnati-bengals,4750000,2016
8732,1071364,3550153,Giovani Bernard,RB,injured_reserve,cincinnati-bengals,4621517,2016
8733,765409,1861500,Tyler Eifert,TE,injured_reserve,cincinnati-bengals,2626909,2016
8734,858895,1260577,Cedric Ogbuehi,LT,injured_reserve,cincinnati-bengals,2119472,2016
8735,450000,1314662,William Jackson,CB,injured_reserve,cincinnati-bengals,1764662,2016
8736,760000,0,Chykie Brown,CB,injured_reserve,cincinnati-bengals,760000,2016
8737,333000,133961,Andrew Billings,DT,injured_reserve,cincinnati-bengals,466961,2016
8738,348000,86423,Marcus Hardison,DT,injured_reserve,cincinnati-bengals,434423,2016
8739,1200000,303125,Mike Nugent,K,dead_cap,cincinnati-bengals,1503125,2016
8740,317647,0,Chris Lewis-Harris,CB,dead_cap,cincinnati-bengals,317647,2016
8741,291170,3334,DeShawn Williams,DT,dead_cap,cincinnati-bengals,294504,2016
8742,103500,155488,Paul Dawson,OLB,dead_cap,cincinnati-bengals,258988,2016
8743,169110,1667,Trevor Roach,ILB,dead_cap,cincinnati-bengals,170777,2016
8744,129970,5000,Trey Hopkins,G,dead_cap,cincinnati-bengals,134970,2016
8745,0,120000,Brandon Tate,WR,dead_cap,cincinnati-bengals,120000,2016
8746,117300,0,Ryan Brown,DE,dead_cap,cincinnati-bengals,117300,2016
8747,117300,0,David Dean,DT,dead_cap,cincinnati-bengals,117300,2016
8748,117300,0,Alex Redmond,G,dead_cap,cincinnati-bengals,117300,2016
8749,117300,0,Alonzo Russell,WR,dead_cap,cincinnati-bengals,117300,2016
8750,110400,3334,Jake Kumerow,WR,dead_cap,cincinnati-bengals,113734,2016
8751,110400,0,Tra Carson,RB,dead_cap,cincinnati-bengals,110400,2016
8752,0,107325,Sean Porter,ILB,dead_cap,cincinnati-bengals,107325,2016
8753,105880,0,Tyler Ott,LS,dead_cap,cincinnati-bengals,105880,2016
8754,55200,3334,Matt Lengel,TE,dead_cap,cincinnati-bengals,58534,2016
8755,48300,0,Tony McRae,CB,dead_cap,cincinnati-bengals,48300,2016
8756,0,45606,Tanner Hawkinson,G,dead_cap,cincinnati-bengals,45606,2016
8757,20000,25000,Taylor Mays,SS,dead_cap,cincinnati-bengals,45000,2016
8758,20700,0,Darius Hillary,CB,dead_cap,cincinnati-bengals,20700,2016
8759,0,14776,Mario Alford,WR,dead_cap,cincinnati-bengals,14776,2016
8760,0,5000,Matt Johnson,QB,dead_cap,cincinnati-bengals,5000,2016
8761,0,5000,Matthew O'Donnell,T,dead_cap,cincinnati-bengals,5000,2016
8762,0,4000,Terrell Watson,RB,dead_cap,cincinnati-bengals,4000,2016
8763,0,3667,Troy Hill,CB,dead_cap,cincinnati-bengals,3667,2016
8764,0,3667,Floyd Raven,SS,dead_cap,cincinnati-bengals,3667,2016
8765,0,2334,Mark Weisman,RB,dead_cap,cincinnati-bengals,2334,2016
8766,0,2000,Jake Smith,C,dead_cap,cincinnati-bengals,2000,2016
8767,0,1667,Tom Obarski,K,dead_cap,cincinnati-bengals,1667,2016
8768,0,500,Dyshawn Mobley,RB,dead_cap,cincinnati-bengals,500,2016
8769,0,334,Erick Dargan,FS,dead_cap,cincinnati-bengals,334,2016
8770,0,334,Chris Jasperse,C,dead_cap,cincinnati-bengals,334,2016
8771,0,334,John Peters,TE,dead_cap,cincinnati-bengals,334,2016
8772,0,334,Kalafitoni Pole,DT,dead_cap,cincinnati-bengals,334,2016
8773,13100000,2600000,Andy Dalton,QB,active,cincinnati-bengals,15700000,2017
8774,10300000,3200000,A.J. Green,WR,active,cincinnati-bengals,13500000,2017
8775,7300000,3300000,Geno Atkins,DT,active,cincinnati-bengals,10600000,2017
8776,2550000,6834375,Dre Kirkpatrick,CB,active,cincinnati-bengals,9384375,2017
8777,6535529,1925000,Vontaze Burfict,OLB,active,cincinnati-bengals,8460529,2017
8778,5350000,1900000,Carlos Dunlap,DE,active,cincinnati-bengals,7250000,2017
8779,4000000,1400000,George Iloka,FS,active,cincinnati-bengals,5400000,2017
8780,3550000,1575000,Michael Johnson,DE,active,cincinnati-bengals,5125000,2017
8781,1250000,3750000,Brandon LaFell,WR,active,cincinnati-bengals,5000000,2017
8782,4050000,900000,Clint Boling,G,active,cincinnati-bengals,4950000,2017
8783,3100000,934375,Shawn Williams,SS,active,cincinnati-bengals,4034375,2017
8784,1600000,2075000,Giovani Bernard,RB,active,cincinnati-bengals,3675000,2017
8785,2250000,1000000,Vincent Rey,ILB,active,cincinnati-bengals,3250000,2017
8786,2800000,370000,Kevin Huber,P,active,cincinnati-bengals,3170000,2017
8787,1282789,1260577,Cedric Ogbuehi,LT,active,cincinnati-bengals,2543366,2017
8788,988032,1550708,Darqueze Dennard,CB,active,cincinnati-bengals,2538740,2017
8789,1700000,575000,Ryan Hewitt,FB,active,cincinnati-bengals,2275000,2017
8790,891166,1314662,William Jackson,CB,active,cincinnati-bengals,2205828,2017
8791,1797000,114114,Russell Bodine,C,active,cincinnati-bengals,1911114,2017
8792,950000,95000,Clark Harris,LS,active,cincinnati-bengals,1045000,2017
8793,465000,525940,Joe Mixon,RB,active,cincinnati-bengals,990940,2017
8794,643589,324358,Tyler Boyd,WR,active,cincinnati-bengals,967947,2017
8795,628000,171944,Tyler Kroft,TE,active,cincinnati-bengals,799944,2017
8796,775000,0,Randy Bullock,K,active,cincinnati-bengals,775000,2017
8797,615000,123431,Josh Shaw,CB,active,cincinnati-bengals,738431,2017
8798,690000,45413,A.J. McCarron,QB,active,cincinnati-bengals,735413,2017
8799,465000,226100,Jordan Willis,DE,active,cincinnati-bengals,691100,2017
8800,690000,0,Chris Smith,DE,active,cincinnati-bengals,690000,2017
8801,615000,53190,C.J. Uzomah,TE,active,cincinnati-bengals,668190,2017
8802,465000,163153,Carl Lawson,OLB,active,cincinnati-bengals,628153,2017
8803,465000,148382,Josh Malone,WR,active,cincinnati-bengals,613382,2017
8804,465000,133961,Andrew Billings,DT,active,cincinnati-bengals,598961,2017
8805,540000,57924,Christian Westerman,G,active,cincinnati-bengals,597924,2017
8806,570000,25000,Keivarae Russell,CB,active,cincinnati-bengals,595000,2017
8807,540000,31983,Cody Core,WR,active,cincinnati-bengals,571983,2017
8808,465000,104912,Ryan Glasgow,DT,active,cincinnati-bengals,569912,2017
8809,540000,15887,Clayton Fejedelem,S,active,cincinnati-bengals,555887,2017
8810,540000,3000,Alex Erickson,WR,active,cincinnati-bengals,543000,2017
8811,465000,39126,Jordan Evans,ILB,active,cincinnati-bengals,504126,2017
8812,470588,0,Eric Winston,RT,active,cincinnati-bengals,470588,2017
8813,465000,3333,Cethan Carter,TE,active,cincinnati-bengals,468333,2017
8814,465000,0,Trey Hopkins,G,active,cincinnati-bengals,465000,2017
8815,465000,0,Alex Redmond,G,active,cincinnati-bengals,465000,2017
8816,352941,0,Pat Sims,DT,active,cincinnati-bengals,352941,2017
8817,222353,0,Hardy Nickerson Jr.,ILB,active,cincinnati-bengals,222353,2017
8818,218824,0,Brandon Wilson,S,active,cincinnati-bengals,218824,2017
8819,191471,0,Brian Hill,RB,active,cincinnati-bengals,191471,2017
8820,109412,0,Tony McRae,CB,active,cincinnati-bengals,109412,2017
8821,82059,0,Brandon Bell,OLB,active,cincinnati-bengals,82059,2017
8822,82059,0,Jarveon Williams,RB,active,cincinnati-bengals,82059,2017
8823,54706,0,Justin Murray,T,active,cincinnati-bengals,54706,2017
8824,54706,0,Kent Perkins,G,active,cincinnati-bengals,54706,2017
8825,6023529,1366666,Adam-Pacman Jones,CB,injured_reserve,cincinnati-bengals,7390195,2017
8826,4782000,0,Tyler Eifert,TE,injured_reserve,cincinnati-bengals,4782000,2017
8827,800000,3450000,Kevin Minter,ILB,injured_reserve,cincinnati-bengals,4250000,2017
8828,437469,2646975,John Ross,WR,injured_reserve,cincinnati-bengals,3084444,2017
8829,1250000,1812500,Andre Smith,G,injured_reserve,cincinnati-bengals,3062500,2017
8830,1300000,325000,T.J. Johnson,C,injured_reserve,cincinnati-bengals,1625000,2017
8831,881855,312473,Jeremy Hill,RB,injured_reserve,cincinnati-bengals,1194328,2017
8832,900000,187500,Cedric Peerman,RB,injured_reserve,cincinnati-bengals,1087500,2017
8833,540000,198907,Nick Vigil,OLB,injured_reserve,cincinnati-bengals,738907,2017
8834,348000,16067,Mason Schreck,TE,injured_reserve,cincinnati-bengals,364067,2017
8835,363000,0,Jeff Driskel,QB,injured_reserve,cincinnati-bengals,363000,2017
8836,348000,0,Tra Carson,RB,injured_reserve,cincinnati-bengals,348000,2017
8837,1000000,75000,Pat Sims,DT,dead_cap,cincinnati-bengals,1075000,2017
8838,0,400000,Wallace Gilberry,DE,dead_cap,cincinnati-bengals,400000,2017
8839,289412,29658,Derron Smith,SS,dead_cap,cincinnati-bengals,319070,2017
8840,0,290976,Paul Dawson,OLB,dead_cap,cincinnati-bengals,290976,2017
8841,213071,0,Hardy Nickerson Jr.,ILB,dead_cap,cincinnati-bengals,213071,2017
8842,0,151345,Will Clarke,DE,dead_cap,cincinnati-bengals,151345,2017
8843,93600,50484,J.J. Dielman,C,dead_cap,cincinnati-bengals,144084,2017
8844,133906,0,Josh Tupou,DT,dead_cap,cincinnati-bengals,133906,2017
8845,122400,0,Levonte Whitfield,WR,dead_cap,cincinnati-bengals,122400,2017
8846,122400,0,DeShawn Williams,DT,dead_cap,cincinnati-bengals,122400,2017
8847,108000,0,Kent Perkins,G,dead_cap,cincinnati-bengals,108000,2017
8848,100800,0,Brandon Bell,OLB,dead_cap,cincinnati-bengals,100800,2017
8849,100800,0,Jarveon Williams,RB,dead_cap,cincinnati-bengals,100800,2017
8850,100800,0,Sojourn Shelton,CB,dead_cap,cincinnati-bengals,100800,2017
8851,64800,35523,Brandon Wilson,RB,dead_cap,cincinnati-bengals,100323,2017
8852,0,86423,Marcus Hardison,DT,dead_cap,cincinnati-bengals,86423,2017
8853,0,80000,Eric Winston,RT,dead_cap,cincinnati-bengals,80000,2017
8854,79200,0,Scott Orndoff,TE,dead_cap,cincinnati-bengals,79200,2017
8855,7200,69300,Jake Elliott,K,dead_cap,cincinnati-bengals,76500,2017
8856,54706,0,Jake Kumerow,WR,dead_cap,cincinnati-bengals,54706,2017
8857,43200,0,Tony McRae,CB,dead_cap,cincinnati-bengals,43200,2017
8858,31765,0,Christian Ringo,DT,dead_cap,cincinnati-bengals,31765,2017
8859,0,29552,Mario Alford,WR,dead_cap,cincinnati-bengals,29552,2017
8860,28800,0,Carl Bradford,OLB,dead_cap,cincinnati-bengals,28800,2017
8861,27353,0,Marshall Koehn,K,dead_cap,cincinnati-bengals,27353,2017
8862,21600,0,Robenson Therezie,FS,dead_cap,cincinnati-bengals,21600,2017
8863,21600,0,Cole Toner,G,dead_cap,cincinnati-bengals,21600,2017
8864,0,19670,Marquis Flowers,OLB,dead_cap,cincinnati-bengals,19670,2017
8865,0,16067,Mason Schreck,TE,dead_cap,cincinnati-bengals,16067,2017
8866,14400,0,Javarius Leamon,T,dead_cap,cincinnati-bengals,14400,2017
8867,14400,0,Oni Omoile,G,dead_cap,cincinnati-bengals,14400,2017
8868,0,12456,James Wright,WR,dead_cap,cincinnati-bengals,12456,2017
8869,7200,0,Jonathan Brown,K,dead_cap,cincinnati-bengals,7200,2017
8870,0,1000,Dyshawn Mobley,RB,dead_cap,cincinnati-bengals,1000,2017
8871,8000000,7100000,Geno Atkins,DT,active,cincinnati-bengals,15100000,2018
8872,1000000,12050000,Carlos Dunlap,DE,active,cincinnati-bengals,13050000,2018
8873,9250000,2000000,Cordy Glenn,LT,active,cincinnati-bengals,11250000,2018
8874,8526000,0,Darqueze Dennard,CB,active,cincinnati-bengals,8526000,2018
8875,2913529,4387500,Vontaze Burfict,OLB,active,cincinnati-bengals,7301029,2018
8876,4550000,900000,Clint Boling,G,active,cincinnati-bengals,5450000,2018
8877,4550000,187500,Michael Johnson,DE,active,cincinnati-bengals,4737500,2018
8878,3100000,1100000,Giovani Bernard,RB,active,cincinnati-bengals,4200000,2018
8879,3200000,950000,Shawn Williams,SS,active,cincinnati-bengals,4150000,2018
8880,1242994,2646975,John Ross,WR,active,cincinnati-bengals,3889969,2018
8881,1706684,1260579,Cedric Ogbuehi,LT,active,cincinnati-bengals,2967263,2018
8882,2250000,500000,Vincent Rey,ILB,active,cincinnati-bengals,2750000,2018
8883,1332331,1314662,William Jackson,CB,active,cincinnati-bengals,2646993,2018
8884,1400000,900000,Kevin Huber,P,active,cincinnati-bengals,2300000,2018
8885,480000,1649543,Billy Price,C,active,cincinnati-bengals,2129543,2018
8886,880000,769666,Alex Erickson,WR,active,cincinnati-bengals,1649666,2018
8887,1045000,250000,Randy Bullock,K,active,cincinnati-bengals,1295000,2018
8888,712735,525940,Joe Mixon,RB,active,cincinnati-bengals,1238675,2018
8889,1015000,115000,Clark Harris,LS,active,cincinnati-bengals,1130000,2018
8890,705000,300000,Bobby Hart,RT,active,cincinnati-bengals,1005000,2018
8891,480000,419602,Jessie Bates III,FS,active,cincinnati-bengals,899602,2018
8892,628000,226100,Jordan Willis,DE,active,cincinnati-bengals,854100,2018
8893,630000,198907,Nick Vigil,OLB,active,cincinnati-bengals,828907,2018
8894,630000,133961,Andrew Billings,DT,active,cincinnati-bengals,763961,2018
8895,705000,53192,C.J. Uzomah,TE,active,cincinnati-bengals,758192,2018
8896,480000,232300,Sam Hubbard,DE,active,cincinnati-bengals,712300,2018
8897,555000,148382,Josh Malone,WR,active,cincinnati-bengals,703382,2018
8898,630000,57924,Christian Westerman,G,active,cincinnati-bengals,687924,2018
8899,630000,31983,Cody Core,WR,active,cincinnati-bengals,661983,2018
8900,480000,171336,Mark Walton,RB,active,cincinnati-bengals,651336,2018
8901,630000,15887,Clayton Fejedelem,S,active,cincinnati-bengals,645887,2018
8902,630000,0,Jeff Driskel,QB,active,cincinnati-bengals,630000,2018
8903,555000,0,Trey Hopkins,C,active,cincinnati-bengals,555000,2018
8904,555000,0,Tony McRae,CB,active,cincinnati-bengals,555000,2018
8905,555000,0,Hardy Nickerson Jr.,ILB,active,cincinnati-bengals,555000,2018
8906,555000,0,Alex Redmond,G,active,cincinnati-bengals,555000,2018
8907,555000,0,Brandon Wilson,S,active,cincinnati-bengals,555000,2018
8908,480000,54388,Darius Phillips,CB,active,cincinnati-bengals,534388,2018
8909,424941,72143,Davontae Harris,CB,active,cincinnati-bengals,497084,2018
8910,444706,0,Matt Lengel,TE,active,cincinnati-bengals,444706,2018
8911,407647,0,Keivarae Russell,CB,active,cincinnati-bengals,407647,2018
8912,282350,0,Jordan Franks,TE,active,cincinnati-bengals,282350,2018
8913,269118,0,Andre Smith,RT,active,cincinnati-bengals,269118,2018
8914,228529,0,Brandon Bell,OLB,active,cincinnati-bengals,228529,2018
8915,225880,0,Auden Tate,WR,active,cincinnati-bengals,225880,2018
8916,278824,0,Kasim Edebali,OLB,active,cincinnati-bengals,278824,2018
8917,222354,0,Christian Ringo,DT,active,cincinnati-bengals,222354,2018
8918,207353,0,Tom Savage,QB,active,cincinnati-bengals,207353,2018
8919,169410,0,Niles Scott,DT,active,cincinnati-bengals,169410,2018
8920,56470,0,Chris Worley,LB,active,cincinnati-bengals,56470,2018
8921,32647,0,Hunter Sharp,WR,active,cincinnati-bengals,32647,2018
8922,28235,0,Quinton Flowers,RB,active,cincinnati-bengals,28235,2018
8923,28235,0,Kent Perkins,G,active,cincinnati-bengals,28235,2018
8924,13700000,2600000,Andy Dalton,QB,injured_reserve,cincinnati-bengals,16300000,2018
8925,10550000,3200000,A.J. Green,WR,injured_reserve,cincinnati-bengals,13750000,2018
8926,4750000,4803125,Dre Kirkpatrick,CB,injured_reserve,cincinnati-bengals,9553125,2018
8927,1000000,4000000,Preston Brown,ILB,injured_reserve,cincinnati-bengals,5000000,2018
8928,1000000,3750000,Tyler Eifert,TE,injured_reserve,cincinnati-bengals,4750000,2018
8929,1897000,171944,Tyler Kroft,TE,injured_reserve,cincinnati-bengals,2068944,2018
8930,965884,389459,Jake Fisher,LT,injured_reserve,cincinnati-bengals,1355343,2018
8931,787179,374358,Tyler Boyd,WR,injured_reserve,cincinnati-bengals,1161537,2018
8932,466229,230932,Malik Jefferson,OLB,injured_reserve,cincinnati-bengals,697161,2018
8933,555000,104912,Ryan Glasgow,DT,injured_reserve,cincinnati-bengals,659912,2018
8934,471706,163153,Carl Lawson,OLB,injured_reserve,cincinnati-bengals,634859,2018
8935,544587,39126,Jordan Evans,OLB,injured_reserve,cincinnati-bengals,583713,2018
8936,492529,7500,Josh Tupou,DT,injured_reserve,cincinnati-bengals,500029,2018
8937,435176,0,Adolphus Washington,DT,injured_reserve,cincinnati-bengals,435176,2018
8938,411165,16067,Mason Schreck,TE,injured_reserve,cincinnati-bengals,427232,2018
8939,378000,3333,Cethan Carter,TE,injured_reserve,cincinnati-bengals,381333,2018
8940,363000,17267,Rod Taylor,G,injured_reserve,cincinnati-bengals,380267,2018
8941,363000,2000,Trayvon Henderson,S,injured_reserve,cincinnati-bengals,365000,2018
8942,0,1375000,Michael Johnson,DE,dead_cap,cincinnati-bengals,1375000,2018
8943,0,1200000,Brandon LaFell,WR,dead_cap,cincinnati-bengals,1200000,2018
8944,0,900000,George Iloka,FS,dead_cap,cincinnati-bengals,900000,2018
8945,0,666668,Adam-Pacman Jones,CB,dead_cap,cincinnati-bengals,666668,2018
8946,58824,525000,Matt Barkley,QB,dead_cap,cincinnati-bengals,583824,2018
8947,0,475000,Ryan Hewitt,FB,dead_cap,cincinnati-bengals,475000,2018
8948,0,450000,Chris Baker,DT,dead_cap,cincinnati-bengals,450000,2018
8949,224343,123431,Josh Shaw,CB,dead_cap,cincinnati-bengals,347774,2018
8950,0,325000,T.J. Johnson,C,dead_cap,cincinnati-bengals,325000,2018
8951,212848,17267,Auden Tate,WR,dead_cap,cincinnati-bengals,230115,2018
8952,213530,0,Sojourn Shelton,CB,dead_cap,cincinnati-bengals,213530,2018
8953,0,207901,Jake Elliott,K,dead_cap,cincinnati-bengals,207901,2018
8954,129200,69603,Andrew Brown,DE,dead_cap,cincinnati-bengals,198803,2018
8955,0,151455,J.J. Dielman,C,dead_cap,cincinnati-bengals,151455,2018
8956,129200,0,Moritz Boehringer,WR,dead_cap,cincinnati-bengals,129200,2018
8957,129200,0,Brad Lundblade,C,dead_cap,cincinnati-bengals,129200,2018
8958,129200,0,Levonte Whitfield,WR,dead_cap,cincinnati-bengals,129200,2018
8959,124412,0,Thomas Rawls,RB,dead_cap,cincinnati-bengals,124412,2018
8960,121600,0,Quinton Flowers,RB,dead_cap,cincinnati-bengals,121600,2018
8961,121600,0,Kent Perkins,G,dead_cap,cincinnati-bengals,121600,2018
8962,114000,0,Chris Worley,LB,dead_cap,cincinnati-bengals,114000,2018
8963,0,106572,Brandon Wilson,RB,dead_cap,cincinnati-bengals,106572,2018
8964,91200,0,Demetrious Cox,S,dead_cap,cincinnati-bengals,91200,2018
8965,87529,0,Tra Carson,RB,dead_cap,cincinnati-bengals,87529,2018
8966,0,86423,Marcus Hardison,DT,dead_cap,cincinnati-bengals,86423,2018
8967,45600,25000,Keivarae Russell,CB,dead_cap,cincinnati-bengals,70600,2018
8968,68400,0,Christian Hackenberg,QB,dead_cap,cincinnati-bengals,68400,2018
8969,60800,0,Connor Cook,QB,dead_cap,cincinnati-bengals,60800,2018
8970,60800,0,Andrew Vollert,TE,dead_cap,cincinnati-bengals,60800,2018
8971,53200,0,Jordan Franks,TE,dead_cap,cincinnati-bengals,53200,2018
8972,0,48204,Mason Schreck,TE,dead_cap,cincinnati-bengals,48204,2018
8973,38000,0,C.J. Goodwin,S,dead_cap,cincinnati-bengals,38000,2018
8974,38000,0,Hunter Sharp,WR,dead_cap,cincinnati-bengals,38000,2018
8975,38000,0,Aaron Wallace,OLB,dead_cap,cincinnati-bengals,38000,2018
8976,0,29658,Derron Smith,SS,dead_cap,cincinnati-bengals,29658,2018
8977,22800,0,Brandon Bell,OLB,dead_cap,cincinnati-bengals,22800,2018
8978,0,17499,Logan Woodside,QB,dead_cap,cincinnati-bengals,17499,2018
8979,15200,0,Chris Cooper,S,dead_cap,cincinnati-bengals,15200,2018
8980,16000000,200000,Andy Dalton,QB,active,cincinnati-bengals,16200000,2019
8981,8000000,6600000,Geno Atkins,DT,active,cincinnati-bengals,14600000,2019
8982,3100000,7187500,Carlos Dunlap,DE,active,cincinnati-bengals,10287500,2019
8983,7250000,2000000,Cordy Glenn,LT,active,cincinnati-bengals,9250000,2019
8984,1500000,4583333,C.J. Uzomah,TE,active,cincinnati-bengals,6083333,2019
8985,2030769,4024358,Tyler Boyd,WR,active,cincinnati-bengals,6055127,2019
8986,900000,5000000,Bobby Hart,RT,active,cincinnati-bengals,5900000,2019
8987,900000,4539583,John Miller,G,active,cincinnati-bengals,5439583,2019
8988,3500000,1816666,Giovani Bernard,RB,active,cincinnati-bengals,5316666,2019
8989,2020988,2646975,John Ross,WR,active,cincinnati-bengals,4667963,2019
8990,3500000,950000,Shawn Williams,SS,active,cincinnati-bengals,4450000,2019
8991,1500000,2890625,Darqueze Dennard,CB,active,cincinnati-bengals,4390625,2019
8992,3095000,1125000,Trey Hopkins,C,active,cincinnati-bengals,4220000,2019
8993,1000000,3000000,Tyler Eifert,TE,active,cincinnati-bengals,4000000,2019
8994,1000000,1984375,B.W. Webb,CB,active,cincinnati-bengals,2984375,2019
8995,2350000,400000,Kevin Huber,P,active,cincinnati-bengals,2750000,2019
8996,1012386,1649543,Billy Price,C,active,cincinnati-bengals,2661929,2019
8997,2000000,223908,Nick Vigil,OLB,active,cincinnati-bengals,2223908,2019
8998,1475000,350000,Randy Bullock,K,active,cincinnati-bengals,1825000,2019
8999,1400000,366666,Alex Erickson,WR,active,cincinnati-bengals,1766666,2019
9000,960470,525940,Joe Mixon,RB,active,cincinnati-bengals,1486410,2019
9001,704901,419602,Jessie Bates III,S,active,cincinnati-bengals,1124503,2019
9002,1030000,80000,Clark Harris,LS,active,cincinnati-bengals,1110000,2019
9003,640000,232300,Sam Hubbard,DE,active,cincinnati-bengals,872300,2019
9004,720000,133962,Andrew Billings,DT,active,cincinnati-bengals,853962,2019
9005,645000,163153,Carl Lawson,DE,active,cincinnati-bengals,808153,2019
9006,495000,263221,Germaine Pratt,LB,active,cincinnati-bengals,758221,2019
9007,720000,15889,Clayton Fejedelem,S,active,cincinnati-bengals,735889,2019
9008,495000,197414,Ryan Finley,QB,active,cincinnati-bengals,692414,2019
9009,645000,39126,Jordan Evans,OLB,active,cincinnati-bengals,684126,2019
9010,930000,0,John Jerry,G,active,cincinnati-bengals,930000,2019
9011,645000,0,Tony McRae,CB,active,cincinnati-bengals,645000,2019
9012,645000,0,Josh Tupou,DT,active,cincinnati-bengals,645000,2019
9013,495000,122098,Michael Jordan,G,active,cincinnati-bengals,617098,2019
9014,757647,0,LaRoy Reynolds,ILB,active,cincinnati-bengals,757647,2019
9015,570000,3334,Cethan Carter,TE,active,cincinnati-bengals,573334,2019
9016,495000,45496,Trayveon Williams,RB,active,cincinnati-bengals,540496,2019
9017,531176,0,Torry McTyer,CB,active,cincinnati-bengals,531176,2019
9018,495000,1666,Jacob Dolegala,QB,active,cincinnati-bengals,496666,2019
9019,495000,0,Andrew Brown,DE,active,cincinnati-bengals,495000,2019
9020,424234,54388,Darius Phillips,CB,active,cincinnati-bengals,478622,2019
9021,378529,0,Stanley Morgan,WR,active,cincinnati-bengals,378529,2019
9022,341471,0,Greg Mabin,CB,active,cincinnati-bengals,341471,2019
9023,320298,0,Fred Johnson,G,active,cincinnati-bengals,320298,2019
9024,265588,0,Hardy Nickerson Jr.,ILB,active,cincinnati-bengals,265588,2019
9025,167647,0,Mason Schreck,TE,active,cincinnati-bengals,167647,2019
9026,134118,0,Trayvon Henderson,S,active,cincinnati-bengals,134118,2019
9027,116472,0,Isaiah Prince,T,active,cincinnati-bengals,116472,2019
9028,87353,0,Freedom Akinmoladun,DE,active,cincinnati-bengals,87353,2019
9029,87353,0,Damion Willis,WR,active,cincinnati-bengals,87353,2019
9030,58235,0,Brady Sheldon,OLB,active,cincinnati-bengals,58235,2019
9031,33529,0,Jordan Franks,TE,active,cincinnati-bengals,33529,2019
9032,29118,0,Trenton Irwin,WR,active,cincinnati-bengals,29118,2019
9033,11976000,3200000,A.J. Green,WR,injured_reserve,cincinnati-bengals,15176000,2019
9034,9150000,1693750,Dre Kirkpatrick,CB,injured_reserve,cincinnati-bengals,10843750,2019
9035,1773497,1314664,William Jackson,CB,injured_reserve,cincinnati-bengals,3088161,2019
9036,900000,412500,Kerry Wynn,DE,injured_reserve,cincinnati-bengals,1312500,2019
9037,495000,506145,Drew Sample,TE,injured_reserve,cincinnati-bengals,1001145,2019
9038,645000,104912,Ryan Glasgow,DT,injured_reserve,cincinnati-bengals,749912,2019
9039,474358,170649,Renell Wren,DT,injured_reserve,cincinnati-bengals,645007,2019
9040,645000,0,Brandon Wilson,S,injured_reserve,cincinnati-bengals,645000,2019
9041,538759,0,Auden Tate,WR,injured_reserve,cincinnati-bengals,538759,2019
9042,493236,0,Alex Redmond,G,injured_reserve,cincinnati-bengals,493236,2019
9043,378000,31839,Rodney Anderson,RB,injured_reserve,cincinnati-bengals,409839,2019
9044,393000,0,Niles Scott,DT,injured_reserve,cincinnati-bengals,393000,2019
9045,378000,1833,O’Shea Dugas,T,injured_reserve,cincinnati-bengals,379833,2019
9046,900000,3858333,Preston Brown,ILB,dead_cap,cincinnati-bengals,4758333,2019
9047,0,1709190,Vontaze Burfict,OLB,dead_cap,cincinnati-bengals,1709190,2019
9048,0,1200000,George Iloka,FS,dead_cap,cincinnati-bengals,1200000,2019
9049,1030000,0,Andre Smith,RT,dead_cap,cincinnati-bengals,1030000,2019
9050,0,514011,Mark Walton,RB,dead_cap,cincinnati-bengals,514011,2019
9051,0,500000,Clint Boling,G,dead_cap,cincinnati-bengals,500000,2019
9052,381177,0,Anthony Zettel,DE,dead_cap,cincinnati-bengals,381177,2019
9053,0,375000,Ryan Hewitt,FB,dead_cap,cincinnati-bengals,375000,2019
9054,352294,5000,Damion Willis,WR,dead_cap,cincinnati-bengals,357294,2019
9055,337588,0,Samaje Perine,RB,dead_cap,cincinnati-bengals,337588,2019
9056,44397,226100,Jordan Willis,DE,dead_cap,cincinnati-bengals,270497,2019
9057,0,250000,Matt Barkley,QB,dead_cap,cincinnati-bengals,250000,2019
9058,0,230932,Malik Jefferson,OLB,dead_cap,cincinnati-bengals,230932,2019
9059,0,208810,Andrew Brown,DE,dead_cap,cincinnati-bengals,208810,2019
9060,0,148382,Josh Malone,WR,dead_cap,cincinnati-bengals,148382,2019
9061,128000,0,Jordan Franks,TE,dead_cap,cincinnati-bengals,128000,2019
9062,128000,0,Wyatt Miller,T,dead_cap,cincinnati-bengals,128000,2019
9063,96000,16068,Mason Schreck,TE,dead_cap,cincinnati-bengals,112068,2019
9064,112000,0,Davin Bellamy,LB,dead_cap,cincinnati-bengals,112000,2019
9065,104000,2000,Trayvon Henderson,S,dead_cap,cincinnati-bengals,106000,2019
9066,96000,0,Trenton Irwin,WR,dead_cap,cincinnati-bengals,96000,2019
9067,84706,0,Pharoh Cooper,WR,dead_cap,cincinnati-bengals,84706,2019
9068,80000,0,Hardy Nickerson Jr.,ILB,dead_cap,cincinnati-bengals,80000,2019
9069,0,72144,Davontae Harris,CB,dead_cap,cincinnati-bengals,72144,2019
9070,61941,0,Greg Mabin,CB,dead_cap,cincinnati-bengals,61941,2019
9071,56000,2000,Anthony Chesley,CB,dead_cap,cincinnati-bengals,58000,2019
9072,0,57924,Christian Westerman,G,dead_cap,cincinnati-bengals,57924,2019
9073,0,52498,Logan Woodside,QB,dead_cap,cincinnati-bengals,52498,2019
9074,0,51803,Auden Tate,WR,dead_cap,cincinnati-bengals,51803,2019
9075,45118,3333,Keaton Sutherland,T,dead_cap,cincinnati-bengals,48451,2019
9076,48000,0,Brady Sheldon,OLB,dead_cap,cincinnati-bengals,48000,2019
9077,48000,0,Cody Thompson,WR,dead_cap,cincinnati-bengals,48000,2019
9078,42353,0,Jeff Driskel,QB,dead_cap,cincinnati-bengals,42353,2019
9079,40000,0,Noah Dawkins,LB,dead_cap,cincinnati-bengals,40000,2019
9080,32000,3333,Stanley Morgan,WR,dead_cap,cincinnati-bengals,35333,2019
9081,32000,0,Dino Boyd,T,dead_cap,cincinnati-bengals,32000,2019
9082,0,31983,Cody Core,WR,dead_cap,cincinnati-bengals,31983,2019
9083,0,31839,Deshaun Davis,LB,dead_cap,cincinnati-bengals,31839,2019
9084,0,25189,Jordan Brown,CB,dead_cap,cincinnati-bengals,25189,2019
9085,0,25000,Keivarae Russell,CB,dead_cap,cincinnati-bengals,25000,2019
9086,24000,666,Jordan Ellis,RB,dead_cap,cincinnati-bengals,24666,2019
9087,24000,0,Freedom Akinmoladun,DE,dead_cap,cincinnati-bengals,24000,2019
9088,24000,0,DaMarkus Lodge,WR,dead_cap,cincinnati-bengals,24000,2019
9089,0,17267,Rod Taylor,G,dead_cap,cincinnati-bengals,17267,2019
9090,16000,0,Kaare Vedvik,K,dead_cap,cincinnati-bengals,16000,2019
9091,0,3333,Curtis Akins,LB,dead_cap,cincinnati-bengals,3333,2019
9092,0,1000,Tyree Kinnel,S,dead_cap,cincinnati-bengals,1000,2019
9093,17500000,200000,Andy Dalton,QB,active,cincinnati-bengals,17700000,2020
9094,11100000,3100000,Geno Atkins,DT,active,cincinnati-bengals,14200000,2020
9095,9400000,1693750,Dre Kirkpatrick,CB,active,cincinnati-bengals,11093750,2020
9096,7800000,3187500,Carlos Dunlap,DE,active,cincinnati-bengals,10987500,2020
9097,9954000,0,William Jackson,CB,active,cincinnati-bengals,9954000,2020
9098,7500000,2000000,Cordy Glenn,LT,active,cincinnati-bengals,9500000,2020
9099,4200000,3850000,Tyler Boyd,WR,active,cincinnati-bengals,8050000,2020
9100,3050000,2833333,C.J. Uzomah,TE,active,cincinnati-bengals,5883333,2020
9101,2550000,3025000,Trey Hopkins,C,active,cincinnati-bengals,5575000,2020
9102,2798981,2646975,John Ross,WR,active,cincinnati-bengals,5445956,2020
9103,2400000,3039583,John Miller,G,active,cincinnati-bengals,5439583,2020
9104,1850000,3000000,Bobby Hart,RT,active,cincinnati-bengals,4850000,2020
9105,3535000,950000,Shawn Williams,SS,active,cincinnati-bengals,4485000,2020
9106,3100000,1066666,Giovani Bernard,RB,active,cincinnati-bengals,4166666,2020
9107,1296371,2710485,Jonah Williams,T,active,cincinnati-bengals,4006856,2020
9108,2000000,1584375,B.W. Webb,CB,active,cincinnati-bengals,3584375,2020
9109,1544772,1649543,Billy Price,C,active,cincinnati-bengals,3194315,2020
9110,2500000,550000,Kevin Huber,P,active,cincinnati-bengals,3050000,2020
9111,1525000,350000,Randy Bullock,K,active,cincinnati-bengals,1875000,2020
9112,1500000,366668,Alex Erickson,WR,active,cincinnati-bengals,1866668,2020
9113,1208206,525943,Joe Mixon,RB,active,cincinnati-bengals,1734149,2020
9114,929801,419602,Jessie Bates III,S,active,cincinnati-bengals,1349403,2020
9115,745286,506145,Drew Sample,TE,active,cincinnati-bengals,1251431,2020
9116,1045000,80000,Clark Harris,LS,active,cincinnati-bengals,1125000,2020
9117,735000,232300,Sam Hubbard,DE,active,cincinnati-bengals,967300,2020
9118,684555,263221,Germaine Pratt,LB,active,cincinnati-bengals,947776,2020
9119,735000,163155,Carl Lawson,DE,active,cincinnati-bengals,898155,2020
9120,735000,104912,Ryan Glasgow,DT,active,cincinnati-bengals,839912,2020
9121,585000,197414,Ryan Finley,QB,active,cincinnati-bengals,782414,2020
9122,735000,39128,Jordan Evans,OLB,active,cincinnati-bengals,774128,2020
9123,585000,170649,Renell Wren,DT,active,cincinnati-bengals,755649,2020
9124,660000,54388,Darius Phillips,CB,active,cincinnati-bengals,714388,2020
9125,585000,122098,Michael Jordan,G,active,cincinnati-bengals,707098,2020
9126,660000,0,Tony Brown,CB,active,cincinnati-bengals,660000,2020
9127,660000,0,Mason Schreck,TE,active,cincinnati-bengals,660000,2020
9128,660000,0,Auden Tate,WR,active,cincinnati-bengals,660000,2020
9129,585000,45496,Trayveon Williams,RB,active,cincinnati-bengals,630496,2020
9130,585000,1833,O’Shea Dugas,T,active,cincinnati-bengals,586833,2020
9131,585000,1666,Jacob Dolegala,QB,active,cincinnati-bengals,586666,2020
9132,585000,0,Andrew Brown,DE,active,cincinnati-bengals,585000,2020
9133,585000,0,Trenton Irwin,WR,active,cincinnati-bengals,585000,2020
9134,585000,0,Fred Johnson,G,active,cincinnati-bengals,585000,2020
9135,585000,0,Stanley Morgan,WR,active,cincinnati-bengals,585000,2020
9136,585000,0,Isaiah Prince,T,active,cincinnati-bengals,585000,2020
9137,585000,0,Damion Willis,WR,active,cincinnati-bengals,585000,2020
9138,510000,31839,Rodney Anderson,RB,active,cincinnati-bengals,541839,2020
9139,510000,30000,Winston Rose,CB,active,cincinnati-bengals,540000,2020
9140,510000,0,Moritz Boehringer,WR,active,cincinnati-bengals,510000,2020
9141,510000,0,Dan Godsil,LS,active,cincinnati-bengals,510000,2020
9142,510000,0,DaMarkus Lodge,WR,active,cincinnati-bengals,510000,2020
9143,0,1666667,Preston Brown,ILB,dead_cap,cincinnati-bengals,1666667,2020
9144,0,461864,Malik Jefferson,OLB,dead_cap,cincinnati-bengals,461864,2020
9145,0,226100,Jordan Willis,DE,dead_cap,cincinnati-bengals,226100,2020
9146,0,148382,Josh Malone,WR,dead_cap,cincinnati-bengals,148382,2020
9147,0,144287,Davontae Harris,CB,dead_cap,cincinnati-bengals,144287,2020
9148,0,95517,Deshaun Davis,LB,dead_cap,cincinnati-bengals,95517,2020
9149,0,75567,Jordan Brown,CB,dead_cap,cincinnati-bengals,75567,2020
9150,0,34534,Rod Taylor,G,dead_cap,cincinnati-bengals,34534,2020
9151,0,16068,Mason Schreck,TE,dead_cap,cincinnati-bengals,16068,2020
9152,0,10000,Damion Willis,WR,dead_cap,cincinnati-bengals,10000,2020
9153,0,6667,Curtis Akins,LB,dead_cap,cincinnati-bengals,6667,2020
9154,0,6667,Stanley Morgan,WR,dead_cap,cincinnati-bengals,6667,2020
9155,0,6667,Keaton Sutherland,T,dead_cap,cincinnati-bengals,6667,2020
9156,0,4000,Anthony Chesley,CB,dead_cap,cincinnati-bengals,4000,2020
9157,0,2000,Trayvon Henderson,S,dead_cap,cincinnati-bengals,2000,2020
9158,0,2000,Tyree Kinnel,S,dead_cap,cincinnati-bengals,2000,2020
9159,0,1334,Jordan Ellis,RB,dead_cap,cincinnati-bengals,1334,2020
9160,1900000,666666,Willie McGinest,LB,active,cleveland-browns,2566666,2007
9161,750000,0,Shaun Smith,DT,active,cleveland-browns,750000,2007
9162,2000000,3423334,Kellen Winslow,TE,active,cleveland-browns,5423334,2007
9163,879750,4287500,Braylon Edwards,WR,active,cleveland-browns,5167250,2007
9164,2550000,1066666,Ryan Tucker,T,active,cleveland-browns,3616666,2007
9165,900000,2600000,Jamal Lewis,RB,active,cleveland-browns,3500000,2007
9166,435000,2425000,Joshua Cribbs,WR,active,cleveland-browns,2860000,2007
9167,285000,2415000,Joe Thomas,LT,active,cleveland-browns,2700000,2007
9168,1350000,1150000,Andra Davis,LB,active,cleveland-browns,2500000,2007
9169,600000,1666667,Eric Steinbach,G,active,cleveland-browns,2266667,2007
9170,360000,2742500,Kamerion Wimbley,OLB,active,cleveland-browns,3102500,2007
9171,1050000,570000,Dave Zastudil,P,active,cleveland-browns,1620000,2007
9172,1000000,500000,Trent Dilfer,QB,active,cleveland-browns,1500000,2007
9173,800000,680000,Phil Dawson,K,active,cleveland-browns,1480000,2007
9174,285000,862000,Brady Quinn,QB,active,cleveland-browns,1147000,2007
9175,503250,400000,Brodney Pool,S,active,cleveland-browns,903250,2007
9176,360000,475000,D'Qwell Jackson,ILB,active,cleveland-browns,835000,2007
9177,510000,270000,Sean Jones,S,active,cleveland-browns,780000,2007
9178,285000,328000,Eric Wright,CB,active,cleveland-browns,613000,2007
9179,510000,50000,Mike Adams,SS,active,cleveland-browns,560000,2007
9180,510000,32500,Jason Wright,RB,active,cleveland-browns,542500,2007
9181,360000,181000,Travis Wilson,WR,active,cleveland-browns,541000,2007
9182,510000,0,Colby Bockwoldt,OLB,active,cleveland-browns,510000,2007
9183,435000,47000,David McMillan,DE,active,cleveland-browns,482000,2007
9184,360000,112500,Leon Williams,LB,active,cleveland-browns,472500,2007
9185,360000,111000,Isaac Sowells,G,active,cleveland-browns,471000,2007
9186,435000,0,Derek Anderson,QB,active,cleveland-browns,435000,2007
9187,435000,0,Simon Fraser,DE,active,cleveland-browns,435000,2007
9188,435000,0,Daven Holly,CB,active,cleveland-browns,435000,2007
9189,360000,43500,Jerome Harrison,RB,active,cleveland-browns,403500,2007
9190,360000,24000,Lawrence Vickers,FB,active,cleveland-browns,384000,2007
9191,285000,48250,Brandon McDonald,CB,active,cleveland-browns,333250,2007
9192,295000,11716,Alex Hall,OLB,active,cleveland-browns,306716,2007
9193,285000,2000,Charles Ali,RB,active,cleveland-browns,287000,2007
9194,285000,0,Melila Purcell,DE,active,cleveland-browns,285000,2007
9195,135000,0,Greg Eslinger,C,active,cleveland-browns,135000,2007
9196,1150000,1100000,Ted Washington,DT,injured_reserve,cleveland-browns,2250000,2007
9197,600000,137500,Seth McKinney,G,injured_reserve,cleveland-browns,737500,2007
9198,3333334,0,Jamal Lewis,RB,dead_cap,cleveland-browns,3333334,2007
9199,0,3207138,Jeff Faine,C,dead_cap,cleveland-browns,3207138,2007
9200,0,1050000,Trent Dilfer,QB,dead_cap,cleveland-browns,1050000,2007
9201,0,1066668,William Green,RB,dead_cap,cleveland-browns,1066668,2007
9202,200000,0,Charlie Frye,QB,dead_cap,cleveland-browns,200000,2007
9203,116250,0,Antonio Perkins,CB,dead_cap,cleveland-browns,116250,2007
9204,71625,0,Babatunde Oshinowo,DT,dead_cap,cleveland-browns,71625,2007
9205,55000,0,Nick Speegle,LB,dead_cap,cleveland-browns,55000,2007
9206,41375,0,DeMario Minter,C,dead_cap,cleveland-browns,41375,2007
9207,28500,0,Joe Dunn,T,dead_cap,cleveland-browns,28500,2007
9208,21812,0,Melila Purcell,DE,dead_cap,cleveland-browns,21812,2007
9209,15300,0,Chase Pittman,DE,dead_cap,cleveland-browns,15300,2007
9210,13500,0,Justin Hamilton,RB,dead_cap,cleveland-browns,13500,2007
9211,11375,0,Syndric Steptoe,WR,dead_cap,cleveland-browns,11375,2007
9212,4000000,8110000,Joe Thomas,LT,active,cleveland-browns,12110000,2008
9213,1500000,1666667,Eric Steinbach,G,active,cleveland-browns,3166667,2008
9214,4350000,4737500,Braylon Edwards,WR,active,cleveland-browns,9087500,2008
9215,1400000,5100000,Jamal Lewis,RB,active,cleveland-browns,6500000,2008
9216,3764705,3423334,Kellen Winslow,TE,active,cleveland-browns,7188039,2008
9217,3000000,1225000,Andra Davis,LB,active,cleveland-browns,4225000,2008
9218,900000,666668,Willie McGinest,LB,active,cleveland-browns,1566668,2008
9219,1400000,2200000,Shaun Rogers,DT,active,cleveland-browns,3600000,2008
9220,950000,2383333,Derek Anderson,QB,active,cleveland-browns,3333333,2008
9221,605000,1083333,Corey Williams,DT,active,cleveland-browns,1688333,2008
9222,650000,1250000,Rex Hadnot,G,active,cleveland-browns,1900000,2008
9223,2145000,270000,Sean Jones,S,active,cleveland-browns,2415000,2008
9224,1750000,0,Shaun Smith,DT,active,cleveland-browns,1750000,2008
9225,445000,2742500,Kamerion Wimbley,OLB,active,cleveland-browns,3187500,2008
9226,1200000,570000,Dave Zastudil,P,active,cleveland-browns,1770000,2008
9227,950000,680000,Phil Dawson,K,active,cleveland-browns,1630000,2008
9228,1417000,0,Daven Holly,CB,active,cleveland-browns,1417000,2008
9229,605000,800000,Donte Stallworth,WR,active,cleveland-browns,1405000,2008
9230,603250,400000,Brodney Pool,S,active,cleveland-browns,1003250,2008
9231,620000,425000,Joshua Cribbs,WR,active,cleveland-browns,1045000,2008
9232,515000,475000,D'Qwell Jackson,ILB,active,cleveland-browns,990000,2008
9233,775000,0,Travis Daniels,S,active,cleveland-browns,775000,2008
9234,370000,290000,Eric Wright,CB,active,cleveland-browns,660000,2008
9235,605000,50000,Mike Adams,SS,active,cleveland-browns,655000,2008
9236,295000,10667,Allen Patrick,RB,active,cleveland-browns,305667,2008
9237,445000,112500,Leon Williams,LB,active,cleveland-browns,557500,2008
9238,445000,111000,Isaac Sowells,G,active,cleveland-browns,556000,2008
9239,520000,0,Hamza Abdullah,CB,active,cleveland-browns,520000,2008
9240,520000,0,Scott Young,G,active,cleveland-browns,520000,2008
9241,445000,43500,Jerome Harrison,RB,active,cleveland-browns,488500,2008
9242,445000,24000,Lawrence Vickers,FB,active,cleveland-browns,469000,2008
9243,605000,40000,Seth McKinney,G,active,cleveland-browns,645000,2008
9244,445000,0,Bruce Gradkowski,QB,active,cleveland-browns,445000,2008
9245,445000,0,Robert McCune,LB,active,cleveland-browns,445000,2008
9246,295000,123300,Beau Bell,LB,active,cleveland-browns,418300,2008
9247,370000,48250,Brandon McDonald,CB,active,cleveland-browns,418250,2008
9248,385000,11716,Alex Hall,OLB,active,cleveland-browns,396716,2008
9249,370000,0,Charles Ali,RB,active,cleveland-browns,370000,2008
9250,295000,23100,Ahtyba Rubin,DT,active,cleveland-browns,318100,2008
9251,295000,0,Syndric Steptoe,WR,active,cleveland-browns,295000,2008
9252,200000,0,Chase Pittman,DE,active,cleveland-browns,200000,2008
9253,34705,0,Paul Hubbard,WR,active,cleveland-browns,34705,2008
9254,295000,0,Richard Bartel,QB,active,cleveland-browns,295000,2008
9255,2300000,2066666,Ryan Tucker,T,injured_reserve,cleveland-browns,4366666,2008
9256,370000,2127500,Brady Quinn,QB,injured_reserve,cleveland-browns,2497500,2008
9257,927000,12500,Jason Wright,RB,injured_reserve,cleveland-browns,939500,2008
9258,119000,0,Paul Hubbard,WR,practice_squad,cleveland-browns,119000,2008
9259,88400,0,Christian Gaddis,C,practice_squad,cleveland-browns,88400,2008
9260,88400,0,David Holloway,LB,practice_squad,cleveland-browns,88400,2008
9261,200000,0,Charlie Frye,QB,dead_cap,cleveland-browns,200000,2008
9262,181000,0,Travis Wilson,WR,dead_cap,cleveland-browns,181000,2008
9263,116250,0,Antonio Perkins,CB,dead_cap,cleveland-browns,116250,2008
9264,82750,0,DeMario Minter,C,dead_cap,cleveland-browns,82750,2008
9265,65437,0,Melila Purcell,DE,dead_cap,cleveland-browns,65437,2008
9266,47000,0,David McMillan,DE,dead_cap,cleveland-browns,47000,2008
9267,45900,0,Chase Pittman,DE,dead_cap,cleveland-browns,45900,2008
9268,43352,0,Richard Bartel,QB,dead_cap,cleveland-browns,43352,2008
9269,34125,0,Syndric Steptoe,WR,dead_cap,cleveland-browns,34125,2008
9270,27000,0,Justin Hamilton,RB,dead_cap,cleveland-browns,27000,2008
9271,23200,0,Paul Hubbard,WR,dead_cap,cleveland-browns,23200,2008
9272,7000000,3460000,Joe Thomas,LT,active,cleveland-browns,10460000,2009
9273,1700000,1083333,Corey Williams,DT,active,cleveland-browns,2783333,2009
9274,1450000,7383333,Derek Anderson,QB,active,cleveland-browns,8833333,2009
9275,3600000,1666667,Eric Steinbach,G,active,cleveland-browns,5266667,2009
9276,2400000,3843750,Jamal Lewis,RB,active,cleveland-browns,6243750,2009
9277,745000,5250000,Donte Stallworth,WR,active,cleveland-browns,5995000,2009
9278,750000,1250000,Rex Hadnot,G,active,cleveland-browns,2000000,2009
9279,2000000,750000,C.J. Mosley,DT,active,cleveland-browns,2750000,2009
9280,2135000,400000,Brodney Pool,S,active,cleveland-browns,2535000,2009
9281,585000,2792500,Kamerion Wimbley,OLB,active,cleveland-browns,3377500,2009
9282,1400000,570000,Dave Zastudil,P,active,cleveland-browns,1970000,2009
9283,1370000,466667,Mike Adams,SS,active,cleveland-browns,1836667,2009
9284,1000000,630000,Phil Dawson,K,active,cleveland-browns,1630000,2009
9285,1150000,250000,Abram Elam,S,active,cleveland-browns,1400000,2009
9286,816000,500000,Alex Mack,C,active,cleveland-browns,1316000,2009
9287,640000,475000,D'Qwell Jackson,ILB,active,cleveland-browns,1115000,2009
9288,620000,425000,Joshua Cribbs,WR,active,cleveland-browns,1045000,2009
9289,745000,250000,Floyd Womack,G,active,cleveland-browns,995000,2009
9290,310000,531250,Brian Robiskie,WR,active,cleveland-browns,841250,2009
9291,460000,290000,Eric Wright,CB,active,cleveland-browns,750000,2009
9292,310000,357876,Mohamed Massaquoi,WR,active,cleveland-browns,667876,2009
9293,535000,43500,Jerome Harrison,RB,active,cleveland-browns,578500,2009
9294,535000,24000,Lawrence Vickers,FB,active,cleveland-browns,559000,2009
9295,460000,48250,Brandon McDonald,CB,active,cleveland-browns,508250,2009
9296,460000,0,Chansi Stuckey,WR,active,cleveland-browns,460000,2009
9297,460000,0,Jason Trusnik,ILB,active,cleveland-browns,460000,2009
9298,460000,0,Raymond Ventrone,S,active,cleveland-browns,460000,2009
9299,310000,129125,Kaluka Maiava,ILB,active,cleveland-browns,439125,2009
9300,385000,23100,Ahtyba Rubin,DT,active,cleveland-browns,408100,2009
9301,385000,0,Syndric Steptoe,WR,active,cleveland-browns,385000,2009
9302,310000,25125,Coye Francies,CB,active,cleveland-browns,335125,2009
9303,310000,24812,James Davis,RB,active,cleveland-browns,334812,2009
9304,310000,0,Thomas Brown,RB,active,cleveland-browns,310000,2009
9305,310000,0,Bo Ruud,LB,active,cleveland-browns,310000,2009
9306,145883,0,Marcus Benard,OLB,active,cleveland-browns,145883,2009
9307,109411,0,Scott Kooistra,T,active,cleveland-browns,109411,2009
9308,2400000,4755000,Shaun Rogers,DT,injured_reserve,cleveland-browns,7155000,2009
9309,850000,1066668,Ryan Tucker,T,injured_reserve,cleveland-browns,1916668,2009
9310,655000,2127500,Brady Quinn,QB,injured_reserve,cleveland-browns,2782500,2009
9311,88400,0,Marcus Benard,OLB,practice_squad,cleveland-browns,88400,2009
9312,88400,0,Jason Capizzi,T,practice_squad,cleveland-browns,88400,2009
9313,88400,0,Colin Cloherty,TE,practice_squad,cleveland-browns,88400,2009
9314,0,3787500,Braylon Edwards,WR,dead_cap,cleveland-browns,3787500,2009
9315,1390834,0,Kellen Winslow,TE,dead_cap,cleveland-browns,1390834,2009
9316,700000,0,Andra Davis,LB,dead_cap,cleveland-browns,700000,2009
9317,181000,0,Travis Wilson,WR,dead_cap,cleveland-browns,181000,2009
9318,123300,0,Beau Bell,LB,dead_cap,cleveland-browns,123300,2009
9319,112500,0,Leon Williams,LB,dead_cap,cleveland-browns,112500,2009
9320,111000,0,Isaac Sowells,G,dead_cap,cleveland-browns,111000,2009
9321,100000,0,Corey Ivy,CB,dead_cap,cleveland-browns,100000,2009
9322,69600,0,Paul Hubbard,WR,dead_cap,cleveland-browns,69600,2009
9323,11716,0,Alex Hall,OLB,dead_cap,cleveland-browns,11716,2009
9324,0,333,Marcus Benard,OLB,dead_cap,cleveland-browns,333,2009
9325,0,333,Phillip Hunt,DE,dead_cap,cleveland-browns,333,2009
9326,8000000,3960000,Joe Thomas,LT,active,cleveland-browns,11960000,2010
9327,6900000,2948750,Shaun Rogers,DT,active,cleveland-browns,9848750,2010
9328,5750000,1666667,Eric Steinbach,G,active,cleveland-browns,7416667,2010
9329,855000,5395000,Jake Delhomme,QB,active,cleveland-browns,6250000,2010
9330,4350000,1100000,Scott Fujita,LB,active,cleveland-browns,5450000,2010
9331,2500000,1666667,Sheldon Brown,CB,active,cleveland-browns,4166667,2010
9332,755000,2750000,Tony Pashos,RT,active,cleveland-browns,3505000,2010
9333,320000,2772000,Joe Haden,CB,active,cleveland-browns,3092000,2010
9334,445000,3630000,Alex Mack,C,active,cleveland-browns,4075000,2010
9335,688500,1850000,Joshua Cribbs,WR,active,cleveland-browns,2538500,2010
9336,350000,2116666,Benjamin Watson,TE,active,cleveland-browns,2466666,2010
9337,2000000,300000,Chris Gocong,LB,active,cleveland-browns,2300000,2010
9338,1370000,466667,Mike Adams,SS,active,cleveland-browns,1836667,2010
9339,1809000,0,Matt Roth,DE,active,cleveland-browns,1809000,2010
9340,1759000,0,Abram Elam,S,active,cleveland-browns,1759000,2010
9341,1759000,0,D'Qwell Jackson,ILB,active,cleveland-browns,1759000,2010
9342,1659000,0,Lawrence Vickers,FB,active,cleveland-browns,1659000,2010
9343,395000,1332000,Brian Robiskie,WR,active,cleveland-browns,1727000,2010
9344,1500000,0,Seneca Wallace,QB,active,cleveland-browns,1500000,2010
9345,1000000,470000,Phil Dawson,K,active,cleveland-browns,1470000,2010
9346,390000,357876,Mohamed Massaquoi,WR,active,cleveland-browns,747876,2010
9347,600000,525000,Raymond Ventrone,S,active,cleveland-browns,1125000,2010
9348,545000,250000,Reggie Hodges,P,active,cleveland-browns,795000,2010
9349,755000,250000,Floyd Womack,G,active,cleveland-browns,1005000,2010
9350,550000,291500,Eric Wright,CB,active,cleveland-browns,841500,2010
9351,302000,518750,T.J. Ward,SS,active,cleveland-browns,820750,2010
9352,630000,0,Alex Smith,TE,active,cleveland-browns,630000,2010
9353,390000,187750,Colt McCoy,QB,active,cleveland-browns,577750,2010
9354,320000,250000,Montario Hardesty,RB,active,cleveland-browns,570000,2010
9355,550000,0,Sabby Piscitelli,S,active,cleveland-browns,550000,2010
9356,550000,0,Chansi Stuckey,WR,active,cleveland-browns,550000,2010
9357,545000,0,Blake Costanzo,OLB,active,cleveland-browns,545000,2010
9358,395000,129125,Kaluka Maiava,ILB,active,cleveland-browns,524125,2010
9359,320000,174250,Shawn Lauvao,G,active,cleveland-browns,494250,2010
9360,470000,23100,Ahtyba Rubin,DT,active,cleveland-browns,493100,2010
9361,475000,0,Steve Vallos,C,active,cleveland-browns,475000,2010
9362,470000,0,Peyton Hillis,RB,active,cleveland-browns,470000,2010
9363,395000,0,Marcus Benard,OLB,active,cleveland-browns,395000,2010
9364,320000,28362,Carlton Mitchell,WR,active,cleveland-browns,348362,2010
9365,320000,0,Larry Asante,SS,active,cleveland-browns,320000,2010
9366,94117,0,Jordan Norwood,WR,active,cleveland-browns,94117,2010
9367,88400,0,Thomas Clayton,RB,practice_squad,cleveland-browns,88400,2010
9368,88400,0,Paul Fanaika,G,practice_squad,cleveland-browns,88400,2010
9369,62400,0,Jordan Norwood,WR,practice_squad,cleveland-browns,62400,2010
9370,0,5385000,Kamerion Wimbley,OLB,dead_cap,cleveland-browns,5385000,2010
9371,0,2333334,Derek Anderson,QB,dead_cap,cleveland-browns,2333334,2010
9372,1063750,0,Brady Quinn,QB,dead_cap,cleveland-browns,1063750,2010
9373,0,750000,Donte Stallworth,WR,dead_cap,cleveland-browns,750000,2010
9374,420000,0,Dave Zastudil,P,dead_cap,cleveland-browns,420000,2010
9375,246600,0,Beau Bell,LB,dead_cap,cleveland-browns,246600,2010
9376,96500,0,Brandon McDonald,CB,dead_cap,cleveland-browns,96500,2010
9377,75375,0,Coye Francies,CB,dead_cap,cleveland-browns,75375,2010
9378,0,42215,Larry Asante,SS,dead_cap,cleveland-browns,42215,2010
9379,0,26055,Clifton Geathers,DE,dead_cap,cleveland-browns,26055,2010
9380,11716,0,Alex Hall,OLB,dead_cap,cleveland-browns,11716,2010
9381,0,667,Marcus Benard,OLB,dead_cap,cleveland-browns,667,2010
9382,0,667,Phillip Hunt,DE,dead_cap,cleveland-browns,667,2010
9383,8000000,8560000,Joe Thomas,LT,active,cleveland-browns,16560000,2011
9384,6250000,1666667,Eric Steinbach,G,active,cleveland-browns,7916667,2011
9385,3100000,1666667,Sheldon Brown,CB,active,cleveland-browns,4766667,2011
9386,2558165,2413124,Joe Haden,CB,active,cleveland-browns,4971289,2011
9387,4750000,0,D'Qwell Jackson,ILB,active,cleveland-browns,4750000,2011
9388,2420000,2116666,Benjamin Watson,TE,active,cleveland-browns,4536666,2011
9389,3821000,612500,Chris Gocong,LB,active,cleveland-browns,4433500,2011
9390,685000,2915000,Dimitri Patterson,CB,active,cleveland-browns,3600000,2011
9391,2400000,1100000,Scott Fujita,LB,active,cleveland-browns,3500000,2011
9392,3250000,0,Phil Dawson,K,active,cleveland-browns,3250000,2011
9393,2550000,250000,Evan Moore,TE,active,cleveland-browns,2800000,2011
9394,2200000,600000,Tony Pashos,RT,active,cleveland-browns,2800000,2011
9395,1950000,666667,Seneca Wallace,QB,active,cleveland-browns,2616667,2011
9396,957000,1450000,Joshua Cribbs,WR,active,cleveland-browns,2407000,2011
9397,1750000,500000,Brandon Jackson,RB,active,cleveland-browns,2250000,2011
9398,600000,1398100,Ahtyba Rubin,DT,active,cleveland-browns,1998100,2011
9399,774000,2400000,Alex Mack,C,active,cleveland-browns,3174000,2011
9400,405000,1491750,T.J. Ward,SS,active,cleveland-browns,1896750,2011
9401,1550000,150000,Usama Young,S,active,cleveland-browns,1700000,2011
9402,1100000,466667,Mike Adams,SS,active,cleveland-browns,1566667,2011
9403,375000,1096500,Phil Taylor,DT,active,cleveland-browns,1471500,2011
9404,700000,525000,Raymond Ventrone,S,active,cleveland-browns,1225000,2011
9405,685000,250000,Reggie Hodges,P,active,cleveland-browns,935000,2011
9406,375000,550500,Jabaal Sheard,OLB,active,cleveland-browns,925500,2011
9407,525000,357876,Mohamed Massaquoi,WR,active,cleveland-browns,882876,2011
9408,685000,0,Alex Smith,TE,active,cleveland-browns,685000,2011
9409,405000,250000,Montario Hardesty,RB,active,cleveland-browns,655000,2011
9410,450000,187750,Colt McCoy,QB,active,cleveland-browns,637750,2011
9411,450000,174250,Shawn Lauvao,G,active,cleveland-browns,624250,2011
9412,480000,129125,Kaluka Maiava,ILB,active,cleveland-browns,609125,2011
9413,375000,230000,Greg Little,WR,active,cleveland-browns,605000,2011
9414,600000,0,Steve Vallos,C,active,cleveland-browns,600000,2011
9415,555000,0,Peyton Hillis,RB,active,cleveland-browns,555000,2011
9416,525000,0,Marcus Benard,OLB,active,cleveland-browns,525000,2011
9417,375000,119350,Jordan Cameron,TE,active,cleveland-browns,494350,2011
9418,375000,102000,Owen Marecic,FB,active,cleveland-browns,477000,2011
9419,450000,0,Jordan Norwood,WR,active,cleveland-browns,450000,2011
9420,405000,28362,Carlton Mitchell,WR,active,cleveland-browns,433362,2011
9421,375000,50500,Buster Skrine,CB,active,cleveland-browns,425500,2011
9422,375000,47000,Jason Pinkston,G,active,cleveland-browns,422000,2011
9423,375000,10100,Eric Hagg,S,active,cleveland-browns,385100,2011
9424,375000,5000,Quinton Spears,OLB,active,cleveland-browns,380000,2011
9425,375000,0,Colin Cochart,TE,active,cleveland-browns,375000,2011
9426,375000,0,Richmond Mcgee,P,active,cleveland-browns,375000,2011
9427,375000,0,Emmanuel Stephens,DE,active,cleveland-browns,375000,2011
9428,96900,0,Ben Jacobs,ILB,practice_squad,cleveland-browns,96900,2011
9429,96900,0,Jarrod Shaw,C,practice_squad,cleveland-browns,96900,2011
9430,0,2250000,Donte Stallworth,WR,dead_cap,cleveland-browns,2250000,2011
9431,1440000,0,Shaun Rogers,DT,dead_cap,cleveland-browns,1440000,2011
9432,0,800000,Jake Delhomme,QB,dead_cap,cleveland-browns,800000,2011
9433,750000,0,C.J. Mosley,DT,dead_cap,cleveland-browns,750000,2011
9434,0,126645,Larry Asante,SS,dead_cap,cleveland-browns,126645,2011
9435,0,78165,Clifton Geathers,DE,dead_cap,cleveland-browns,78165,2011
9436,29187,0,Don Carey,SS,dead_cap,cleveland-browns,29187,2011
9437,0,4000,James Dockery,CB,dead_cap,cleveland-browns,4000,2011
9438,0,666,Chris Matthews,WR,dead_cap,cleveland-browns,666,2011
9439,0,250,Ben Jacobs,ILB,dead_cap,cleveland-browns,250,2011
9440,10500000,3660000,Joe Thomas,LT,active,cleveland-browns,14160000,2012
9441,5680718,4413124,Joe Haden,CB,active,cleveland-browns,10093842,2012
9442,7700000,1675000,Ahtyba Rubin,DT,active,cleveland-browns,9375000,2012
9443,3400000,2800000,D'Qwell Jackson,ILB,active,cleveland-browns,6200000,2012
9444,3700000,1666667,Sheldon Brown,CB,active,cleveland-browns,5366667,2012
9445,4500000,512500,Chris Gocong,LB,active,cleveland-browns,5012500,2012
9446,2880000,2116666,Benjamin Watson,TE,active,cleveland-browns,4996666,2012
9447,2950000,1100000,Dimitri Patterson,CB,active,cleveland-browns,4050000,2012
9448,3810000,0,Phil Dawson,K,active,cleveland-browns,3810000,2012
9449,390000,3335250,Trent Richardson,RB,active,cleveland-browns,3725250,2012
9450,1903000,2500000,Alex Mack,C,active,cleveland-browns,4403000,2012
9451,1400000,0,Juqua Parker,DE,active,cleveland-browns,1400000,2012
9452,1438000,1250000,Joshua Cribbs,WR,active,cleveland-browns,2688000,2012
9453,1650000,500000,Brandon Jackson,RB,active,cleveland-browns,2150000,2012
9454,1000000,1000000,Frostee Rucker,DT,active,cleveland-browns,2000000,2012
9455,742875,1096500,Phil Taylor,DT,active,cleveland-browns,1839375,2012
9456,1550000,250000,Usama Young,S,active,cleveland-browns,1800000,2012
9457,390000,1079745,Brandon Weeden,QB,active,cleveland-browns,1469745,2012
9458,700000,658823,Josh Johnson,QB,active,cleveland-browns,1358823,2012
9459,700000,525000,Raymond Ventrone,S,active,cleveland-browns,1225000,2012
9460,556375,600500,Jabaal Sheard,OLB,active,cleveland-browns,1156875,2012
9461,490000,568750,T.J. Ward,SS,active,cleveland-browns,1058750,2012
9462,390000,564115,Josh Gordon,WR,active,cleveland-browns,954115,2012
9463,700000,250000,Reggie Hodges,P,active,cleveland-browns,950000,2012
9464,390000,550153,Mitchell Schwartz,RT,active,cleveland-browns,940153,2012
9465,850000,0,Alex Smith,TE,active,cleveland-browns,850000,2012
9466,725000,50000,Oniel Cousins,G,active,cleveland-browns,775000,2012
9467,725000,50000,John Greco,G,active,cleveland-browns,775000,2012
9468,476250,280000,Greg Little,WR,active,cleveland-browns,756250,2012
9469,490000,250000,Montario Hardesty,RB,active,cleveland-browns,740000,2012
9470,540000,187750,Colt McCoy,QB,active,cleveland-browns,727750,2012
9471,540000,174250,Shawn Lauvao,G,active,cleveland-browns,714250,2012
9472,565000,129125,Kaluka Maiava,ILB,active,cleveland-browns,694125,2012
9473,465000,119350,Jordan Cameron,TE,active,cleveland-browns,584350,2012
9474,465000,102000,Owen Marecic,FB,active,cleveland-browns,567000,2012
9475,540000,0,Stanley Daniels,G,active,cleveland-browns,540000,2012
9476,540000,0,Dan Gronkowski,TE,active,cleveland-browns,540000,2012
9477,540000,0,Chris Ogbonnaya,RB,active,cleveland-browns,540000,2012
9478,390000,136035,John Hughes,DE,active,cleveland-browns,526035,2012
9479,465000,50500,Buster Skrine,CB,active,cleveland-browns,515500,2012
9480,465000,47000,Jason Pinkston,G,active,cleveland-browns,512000,2012
9481,390000,119250,Travis Benjamin,WR,active,cleveland-browns,509250,2012
9482,465000,10100,Eric Hagg,S,active,cleveland-browns,475100,2012
9483,465000,0,Hall Davis,DE,active,cleveland-browns,465000,2012
9484,465000,0,Thaddeus Lewis,QB,active,cleveland-browns,465000,2012
9485,465000,0,Prince Miller,CB,active,cleveland-browns,465000,2012
9486,465000,0,Adrian Moten,LB,active,cleveland-browns,465000,2012
9487,465000,0,Jordan Norwood,WR,active,cleveland-browns,465000,2012
9488,390000,44633,Ryan Miller,RT,active,cleveland-browns,434633,2012
9489,390000,19670,Emmanuel Acho,ILB,active,cleveland-browns,409670,2012
9490,390000,19670,Billy Winn,DE,active,cleveland-browns,409670,2012
9491,390000,11472,Trevin Wade,CB,active,cleveland-browns,401472,2012
9492,390000,833,Johnson Bademosi,CB,active,cleveland-browns,390833,2012
9493,390000,500,Tashaun Gipson,FS,active,cleveland-browns,390500,2012
9494,390000,0,Dominic Alford,RT,active,cleveland-browns,390000,2012
9495,390000,0,Tank Carder,ILB,active,cleveland-browns,390000,2012
9496,390000,0,Josh Cooper,WR,active,cleveland-browns,390000,2012
9497,390000,0,L.J. Fort,ILB,active,cleveland-browns,390000,2012
9498,390000,0,Ishmaa'ily Kitchen,DT,active,cleveland-browns,390000,2012
9499,390000,0,Richmond Mcgee,P,active,cleveland-browns,390000,2012
9500,390000,0,Craig Robertson,ILB,active,cleveland-browns,390000,2012
9501,390000,0,Jarrod Shaw,C,active,cleveland-browns,390000,2012
9502,390000,0,Christian Yount,LS,active,cleveland-browns,390000,2012
9503,390000,0,Ronnie Cameron,DE,active,cleveland-browns,390000,2012
9504,390000,0,Brad Smelley,TE,active,cleveland-browns,390000,2012
9505,3650000,1100000,Scott Fujita,LB,injured_reserve,cleveland-browns,4750000,2012
9506,615000,357876,Mohamed Massaquoi,WR,injured_reserve,cleveland-browns,972876,2012
9507,540000,0,Brian Sanford,DE,injured_reserve,cleveland-browns,540000,2012
9508,540000,0,Eddie Williams,RB,injured_reserve,cleveland-browns,540000,2012
9509,390000,103977,James-Michael Johnson,OLB,injured_reserve,cleveland-browns,493977,2012
9510,465000,0,Auston English,DT,injured_reserve,cleveland-browns,465000,2012
9511,415000,0,Emmanuel Stephens,DE,injured_reserve,cleveland-browns,415000,2012
9512,1880000,0,Shaun Rogers,DT,dead_cap,cleveland-browns,1880000,2012
9513,1666667,0,Eric Steinbach,G,dead_cap,cleveland-browns,1666667,2012
9514,1062500,0,Brian Robiskie,WR,dead_cap,cleveland-browns,1062500,2012
9515,1000000,0,Dimitri Patterson,CB,dead_cap,cleveland-browns,1000000,2012
9516,500000,0,Tony Pashos,RT,dead_cap,cleveland-browns,500000,2012
9517,333334,0,Seneca Wallace,QB,dead_cap,cleveland-browns,333334,2012
9518,192187,0,Marcus Benard,OLB,dead_cap,cleveland-browns,192187,2012
9519,166667,0,Evan Moore,TE,dead_cap,cleveland-browns,166667,2012
9520,145312,0,Thaddeus Lewis,QB,dead_cap,cleveland-browns,145312,2012
9521,29187,0,Don Carey,SS,dead_cap,cleveland-browns,29187,2012
9522,0,28362,Carlton Mitchell,WR,dead_cap,cleveland-browns,28362,2012
9523,9334,8000,James Dockery,CB,dead_cap,cleveland-browns,17334,2012
9524,0,11472,Brad Smelley,TE,dead_cap,cleveland-browns,11472,2012
9525,10000,0,Quinton Spears,OLB,dead_cap,cleveland-browns,10000,2012
9526,0,1334,Chris Matthews,WR,dead_cap,cleveland-browns,1334,2012
9527,0,250,Ben Jacobs,ILB,dead_cap,cleveland-browns,250,2012
9528,10000000,1400000,Joe Thomas,LT,active,cleveland-browns,11400000,2013
9529,6936429,2256262,Joe Haden,CB,active,cleveland-browns,9192691,2013
9530,715000,7485000,Paul Kruger,OLB,active,cleveland-browns,8200000,2013
9531,2000000,6000000,Desmond Bryant,DE,active,cleveland-browns,8000000,2013
9532,6000000,1575000,Ahtyba Rubin,DT,active,cleveland-browns,7575000,2013
9533,3600000,2800000,D'Qwell Jackson,ILB,active,cleveland-browns,6400000,2013
9534,3732000,2500000,Alex Mack,C,active,cleveland-browns,6232000,2013
9535,405000,2567182,Barkevious Mingo,OLB,active,cleveland-browns,2972182,2013
9536,1110750,1096500,Phil Taylor,DT,active,cleveland-browns,2207250,2013
9537,715000,1375000,John Greco,G,active,cleveland-browns,2090000,2013
9538,757436,1079745,Brandon Weeden,QB,active,cleveland-browns,1837181,2013
9539,1500000,0,Jason Campbell,QB,active,cleveland-browns,1500000,2013
9540,1323000,174250,Shawn Lauvao,G,active,cleveland-browns,1497250,2013
9541,762750,625500,Jabaal Sheard,OLB,active,cleveland-browns,1388250,2013
9542,630000,568750,T.J. Ward,SS,active,cleveland-browns,1198750,2013
9543,625038,550153,Mitchell Schwartz,RT,active,cleveland-browns,1175191,2013
9544,558355,564115,Josh Gordon,WR,active,cleveland-browns,1122470,2013
9545,555000,500000,Christian Yount,LS,active,cleveland-browns,1055000,2013
9546,602500,305000,Greg Little,WR,active,cleveland-browns,907500,2013
9547,725000,75000,Oniel Cousins,G,active,cleveland-browns,800000,2013
9548,675000,100000,Chris Ogbonnaya,RB,active,cleveland-browns,775000,2013
9549,750000,0,Gary Barnidge,TE,active,cleveland-browns,750000,2013
9550,715000,0,Brian Hoyer,QB,active,cleveland-browns,715000,2013
9551,555000,119350,Jordan Cameron,TE,active,cleveland-browns,674350,2013
9552,480000,136035,John Hughes,DE,active,cleveland-browns,616035,2013
9553,555000,50500,Buster Skrine,CB,active,cleveland-browns,605500,2013
9554,555000,47000,Jason Pinkston,G,active,cleveland-browns,602000,2013
9555,480000,119250,Travis Benjamin,WR,active,cleveland-browns,599250,2013
9556,405000,167813,Leon McFadden,CB,active,cleveland-browns,572813,2013
9557,840000,0,Billy Cundiff,K,active,cleveland-browns,840000,2013
9558,555000,0,Dion Lewis,RB,active,cleveland-browns,555000,2013
9559,480000,19670,Billy Winn,DE,active,cleveland-browns,499670,2013
9560,829411,0,Willis McGahee,RB,active,cleveland-browns,829411,2013
9561,480000,833,Johnson Bademosi,CB,active,cleveland-browns,480833,2013
9562,480000,500,Tashaun Gipson,FS,active,cleveland-browns,480500,2013
9563,480000,0,Tank Carder,ILB,active,cleveland-browns,480000,2013
9564,480000,0,Ishmaa'ily Kitchen,DT,active,cleveland-browns,480000,2013
9565,480000,0,Craig Robertson,ILB,active,cleveland-browns,480000,2013
9566,405000,12848,Garrett Gilkey,G,active,cleveland-browns,417848,2013
9567,405000,11474,Armonty Bryant,DE,active,cleveland-browns,416474,2013
9568,405000,2000,Martin Wallace,LT,active,cleveland-browns,407000,2013
9569,405000,0,MarQueis Gray,TE,active,cleveland-browns,405000,2013
9570,405000,0,Paul Hazel,DE,active,cleveland-browns,405000,2013
9571,405000,0,Spencer Lanning,P,active,cleveland-browns,405000,2013
9572,405000,0,Eric Martin,ILB,active,cleveland-browns,405000,2013
9573,405000,0,Keavon Milton,T,active,cleveland-browns,405000,2013
9574,405000,0,Fozzy Whittaker,RB,active,cleveland-browns,405000,2013
9575,405000,0,Darius Eubanks,S,active,cleveland-browns,405000,2013
9576,405000,0,Jordan Poyer,FS,active,cleveland-browns,405000,2013
9577,405000,0,Reid Fragel,RT,active,cleveland-browns,405000,2013
9578,480000,0,Josh Cooper,WR,active,cleveland-browns,480000,2013
9579,480000,0,Andre Smith,TE,active,cleveland-browns,480000,2013
9580,405000,0,Alex Tanney,QB,active,cleveland-browns,405000,2013
9581,405000,0,Julian Posey,CB,active,cleveland-browns,405000,2013
9582,405000,0,Brian Tyms,WR,active,cleveland-browns,405000,2013
9583,405000,0,Edwin Baker,RB,active,cleveland-browns,405000,2013
9584,555000,0,Brian Sanford,DE,active,cleveland-browns,555000,2013
9585,715000,585000,Quentin Groves,OLB,injured_reserve,cleveland-browns,1300000,2013
9586,405000,1666,Brandon Bogotay,K,injured_reserve,cleveland-browns,406666,2013
9587,405000,1666,Josh Aubrey,SS,injured_reserve,cleveland-browns,406666,2013
9588,405000,0,Brandon Magee,ILB,injured_reserve,cleveland-browns,405000,2013
9589,2683334,0,Davone Bess,WR,non_fb_injury,cleveland-browns,2683334,2013
9590,288000,3333,Chris Faulk,LT,non_fb_injury,cleveland-browns,291333,2013
9591,405000,0,Charles Johnson,WR,non_fb_injury,cleveland-browns,405000,2013
9592,303882,0,Patrick Lewis,C,practice_squad,cleveland-browns,303882,2013
9593,96000,0,Terrence Frederick,CB,practice_squad,cleveland-browns,96000,2013
9594,18000,0,Kip Edwards,CB,practice_squad,cleveland-browns,18000,2013
9595,18000,0,Caylin Hauptmann,G,practice_squad,cleveland-browns,18000,2013
9596,12000,0,Reggie Dunn,WR,practice_squad,cleveland-browns,12000,2013
9597,6000,0,Arceto Clark,WR,practice_squad,cleveland-browns,6000,2013
9598,4000000,0,Frostee Rucker,DT,dead_cap,cleveland-browns,4000000,2013
9599,3490703,0,Trent Richardson,RB,dead_cap,cleveland-browns,3490703,2013
9600,1000000,0,Dimitri Patterson,CB,dead_cap,cleveland-browns,1000000,2013
9601,882353,0,Christopher Owens,CB,dead_cap,cleveland-browns,882353,2013
9602,666668,0,Seneca Wallace,QB,dead_cap,cleveland-browns,666668,2013
9603,0,625000,Chris Gocong,LB,dead_cap,cleveland-browns,625000,2013
9604,555000,0,Rashad Butler,LT,dead_cap,cleveland-browns,555000,2013
9605,135296,250000,Montario Hardesty,RB,dead_cap,cleveland-browns,385296,2013
9606,208588,0,Brandon Magee,ILB,dead_cap,cleveland-browns,208588,2013
9607,197647,0,Bobby Rainey,RB,dead_cap,cleveland-browns,197647,2013
9608,195412,0,Armanti Edwards,WR,dead_cap,cleveland-browns,195412,2013
9609,187750,0,Colt McCoy,QB,dead_cap,cleveland-browns,187750,2013
9610,150000,0,Usama Young,S,dead_cap,cleveland-browns,150000,2013
9611,148940,0,Josh Cooper,WR,dead_cap,cleveland-browns,148940,2013
9612,125118,0,Brian Tyms,WR,dead_cap,cleveland-browns,125118,2013
9613,103977,0,James-Michael Johnson,OLB,dead_cap,cleveland-browns,103977,2013
9614,0,102000,Owen Marecic,FB,dead_cap,cleveland-browns,102000,2013
9615,95471,0,Tori Gurley,WR,dead_cap,cleveland-browns,95471,2013
9616,89824,0,Julian Posey,CB,dead_cap,cleveland-browns,89824,2013
9617,59010,0,Emmanuel Acho,ILB,dead_cap,cleveland-browns,59010,2013
9618,54000,0,Jamaine Cook,RB,dead_cap,cleveland-browns,54000,2013
9619,54000,0,Jeremiah Warren,C,dead_cap,cleveland-browns,54000,2013
9620,44633,0,Ryan Miller,RT,dead_cap,cleveland-browns,44633,2013
9621,42000,0,Darius Eubanks,S,dead_cap,cleveland-browns,42000,2013
9622,42000,0,Dennis Johnson,RB,dead_cap,cleveland-browns,42000,2013
9623,0,34416,Brad Smelley,TE,dead_cap,cleveland-browns,34416,2013
9624,32647,0,Caleb Hanie,QB,dead_cap,cleveland-browns,32647,2013
9625,30000,0,Justin Staples,OLB,dead_cap,cleveland-browns,30000,2013
9626,28556,0,Jamoris Slaughter,S,dead_cap,cleveland-browns,28556,2013
9627,0,28362,Carlton Mitchell,WR,dead_cap,cleveland-browns,28362,2013
9628,25000,0,Evan Moore,TE,dead_cap,cleveland-browns,25000,2013
9629,25000,0,David Nelson,WR,dead_cap,cleveland-browns,25000,2013
9630,20200,0,Eric Hagg,S,dead_cap,cleveland-browns,20200,2013
9631,20000,0,Shayne Graham,K,dead_cap,cleveland-browns,20000,2013
9632,11472,0,Trevin Wade,CB,dead_cap,cleveland-browns,11472,2013
9633,6000,0,Jonathan Stewart,OLB,dead_cap,cleveland-browns,6000,2013
9634,4000,0,James Dockery,CB,dead_cap,cleveland-browns,4000,2013
9635,3000,0,Aaron Adams,G,dead_cap,cleveland-browns,3000,2013
9636,1667,0,Caylin Hauptmann,G,dead_cap,cleveland-browns,1667,2013
9637,1000,0,Braxston Cave,C,dead_cap,cleveland-browns,1000,2013
9638,333,0,Cordell Roberson,WR,dead_cap,cleveland-browns,333,2013
9639,10900000,1400000,Joe Thomas,LT,active,cleveland-browns,12300000,2014
9640,6678193,5556264,Joe Haden,CB,active,cleveland-browns,12234457,2014
9641,10000000,0,Alex Mack,C,active,cleveland-browns,10000000,2014
9642,7000000,1200000,Paul Kruger,OLB,active,cleveland-browns,8200000,2014
9643,6600000,1575000,Ahtyba Rubin,DT,active,cleveland-browns,8175000,2014
9644,2000000,3800000,Andrew Hawkins,WR,active,cleveland-browns,5800000,2014
9645,4000000,1500000,Karlos Dansby,ILB,active,cleveland-browns,5500000,2014
9646,2000000,2250000,Donte Whitner,SS,active,cleveland-browns,4250000,2014
9647,3000000,1000000,Desmond Bryant,DE,active,cleveland-browns,4000000,2014
9648,495000,3220228,Barkevious Mingo,OLB,active,cleveland-browns,3715228,2014
9649,750000,1825125,Phil Taylor,DT,active,cleveland-browns,2575125,2014
9650,730000,1700000,John Greco,G,active,cleveland-browns,2430000,2014
9651,420000,1913364,Justin Gilbert,CB,active,cleveland-browns,2333364,2014
9652,1700000,300000,Miles Austin,WR,active,cleveland-browns,2000000,2014
9653,1350000,300000,Jim Dray,TE,active,cleveland-browns,1650000,2014
9654,994125,625500,Jabaal Sheard,OLB,active,cleveland-browns,1619625,2014
9655,855000,725000,Paul McQuistan,LT,active,cleveland-browns,1580000,2014
9656,1431000,119350,Jordan Cameron,TE,active,cleveland-browns,1550350,2014
9657,1431000,50500,Buster Skrine,CB,active,cleveland-browns,1481500,2014
9658,835076,575153,Mitchell Schwartz,RT,active,cleveland-browns,1410229,2014
9659,1000000,250000,Brian Hoyer,QB,active,cleveland-browns,1250000,2014
9660,1150000,0,Gary Barnidge,TE,active,cleveland-browns,1150000,2014
9661,420000,573036,Joel Bitonio,G,active,cleveland-browns,993036,2014
9662,291390,614115,Josh Gordon,WR,active,cleveland-browns,905505,2014
9663,570000,136035,John Hughes,DE,active,cleveland-browns,706035,2014
9664,570000,119250,Travis Benjamin,WR,active,cleveland-browns,689250,2014
9665,645000,0,Nick McDonald,C,active,cleveland-browns,645000,2014
9666,645000,0,Christian Yount,LS,active,cleveland-browns,645000,2014
9667,570000,19670,Billy Winn,DE,active,cleveland-browns,589670,2014
9668,420000,165625,Christian Kirksey,ILB,active,cleveland-browns,585625,2014
9669,570000,834,Johnson Bademosi,CB,active,cleveland-browns,570834,2014
9670,570000,500,Tashaun Gipson,FS,active,cleveland-browns,570500,2014
9671,855000,0,Jim Leonhard,S,active,cleveland-browns,855000,2014
9672,570000,0,Tank Carder,ILB,active,cleveland-browns,570000,2014
9673,570000,0,Craig Robertson,ILB,active,cleveland-browns,570000,2014
9674,420000,131850,Terrance West,RB,active,cleveland-browns,551850,2014
9675,420000,101903,Pierre Desir,CB,active,cleveland-browns,521903,2014
9676,495000,16375,Armonty Bryant,DE,active,cleveland-browns,511375,2014
9677,495000,0,Spencer Lanning,P,active,cleveland-browns,495000,2014
9678,495000,0,Jordan Poyer,FS,active,cleveland-browns,495000,2014
9679,687059,0,Marlon Moore,WR,active,cleveland-browns,687059,2014
9680,420000,3333,Isaiah Crowell,RB,active,cleveland-browns,423333,2014
9681,420000,0,Taylor Gabriel,WR,active,cleveland-browns,420000,2014
9682,420000,0,Jamie Meder,DE,active,cleveland-browns,420000,2014
9683,420000,0,Robert Nelson,CB,active,cleveland-browns,420000,2014
9684,420000,0,Vinston Painter,RT,active,cleveland-browns,420000,2014
9685,420000,0,K'Waun Williams,CB,active,cleveland-browns,420000,2014
9686,420000,0,Glenn Winston,RB,active,cleveland-browns,420000,2014
9687,645000,0,Sione Fua,DT,active,cleveland-browns,645000,2014
9688,495000,0,Rodney Smith,WR,active,cleveland-browns,495000,2014
9689,320294,0,Ryan Seymour,G,active,cleveland-browns,320294,2014
9690,318000,0,Michael Bowie,RT,active,cleveland-browns,318000,2014
9691,570000,0,Shaun Draughn,RB,active,cleveland-browns,570000,2014
9692,730000,0,Garret Hartley,K,active,cleveland-browns,730000,2014
9693,570000,0,Scott Solomon,OLB,active,cleveland-browns,570000,2014
9694,420000,0,Andrew McDonald,RT,active,cleveland-browns,420000,2014
9695,730000,0,Tyler Thigpen,QB,active,cleveland-browns,730000,2014
9696,420000,0,Phil Bates,WR,active,cleveland-browns,420000,2014
9697,420000,0,Charley Hughlett,LS,active,cleveland-browns,420000,2014
9698,420000,0,Connor Shaw,QB,active,cleveland-browns,420000,2014
9699,420000,1079745,Johnny Manziel,QB,injured_reserve,cleveland-browns,1499745,2014
9700,570000,0,Ishmaa'ily Kitchen,DT,injured_reserve,cleveland-browns,570000,2014
9701,333000,0,Andre Smith,TE,injured_reserve,cleveland-browns,333000,2014
9702,318000,0,Darius Eubanks,S,injured_reserve,cleveland-browns,318000,2014
9703,107100,0,Karim Barton,G,practice_squad,cleveland-browns,107100,2014
9704,107100,0,Connor Shaw,QB,practice_squad,cleveland-browns,107100,2014
9705,100800,0,Calvin Barnett,DT,practice_squad,cleveland-browns,100800,2014
9706,75600,0,Braxston Cave,C,practice_squad,cleveland-browns,75600,2014
9707,69300,0,Kevin Cone,WR,practice_squad,cleveland-browns,69300,2014
9708,37800,0,Jacobbi McDaniel,DT,practice_squad,cleveland-browns,37800,2014
9709,31500,0,Keith Pough,OLB,practice_squad,cleveland-browns,31500,2014
9710,18900,0,Kendall James,CB,practice_squad,cleveland-browns,18900,2014
9711,6300,0,Christian Tupou,DT,practice_squad,cleveland-browns,6300,2014
9712,6670836,0,Trent Richardson,RB,dead_cap,cleveland-browns,6670836,2014
9713,4204362,0,Brandon Weeden,QB,dead_cap,cleveland-browns,4204362,2014
9714,4200000,0,D'Qwell Jackson,ILB,dead_cap,cleveland-browns,4200000,2014
9715,647058,1125000,Ben Tate,RB,dead_cap,cleveland-browns,1772058,2014
9716,635000,0,Billy Cundiff,K,dead_cap,cleveland-browns,635000,2014
9717,321176,0,Ray Agnew,FB,dead_cap,cleveland-browns,321176,2014
9718,303588,0,Isaiah Trufant,CB,dead_cap,cleveland-browns,303588,2014
9719,230000,0,Greg Little,WR,dead_cap,cleveland-browns,230000,2014
9720,207954,0,James-Michael Johnson,OLB,dead_cap,cleveland-browns,207954,2014
9721,0,177813,Leon McFadden,CB,dead_cap,cleveland-browns,177813,2014
9722,172941,0,Gerell Robinson,WR,dead_cap,cleveland-browns,172941,2014
9723,145588,0,Laron Byrd,WR,dead_cap,cleveland-browns,145588,2014
9724,134117,0,Zac Diles,ILB,dead_cap,cleveland-browns,134117,2014
9725,118218,0,Kiero Small,FB,dead_cap,cleveland-browns,118218,2014
9726,112412,0,Keith Pough,OLB,dead_cap,cleveland-browns,112412,2014
9727,0,102000,Owen Marecic,FB,dead_cap,cleveland-browns,102000,2014
9728,0,100000,Quentin Groves,OLB,dead_cap,cleveland-browns,100000,2014
9729,89266,0,Ryan Miller,RT,dead_cap,cleveland-browns,89266,2014
9730,85818,0,Jamoris Slaughter,S,dead_cap,cleveland-browns,85818,2014
9731,81406,0,Jacobbi McDaniel,DT,dead_cap,cleveland-browns,81406,2014
9732,79118,0,Ryan Seymour,G,dead_cap,cleveland-browns,79118,2014
9733,56700,0,Allen Bradford,ILB,dead_cap,cleveland-browns,56700,2014
9734,50400,0,Phil Bates,WR,dead_cap,cleveland-browns,50400,2014
9735,50400,0,Christian Tupou,DT,dead_cap,cleveland-browns,50400,2014
9736,50000,0,Rex Grossman,QB,dead_cap,cleveland-browns,50000,2014
9737,0,47000,Jason Pinkston,G,dead_cap,cleveland-browns,47000,2014
9738,33529,0,Aaron Berry,CB,dead_cap,cleveland-browns,33529,2014
9739,31500,0,Patrick Lewis,C,dead_cap,cleveland-browns,31500,2014
9740,31500,0,L'Damian Washington,WR,dead_cap,cleveland-browns,31500,2014
9741,25200,1666,Calvin Barnett,DT,dead_cap,cleveland-browns,26866,2014
9742,25200,0,Scott Solomon,OLB,dead_cap,cleveland-browns,25200,2014
9743,22944,0,Trevin Wade,CB,dead_cap,cleveland-browns,22944,2014
9744,20000,0,Charles Johnson,WR,dead_cap,cleveland-browns,20000,2014
9745,18900,0,Lee Doss,WR,dead_cap,cleveland-browns,18900,2014
9746,18900,0,A.J. Pataialiim,DT,dead_cap,cleveland-browns,18900,2014
9747,0,12848,Garrett Gilkey,G,dead_cap,cleveland-browns,12848,2014
9748,12600,0,James Brown,G,dead_cap,cleveland-browns,12600,2014
9749,6300,0,Marcus Cromartie,CB,dead_cap,cleveland-browns,6300,2014
9750,6300,0,Charley Hughlett,LS,dead_cap,cleveland-browns,6300,2014
9751,6300,0,Ifeanyi Momah,TE,dead_cap,cleveland-browns,6300,2014
9752,6300,0,Emmanuel Ogbuehi,TE,dead_cap,cleveland-browns,6300,2014
9753,6300,0,Ryan Otten,TE,dead_cap,cleveland-browns,6300,2014
9754,6300,0,D.J. Smith,ILB,dead_cap,cleveland-browns,6300,2014
9755,6300,0,Justin Staples,OLB,dead_cap,cleveland-browns,6300,2014
9756,6000,0,Aaron Adams,G,dead_cap,cleveland-browns,6000,2014
9757,0,5000,Anthony Dima,RT,dead_cap,cleveland-browns,5000,2014
9758,0,5000,Michael Phillip,RT,dead_cap,cleveland-browns,5000,2014
9759,0,3334,Jonathan Krause,WR,dead_cap,cleveland-browns,3334,2014
9760,3334,0,Brandon Bogotay,K,dead_cap,cleveland-browns,3334,2014
9761,3334,0,Caylin Hauptmann,G,dead_cap,cleveland-browns,3334,2014
9762,0,3333,Chris Faulk,LT,dead_cap,cleveland-browns,3333,2014
9763,0,2000,Chandler Jones,WR,dead_cap,cleveland-browns,2000,2014
9764,0,2000,Martin Wallace,LT,dead_cap,cleveland-browns,2000,2014
9765,2000,0,Braxston Cave,C,dead_cap,cleveland-browns,2000,2014
9766,2000,0,Dave Kruger,DE,dead_cap,cleveland-browns,2000,2014
9767,0,1666,Josh Aubrey,SS,dead_cap,cleveland-browns,1666,2014
9768,0,1666,Connor Shaw,QB,dead_cap,cleveland-browns,1666,2014
9769,0,1666,Willie Snead,WR,dead_cap,cleveland-browns,1666,2014
9770,1334,0,Travis Tannahill,TE,dead_cap,cleveland-browns,1334,2014
9771,667,0,Cordell Roberson,WR,dead_cap,cleveland-browns,667,2014
9772,0,333,Darwin Cook,CB,dead_cap,cleveland-browns,333,2014
9773,8800000,1400000,Joe Thomas,LT,active,cleveland-browns,10200000,2015
9774,7000000,1200000,Paul Kruger,OLB,active,cleveland-browns,8200000,2015
9775,8000000,0,Alex Mack,C,active,cleveland-browns,8000000,2015
9776,6000000,1000000,Desmond Bryant,DE,active,cleveland-browns,7000000,2015
9777,4500000,2250000,Donte Whitner,SS,active,cleveland-browns,6750000,2015
9778,3700000,2800000,Tramon Williams,CB,active,cleveland-browns,6500000,2015
9779,4000000,1500000,Karlos Dansby,ILB,active,cleveland-browns,5500000,2015
9780,2650000,1850000,Dwayne Bowe,WR,active,cleveland-browns,4500000,2015
9781,585000,3873273,Barkevious Mingo,OLB,active,cleveland-browns,4458273,2015
9782,1750000,1218750,Randy Starks,DE,active,cleveland-browns,2968750,2015
9783,1003341,1913364,Justin Gilbert,CB,active,cleveland-browns,2916705,2015
9784,2356000,0,Tashaun Gipson,FS,active,cleveland-browns,2356000,2015
9785,2356000,0,Craig Robertson,ILB,active,cleveland-browns,2356000,2015
9786,435000,1692939,Danny Shelton,DT,active,cleveland-browns,2127939,2015
9787,2050000,0,Andy Lee,P,active,cleveland-browns,2050000,2015
9788,1200000,812500,Gary Barnidge,TE,active,cleveland-browns,2012500,2015
9789,1600000,300000,Jim Dray,TE,active,cleveland-browns,1900000,2015
9790,794936,1079745,Johnny Manziel,QB,active,cleveland-browns,1874681,2015
9791,435000,1279375,Cameron Erving,G,active,cleveland-browns,1714375,2015
9792,1095114,550153,Mitchell Schwartz,RT,active,cleveland-browns,1645267,2015
9793,1542000,0,Johnson Bademosi,CB,active,cleveland-browns,1542000,2015
9794,860000,636035,John Hughes,DE,active,cleveland-browns,1496035,2015
9795,800000,166666,Austin Davis,QB,active,cleveland-browns,966666,2015
9796,780000,86666,Marlon Moore,WR,active,cleveland-browns,866666,2015
9797,435000,377055,Nate Orchard,OLB,active,cleveland-browns,812055,2015
9798,660000,119250,Travis Benjamin,WR,active,cleveland-browns,779250,2015
9799,542000,165625,Christian Kirksey,ILB,active,cleveland-browns,707625,2015
9800,660000,0,Tank Carder,ILB,active,cleveland-browns,660000,2015
9801,660000,0,Austin Pasztor,T,active,cleveland-browns,660000,2015
9802,660000,0,Scott Solomon,OLB,active,cleveland-browns,660000,2015
9803,435000,177523,Duke Johnson,RB,active,cleveland-browns,612523,2015
9804,510000,101903,Pierre Desir,CB,active,cleveland-browns,611903,2015
9805,585000,16375,Armonty Bryant,DE,active,cleveland-browns,601375,2015
9806,585000,0,Michael Bowie,RT,active,cleveland-browns,585000,2015
9807,585000,0,Jordan Poyer,FS,active,cleveland-browns,585000,2015
9808,435000,148071,Xavier Cooper,DE,active,cleveland-browns,583071,2015
9809,435000,128002,Ibraheim Campbell,SS,active,cleveland-browns,563002,2015
9810,510000,3333,Isaiah Crowell,RB,active,cleveland-browns,513333,2015
9811,510000,0,Taylor Gabriel,WR,active,cleveland-browns,510000,2015
9812,510000,0,K'Waun Williams,CB,active,cleveland-browns,510000,2015
9813,447529,0,Glenn Winston,RB,active,cleveland-browns,447529,2015
9814,435000,0,E.J. Bibbs,TE,active,cleveland-browns,435000,2015
9815,435000,0,Travis Coons,K,active,cleveland-browns,435000,2015
9816,435000,0,Charley Hughlett,LS,active,cleveland-browns,435000,2015
9817,435000,0,Jamie Meder,DE,active,cleveland-browns,435000,2015
9818,412941,0,Don Jones,FS,active,cleveland-browns,412941,2015
9819,379941,30534,Charles Gaines,CB,active,cleveland-browns,410475,2015
9820,318000,0,Connor Shaw,QB,active,cleveland-browns,318000,2015
9821,194117,0,Terrelle Pryor,WR,active,cleveland-browns,194117,2015
9822,102352,0,Darrian Miller,T,active,cleveland-browns,102352,2015
9823,76764,0,Rannell Hall,WR,active,cleveland-browns,76764,2015
9824,76764,0,Kaleb Johnson,T,active,cleveland-browns,76764,2015
9825,76764,0,Raheem Mostert,RB,active,cleveland-browns,76764,2015
9826,51176,0,Darius Jennings,WR,active,cleveland-browns,51176,2015
9827,34411,0,Pat Devlin,QB,active,cleveland-browns,34411,2015
9828,30000,0,Cam Johnson,OLB,active,cleveland-browns,30000,2015
9829,8300000,3400000,Joe Haden,CB,injured_reserve,cleveland-browns,11700000,2015
9830,4000000,1000000,Andrew Hawkins,WR,injured_reserve,cleveland-browns,5000000,2015
9831,2250000,1666666,Josh McCown,QB,injured_reserve,cleveland-browns,3916666,2015
9832,2825000,0,John Greco,G,injured_reserve,cleveland-browns,2825000,2015
9833,1500000,750000,Brian Hartline,WR,injured_reserve,cleveland-browns,2250000,2015
9834,668259,573036,Joel Bitonio,G,injured_reserve,cleveland-browns,1241295,2015
9835,407470,29862,Malcolm Johnson,FB,injured_reserve,cleveland-browns,437332,2015
9836,1000000,760000,Robert Housler,TE,dead_cap,cleveland-browns,1760000,2015
9837,966529,0,Phil Taylor,DT,dead_cap,cleveland-browns,966529,2015
9838,0,750000,Ben Tate,RB,dead_cap,cleveland-browns,750000,2015
9839,0,375000,Paul McQuistan,LT,dead_cap,cleveland-browns,375000,2015
9840,350000,0,Nate Burleson,WR,dead_cap,cleveland-browns,350000,2015
9841,349411,0,Robert Turbin,RB,dead_cap,cleveland-browns,349411,2015
9842,0,335626,Leon McFadden,CB,dead_cap,cleveland-browns,335626,2015
9843,232941,0,Shaun Draughn,RB,dead_cap,cleveland-browns,232941,2015
9844,177246,0,Jayson Dimanche,ILB,dead_cap,cleveland-browns,177246,2015
9845,151164,1666,Darrian Miller,T,dead_cap,cleveland-browns,152830,2015
9846,0,131850,Terrance West,RB,dead_cap,cleveland-browns,131850,2015
9847,130376,0,Darius Jennings,WR,dead_cap,cleveland-browns,130376,2015
9848,124588,0,De'Ante Saunders,FS,dead_cap,cleveland-browns,124588,2015
9849,0,120788,Vince Mayle,WR,dead_cap,cleveland-browns,120788,2015
9850,99000,0,Erle Ladson,LT,dead_cap,cleveland-browns,99000,2015
9851,92400,0,Cam Johnson,OLB,dead_cap,cleveland-browns,92400,2015
9852,85800,0,Kendall James,CB,dead_cap,cleveland-browns,85800,2015
9853,85800,0,Ty Zimmerman,SS,dead_cap,cleveland-browns,85800,2015
9854,85800,0,Dylan Wynn,DT,dead_cap,cleveland-browns,85800,2015
9855,79200,0,Garth Gerhart,C,dead_cap,cleveland-browns,79200,2015
9856,46200,19810,Hayes Pullard,ILB,dead_cap,cleveland-browns,66010,2015
9857,66000,0,Chance Casey,CB,dead_cap,cleveland-browns,66000,2015
9858,59400,0,Ronald Patrick,C,dead_cap,cleveland-browns,59400,2015
9859,41011,0,Daryl Richardson,RB,dead_cap,cleveland-browns,41011,2015
9860,38823,0,Terrelle Pryor,WR,dead_cap,cleveland-browns,38823,2015
9861,34411,0,Gabe Ikard,C,dead_cap,cleveland-browns,34411,2015
9862,33000,0,Dan France,G,dead_cap,cleveland-browns,33000,2015
9863,26400,0,Ray Drew,DE,dead_cap,cleveland-browns,26400,2015
9864,26400,0,Tim Scott,SS,dead_cap,cleveland-browns,26400,2015
9865,0,25696,Garrett Gilkey,G,dead_cap,cleveland-browns,25696,2015
9866,25200,0,Scott Solomon,OLB,dead_cap,cleveland-browns,25200,2015
9867,19800,0,Brian Leonhardt,TE,dead_cap,cleveland-browns,19800,2015
9868,19800,0,Andrew McDonald,RT,dead_cap,cleveland-browns,19800,2015
9869,0,19670,Billy Winn,DE,dead_cap,cleveland-browns,19670,2015
9870,13200,0,Matt Blanchard,QB,dead_cap,cleveland-browns,13200,2015
9871,13200,0,Conor Bofeli,G,dead_cap,cleveland-browns,13200,2015
9872,0,6667,Jonathan Krause,WR,dead_cap,cleveland-browns,6667,2015
9873,6600,0,Sean Baker,FS,dead_cap,cleveland-browns,6600,2015
9874,6600,0,Kelcy Quarles,DT,dead_cap,cleveland-browns,6600,2015
9875,0,4000,Chandler Jones,WR,dead_cap,cleveland-browns,4000,2015
9876,0,3334,Calvin Barnett,DT,dead_cap,cleveland-browns,3334,2015
9877,0,3334,Chris Faulk,LT,dead_cap,cleveland-browns,3334,2015
9878,0,3334,Connor Shaw,QB,dead_cap,cleveland-browns,3334,2015
9879,0,3334,Willie Snead,WR,dead_cap,cleveland-browns,3334,2015
9880,0,2000,Martin Wallace,LT,dead_cap,cleveland-browns,2000,2015
9881,0,1668,Josh Aubrey,SS,dead_cap,cleveland-browns,1668,2015
9882,0,667,Darwin Cook,CB,dead_cap,cleveland-browns,667,2015
9883,10100000,3300000,Joe Haden,CB,active,cleveland-browns,13400000,2016
9884,8300000,1200000,Joe Thomas,LT,active,cleveland-browns,9500000,2016
9885,6200000,781250,Tramon Williams,CB,active,cleveland-browns,6981250,2016
9886,3250000,1984375,Robert Griffin III,QB,active,cleveland-browns,5234375,2016
9887,4375000,666666,Josh McCown,QB,active,cleveland-browns,5041666,2016
9888,2100000,1100000,Demario Davis,ILB,active,cleveland-browns,3200000,2016
9889,966985,1692939,Danny Shelton,DT,active,cleveland-browns,2659924,2016
9890,1500000,1062500,Gary Barnidge,TE,active,cleveland-browns,2562500,2016
9891,863594,1279375,Cameron Erving,G,active,cleveland-browns,2142969,2016
9892,450000,1669090,Corey Coleman,WR,active,cleveland-browns,2119090,2016
9893,1200000,700000,Stephen Paea,DT,active,cleveland-browns,1900000,2016
9894,1700000,0,Britton Colquitt,P,active,cleveland-browns,1700000,2016
9895,1671000,0,Austin Pasztor,T,active,cleveland-browns,1671000,2016
9896,1671000,0,Terrelle Pryor,WR,active,cleveland-browns,1671000,2016
9897,899475,750000,Jamar Taylor,CB,active,cleveland-browns,1649475,2016
9898,450000,751753,Emmanuel Ogbah,DE,active,cleveland-browns,1201753,2016
9899,900000,200000,Tank Carder,ILB,active,cleveland-browns,1100000,2016
9900,1000000,0,Andrew Hawkins,WR,active,cleveland-browns,1000000,2016
9901,1068406,0,Josh Gordon,WR,active,cleveland-browns,1068406,2016
9902,650000,165625,Christian Kirksey,ILB,active,cleveland-browns,815625,2016
9903,545000,187523,Duke Johnson,RB,active,cleveland-browns,732523,2016
9904,532000,148071,Xavier Cooper,DE,active,cleveland-browns,680071,2016
9905,450000,222438,Carl Nassib,DE,active,cleveland-browns,672438,2016
9906,525000,128002,Ibraheim Campbell,SS,active,cleveland-browns,653002,2016
9907,450000,196884,Shon Coleman,T,active,cleveland-browns,646884,2016
9908,450000,166197,Cody Kessler,QB,active,cleveland-browns,616197,2016
9909,450000,158489,Joe Schobert,OLB,active,cleveland-browns,608489,2016
9910,600000,3334,Isaiah Crowell,RB,active,cleveland-browns,603334,2016
9911,600000,0,Marcus Burley,CB,active,cleveland-browns,600000,2016
9912,450000,141962,Ricardo Louis,WR,active,cleveland-browns,591962,2016
9913,450000,95848,Seth Devalve,TE,active,cleveland-browns,545848,2016
9914,525000,0,George Atkinson,RB,active,cleveland-browns,525000,2016
9915,525000,0,Charley Hughlett,LS,active,cleveland-browns,525000,2016
9916,525000,0,Jamie Meder,DE,active,cleveland-browns,525000,2016
9917,450000,51912,Spencer Drango,G,active,cleveland-browns,501912,2016
9918,450000,46096,Rashard Higgins,WR,active,cleveland-browns,496096,2016
9919,494117,0,Cody Parkey,K,active,cleveland-browns,494117,2016
9920,485928,0,Jamie Collins,OLB,active,cleveland-browns,485928,2016
9921,450000,29384,Randall Telfer,TE,active,cleveland-browns,479384,2016
9922,450000,5833,Dominque Alexander,ILB,active,cleveland-browns,455833,2016
9923,450000,3000,Tracy Howard,CB,active,cleveland-browns,453000,2016
9924,450000,0,Briean Boddy-Calhoun,CB,active,cleveland-browns,450000,2016
9925,450000,0,Tyrone Holmes,DE,active,cleveland-browns,450000,2016
9926,450000,0,Tyvis Powell,S,active,cleveland-browns,450000,2016
9927,432348,0,Cam Johnson,OLB,active,cleveland-browns,432348,2016
9928,339705,0,Ed Reynolds,FS,active,cleveland-browns,339705,2016
9929,317640,0,Kevin Hogan,QB,active,cleveland-browns,317640,2016
9930,317640,0,Dan Vitale,FB,active,cleveland-browns,317640,2016
9931,308823,0,Gabe Ikard,C,active,cleveland-browns,308823,2016
9932,105880,0,Anthony Fabiano,T,active,cleveland-browns,105880,2016
9933,92646,0,Mario Alford,WR,active,cleveland-browns,92646,2016
9934,92646,0,Gabe Wright,DT,active,cleveland-browns,92646,2016
9935,79410,0,Darius Jackson,RB,active,cleveland-browns,79410,2016
9936,52940,0,Trey Caldwell,S,active,cleveland-browns,52940,2016
9937,26470,0,Terrell Watson,RB,active,cleveland-browns,26470,2016
9938,2925000,0,John Greco,G,injured_reserve,cleveland-browns,2925000,2016
9939,916518,573036,Joel Bitonio,G,injured_reserve,cleveland-browns,1489554,2016
9940,638014,377055,Nate Orchard,OLB,injured_reserve,cleveland-browns,1015069,2016
9941,675000,0,Jordan Poyer,FS,injured_reserve,cleveland-browns,675000,2016
9942,600000,0,Glenn Winston,RB,injured_reserve,cleveland-browns,600000,2016
9943,397050,0,Austin Reiter,C,injured_reserve,cleveland-browns,397050,2016
9944,348000,0,Rannell Hall,WR,injured_reserve,cleveland-browns,348000,2016
9945,348000,0,Rajion Neal,RB,injured_reserve,cleveland-browns,348000,2016
9946,333000,0,Nile Lawrence-Stample,DT,injured_reserve,cleveland-browns,333000,2016
9947,333000,0,Dennis Parks,WR,injured_reserve,cleveland-browns,333000,2016
9948,333000,0,Dylan Wynn,DT,injured_reserve,cleveland-browns,333000,2016
9949,1250000,1000000,Desmond Bryant,DE,non_fb_injury,cleveland-browns,2250000,2016
9950,450000,124839,Derrick Kindred,S,non_fb_injury,cleveland-browns,574839,2016
9951,2850000,1750000,Dwayne Bowe,WR,dead_cap,cleveland-browns,4600000,2016
9952,0,4526319,Barkevious Mingo,OLB,dead_cap,cleveland-browns,4526319,2016
9953,0,4500000,Donte Whitner,SS,dead_cap,cleveland-browns,4500000,2016
9954,2173997,2159490,Johnny Manziel,QB,dead_cap,cleveland-browns,4333487,2016
9955,0,3000000,Karlos Dansby,ILB,dead_cap,cleveland-browns,3000000,2016
9956,2400000,500000,John Hughes,DE,dead_cap,cleveland-browns,2900000,2016
9957,0,2713364,Justin Gilbert,CB,dead_cap,cleveland-browns,2713364,2016
9958,0,1200000,Paul Kruger,OLB,dead_cap,cleveland-browns,1200000,2016
9959,0,750000,Brian Hartline,WR,dead_cap,cleveland-browns,750000,2016
9960,0,625000,Randy Starks,DE,dead_cap,cleveland-browns,625000,2016
9961,564116,0,Corey Lemonier,OLB,dead_cap,cleveland-browns,564116,2016
9962,476470,0,Jonathan Cooper,G,dead_cap,cleveland-browns,476470,2016
9963,393270,15175,Scooby Wright,ILB,dead_cap,cleveland-browns,408445,2016
9964,0,400000,Rahim Moore,FS,dead_cap,cleveland-browns,400000,2016
9965,393176,0,Don Jones,FS,dead_cap,cleveland-browns,393176,2016
9966,0,362364,Vince Mayle,WR,dead_cap,cleveland-browns,362364,2016
9967,308820,0,Patrick Murray,K,dead_cap,cleveland-browns,308820,2016
9968,0,300000,Jim Dray,TE,dead_cap,cleveland-browns,300000,2016
9969,0,263700,Terrance West,RB,dead_cap,cleveland-browns,263700,2016
9970,216176,29862,Malcolm Johnson,FB,dead_cap,cleveland-browns,246038,2016
9971,216510,0,Gabe Wright,DT,dead_cap,cleveland-browns,216510,2016
9972,195580,0,Connor Hamlett,TE,dead_cap,cleveland-browns,195580,2016
9973,173823,0,Charlie Whitehurst,QB,dead_cap,cleveland-browns,173823,2016
9974,0,166666,Austin Davis,QB,dead_cap,cleveland-browns,166666,2016
9975,103500,46096,Trey Caldwell,S,dead_cap,cleveland-browns,149596,2016
9976,132350,0,Joe Callahan,QB,dead_cap,cleveland-browns,132350,2016
9977,110400,0,Josh Boyce,WR,dead_cap,cleveland-browns,110400,2016
9978,109270,0,Anthony Fabiano,T,dead_cap,cleveland-browns,109270,2016
9979,0,101903,Pierre Desir,CB,dead_cap,cleveland-browns,101903,2016
9980,95470,0,Darius Hillary,CB,dead_cap,cleveland-browns,95470,2016
9981,0,86666,Marlon Moore,WR,dead_cap,cleveland-browns,86666,2016
9982,82800,0,Dan France,G,dead_cap,cleveland-browns,82800,2016
9983,75900,0,Jordan Leslie,WR,dead_cap,cleveland-browns,75900,2016
9984,66740,0,Trae Elston,S,dead_cap,cleveland-browns,66740,2016
9985,0,59430,Hayes Pullard,ILB,dead_cap,cleveland-browns,59430,2016
9986,55200,0,Terrence Magee,RT,dead_cap,cleveland-browns,55200,2016
9987,48300,0,Terrell Watson,RB,dead_cap,cleveland-browns,48300,2016
9988,0,42976,Ifo Ekpre-Olomu,CB,dead_cap,cleveland-browns,42976,2016
9989,41400,0,Ed Reynolds,FS,dead_cap,cleveland-browns,41400,2016
9990,39705,0,Matt McCants,RT,dead_cap,cleveland-browns,39705,2016
9991,34500,0,Kevin Hogan,QB,dead_cap,cleveland-browns,34500,2016
9992,0,30534,Charles Gaines,CB,dead_cap,cleveland-browns,30534,2016
9993,27600,0,Justin Currie,SS,dead_cap,cleveland-browns,27600,2016
9994,27600,0,Darius Jennings,WR,dead_cap,cleveland-browns,27600,2016
9995,27600,0,Zach Sterup,T,dead_cap,cleveland-browns,27600,2016
9996,20700,0,Trevon Coley,DT,dead_cap,cleveland-browns,20700,2016
9997,20700,0,Michael Liedtke,G,dead_cap,cleveland-browns,20700,2016
9998,20700,0,Mitch Mathews,WR,dead_cap,cleveland-browns,20700,2016
9999,13800,0,E.J. Bibbs,TE,dead_cap,cleveland-browns,13800,2016
10000,13800,0,James Burgess,ILB,dead_cap,cleveland-browns,13800,2016
10001,13800,0,J.P. Holtz,TE,dead_cap,cleveland-browns,13800,2016
10002,13800,0,Michael Palardy,K,dead_cap,cleveland-browns,13800,2016
10003,6900,0,Kaleb Johnson,T,dead_cap,cleveland-browns,6900,2016
10004,2500,2500,Mike Matthews,C,dead_cap,cleveland-browns,5000,2016
10005,0,3334,Darrian Miller,T,dead_cap,cleveland-browns,3334,2016
10006,0,1666,A.J. Stamps,S,dead_cap,cleveland-browns,1666,2016
10007,3164777,9073036,Joel Bitonio,G,active,cleveland-browns,12237813,2017
10008,6000000,2400000,Kevin Zeitler,G,active,cleveland-browns,8400000,2017
10009,465000,5064501,Myles Garrett,DE,active,cleveland-browns,5529501,2017
10010,3797000,1365625,Christian Kirksey,ILB,active,cleveland-browns,5162625,2017
10011,2000000,1609375,J.C. Tretter,C,active,cleveland-browns,3609375,2017
10012,2500000,775000,Jamar Taylor,CB,active,cleveland-browns,3275000,2017
10013,1498970,1692939,Danny Shelton,DT,active,cleveland-browns,3191909,2017
10014,1650000,1500000,Britton Colquitt,P,active,cleveland-browns,3150000,2017
10015,2746000,0,Isaiah Crowell,RB,active,cleveland-browns,2746000,2017
10016,979773,1669090,Corey Coleman,WR,active,cleveland-browns,2648863,2017
10017,1500000,843750,Jason McCourty,CB,active,cleveland-browns,2343750,2017
10018,465000,1415361,Jabrill Peppers,S,active,cleveland-browns,1880361,2017
10019,1777000,20000,Marcus Martin,G,active,cleveland-browns,1797000,2017
10020,465000,1266835,David Njoku,TE,active,cleveland-browns,1731835,2017
10021,615000,850000,Charley Hughlett,LS,active,cleveland-browns,1465000,2017
10022,841028,377055,Nate Orchard,OLB,active,cleveland-browns,1218083,2017
10023,465000,434712,DeShone Kizer,QB,active,cleveland-browns,899712,2017
10024,618110,222438,Carl Nassib,DE,active,cleveland-browns,840548,2017
10025,642500,187523,Duke Johnson,RB,active,cleveland-browns,830023,2017
10026,568000,216884,Shon Coleman,T,active,cleveland-browns,784884,2017
10027,604049,166197,Cody Kessler,QB,active,cleveland-browns,770246,2017
10028,465000,245391,Larry Ogunjobi,DT,active,cleveland-browns,710391,2017
10029,540000,158489,Joe Schobert,OLB,active,cleveland-browns,698489,2017
10030,540000,141962,Ricardo Louis,WR,active,cleveland-browns,681962,2017
10031,540000,95848,Seth Devalve,TE,active,cleveland-browns,635848,2017
10032,615000,0,Sammie Coates,WR,active,cleveland-browns,615000,2017
10033,540000,51912,Spencer Drango,G,active,cleveland-browns,591912,2017
10034,540000,29384,Randall Telfer,TE,active,cleveland-browns,569384,2017
10035,540000,0,Briean Boddy-Calhoun,CB,active,cleveland-browns,540000,2017
10036,540000,0,Kevin Hogan,QB,active,cleveland-browns,540000,2017
10037,540000,0,Mike Jordan,CB,active,cleveland-browns,540000,2017
10038,540000,0,Austin Reiter,C,active,cleveland-browns,540000,2017
10039,540000,0,Dan Vitale,FB,active,cleveland-browns,540000,2017
10040,465000,44993,Caleb Brantley,DT,active,cleveland-browns,509993,2017
10041,508224,0,Rashard Higgins,WR,active,cleveland-browns,508224,2017
10042,465000,22289,Zane Gonzalez,K,active,cleveland-browns,487289,2017
10043,465000,16067,Matt Dayes,RB,active,cleveland-browns,481067,2017
10044,465000,0,Zach Banner,T,active,cleveland-browns,465000,2017
10045,465000,0,B.J. Bello,ILB,active,cleveland-browns,465000,2017
10046,465000,0,James Burgess,ILB,active,cleveland-browns,465000,2017
10047,465000,0,Trevon Coley,DT,active,cleveland-browns,465000,2017
10048,465000,0,Kai Nacua,S,active,cleveland-browns,465000,2017
10049,1068406,0,Josh Gordon,WR,active,cleveland-browns,1068406,2017
10050,325588,0,Josh Keyes,ILB,active,cleveland-browns,325588,2017
10051,317647,0,Matt Lengel,TE,active,cleveland-browns,317647,2017
10052,289412,0,Derron Smith,SS,active,cleveland-browns,289412,2017
10053,136765,0,Lavar Edwards,DE,active,cleveland-browns,136765,2017
10054,109412,0,Justin Currie,SS,active,cleveland-browns,109412,2017
10055,95294,0,Matt Hazel,WR,active,cleveland-browns,95294,2017
10056,95294,0,C.J. Smith,CB,active,cleveland-browns,95294,2017
10057,82059,0,Geoff Gray,T,active,cleveland-browns,82059,2017
10058,63530,0,Jeremy Cash,OLB,active,cleveland-browns,63530,2017
10059,27353,0,Marquez Williams,FB,active,cleveland-browns,27353,2017
10060,8800000,4950000,Joe Thomas,LT,injured_reserve,cleveland-browns,13750000,2017
10061,4750000,7350000,Jamie Collins,OLB,injured_reserve,cleveland-browns,12100000,2017
10062,750438,751753,Emmanuel Ogbah,DE,injured_reserve,cleveland-browns,1502191,2017
10063,1200000,200000,Tank Carder,ILB,injured_reserve,cleveland-browns,1400000,2017
10064,540000,124839,Derrick Kindred,S,injured_reserve,cleveland-browns,664839,2017
10065,615000,0,Jamie Meder,DE,injured_reserve,cleveland-browns,615000,2017
10066,348000,66739,Roderick Johnson,T,injured_reserve,cleveland-browns,414739,2017
10067,404648,5833,Dominque Alexander,ILB,injured_reserve,cleveland-browns,410481,2017
10068,363000,0,Chris Barker,G,injured_reserve,cleveland-browns,363000,2017
10069,363000,0,Darius Jackson,RB,injured_reserve,cleveland-browns,363000,2017
10070,355231,0,Reggie Porter,CB,injured_reserve,cleveland-browns,355231,2017
10071,43200,0,Jacob Hagen,FS,practice_squad,cleveland-browns,43200,2017
10072,15225000,0,Brock Osweiler,QB,dead_cap,cleveland-browns,15225000,2017
10073,4000000,3300000,Joe Haden,CB,dead_cap,cleveland-browns,7300000,2017
10074,4000000,1625000,Kenny Britt,WR,dead_cap,cleveland-browns,5625000,2017
10075,0,1913364,Justin Gilbert,CB,dead_cap,cleveland-browns,1913364,2017
10076,0,1750000,Robert Griffin III,QB,dead_cap,cleveland-browns,1750000,2017
10077,0,1625000,Gary Barnidge,TE,dead_cap,cleveland-browns,1625000,2017
10078,0,1500000,John Hughes,DE,dead_cap,cleveland-browns,1500000,2017
10079,0,1279375,Cameron Erving,G,dead_cap,cleveland-browns,1279375,2017
10080,0,1200000,Paul Kruger,OLB,dead_cap,cleveland-browns,1200000,2017
10081,0,1000000,Desmond Bryant,DE,dead_cap,cleveland-browns,1000000,2017
10082,0,1000000,Demario Davis,ILB,dead_cap,cleveland-browns,1000000,2017
10083,0,666667,Alvin Bailey,G,dead_cap,cleveland-browns,666667,2017
10084,0,666667,Josh McCown,QB,dead_cap,cleveland-browns,666667,2017
10085,434118,128002,Ibraheim Campbell,SS,dead_cap,cleveland-browns,562120,2017
10086,528064,0,T.Y. McGill,DT,dead_cap,cleveland-browns,528064,2017
10087,0,500000,Tramon Williams,CB,dead_cap,cleveland-browns,500000,2017
10088,353648,0,Deon King,OLB,dead_cap,cleveland-browns,353648,2017
10089,273529,80000,Matt McCants,RT,dead_cap,cleveland-browns,353529,2017
10090,323930,0,Kasen Williams,WR,dead_cap,cleveland-browns,323930,2017
10091,317647,0,Bryce Treggs,WR,dead_cap,cleveland-browns,317647,2017
10092,216424,0,Tyrone Holmes,DE,dead_cap,cleveland-browns,216424,2017
10093,201565,0,Darius Hillary,CB,dead_cap,cleveland-browns,201565,2017
10094,0,166668,Austin Davis,QB,dead_cap,cleveland-browns,166668,2017
10095,0,148071,Xavier Cooper,DE,dead_cap,cleveland-browns,148071,2017
10096,0,138289,Trey Caldwell,S,dead_cap,cleveland-browns,138289,2017
10097,0,101903,Pierre Desir,CB,dead_cap,cleveland-browns,101903,2017
10098,100800,0,Bug Howard,WR,dead_cap,cleveland-browns,100800,2017
10099,93600,0,Austin Calitro,ILB,dead_cap,cleveland-browns,93600,2017
10100,93600,0,C.J. Smith,CB,dead_cap,cleveland-browns,93600,2017
10101,86400,0,Travis Averill,T,dead_cap,cleveland-browns,86400,2017
10102,31765,46096,Rashard Higgins,WR,dead_cap,cleveland-browns,77861,2017
10103,75176,0,Jordan Leslie,WR,dead_cap,cleveland-browns,75176,2017
10104,72000,0,Terrence Magee,RT,dead_cap,cleveland-browns,72000,2017
10105,72000,0,Victor Salako,T,dead_cap,cleveland-browns,72000,2017
10106,0,66668,Marlon Moore,WR,dead_cap,cleveland-browns,66668,2017
10107,64800,0,Rannell Hall,WR,dead_cap,cleveland-browns,64800,2017
10108,64800,0,Zach Sterup,T,dead_cap,cleveland-browns,64800,2017
10109,64800,0,Andrew Wylie,T,dead_cap,cleveland-browns,64800,2017
10110,0,61068,Charles Gaines,CB,dead_cap,cleveland-browns,61068,2017
10111,0,61000,Jordan Payton,WR,dead_cap,cleveland-browns,61000,2017
10112,0,59724,Malcolm Johnson,FB,dead_cap,cleveland-browns,59724,2017
10113,54706,0,Reginald Davis III,WR,dead_cap,cleveland-browns,54706,2017
10114,50400,0,Josh Rounds,RB,dead_cap,cleveland-browns,50400,2017
10115,45588,0,B.W. Webb,CB,dead_cap,cleveland-browns,45588,2017
10116,0,45528,Scooby Wright,ILB,dead_cap,cleveland-browns,45528,2017
10117,36000,0,J.P. Holtz,TE,dead_cap,cleveland-browns,36000,2017
10118,36000,0,Korren Kirven,T,dead_cap,cleveland-browns,36000,2017
10119,31765,0,Brandon Wilds,RB,dead_cap,cleveland-browns,31765,2017
10120,27353,0,Justin Currie,SS,dead_cap,cleveland-browns,27353,2017
10121,21600,0,Laurence Gibson,T,dead_cap,cleveland-browns,21600,2017
10122,14400,0,Trevon Hartfield,S,dead_cap,cleveland-browns,14400,2017
10123,14400,0,Matt Lengel,TE,dead_cap,cleveland-browns,14400,2017
10124,14400,0,Najee Murray,CB,dead_cap,cleveland-browns,14400,2017
10125,14400,0,Channing Stribling,CB,dead_cap,cleveland-browns,14400,2017
10126,7200,0,C.J. Board,WR,dead_cap,cleveland-browns,7200,2017
10127,7200,0,Garrett Sickels,OLB,dead_cap,cleveland-browns,7200,2017
10128,7200,0,Ian Silberman,G,dead_cap,cleveland-browns,7200,2017
10129,7200,0,Jhaustin Thomas,DT,dead_cap,cleveland-browns,7200,2017
10130,7200,0,Marquez Williams,FB,dead_cap,cleveland-browns,7200,2017
10131,0,6000,Tracy Howard,CB,dead_cap,cleveland-browns,6000,2017
10132,0,5000,Mike Matthews,C,dead_cap,cleveland-browns,5000,2017
10133,0,3334,A.J. Stamps,S,dead_cap,cleveland-browns,3334,2017
10134,0,2000,Nile Lawrence-Stample,DT,dead_cap,cleveland-browns,2000,2017
10135,10000000,6000000,Tyrod Taylor,QB,active,cleveland-browns,16000000,2018
10136,3500000,12000000,Jarvis Landry,WR,active,cleveland-browns,15500000,2018
10137,10650000,1750000,Jamie Collins,OLB,active,cleveland-browns,12400000,2018
10138,10000000,2400000,Kevin Zeitler,G,active,cleveland-browns,12400000,2018
10139,1847375,5064501,Myles Garrett,DE,active,cleveland-browns,6911876,2018
10140,5000000,1750000,J.C. Tretter,C,active,cleveland-browns,6750000,2018
10141,5500000,500000,Joel Bitonio,G,active,cleveland-browns,6000000,2018
10142,480000,5462360,Baker Mayfield,QB,active,cleveland-browns,5942360,2018
10143,2500000,3300000,Chris Hubbard,RT,active,cleveland-browns,5800000,2018
10144,480000,4822792,Denzel Ward,CB,active,cleveland-browns,5302792,2018
10145,2000000,3300000,Travis Carrie,CB,active,cleveland-browns,5300000,2018
10146,957000,2937523,Duke Johnson,RB,active,cleveland-browns,3894523,2018
10147,1150000,2450000,Darren Fells,TE,active,cleveland-browns,3600000,2018
10148,1000000,1666666,Chris Smith,DE,active,cleveland-browns,2666666,2018
10149,2550000,0,Britton Colquitt,P,active,cleveland-browns,2550000,2018
10150,1500000,966666,Terrance Mitchell,CB,active,cleveland-browns,2466666,2018
10151,935090,1415361,Jabrill Peppers,SS,active,cleveland-browns,2350451,2018
10152,1150000,1115625,Drew Stanton,QB,active,cleveland-browns,2265625,2018
10153,897959,1266835,David Njoku,TE,active,cleveland-browns,2164794,2018
10154,1050876,751753,Emmanuel Ogbah,DE,active,cleveland-browns,1802629,2018
10155,1090381,424037,Damarious Randall,FS,active,cleveland-browns,1514418,2018
10156,480000,896000,Austin Corbett,G,active,cleveland-browns,1376000,2018
10157,480000,862381,Nick Chubb,RB,active,cleveland-browns,1342381,2018
10158,950000,0,Earl Watford,RT,active,cleveland-browns,950000,2018
10159,642500,245391,Larry Ogunjobi,DT,active,cleveland-browns,887891,2018
10160,790000,0,Greg Robinson,LT,active,cleveland-browns,790000,2018
10161,630000,158489,Joe Schobert,ILB,active,cleveland-browns,788489,2018
10162,630000,124839,Derrick Kindred,S,active,cleveland-browns,754839,2018
10163,480000,262235,Chad Thomas,DE,active,cleveland-browns,742235,2018
10164,630000,95848,Seth Devalve,TE,active,cleveland-browns,725848,2018
10165,720750,0,Carl Davis,DT,active,cleveland-browns,720750,2018
10166,705000,0,Charley Hughlett,LS,active,cleveland-browns,705000,2018
10167,480000,179463,Antonio Callaway,WR,active,cleveland-browns,659463,2018
10168,630000,0,Briean Boddy-Calhoun,CB,active,cleveland-browns,630000,2018
10169,630000,0,Rashard Higgins,WR,active,cleveland-browns,630000,2018
10170,630000,0,Anthony Zettel,DE,active,cleveland-browns,630000,2018
10171,588235,0,Ray-Ray Armstrong,OLB,active,cleveland-browns,588235,2018
10172,555000,0,Trevon Coley,DT,active,cleveland-browns,555000,2018
10173,480000,72236,Genard Avery,ILB,active,cleveland-browns,552236,2018
10174,480000,48466,Damion Ratley,WR,active,cleveland-browns,528466,2018
10175,518812,0,Brian Price,DT,active,cleveland-browns,518812,2018
10176,497647,0,Breshad Perriman,WR,active,cleveland-browns,497647,2018
10177,480000,6666,Desmond Harrison,LT,active,cleveland-browns,486666,2018
10178,480000,0,Tavierre Thomas,S,active,cleveland-browns,480000,2018
10179,423529,0,D’Juan Hines,LB,active,cleveland-browns,423529,2018
10180,423529,0,Greg Joseph,K,active,cleveland-browns,423529,2018
10181,338820,0,Dontrell Hilliard,RB,active,cleveland-browns,338820,2018
10182,296471,0,Phillip Gaines,CB,active,cleveland-browns,296471,2018
10183,296471,0,Juston Burris,CB,active,cleveland-browns,296471,2018
10184,261176,0,Jermaine Whitehead,FS,active,cleveland-browns,261176,2018
10185,163235,0,Kyle Kalis,T,active,cleveland-browns,163235,2018
10186,97941,0,Xavier Woodson-Luster,ILB,active,cleveland-browns,97941,2018
10187,28235,0,Blake Jackson,WR,active,cleveland-browns,28235,2018
10188,5000000,1200000,Christian Kirksey,OLB,injured_reserve,cleveland-browns,6200000,2018
10189,1750000,1781250,E.J. Gaines,CB,injured_reserve,cleveland-browns,3531250,2018
10190,630000,141962,Ricardo Louis,WR,injured_reserve,cleveland-browns,771962,2018
10191,790000,0,Orson Charles,FB,injured_reserve,cleveland-browns,790000,2018
10192,544587,0,Tanner Vallejo,OLB,injured_reserve,cleveland-browns,544587,2018
10193,378000,151751,Howard Wilson,CB,injured_reserve,cleveland-browns,529751,2018
10194,397399,833,Derrick Willies,WR,injured_reserve,cleveland-browns,398232,2018
10195,790000,0,Rod Streater,WR,injured_reserve,cleveland-browns,790000,2018
10196,363000,0,Lenny Jones,DE,injured_reserve,cleveland-browns,363000,2018
10197,282350,0,Pharaoh Brown,TE,injured_reserve,cleveland-browns,282350,2018
10198,0,4875000,Kenny Britt,WR,dead_cap,cleveland-browns,4875000,2018
10199,0,3200000,Joe Haden,CB,dead_cap,cleveland-browns,3200000,2018
10200,0,2000000,Jamar Taylor,CB,dead_cap,cleveland-browns,2000000,2018
10201,529412,1416667,Carlos Hyde,RB,dead_cap,cleveland-browns,1946079,2018
10202,0,1692941,Danny Shelton,DT,dead_cap,cleveland-browns,1692941,2018
10203,0,1669090,Corey Coleman,WR,dead_cap,cleveland-browns,1669090,2018
10204,0,1304136,DeShone Kizer,QB,dead_cap,cleveland-browns,1304136,2018
10205,0,1279375,Cameron Erving,G,dead_cap,cleveland-browns,1279375,2018
10206,0,1000000,Donald Stephenson,LT,dead_cap,cleveland-browns,1000000,2018
10207,0,750000,Joe Thomas,LT,dead_cap,cleveland-browns,750000,2018
10208,0,625000,Jason McCourty,CB,dead_cap,cleveland-browns,625000,2018
10209,0,500000,Mychal Kendricks,OLB,dead_cap,cleveland-browns,500000,2018
10210,0,377055,Nate Orchard,OLB,dead_cap,cleveland-browns,377055,2018
10211,370588,0,Denzel Rice,CB,dead_cap,cleveland-browns,370588,2018
10212,342153,0,Montrel Meander,S,dead_cap,cleveland-browns,342153,2018
10213,0,332394,Cody Kessler,QB,dead_cap,cleveland-browns,332394,2018
10214,246580,0,Da'Mari Scott,WR,dead_cap,cleveland-browns,246580,2018
10215,239976,0,Devaroe Lawrence,DT,dead_cap,cleveland-browns,239976,2018
10216,0,222438,Carl Nassib,DE,dead_cap,cleveland-browns,222438,2018
10217,222354,0,Dan Vitale,FB,dead_cap,cleveland-browns,222354,2018
10218,218118,0,James Burgess,ILB,dead_cap,cleveland-browns,218118,2018
10219,0,216884,Shon Coleman,T,dead_cap,cleveland-browns,216884,2018
10220,0,148071,Xavier Cooper,DE,dead_cap,cleveland-browns,148071,2018
10221,129200,0,Brad Seaton,T,dead_cap,cleveland-browns,129200,2018
10222,0,128004,Ibraheim Campbell,SS,dead_cap,cleveland-browns,128004,2018
10223,0,122000,Jordan Payton,WR,dead_cap,cleveland-browns,122000,2018
10224,0,100000,Jeff Janis,WR,dead_cap,cleveland-browns,100000,2018
10225,98800,0,Daniel Ekuale,DT,dead_cap,cleveland-browns,98800,2018
10226,92942,0,Josh Gordon,WR,dead_cap,cleveland-browns,92942,2018
10227,0,92193,Rashard Higgins,WR,dead_cap,cleveland-browns,92193,2018
10228,91200,0,Kyle Kalis,T,dead_cap,cleveland-browns,91200,2018
10229,65294,22289,Zane Gonzalez,K,dead_cap,cleveland-browns,87583,2018
10230,80447,0,Xavier Woodson-Luster,ILB,dead_cap,cleveland-browns,80447,2018
10231,76000,0,Blake Jackson,WR,dead_cap,cleveland-browns,76000,2018
10232,76000,0,Devante Mays,RB,dead_cap,cleveland-browns,76000,2018
10233,74116,0,Brian Price,DT,dead_cap,cleveland-browns,74116,2018
10234,68400,0,Robert Jackson,CB,dead_cap,cleveland-browns,68400,2018
10235,0,66739,Roderick Johnson,T,dead_cap,cleveland-browns,66739,2018
10236,60800,0,Brady Sheldon,OLB,dead_cap,cleveland-browns,60800,2018
10237,60800,0,Jake Eldrenkamp,G,dead_cap,cleveland-browns,60800,2018
10238,58635,0,Jeremiah McKinnon,CB,dead_cap,cleveland-browns,58635,2018
10239,56470,0,Ifeadi Odenigbo,DE,dead_cap,cleveland-browns,56470,2018
10240,0,51912,Spencer Drango,G,dead_cap,cleveland-browns,51912,2018
10241,45600,0,Lenzy Pipkins,CB,dead_cap,cleveland-browns,45600,2018
10242,0,44993,Caleb Brantley,DT,dead_cap,cleveland-browns,44993,2018
10243,0,39805,Simeon Thomas,CB,dead_cap,cleveland-browns,39805,2018
10244,38000,0,Dontrell Hilliard,RB,dead_cap,cleveland-browns,38000,2018
10245,38000,0,Arrion Springs,S,dead_cap,cleveland-browns,38000,2018
10246,30400,0,Pharaoh Brown,TE,dead_cap,cleveland-browns,30400,2018
10247,30400,0,Mason Gentry,DE,dead_cap,cleveland-browns,30400,2018
10248,30400,0,Daniel Williams,WR,dead_cap,cleveland-browns,30400,2018
10249,0,29384,Randall Telfer,TE,dead_cap,cleveland-browns,29384,2018
10250,22800,0,Ashton Lampkin,CB,dead_cap,cleveland-browns,22800,2018
10251,22800,0,Pharoah McKever,TE,dead_cap,cleveland-browns,22800,2018
10252,22235,0,Justin Currie,SS,dead_cap,cleveland-browns,22235,2018
10253,21353,0,C.J. Board,WR,dead_cap,cleveland-browns,21353,2018
10254,0,16067,Matt Dayes,RB,dead_cap,cleveland-browns,16067,2018
10255,15200,0,Kyle Friend,T,dead_cap,cleveland-browns,15200,2018
10256,15200,0,Zaycoven Henderson,DT,dead_cap,cleveland-browns,15200,2018
10257,0,5834,Dominque Alexander,ILB,dead_cap,cleveland-browns,5834,2018
10258,0,2000,Nile Lawrence-Stample,DT,dead_cap,cleveland-browns,2000,2018
10259,0,333,Brogan Roback,QB,dead_cap,cleveland-browns,333,2018
10260,16750000,250000,Odell Beckham Jr.,WR,active,cleveland-browns,17000000,2019
10261,15250000,250000,Olivier Vernon,DE,active,cleveland-browns,15500000,2019
10262,12500000,1550000,Jarvis Landry,WR,active,cleveland-browns,14050000,2019
10263,8000000,1666667,Sheldon Richardson,DT,active,cleveland-browns,9666667,2019
10264,9069000,0,Damarious Randall,FS,active,cleveland-browns,9069000,2019
10265,7500000,1400000,Travis Carrie,CB,active,cleveland-browns,8900000,2019
10266,5500000,3375000,J.C. Tretter,C,active,cleveland-browns,8875000,2019
10267,570000,6857950,Baker Mayfield,QB,active,cleveland-browns,7427950,2019
10268,6150000,1118750,Chris Hubbard,RT,active,cleveland-browns,7268750,2019
10269,6500000,500000,Joel Bitonio,G,active,cleveland-browns,7000000,2019
10270,1805698,4822792,Denzel Ward,CB,active,cleveland-browns,6628490,2019
10271,5500000,900000,Greg Robinson,LT,active,cleveland-browns,6400000,2019
10272,2500000,1166666,Terrance Mitchell,CB,active,cleveland-browns,3666666,2019
10273,1330918,1266835,David Njoku,TE,active,cleveland-browns,2597753,2019
10274,1250000,1237500,Demetrius Harris,TE,active,cleveland-browns,2487500,2019
10275,2025000,158489,Joe Schobert,OLB,active,cleveland-browns,2183489,2019
10276,1350000,690625,Adarius Taylor,ILB,active,cleveland-browns,2040625,2019
10277,2025000,0,Rashard Higgins,WR,active,cleveland-browns,2025000,2019
10278,2015500,9500,Eric Murray,FS,active,cleveland-browns,2025000,2019
10279,815595,862381,Nick Chubb,RB,active,cleveland-browns,1677976,2019
10280,1200000,350000,Kendall Lamm,RT,active,cleveland-browns,1550000,2019
10281,1100000,425000,Eric Kush,G,active,cleveland-browns,1525000,2019
10282,495000,679305,Greedy Williams,CB,active,cleveland-browns,1174305,2019
10283,820200,245391,Larry Ogunjobi,DT,active,cleveland-browns,1065591,2019
10284,665000,262235,Chad Thomas,DE,active,cleveland-browns,927235,2019
10285,805000,0,Charley Hughlett,LS,active,cleveland-browns,805000,2019
10286,773500,0,Taywan Taylor,WR,active,cleveland-browns,773500,2019
10287,495000,240219,Sione Takitaki,LB,active,cleveland-browns,735219,2019
10288,495000,180102,Sheldrick Redwine,S,active,cleveland-browns,675102,2019
10289,645000,0,Justin McCray,G,active,cleveland-browns,645000,2019
10290,645000,0,Ricky Seals-Jones,TE,active,cleveland-browns,645000,2019
10291,635294,0,Juston Burris,CB,active,cleveland-browns,635294,2019
10292,570000,62500,Garrett Gilbert,QB,active,cleveland-browns,632500,2019
10293,570000,48466,Damion Ratley,WR,active,cleveland-browns,618466,2019
10294,341471,255000,Kareem Hunt,RB,active,cleveland-browns,596471,2019
10295,495000,77201,Mack Wilson,LB,active,cleveland-browns,572201,2019
10296,570000,0,Pharaoh Brown,TE,active,cleveland-browns,570000,2019
10297,570000,0,Khadarel Hodge,WR,active,cleveland-browns,570000,2019
10298,570000,0,Wyatt Teller,G,active,cleveland-browns,570000,2019
10299,570000,0,Tavierre Thomas,CB,active,cleveland-browns,570000,2019
10300,495000,65114,Austin Seibert,K,active,cleveland-browns,560114,2019
10301,495000,3333,Jamie Gillan,P,active,cleveland-browns,498333,2019
10302,495000,0,D’Ernest Johnson,RB,active,cleveland-browns,495000,2019
10303,426174,42334,Drew Forbes,G,active,cleveland-browns,468508,2019
10304,379410,0,Eli Ankou,DT,active,cleveland-browns,379410,2019
10305,301761,0,Tae Davis,LB,active,cleveland-browns,301761,2019
10306,265588,0,Bryan Cox Jr.,DE,active,cleveland-browns,265588,2019
10307,262059,0,Stephen Carlson,TE,active,cleveland-browns,262059,2019
10308,174706,0,Porter Gustin,OLB,active,cleveland-browns,174706,2019
10309,174706,0,J.T. Hassell,S,active,cleveland-browns,174706,2019
10310,134118,0,Justin Zimmer,DT,active,cleveland-browns,134118,2019
10311,58236,0,Robert McCray,LB,active,cleveland-browns,58236,2019
10312,33529,0,Colby Gossett,G,active,cleveland-browns,33529,2019
10313,7000000,1200000,Christian Kirksey,ILB,injured_reserve,cleveland-browns,8200000,2019
10314,2650000,1115625,Drew Stanton,QB,injured_reserve,cleveland-browns,3765625,2019
10315,1000000,1550000,Morgan Burnett,SS,injured_reserve,cleveland-browns,2550000,2019
10316,570000,0,Dontrell Hilliard,RB,injured_reserve,cleveland-browns,570000,2019
10317,433059,0,Daniel Ekuale,DT,injured_reserve,cleveland-browns,433059,2019
10318,409236,0,Robert Jackson,CB,injured_reserve,cleveland-browns,409236,2019
10319,378000,1000,DJ Montgomery,WR,injured_reserve,cleveland-browns,379000,2019
10320,378000,0,Lo Falemaka,C,injured_reserve,cleveland-browns,378000,2019
10321,347294,0,Willie Harvey Jr.,LB,injured_reserve,cleveland-browns,347294,2019
10322,136000,0,Derrick Willies,WR,injured_reserve,cleveland-browns,136000,2019
10323,136000,0,Tigie Sankoh,S,practice_squad,cleveland-browns,136000,2019
10324,0,7200000,Kevin Zeitler,G,dead_cap,cleveland-browns,7200000,2019
10325,2750000,1516666,Chris Smith,DE,dead_cap,cleveland-browns,4266666,2019
10326,0,2830724,Jabrill Peppers,S,dead_cap,cleveland-browns,2830724,2019
10327,0,2500000,Jamie Collins,OLB,dead_cap,cleveland-browns,2500000,2019
10328,0,2333334,Carlos Hyde,RB,dead_cap,cleveland-browns,2333334,2019
10329,0,1669091,Corey Coleman,WR,dead_cap,cleveland-browns,1669091,2019
10330,0,1400000,Darren Fells,TE,dead_cap,cleveland-browns,1400000,2019
10331,290028,896000,Austin Corbett,C,dead_cap,cleveland-browns,1186028,2019
10332,0,850000,Duke Johnson,RB,dead_cap,cleveland-browns,850000,2019
10333,0,751753,Emmanuel Ogbah,DE,dead_cap,cleveland-browns,751753,2019
10334,0,600000,Greg Robinson,LT,dead_cap,cleveland-browns,600000,2019
10335,0,500000,Carl Davis,DT,dead_cap,cleveland-browns,500000,2019
10336,0,450000,Ray-Ray Armstrong,ILB,dead_cap,cleveland-browns,450000,2019
10337,402348,0,Devaroe Lawrence,DT,dead_cap,cleveland-browns,402348,2019
10338,373530,0,Malik Jefferson,OLB,dead_cap,cleveland-browns,373530,2019
10339,201176,168908,Antonio Callaway,WR,dead_cap,cleveland-browns,370084,2019
10340,341471,0,Jermaine Whitehead,FS,dead_cap,cleveland-browns,341471,2019
10341,268239,72236,Genard Avery,ILB,dead_cap,cleveland-browns,340475,2019
10342,0,303502,Howard Wilson,CB,dead_cap,cleveland-browns,303502,2019
10343,240000,0,Joe Kerridge,FB,dead_cap,cleveland-browns,240000,2019
10344,231000,5000,Willie Wright,C,dead_cap,cleveland-browns,236000,2019
10345,0,222438,Carl Nassib,DE,dead_cap,cleveland-browns,222438,2019
10346,212472,0,Brandin Bryant,DE,dead_cap,cleveland-browns,212472,2019
10347,0,200000,Bryan Witzmann,G,dead_cap,cleveland-browns,200000,2019
10348,0,196884,Shon Coleman,T,dead_cap,cleveland-browns,196884,2019
10349,192000,0,Colby Gossett,G,dead_cap,cleveland-browns,192000,2019
10350,128000,25481,Donnie Lewis,CB,dead_cap,cleveland-browns,153481,2019
10351,0,141964,Ricardo Louis,WR,dead_cap,cleveland-browns,141964,2019
10352,137500,0,J.T. Hassell,S,dead_cap,cleveland-browns,137500,2019
10353,136000,0,Shelton Gibson,WR,dead_cap,cleveland-browns,136000,2019
10354,0,133478,Roderick Johnson,T,dead_cap,cleveland-browns,133478,2019
10355,43235,90000,Phillip Gaines,CB,dead_cap,cleveland-browns,133235,2019
10356,0,124839,Derrick Kindred,S,dead_cap,cleveland-browns,124839,2019
10357,121823,0,Elijah McGuire,RB,dead_cap,cleveland-browns,121823,2019
10358,120000,0,Malcolm Pridgeon,T,dead_cap,cleveland-browns,120000,2019
10359,0,119417,Simeon Thomas,CB,dead_cap,cleveland-browns,119417,2019
10360,0,95849,Seth Devalve,TE,dead_cap,cleveland-browns,95849,2019
10361,0,89986,Caleb Brantley,DT,dead_cap,cleveland-browns,89986,2019
10362,80000,833,Stephen Carlson,TE,dead_cap,cleveland-browns,80833,2019
10363,80000,0,Eric Dungey,QB,dead_cap,cleveland-browns,80000,2019
10364,80000,0,Montrel Meander,S,dead_cap,cleveland-browns,80000,2019
10365,0,51914,Spencer Drango,G,dead_cap,cleveland-browns,51914,2019
10366,0,44578,Zane Gonzalez,K,dead_cap,cleveland-browns,44578,2019
10367,40000,0,J'Mon Moore,WR,dead_cap,cleveland-browns,40000,2019
10368,0,32134,Matt Dayes,RB,dead_cap,cleveland-browns,32134,2019
10369,32000,0,Trevon Young,DE,dead_cap,cleveland-browns,32000,2019
10370,24000,0,Kyle Kalis,T,dead_cap,cleveland-browns,24000,2019
10371,24000,0,Robert McCray,LB,dead_cap,cleveland-browns,24000,2019
10372,20000,0,Willie Harvey Jr.,LB,dead_cap,cleveland-browns,20000,2019
10373,16000,0,Jermaine Grace,OLB,dead_cap,cleveland-browns,16000,2019
10374,16000,0,Porter Gustin,OLB,dead_cap,cleveland-browns,16000,2019
10375,16000,0,A.J. Howard,S,dead_cap,cleveland-browns,16000,2019
10376,16000,0,Robert Jackson,CB,dead_cap,cleveland-browns,16000,2019
10377,0,6666,David Blough,QB,dead_cap,cleveland-browns,6666,2019
10378,0,6666,Desmond Harrison,LT,dead_cap,cleveland-browns,6666,2019
10379,0,5000,Jarrell Owens,DE,dead_cap,cleveland-browns,5000,2019
10380,0,5000,Wyatt Ray,DE,dead_cap,cleveland-browns,5000,2019
10381,0,2500,Dedrick Young II,LB,dead_cap,cleveland-browns,2500,2019
10382,0,1000,Brian Fineanganofo,T,dead_cap,cleveland-browns,1000,2019
10383,0,833,Derrick Willies,WR,dead_cap,cleveland-browns,833,2019
10384,0,667,Brogan Roback,QB,dead_cap,cleveland-browns,667,2019
10385,0,500,Dorian Baker,WR,dead_cap,cleveland-browns,500,2019
10386,0,500,Anthony Stubbs,LB,dead_cap,cleveland-browns,500,2019
10387,0,333,Jermaine Ponder,CB,dead_cap,cleveland-browns,333,2019
10388,15250000,250000,Olivier Vernon,DE,active,cleveland-browns,15500000,2020
10389,13000000,1550000,Jarvis Landry,WR,active,cleveland-browns,14550000,2020
10390,14000000,250000,Odell Beckham Jr.,WR,active,cleveland-browns,14250000,2020
10391,11900000,1766667,Sheldon Richardson,DT,active,cleveland-browns,13666667,2020
10392,4000000,5975000,J.C. Tretter,C,active,cleveland-browns,9975000,2020
10393,7750000,2200000,Christian Kirksey,ILB,active,cleveland-browns,9950000,2020
10394,4612126,5064501,Myles Garrett,DE,active,cleveland-browns,9676627,2020
10395,8500000,500000,Joel Bitonio,G,active,cleveland-browns,9000000,2020
10396,660000,8253540,Baker Mayfield,QB,active,cleveland-browns,8913540,2020
10397,6750000,1400000,Travis Carrie,CB,active,cleveland-browns,8150000,2020
10398,3131396,4822792,Denzel Ward,CB,active,cleveland-browns,7954188,2020
10399,6150000,1118750,Chris Hubbard,RT,active,cleveland-browns,7268750,2020
10400,3150000,1550000,Morgan Burnett,SS,active,cleveland-browns,4700000,2020
10401,2500000,1166668,Terrance Mitchell,CB,active,cleveland-browns,3666668,2020
10402,2250000,1237500,Demetrius Harris,TE,active,cleveland-browns,3487500,2020
10403,1763877,1266837,David Njoku,TE,active,cleveland-browns,3030714,2020
10404,2250000,690625,Adarius Taylor,ILB,active,cleveland-browns,2940625,2020
10405,2250000,400000,Kendall Lamm,RT,active,cleveland-browns,2650000,2020
10406,1800000,625000,Eric Kush,G,active,cleveland-browns,2425000,2020
10407,1151190,862381,Nick Chubb,RB,active,cleveland-browns,2013571,2020
10408,788576,679305,Greedy Williams,CB,active,cleveland-browns,1467881,2020
10409,998000,245391,Larry Ogunjobi,DT,active,cleveland-browns,1243391,2020
10410,851000,262235,Chad Thomas,DE,active,cleveland-browns,1113235,2020
10411,1000000,0,Charley Hughlett,LS,active,cleveland-browns,1000000,2020
10412,662750,240219,Sione Takitaki,LB,active,cleveland-browns,902969,2020
10413,896500,0,Taywan Taylor,WR,active,cleveland-browns,896500,2020
10414,585000,180102,Sheldrick Redwine,S,active,cleveland-browns,765102,2020
10415,660000,87500,Garrett Gilbert,QB,active,cleveland-browns,747500,2020
10416,735000,0,Eli Ankou,DT,active,cleveland-browns,735000,2020
10417,660000,48466,Damion Ratley,WR,active,cleveland-browns,708466,2020
10418,585000,77201,Mack Wilson,LB,active,cleveland-browns,662201,2020
10419,660000,0,Tae Davis,LB,active,cleveland-browns,660000,2020
10420,660000,0,Colby Gossett,G,active,cleveland-browns,660000,2020
10421,660000,0,Jermaine Grace,OLB,active,cleveland-browns,660000,2020
10422,660000,0,Wyatt Teller,G,active,cleveland-browns,660000,2020
10423,660000,0,Tavierre Thomas,CB,active,cleveland-browns,660000,2020
10424,660000,0,Justin Zimmer,DT,active,cleveland-browns,660000,2020
10425,585000,65114,Austin Seibert,K,active,cleveland-browns,650114,2020
10426,585000,42334,Drew Forbes,G,active,cleveland-browns,627334,2020
10427,585000,3333,Jamie Gillan,P,active,cleveland-browns,588333,2020
10428,585000,0,Brandin Bryant,DE,active,cleveland-browns,585000,2020
10429,585000,0,Stephen Carlson,TE,active,cleveland-browns,585000,2020
10430,585000,0,Daniel Ekuale,DT,active,cleveland-browns,585000,2020
10431,585000,0,Porter Gustin,OLB,active,cleveland-browns,585000,2020
10432,585000,0,Willie Harvey Jr.,LB,active,cleveland-browns,585000,2020
10433,585000,0,J.T. Hassell,S,active,cleveland-browns,585000,2020
10434,585000,0,Robert Jackson,CB,active,cleveland-browns,585000,2020
10435,585000,0,D’Ernest Johnson,RB,active,cleveland-browns,585000,2020
10436,585000,0,Montrel Meander,S,active,cleveland-browns,585000,2020
10437,585000,0,J'Mon Moore,WR,active,cleveland-browns,585000,2020
10438,585000,0,Trevon Young,DE,active,cleveland-browns,585000,2020
10439,510000,1000,DJ Montgomery,WR,active,cleveland-browns,511000,2020
10440,510000,0,Lo Falemaka,C,active,cleveland-browns,510000,2020
10441,510000,0,Donnie Lewis,CB,active,cleveland-browns,510000,2020
10442,510000,0,Malcolm Pridgeon,T,active,cleveland-browns,510000,2020
10443,510000,0,Willie Wright,C,active,cleveland-browns,510000,2020
10444,0,1792000,Austin Corbett,C,dead_cap,cleveland-browns,1792000,2020
10445,0,1500000,Duke Johnson,RB,dead_cap,cleveland-browns,1500000,2020
10446,0,1166666,Chris Smith,DE,dead_cap,cleveland-browns,1166666,2020
10447,0,337816,Antonio Callaway,WR,dead_cap,cleveland-browns,337816,2020
10448,0,144472,Genard Avery,ILB,dead_cap,cleveland-browns,144472,2020
10449,0,76443,Donnie Lewis,CB,dead_cap,cleveland-browns,76443,2020
10450,0,13337,David Blough,QB,dead_cap,cleveland-browns,13337,2020
10451,0,10000,Jarrell Owens,DE,dead_cap,cleveland-browns,10000,2020
10452,0,10000,Wyatt Ray,DE,dead_cap,cleveland-browns,10000,2020
10453,0,6668,Desmond Harrison,LT,dead_cap,cleveland-browns,6668,2020
10454,0,5000,Dedrick Young II,LB,dead_cap,cleveland-browns,5000,2020
10455,0,4667,J.T. Hassell,S,dead_cap,cleveland-browns,4667,2020
10456,0,2000,Brian Fineanganofo,T,dead_cap,cleveland-browns,2000,2020
10457,0,1667,Stephen Carlson,TE,dead_cap,cleveland-browns,1667,2020
10458,0,1000,Dorian Baker,WR,dead_cap,cleveland-browns,1000,2020
10459,0,1000,Anthony Stubbs,LB,dead_cap,cleveland-browns,1000,2020
10460,0,1000,Willie Wright,C,dead_cap,cleveland-browns,1000,2020
10461,0,834,Derrick Willies,WR,dead_cap,cleveland-browns,834,2020
10462,0,667,Jermaine Ponder,CB,dead_cap,cleveland-browns,667,2020
10463,8000000,4666667,Terrell Owens,WR,active,dallas-cowboys,12666667,2007
10464,6000000,2916666,Tony Romo,QB,active,dallas-cowboys,8916666,2007
10465,595000,4558094,Roy Williams,S,active,dallas-cowboys,5153094,2007
10466,3000000,600000,Greg Ellis,LB,active,dallas-cowboys,3600000,2007
10467,1138667,3683900,Terence Newman,CB,active,dallas-cowboys,4822567,2007
10468,1500000,1683000,Bradie James,LB,active,dallas-cowboys,3183000,2007
10469,1000000,2000000,Marc Colombo,T,active,dallas-cowboys,3000000,2007
10470,1710000,1000000,Kyle Kosier,G,active,dallas-cowboys,2710000,2007
10471,595000,3000000,Jason Witten,TE,active,dallas-cowboys,3595000,2007
10472,730000,3580000,DeMarcus Ware,OLB,active,dallas-cowboys,4310000,2007
10473,1300000,1200000,Patrick Crayton,WR,active,dallas-cowboys,2500000,2007
10474,600000,1666667,Andre Gurode,C,active,dallas-cowboys,2266667,2007
10475,1000000,833333,Brad Johnson,QB,active,dallas-cowboys,1833333,2007
10476,435000,1347166,Jay Ratliff,DT,active,dallas-cowboys,1782166,2007
10477,695000,1840000,Marcus Spears,DE,active,dallas-cowboys,2535000,2007
10478,360000,2330000,Bobby Carpenter,LB,active,dallas-cowboys,2690000,2007
10479,285000,1195000,Anthony Spencer,OLB,active,dallas-cowboys,1480000,2007
10480,510000,950001,Julius Jones,RB,active,dallas-cowboys,1460001,2007
10481,600000,500000,Mat McBriar,P,active,dallas-cowboys,1100000,2007
10482,850000,0,Jacques Reeves,CB,active,dallas-cowboys,850000,2007
10483,435000,511250,Kevin Burnett,OLB,active,dallas-cowboys,946250,2007
10484,360000,287500,Anthony Fasano,TE,active,dallas-cowboys,647500,2007
10485,275000,162500,James Marten,T,active,dallas-cowboys,437500,2007
10486,360000,153125,Jason Hatcher,DE,active,dallas-cowboys,513125,2007
10487,510000,0,Nathan Jones,CB,active,dallas-cowboys,510000,2007
10488,435000,73000,Marion Barber,RB,active,dallas-cowboys,508000,2007
10489,435000,62000,Chris Canty,DE,active,dallas-cowboys,497000,2007
10490,435000,0,Joe Berger,G,active,dallas-cowboys,435000,2007
10491,435000,0,L.P. Ladouceur,LS,active,dallas-cowboys,435000,2007
10492,360000,46250,Pat Watkins,S,active,dallas-cowboys,406250,2007
10493,285000,120625,Isaiah Stanback,TE,active,dallas-cowboys,405625,2007
10494,285000,106250,Doug Free,RT,active,dallas-cowboys,391250,2007
10495,360000,14750,Pat McQuistan,RT,active,dallas-cowboys,374750,2007
10496,360000,5466,Miles Austin,WR,active,dallas-cowboys,365466,2007
10497,360000,3333,Sam Hurd,WR,active,dallas-cowboys,363333,2007
10498,360000,0,Stephen Bowen,DE,active,dallas-cowboys,360000,2007
10499,285000,27000,Nick Folk,K,active,dallas-cowboys,312000,2007
10500,285000,23062,Deon Anderson,RB,active,dallas-cowboys,308062,2007
10501,285000,15525,Courtney Brown,S,active,dallas-cowboys,300525,2007
10502,285000,0,Justin Rogers,LB,active,dallas-cowboys,285000,2007
10503,270000,0,Tank Johnson,DT,active,dallas-cowboys,270000,2007
10504,157500,0,Skyler Green,WR,active,dallas-cowboys,157500,2007
10505,67058,5588,Alan Ball,CB,active,dallas-cowboys,72646,2007
10506,79900,0,Alan Ball,CB,practice_squad,dallas-cowboys,79900,2007
10507,79900,0,Marcus Smith,DE,practice_squad,dallas-cowboys,79900,2007
10508,0,666668,Drew Bledsoe,QB,dead_cap,dallas-cowboys,666668,2007
10509,301500,0,Skyler Green,WR,dead_cap,dallas-cowboys,301500,2007
10510,79900,17241,Richard Bartel,QB,dead_cap,dallas-cowboys,97141,2007
10511,18000,0,Justin Beriault,CB,dead_cap,dallas-cowboys,18000,2007
10512,18000,0,Rob Petitti,T,dead_cap,dallas-cowboys,18000,2007
10513,11162,0,Alan Ball,CB,dead_cap,dallas-cowboys,11162,2007
10514,0,6000,Stephen Bowen,DE,dead_cap,dallas-cowboys,6000,2007
10515,5000,0,Matt Moore,QB,dead_cap,dallas-cowboys,5000,2007
10516,3333,0,Marcus Smith,DE,dead_cap,dallas-cowboys,3333,2007
10517,830000,4891667,Terrell Owens,WR,active,dallas-cowboys,5721667,2008
10518,4150000,600000,Greg Ellis,LB,active,dallas-cowboys,4750000,2008
10519,605000,3962499,Tony Romo,QB,active,dallas-cowboys,4567499,2008
10520,1905000,3000000,Jason Witten,TE,active,dallas-cowboys,4905000,2008
10521,605000,3083500,Terence Newman,CB,active,dallas-cowboys,3688500,2008
10522,2000000,1666667,Andre Gurode,C,active,dallas-cowboys,3666667,2008
10523,2409970,1110000,Roy Williams,WR,active,dallas-cowboys,3519970,2008
10524,1750000,1600000,Bradie James,LB,active,dallas-cowboys,3350000,2008
10525,2070000,1000000,Kyle Kosier,G,active,dallas-cowboys,3070000,2008
10526,2000000,833333,Brad Johnson,QB,active,dallas-cowboys,2833333,2008
10527,605000,2000000,Marc Colombo,T,active,dallas-cowboys,2605000,2008
10528,520000,2000000,Marion Barber,RB,active,dallas-cowboys,2520000,2008
10529,725000,3580000,DeMarcus Ware,OLB,active,dallas-cowboys,4305000,2008
10530,1000000,1200000,Patrick Crayton,WR,active,dallas-cowboys,2200000,2008
10531,2017000,0,Chris Canty,DE,active,dallas-cowboys,2017000,2008
10532,520000,1333333,Jay Ratliff,DT,active,dallas-cowboys,1853333,2008
10533,590000,2330000,Bobby Carpenter,LB,active,dallas-cowboys,2920000,2008
10534,1742500,0,Adam-Pacman Jones,CB,active,dallas-cowboys,1742500,2008
10535,370000,1195000,Anthony Spencer,OLB,active,dallas-cowboys,1565000,2008
10536,602500,1840000,Marcus Spears,DE,active,dallas-cowboys,2442500,2008
10537,295000,851000,Mike Jenkins,CB,active,dallas-cowboys,1146000,2008
10538,520000,709457,Kevin Burnett,OLB,active,dallas-cowboys,1229457,2008
10539,295000,714500,Felix Jones,RB,active,dallas-cowboys,1009500,2008
10540,605000,351250,Tank Johnson,DT,active,dallas-cowboys,956250,2008
10541,927000,0,Joe Berger,G,active,dallas-cowboys,927000,2008
10542,520000,160000,L.P. Ladouceur,LS,active,dallas-cowboys,680000,2008
10543,445000,153125,Jason Hatcher,DE,active,dallas-cowboys,598125,2008
10544,295000,205000,Martellus Bennett,TE,active,dallas-cowboys,500000,2008
10545,445000,46250,Pat Watkins,S,active,dallas-cowboys,491250,2008
10546,370000,120625,Isaiah Stanback,TE,active,dallas-cowboys,490625,2008
10547,370000,106250,Doug Free,RT,active,dallas-cowboys,476250,2008
10548,445000,14750,Pat McQuistan,RT,active,dallas-cowboys,459750,2008
10549,445000,5466,Miles Austin,WR,active,dallas-cowboys,450466,2008
10550,445000,0,Stephen Bowen,DE,active,dallas-cowboys,445000,2008
10551,445000,0,Travis Wilson,WR,active,dallas-cowboys,445000,2008
10552,295000,109750,Tashard Choice,RB,active,dallas-cowboys,404750,2008
10553,370000,27000,Nick Folk,K,active,dallas-cowboys,397000,2008
10554,370000,23062,Deon Anderson,RB,active,dallas-cowboys,393062,2008
10555,370000,15525,Courtney Brown,S,active,dallas-cowboys,385525,2008
10556,370000,0,Justin Rogers,LB,active,dallas-cowboys,370000,2008
10557,295000,46250,Orlando Scandrick,CB,active,dallas-cowboys,341250,2008
10558,3720000,4558096,Roy Williams,S,injured_reserve,dallas-cowboys,8278096,2008
10559,900000,500000,Mat McBriar,P,injured_reserve,dallas-cowboys,1400000,2008
10560,445000,3334,Sam Hurd,WR,injured_reserve,dallas-cowboys,448334,2008
10561,88400,0,Danny Amendola,WR,practice_squad,dallas-cowboys,88400,2008
10562,88400,0,Marcus Dixon,DE,practice_squad,dallas-cowboys,88400,2008
10563,575000,0,Anthony Fasano,TE,dead_cap,dallas-cowboys,575000,2008
10564,162500,0,James Marten,T,dead_cap,dallas-cowboys,162500,2008
10565,33486,0,Alan Ball,CB,dead_cap,dallas-cowboys,33486,2008
10566,10000,0,Matt Moore,QB,dead_cap,dallas-cowboys,10000,2008
10567,6667,0,Marcus Smith,DE,dead_cap,dallas-cowboys,6667,2008
10568,5200,0,Richard Bartel,QB,dead_cap,dallas-cowboys,5200,2008
10569,6005000,4000000,DeMarcus Ware,OLB,active,dallas-cowboys,10005000,2009
10570,3452629,4000000,Roy Williams,WR,active,dallas-cowboys,7452629,2009
10571,620000,3962499,Tony Romo,QB,active,dallas-cowboys,4582499,2009
10572,2500000,3000000,Jason Witten,TE,active,dallas-cowboys,5500000,2009
10573,2623000,1600000,Bradie James,LB,active,dallas-cowboys,4223000,2009
10574,2400000,1666667,Andre Gurode,C,active,dallas-cowboys,4066667,2009
10575,2630000,1000000,Kyle Kosier,G,active,dallas-cowboys,3630000,2009
10576,2140000,0,Marc Colombo,T,active,dallas-cowboys,2140000,2009
10577,1700000,0,Igor Olshansky,DE,active,dallas-cowboys,1700000,2009
10578,895000,2000000,Terence Newman,CB,active,dallas-cowboys,2895000,2009
10579,1500000,1200000,Patrick Crayton,WR,active,dallas-cowboys,2700000,2009
10580,1250000,1333333,Jay Ratliff,DT,active,dallas-cowboys,2583333,2009
10581,885000,2330000,Bobby Carpenter,LB,active,dallas-cowboys,3215000,2009
10582,1400000,500000,Keith Brooking,LB,active,dallas-cowboys,1900000,2009
10583,1250000,500000,Mat McBriar,P,active,dallas-cowboys,1750000,2009
10584,650000,1100000,Gerald Sensabaugh,S,active,dallas-cowboys,1750000,2009
10585,481000,1195000,Anthony Spencer,OLB,active,dallas-cowboys,1676000,2009
10586,735000,1840000,Marcus Spears,DE,active,dallas-cowboys,2575000,2009
10587,1545000,0,Miles Austin,WR,active,dallas-cowboys,1545000,2009
10588,1545000,0,Stephen Bowen,DE,active,dallas-cowboys,1545000,2009
10589,1545000,0,Sam Hurd,WR,active,dallas-cowboys,1545000,2009
10590,731250,714500,Felix Jones,RB,active,dallas-cowboys,1445750,2009
10591,657500,620000,Mike Jenkins,CB,active,dallas-cowboys,1277500,2009
10592,1010000,46250,Pat Watkins,S,active,dallas-cowboys,1056250,2009
10593,620000,160000,L.P. Ladouceur,LS,active,dallas-cowboys,780000,2009
10594,385000,498332,Martellus Bennett,TE,active,dallas-cowboys,883332,2009
10595,620000,73000,Marion Barber,RB,active,dallas-cowboys,693000,2009
10596,535000,153125,Jason Hatcher,DE,active,dallas-cowboys,688125,2009
10597,460000,106250,Doug Free,RT,active,dallas-cowboys,566250,2009
10598,535000,14750,Pat McQuistan,RT,active,dallas-cowboys,549750,2009
10599,385000,109750,Tashard Choice,RB,active,dallas-cowboys,494750,2009
10600,460000,27000,Nick Folk,K,active,dallas-cowboys,487000,2009
10601,310000,175800,Jason Williams,OLB,active,dallas-cowboys,485800,2009
10602,460000,23062,Deon Anderson,RB,active,dallas-cowboys,483062,2009
10603,310000,156400,Robert Brewster,T,active,dallas-cowboys,466400,2009
10604,460000,0,Marvin White,S,active,dallas-cowboys,460000,2009
10605,310000,133000,Stephen McGee,QB,active,dallas-cowboys,443000,2009
10606,310000,124635,Victor Butler,OLB,active,dallas-cowboys,434635,2009
10607,385000,46250,Orlando Scandrick,CB,active,dallas-cowboys,431250,2009
10608,310000,48500,DeAngelo Smith,CB,active,dallas-cowboys,358500,2009
10609,310000,40000,Michael Hamlin,S,active,dallas-cowboys,350000,2009
10610,310000,37125,David Buehler,K,active,dallas-cowboys,347125,2009
10611,310000,24250,Stephen Hodge,S,active,dallas-cowboys,334250,2009
10612,310000,19562,John Phillips,TE,active,dallas-cowboys,329562,2009
10613,182352,0,Duke Preston,G,active,dallas-cowboys,182352,2009
10614,310000,116000,Brandon Williams,DE,injured_reserve,dallas-cowboys,426000,2009
10615,88400,0,Marcus Dixon,DE,practice_squad,dallas-cowboys,88400,2009
10616,88400,0,Donovan Woods,LB,practice_squad,dallas-cowboys,88400,2009
10617,9675000,0,Terrell Owens,WR,dead_cap,dallas-cowboys,9675000,2009
10618,0,4440000,Roy Williams,S,dead_cap,dallas-cowboys,4440000,2009
10619,1350000,0,Marc Colombo,T,dead_cap,dallas-cowboys,1350000,2009
10620,0,833333,Brad Johnson,QB,dead_cap,dallas-cowboys,833333,2009
10621,370625,0,Kevin Burnett,OLB,dead_cap,dallas-cowboys,370625,2009
10622,325000,0,James Marten,T,dead_cap,dallas-cowboys,325000,2009
10623,120625,0,Isaiah Stanback,TE,dead_cap,dallas-cowboys,120625,2009
10624,48500,0,DeAngelo Smith,CB,dead_cap,dallas-cowboys,48500,2009
10625,13750,0,Mike Mickens,CB,dead_cap,dallas-cowboys,13750,2009
10626,12937,0,Manuel Johnson,WR,dead_cap,dallas-cowboys,12937,2009
10627,17078000,0,Miles Austin,WR,active,dallas-cowboys,17078000,2010
10628,8500000,3962499,Tony Romo,QB,active,dallas-cowboys,12462499,2010
10629,7800000,4000000,DeMarcus Ware,OLB,active,dallas-cowboys,11800000,2010
10630,9000000,2000000,Terence Newman,CB,active,dallas-cowboys,11000000,2010
10631,5109971,6375000,Roy Williams,WR,active,dallas-cowboys,11484971,2010
10632,3860000,73000,Marion Barber,RB,active,dallas-cowboys,3933000,2010
10633,2641000,3500000,Jason Witten,TE,active,dallas-cowboys,6141000,2010
10634,2950000,2100000,Bradie James,LB,active,dallas-cowboys,5050000,2010
10635,3000000,1666667,Andre Gurode,C,active,dallas-cowboys,4666667,2010
10636,789000,3300000,Mike Jenkins,CB,active,dallas-cowboys,4089000,2010
10637,2990000,1000000,Kyle Kosier,G,active,dallas-cowboys,3990000,2010
10638,2465000,0,Igor Olshansky,DE,active,dallas-cowboys,2465000,2010
10639,2105000,1333333,Jay Ratliff,DT,active,dallas-cowboys,3438333,2010
10640,1900000,0,Marc Colombo,T,active,dallas-cowboys,1900000,2010
10641,2730750,0,Alex Barron,LT,active,dallas-cowboys,2730750,2010
10642,2000000,600000,Jon Kitna,QB,active,dallas-cowboys,2600000,2010
10643,1900000,500000,Keith Brooking,LB,active,dallas-cowboys,2400000,2010
10644,1550000,500000,Mat McBriar,P,active,dallas-cowboys,2050000,2010
10645,741000,1195000,Anthony Spencer,OLB,active,dallas-cowboys,1936000,2010
10646,815000,1000000,Gerald Sensabaugh,S,active,dallas-cowboys,1815000,2010
10647,1759000,0,Stephen Bowen,DE,active,dallas-cowboys,1759000,2010
10648,1759000,0,Jason Hatcher,DE,active,dallas-cowboys,1759000,2010
10649,877500,714500,Felix Jones,RB,active,dallas-cowboys,1592000,2010
10650,320000,960000,Dez Bryant,WR,active,dallas-cowboys,1280000,2010
10651,900000,0,Montrae Holland,G,active,dallas-cowboys,900000,2010
10652,1176000,0,Pat McQuistan,RT,active,dallas-cowboys,1176000,2010
10653,470000,498332,Martellus Bennett,TE,active,dallas-cowboys,968332,2010
10654,635000,160000,L.P. Ladouceur,LS,active,dallas-cowboys,795000,2010
10655,550000,106250,Doug Free,RT,active,dallas-cowboys,656250,2010
10656,320000,300000,Sean Lee,OLB,active,dallas-cowboys,620000,2010
10657,470000,109750,Tashard Choice,RB,active,dallas-cowboys,579750,2010
10658,395000,156400,Robert Brewster,T,active,dallas-cowboys,551400,2010
10659,545000,0,Alan Ball,CB,active,dallas-cowboys,545000,2010
10660,545000,0,Leon Williams,LB,active,dallas-cowboys,545000,2010
10661,395000,133000,Stephen McGee,QB,active,dallas-cowboys,528000,2010
10662,470000,46250,Orlando Scandrick,CB,active,dallas-cowboys,516250,2010
10663,390000,124635,Victor Butler,OLB,active,dallas-cowboys,514635,2010
10664,470000,19562,John Phillips,TE,active,dallas-cowboys,489562,2010
10665,320000,116000,Brandon Williams,DE,active,dallas-cowboys,436000,2010
10666,320000,112630,Akwasi Owusu-Ansah,S,active,dallas-cowboys,432630,2010
10667,390000,37125,David Buehler,K,active,dallas-cowboys,427125,2010
10668,320000,27625,Sam Young,LT,active,dallas-cowboys,347625,2010
10669,320000,11889,Josh Brent,DT,active,dallas-cowboys,331889,2010
10670,320000,4000,Barry Church,SS,active,dallas-cowboys,324000,2010
10671,320000,4000,Phil Costa,C,active,dallas-cowboys,324000,2010
10672,320000,1666,Danny McCray,SS,active,dallas-cowboys,321666,2010
10673,320000,0,Manuel Johnson,WR,active,dallas-cowboys,320000,2010
10674,225000,12150,Sean Lissemore,DT,active,dallas-cowboys,237150,2010
10675,169411,0,Bryan McCann,CB,active,dallas-cowboys,169411,2010
10676,94117,0,Lonyae Miller,RB,active,dallas-cowboys,94117,2010
10677,94117,0,Andrew Sendejo,SS,active,dallas-cowboys,94117,2010
10678,37647,0,Teddy Williams,CB,active,dallas-cowboys,37647,2010
10679,550000,0,Jay Moore,LB,active,dallas-cowboys,550000,2010
10680,1759000,0,Sam Hurd,WR,injured_reserve,dallas-cowboys,1759000,2010
10681,1226000,0,Marcus Spears,DE,injured_reserve,dallas-cowboys,1226000,2010
10682,88400,0,Bryan McCann,CB,practice_squad,dallas-cowboys,88400,2010
10683,88400,0,Lonyae Miller,RB,practice_squad,dallas-cowboys,88400,2010
10684,88400,0,Teddy Williams,CB,practice_squad,dallas-cowboys,88400,2010
10685,1350000,0,Marc Colombo,T,dead_cap,dallas-cowboys,1350000,2010
10686,1200000,0,Patrick Crayton,WR,dead_cap,dallas-cowboys,1200000,2010
10687,0,2330000,Bobby Carpenter,LB,dead_cap,dallas-cowboys,2330000,2010
10688,920000,0,Marcus Spears,DE,dead_cap,dallas-cowboys,920000,2010
10689,527400,0,Jason Williams,OLB,dead_cap,dallas-cowboys,527400,2010
10690,156400,0,Robert Brewster,T,dead_cap,dallas-cowboys,156400,2010
10691,120625,0,Isaiah Stanback,TE,dead_cap,dallas-cowboys,120625,2010
10692,97000,0,DeAngelo Smith,CB,dead_cap,dallas-cowboys,97000,2010
10693,43137,0,John Nalbone,TE,dead_cap,dallas-cowboys,43137,2010
10694,41250,0,Mike Mickens,CB,dead_cap,dallas-cowboys,41250,2010
10695,38811,0,Manuel Johnson,WR,dead_cap,dallas-cowboys,38811,2010
10696,27000,0,Nick Folk,K,dead_cap,dallas-cowboys,27000,2010
10697,0,24250,Jamar Wall,CB,dead_cap,dallas-cowboys,24250,2010
10698,24250,0,Stephen Hodge,S,dead_cap,dallas-cowboys,24250,2010
10699,23062,0,Deon Anderson,RB,dead_cap,dallas-cowboys,23062,2010
10700,4000,0,Lonyae Miller,RB,dead_cap,dallas-cowboys,4000,2010
10701,8000000,2000000,Terence Newman,CB,active,dallas-cowboys,10000000,2011
10702,3391000,6200000,Jason Witten,TE,active,dallas-cowboys,9591000,2011
10703,685000,5803000,DeMarcus Ware,OLB,active,dallas-cowboys,6488000,2011
10704,810000,5600499,Tony Romo,QB,active,dallas-cowboys,6410499,2011
10705,1625000,3600000,Jay Ratliff,DT,active,dallas-cowboys,5225000,2011
10706,3500000,500000,Bradie James,LB,active,dallas-cowboys,4000000,2011
10707,2600000,600000,Jon Kitna,QB,active,dallas-cowboys,3200000,2011
10708,700000,2060000,Doug Free,RT,active,dallas-cowboys,2760000,2011
10709,2200000,500000,Keith Brooking,LB,active,dallas-cowboys,2700000,2011
10710,1800000,800000,Gerald Sensabaugh,S,active,dallas-cowboys,2600000,2011
10711,1800000,700000,Abram Elam,S,active,dallas-cowboys,2500000,2011
10712,375000,1897018,Tyron Smith,LT,active,dallas-cowboys,2272018,2011
10713,685000,1571000,Miles Austin,WR,active,dallas-cowboys,2256000,2011
10714,1700000,500000,Mat McBriar,P,active,dallas-cowboys,2200000,2011
10715,1001000,1195000,Anthony Spencer,OLB,active,dallas-cowboys,2196000,2011
10716,1900000,150000,Daniel Loper,T,active,dallas-cowboys,2050000,2011
10717,1112500,640000,Dez Bryant,WR,active,dallas-cowboys,1752500,2011
10718,1023750,714500,Felix Jones,RB,active,dallas-cowboys,1738250,2011
10719,900000,700000,Kyle Kosier,G,active,dallas-cowboys,1600000,2011
10720,920500,620000,Mike Jenkins,CB,active,dallas-cowboys,1540500,2011
10721,750000,700000,Marcus Spears,DE,active,dallas-cowboys,1450000,2011
10722,700000,600000,Jason Hatcher,DE,active,dallas-cowboys,1300000,2011
10723,600000,646250,Orlando Scandrick,CB,active,dallas-cowboys,1246250,2011
10724,1200000,0,Alan Ball,CB,active,dallas-cowboys,1200000,2011
10725,810000,345000,Kenyon Coleman,DE,active,dallas-cowboys,1155000,2011
10726,555000,498336,Martellus Bennett,TE,active,dallas-cowboys,1053336,2011
10727,375000,507654,Bruce Carter,ILB,active,dallas-cowboys,882654,2011
10728,650000,160000,L.P. Ladouceur,LS,active,dallas-cowboys,810000,2011
10729,405000,300000,Sean Lee,OLB,active,dallas-cowboys,705000,2011
10730,480000,133000,Stephen McGee,QB,active,dallas-cowboys,613000,2011
10731,480000,124635,Victor Butler,OLB,active,dallas-cowboys,604635,2011
10732,375000,190625,DeMarco Murray,RB,active,dallas-cowboys,565625,2011
10733,480000,37125,David Buehler,K,active,dallas-cowboys,517125,2011
10734,375000,113400,David Arkin,G,active,dallas-cowboys,488400,2011
10735,480000,0,Kevin Ogletree,WR,active,dallas-cowboys,480000,2011
10736,450000,12150,Sean Lissemore,DT,active,dallas-cowboys,462150,2011
10737,450000,4000,Barry Church,SS,active,dallas-cowboys,454000,2011
10738,450000,1666,Danny McCray,SS,active,dallas-cowboys,451666,2011
10739,405000,19562,John Phillips,TE,active,dallas-cowboys,424562,2011
10740,405000,11889,Josh Brent,DT,active,dallas-cowboys,416889,2011
10741,405000,4000,Phil Costa,C,active,dallas-cowboys,409000,2011
10742,405000,0,Clifton Geathers,DE,active,dallas-cowboys,405000,2011
10743,405000,0,Manuel Johnson,WR,active,dallas-cowboys,405000,2011
10744,375000,11475,Bill Nagy,G,active,dallas-cowboys,386475,2011
10745,375000,1667,Kevin Kowalski,G,active,dallas-cowboys,376667,2011
10746,375000,833,Dan Bailey,K,active,dallas-cowboys,375833,2011
10747,375000,500,Alex Albright,OLB,active,dallas-cowboys,375500,2011
10748,375000,500,Phillip Tanner,RB,active,dallas-cowboys,375500,2011
10749,375000,0,Shaun Chapas,TE,active,dallas-cowboys,375000,2011
10750,375000,0,Kai Forbath,K,active,dallas-cowboys,375000,2011
10751,375000,0,Dwayne Harris,WR,active,dallas-cowboys,375000,2011
10752,375000,0,Andre Holmes,WR,active,dallas-cowboys,375000,2011
10753,375000,0,Chris Jones,P,active,dallas-cowboys,375000,2011
10754,450000,0,Clifton Geathers,DE,active,dallas-cowboys,450000,2011
10755,96900,0,Mario Butler,CB,practice_squad,dallas-cowboys,96900,2011
10756,0,6375000,Roy Williams,WR,dead_cap,dallas-cowboys,6375000,2011
10757,3333334,0,Andre Gurode,C,dead_cap,dallas-cowboys,3333334,2011
10758,2666667,0,Leonard Davis,G,dead_cap,dallas-cowboys,2666667,2011
10759,1200000,0,Patrick Crayton,WR,dead_cap,dallas-cowboys,1200000,2011
10760,1200000,0,Igor Olshansky,DE,dead_cap,dallas-cowboys,1200000,2011
10761,500000,0,Montrae Holland,G,dead_cap,dallas-cowboys,500000,2011
10762,232000,0,Brandon Williams,DE,dead_cap,dallas-cowboys,232000,2011
10763,156400,0,Robert Brewster,T,dead_cap,dallas-cowboys,156400,2011
10764,0,112630,Akwasi Owusu-Ansah,S,dead_cap,dallas-cowboys,112630,2011
10765,86274,0,John Nalbone,TE,dead_cap,dallas-cowboys,86274,2011
10766,0,72750,Jamar Wall,CB,dead_cap,dallas-cowboys,72750,2011
10767,48500,0,Stephen Hodge,S,dead_cap,dallas-cowboys,48500,2011
10768,0,48200,Joshua Thomas,CB,dead_cap,dallas-cowboys,48200,2011
10769,0,27625,Sam Young,LT,dead_cap,dallas-cowboys,27625,2011
10770,0,27515,Dwayne Harris,WR,dead_cap,dallas-cowboys,27515,2011
10771,0,14213,Shaun Chapas,TE,dead_cap,dallas-cowboys,14213,2011
10772,8000,0,Lonyae Miller,RB,dead_cap,dallas-cowboys,8000,2011
10773,0,1666,Mario Butler,CB,dead_cap,dallas-cowboys,1666,2011
10774,8856000,0,Anthony Spencer,OLB,active,dallas-cowboys,8856000,2012
10775,3641000,5500000,Jason Witten,TE,active,dallas-cowboys,9141000,2012
10776,825000,8870499,Tony Romo,QB,active,dallas-cowboys,9695499,2012
10777,825000,6721750,DeMarcus Ware,OLB,active,dallas-cowboys,7546750,2012
10778,1500000,4100000,Jay Ratliff,DT,active,dallas-cowboys,5600000,2012
10779,1200000,3020000,Doug Free,RT,active,dallas-cowboys,4220000,2012
10780,1335000,2825500,Dez Bryant,WR,active,dallas-cowboys,4160500,2012
10781,1200000,2000000,Brandon Carr,CB,active,dallas-cowboys,3200000,2012
10782,390000,2567182,Morris Claiborne,CB,active,dallas-cowboys,2957182,2012
10783,943004,1897018,Tyron Smith,LT,active,dallas-cowboys,2840022,2012
10784,975000,1780000,Orlando Scandrick,CB,active,dallas-cowboys,2755000,2012
10785,1150000,1571000,Miles Austin,WR,active,dallas-cowboys,2721000,2012
10786,2000000,700000,Marcus Spears,DE,active,dallas-cowboys,2700000,2012
10787,800000,1350000,Dan Connor,ILB,active,dallas-cowboys,2150000,2012
10788,1500000,600000,Jason Hatcher,DE,active,dallas-cowboys,2100000,2012
10789,900000,1000000,Kyle Orton,QB,active,dallas-cowboys,1900000,2012
10790,1170000,714500,Felix Jones,RB,active,dallas-cowboys,1884500,2012
10791,1000000,812500,Mackenzy Bernadeau,C,active,dallas-cowboys,1812500,2012
10792,1000000,800000,Gerald Sensabaugh,S,active,dallas-cowboys,1800000,2012
10793,1000000,700000,Nate Livings,G,active,dallas-cowboys,1700000,2012
10794,1052000,620000,Mike Jenkins,CB,active,dallas-cowboys,1672000,2012
10795,545664,557654,Bruce Carter,ILB,active,dallas-cowboys,1103318,2012
10796,540000,504000,Barry Church,SS,active,dallas-cowboys,1044000,2012
10797,540000,412150,Sean Lissemore,DT,active,dallas-cowboys,952150,2012
10798,790000,160000,L.P. Ladouceur,LS,active,dallas-cowboys,950000,2012
10799,925000,0,Brian Moorman,P,active,dallas-cowboys,925000,2012
10800,800000,100000,Lawrence Vickers,FB,active,dallas-cowboys,900000,2012
10801,540000,333333,Jermey Parnell,RT,active,dallas-cowboys,873333,2012
10802,850000,0,Eric Frampton,S,active,dallas-cowboys,850000,2012
10803,700000,150000,Ryan Cook,C,active,dallas-cowboys,850000,2012
10804,540000,300000,Sean Lee,OLB,active,dallas-cowboys,840000,2012
10805,825000,0,Derrick Dockery,G,active,dallas-cowboys,825000,2012
10806,615000,124635,Victor Butler,OLB,active,dallas-cowboys,739635,2012
10807,485281,190625,DeMarco Murray,RB,active,dallas-cowboys,675906,2012
10808,640000,0,Kevin Ogletree,WR,active,dallas-cowboys,640000,2012
10809,615000,0,Brian Schaefering,DT,active,dallas-cowboys,615000,2012
10810,465000,133400,David Arkin,G,active,dallas-cowboys,598400,2012
10811,565000,19562,John Phillips,TE,active,dallas-cowboys,584562,2012
10812,540000,4000,Barry Church,SS,active,dallas-cowboys,544000,2012
10813,540000,1668,Danny McCray,SS,active,dallas-cowboys,541668,2012
10814,390000,143813,Tyrone Crawford,DE,active,dallas-cowboys,533813,2012
10815,490000,11889,Josh Brent,DT,active,dallas-cowboys,501889,2012
10816,390000,109805,Kyle Wilber,OLB,active,dallas-cowboys,499805,2012
10817,490000,4000,Phil Costa,C,active,dallas-cowboys,494000,2012
10818,480000,0,Sterling Moore,CB,active,dallas-cowboys,480000,2012
10819,465000,10000,Dwayne Harris,WR,active,dallas-cowboys,475000,2012
10820,465000,1667,Kevin Kowalski,G,active,dallas-cowboys,466667,2012
10821,465000,833,Dan Bailey,K,active,dallas-cowboys,465833,2012
10822,465000,500,Alex Albright,OLB,active,dallas-cowboys,465500,2012
10823,465000,500,Phillip Tanner,RB,active,dallas-cowboys,465500,2012
10824,390000,75146,Matt Johnson,S,active,dallas-cowboys,465146,2012
10825,465000,0,Chris Jones,P,active,dallas-cowboys,465000,2012
10826,390000,26213,James Hanna,TE,active,dallas-cowboys,416213,2012
10827,390000,14850,Caleb McSurdy,ILB,active,dallas-cowboys,404850,2012
10828,700000,0,Charlie Peprah,S,active,dallas-cowboys,700000,2012
10829,700000,0,Ernie Sims,OLB,active,dallas-cowboys,700000,2012
10830,390000,3000,Ron Leary,G,active,dallas-cowboys,393000,2012
10831,390000,500,Cole Beasley,WR,active,dallas-cowboys,390500,2012
10832,390000,500,Donavon Kemp,WR,active,dallas-cowboys,390500,2012
10833,390000,0,Rob Callaway,DT,active,dallas-cowboys,390000,2012
10834,390000,0,Lance Dunbar,RB,active,dallas-cowboys,390000,2012
10835,390000,0,Justin Taplin-Ross,CB,active,dallas-cowboys,390000,2012
10836,465000,0,Andre Holmes,WR,active,dallas-cowboys,465000,2012
10837,700000,0,Gary Guyton,OLB,active,dallas-cowboys,700000,2012
10838,825000,0,Brady Poppinga,LB,active,dallas-cowboys,825000,2012
10839,540000,0,Anthony Armstrong,WR,active,dallas-cowboys,540000,2012
10840,390000,0,Darrion Weems,RT,active,dallas-cowboys,390000,2012
10841,1900000,345000,Kenyon Coleman,DE,injured_reserve,dallas-cowboys,2245000,2012
10842,390000,5747,Ben Bass,DT,injured_reserve,dallas-cowboys,395747,2012
10843,390000,0,Orie Lemon,ILB,injured_reserve,dallas-cowboys,390000,2012
10844,0,12750000,Roy Williams,WR,dead_cap,dallas-cowboys,12750000,2012
10845,4000000,0,Marion Barber,RB,dead_cap,dallas-cowboys,4000000,2012
10846,2666667,0,Leonard Davis,G,dead_cap,dallas-cowboys,2666667,2012
10847,2400000,0,Igor Olshansky,DE,dead_cap,dallas-cowboys,2400000,2012
10848,1200000,0,Jon Kitna,QB,dead_cap,dallas-cowboys,1200000,2012
10849,1000000,0,Terence Newman,CB,dead_cap,dallas-cowboys,1000000,2012
10850,0,800000,Keith Brooking,LB,dead_cap,dallas-cowboys,800000,2012
10851,700000,0,Kyle Kosier,G,dead_cap,dallas-cowboys,700000,2012
10852,0,225260,Akwasi Owusu-Ansah,S,dead_cap,dallas-cowboys,225260,2012
10853,146250,3334,Mario Butler,CB,dead_cap,dallas-cowboys,149584,2012
10854,0,144600,Joshua Thomas,CB,dead_cap,dallas-cowboys,144600,2012
10855,133000,0,Stephen McGee,QB,dead_cap,dallas-cowboys,133000,2012
10856,109750,0,Tashard Choice,RB,dead_cap,dallas-cowboys,109750,2012
10857,100000,0,Brodney Pool,S,dead_cap,dallas-cowboys,100000,2012
10858,0,82545,Dwayne Harris,WR,dead_cap,dallas-cowboys,82545,2012
10859,0,55250,Sam Young,LT,dead_cap,dallas-cowboys,55250,2012
10860,47513,0,Danny Coale,WR,dead_cap,dallas-cowboys,47513,2012
10861,0,42639,Shaun Chapas,TE,dead_cap,dallas-cowboys,42639,2012
10862,37125,0,David Buehler,K,dead_cap,dallas-cowboys,37125,2012
10863,0,11475,Bill Nagy,G,dead_cap,dallas-cowboys,11475,2012
10864,3333,0,Saalim Hakim,WR,dead_cap,dallas-cowboys,3333,2012
10865,3333,0,Charley Hughlett,LS,dead_cap,dallas-cowboys,3333,2012
10866,3000,0,Levy Adcock,T,dead_cap,dallas-cowboys,3000,2012
10867,3000,0,Ron Leary,G,dead_cap,dallas-cowboys,3000,2012
10868,1666,0,Harland Gunn,G,dead_cap,dallas-cowboys,1666,2012
10869,1334,0,George Bryan,TE,dead_cap,dallas-cowboys,1334,2012
10870,1334,0,Taylor Dever,T,dead_cap,dallas-cowboys,1334,2012
10871,1334,0,Adrian Hamilton,OLB,dead_cap,dallas-cowboys,1334,2012
10872,1334,0,Tyrone Novikoff,T,dead_cap,dallas-cowboys,1334,2012
10873,1334,0,Darrell Scott,RB,dead_cap,dallas-cowboys,1334,2012
10874,0,1333,Jeff Adams,G,dead_cap,dallas-cowboys,1333,2012
10875,1333,0,Taylor Reed,OLB,dead_cap,dallas-cowboys,1333,2012
10876,1333,0,Andrew Szczerba,TE,dead_cap,dallas-cowboys,1333,2012
10877,1333,0,Eddie Whitley,S,dead_cap,dallas-cowboys,1333,2012
10878,667,0,Isaac Madison,CB,dead_cap,dallas-cowboys,667,2012
10879,667,0,Aston Whiteside,DT,dead_cap,dallas-cowboys,667,2012
10880,500,0,Lance Dunbar,RB,dead_cap,dallas-cowboys,500,2012
10881,500,0,Lionel Smith,CB,dead_cap,dallas-cowboys,500,2012
10882,1500000,11953833,Tony Romo,QB,active,dallas-cowboys,13453833,2013
10883,10627200,0,Anthony Spencer,OLB,active,dallas-cowboys,10627200,2013
10884,840000,7753750,DeMarcus Ware,OLB,active,dallas-cowboys,8593750,2013
10885,3500000,3980000,Doug Free,RT,active,dallas-cowboys,7480000,2013
10886,715000,4717000,Brandon Carr,CB,active,dallas-cowboys,5432000,2013
10887,940000,3412000,Jason Witten,TE,active,dallas-cowboys,4352000,2013
10888,1129296,2567182,Morris Claiborne,CB,active,dallas-cowboys,3696478,2013
10889,840000,2749400,Miles Austin,WR,active,dallas-cowboys,3589400,2013
10890,1511009,1897018,Tyron Smith,LT,active,dallas-cowboys,3408027,2013
10891,630000,2300000,Sean Lee,OLB,active,dallas-cowboys,2930000,2013
10892,715000,2101250,Orlando Scandrick,CB,active,dallas-cowboys,2816250,2013
10893,2000000,600000,Jason Hatcher,DE,active,dallas-cowboys,2600000,2013
10894,1557500,640000,Dez Bryant,WR,active,dallas-cowboys,2197500,2013
10895,715000,1324166,Mackenzy Bernadeau,C,active,dallas-cowboys,2039166,2013
10896,840000,1127500,Kyle Orton,QB,active,dallas-cowboys,1967500,2013
10897,1023088,333333,Jermey Parnell,RT,active,dallas-cowboys,1356421,2013
10898,766327,557654,Bruce Carter,ILB,active,dallas-cowboys,1323981,2013
10899,823000,500000,Barry Church,SS,active,dallas-cowboys,1323000,2013
10900,405000,844096,Travis Frederick,C,active,dallas-cowboys,1249096,2013
10901,865000,120000,L.P. Ladouceur,LS,active,dallas-cowboys,985000,2013
10902,750000,225000,Phil Costa,C,active,dallas-cowboys,975000,2013
10903,750000,200000,Justin Durant,OLB,active,dallas-cowboys,950000,2013
10904,620313,190625,DeMarco Murray,RB,active,dallas-cowboys,810938,2013
10905,405000,360544,Gavin Escobar,TE,active,dallas-cowboys,765544,2013
10906,630000,100000,Danny McCray,SS,active,dallas-cowboys,730000,2013
10907,490000,153813,Tyrone Crawford,DE,active,dallas-cowboys,643813,2013
10908,630000,0,Nick Hayden,DT,active,dallas-cowboys,630000,2013
10909,630000,0,George Selvie,DE,active,dallas-cowboys,630000,2013
10910,480000,109805,Kyle Wilber,OLB,active,dallas-cowboys,589805,2013
10911,555000,10000,Dwayne Harris,WR,active,dallas-cowboys,565000,2013
10912,405000,154868,Terrance Williams,WR,active,dallas-cowboys,559868,2013
10913,555000,833,Dan Bailey,K,active,dallas-cowboys,555833,2013
10914,555000,500,Phillip Tanner,RB,active,dallas-cowboys,555500,2013
10915,840000,0,Ernie Sims,OLB,active,dallas-cowboys,840000,2013
10916,555000,0,Chris Jones,P,active,dallas-cowboys,555000,2013
10917,405000,146517,J.J. Wilcox,FS,active,dallas-cowboys,551517,2013
10918,405000,110845,B.W. Webb,CB,active,dallas-cowboys,515845,2013
10919,480000,26213,James Hanna,TE,active,dallas-cowboys,506213,2013
10920,480000,500,Cole Beasley,WR,active,dallas-cowboys,480500,2013
10921,480000,0,Darrion Weems,RT,active,dallas-cowboys,480000,2013
10922,715000,10000,Edgar Jones,OLB,active,dallas-cowboys,725000,2013
10923,405000,47220,Joseph Randle,RB,active,dallas-cowboys,452220,2013
10924,480000,0,Lance Dunbar,RB,active,dallas-cowboys,480000,2013
10925,405000,26055,DeVonte Holloman,OLB,active,dallas-cowboys,431055,2013
10926,405000,666,Jeff Heath,FS,active,dallas-cowboys,405666,2013
10927,405000,0,Ron Leary,G,active,dallas-cowboys,405000,2013
10928,715000,0,Jarius Wynn,OLB,active,dallas-cowboys,715000,2013
10929,630000,0,Everette Brown,OLB,active,dallas-cowboys,630000,2013
10930,405000,0,Cameron Lawrence,OLB,active,dallas-cowboys,405000,2013
10931,630000,0,Corvey Irvin,DT,active,dallas-cowboys,630000,2013
10932,405000,9333,Jakar Hamilton,S,active,dallas-cowboys,414333,2013
10933,555000,0,Sterling Moore,CB,active,dallas-cowboys,555000,2013
10934,555000,0,Martez Wilson,OLB,active,dallas-cowboys,555000,2013
10935,555000,0,Tyler Clutts,FB,active,dallas-cowboys,555000,2013
10936,555000,0,Frank Kearse,DE,active,dallas-cowboys,555000,2013
10937,480000,0,Orie Lemon,ILB,active,dallas-cowboys,480000,2013
10938,940000,0,Jon Kitna,QB,active,dallas-cowboys,940000,2013
10939,405000,0,Justin Green,CB,active,dallas-cowboys,405000,2013
10940,1500000,0,Brian Waters,G,injured_reserve,dallas-cowboys,1500000,2013
10941,1100000,150000,Ryan Cook,C,injured_reserve,dallas-cowboys,1250000,2013
10942,303000,75146,Matt Johnson,S,injured_reserve,dallas-cowboys,378146,2013
10943,405000,5747,Ben Bass,DT,injured_reserve,dallas-cowboys,410747,2013
10944,405000,0,Jeff Olson,G,injured_reserve,dallas-cowboys,405000,2013
10945,12000,0,Danny Coale,WR,practice_squad,dallas-cowboys,12000,2013
10946,3447000,0,Jay Ratliff,DT,dead_cap,dallas-cowboys,3447000,2013
10947,0,2400000,Gerald Sensabaugh,S,dead_cap,dallas-cowboys,2400000,2013
10948,2000000,0,Terence Newman,CB,dead_cap,dallas-cowboys,2000000,2013
10949,715000,946250,Nate Livings,G,dead_cap,dallas-cowboys,1661250,2013
10950,1350000,0,Dan Connor,ILB,dead_cap,dallas-cowboys,1350000,2013
10951,700000,0,Marcus Spears,DE,dead_cap,dallas-cowboys,700000,2013
10952,620000,0,Will Allen,SS,dead_cap,dallas-cowboys,620000,2013
10953,490206,0,Alex Albright,OLB,dead_cap,dallas-cowboys,490206,2013
10954,489706,0,Kyle Bosworth,OLB,dead_cap,dallas-cowboys,489706,2013
10955,412150,0,Sean Lissemore,DT,dead_cap,dallas-cowboys,412150,2013
10956,406765,0,Drake Nevis,DE,dead_cap,dallas-cowboys,406765,2013
10957,338824,0,Andre Smith,TE,dead_cap,dallas-cowboys,338824,2013
10958,238235,0,Caesar Rayford,ILB,dead_cap,dallas-cowboys,238235,2013
10959,113400,113400,David Arkin,G,dead_cap,dallas-cowboys,226800,2013
10960,142539,0,Danny Coale,WR,dead_cap,dallas-cowboys,142539,2013
10961,130588,0,David Carter,DT,dead_cap,dallas-cowboys,130588,2013
10962,119471,0,Micah Pellerin,CB,dead_cap,dallas-cowboys,119471,2013
10963,112941,0,Orie Lemon,ILB,dead_cap,dallas-cowboys,112941,2013
10964,100000,0,Lawrence Vickers,FB,dead_cap,dallas-cowboys,100000,2013
10965,84706,0,Chris Greenwood,CB,dead_cap,dallas-cowboys,84706,2013
10966,83647,0,Jason Vega,DE,dead_cap,dallas-cowboys,83647,2013
10967,74118,0,Landon Cohen,DT,dead_cap,dallas-cowboys,74118,2013
10968,72000,0,Alex Tanney,QB,dead_cap,dallas-cowboys,72000,2013
10969,71471,0,Everett Dawkins,DT,dead_cap,dallas-cowboys,71471,2013
10970,71471,0,Jerome Long,DE,dead_cap,dallas-cowboys,71471,2013
10971,65294,0,Eric Frampton,S,dead_cap,dallas-cowboys,65294,2013
10972,65000,0,Dante Rosario,TE,dead_cap,dallas-cowboys,65000,2013
10973,56471,0,Marvin Austin,DT,dead_cap,dallas-cowboys,56471,2013
10974,45333,0,Jakar Hamilton,S,dead_cap,dallas-cowboys,45333,2013
10975,42000,0,Ray Dominguez,G,dead_cap,dallas-cowboys,42000,2013
10976,32647,0,Micheal Spurlock,WR,dead_cap,dallas-cowboys,32647,2013
10977,30666,0,Cameron Lawrence,OLB,dead_cap,dallas-cowboys,30666,2013
10978,30000,0,Jamar Newsome,WR,dead_cap,dallas-cowboys,30000,2013
10979,0,22950,Bill Nagy,G,dead_cap,dallas-cowboys,22950,2013
10980,18000,0,Hall Davis,DE,dead_cap,dallas-cowboys,18000,2013
10981,14850,0,Caleb McSurdy,ILB,dead_cap,dallas-cowboys,14850,2013
10982,12000,0,Davin Meggett,RB,dead_cap,dallas-cowboys,12000,2013
10983,12000,0,George Winn,RB,dead_cap,dallas-cowboys,12000,2013
10984,11889,0,Josh Brent,DT,dead_cap,dallas-cowboys,11889,2013
10985,8166,0,Taylor Reed,OLB,dead_cap,dallas-cowboys,8166,2013
10986,6667,0,Saalim Hakim,WR,dead_cap,dallas-cowboys,6667,2013
10987,6664,0,Charley Hughlett,LS,dead_cap,dallas-cowboys,6664,2013
10988,6000,0,Levy Adcock,T,dead_cap,dallas-cowboys,6000,2013
10989,6000,0,Ron Leary,G,dead_cap,dallas-cowboys,6000,2013
10990,6000,0,Phillip Manley,G,dead_cap,dallas-cowboys,6000,2013
10991,3334,0,Harland Gunn,G,dead_cap,dallas-cowboys,3334,2013
10992,0,2667,Jeff Adams,G,dead_cap,dallas-cowboys,2667,2013
10993,2667,0,George Bryan,TE,dead_cap,dallas-cowboys,2667,2013
10994,2667,0,Taylor Dever,T,dead_cap,dallas-cowboys,2667,2013
10995,2667,0,Adrian Hamilton,OLB,dead_cap,dallas-cowboys,2667,2013
10996,2667,0,Tyrone Novikoff,T,dead_cap,dallas-cowboys,2667,2013
10997,2667,0,Darrell Scott,RB,dead_cap,dallas-cowboys,2667,2013
10998,2667,0,Andrew Szczerba,TE,dead_cap,dallas-cowboys,2667,2013
10999,2667,0,Eddie Whitley,S,dead_cap,dallas-cowboys,2667,2013
11000,1668,0,Kevin Kowalski,G,dead_cap,dallas-cowboys,1668,2013
11001,1666,0,Brandon Magee,ILB,dead_cap,dallas-cowboys,1666,2013
11002,1333,0,Isaac Madison,CB,dead_cap,dallas-cowboys,1333,2013
11003,1333,0,Aston Whiteside,DT,dead_cap,dallas-cowboys,1333,2013
11004,1166,0,Deon Lacey,OLB,dead_cap,dallas-cowboys,1166,2013
11005,1000,0,Lance Dunbar,RB,dead_cap,dallas-cowboys,1000,2013
11006,1000,0,Donavon Kemp,WR,dead_cap,dallas-cowboys,1000,2013
11007,1000,0,Lionel Smith,CB,dead_cap,dallas-cowboys,1000,2013
11008,833,0,Eric Rogers,WR,dead_cap,dallas-cowboys,833,2013
11009,500,0,Devin Smith,CB,dead_cap,dallas-cowboys,500,2013
11010,333,0,Spencer Benton,KR,dead_cap,dallas-cowboys,333,2013
11011,333,0,Xavier Brewer,CB,dead_cap,dallas-cowboys,333,2013
11012,333,0,Paul Freedman,TE,dead_cap,dallas-cowboys,333,2013
11013,166,0,Kendial Lawrence,RB,dead_cap,dallas-cowboys,166,2013
11014,166,0,Dalton Williams,QB,dead_cap,dallas-cowboys,166,2013
11015,7500000,4717000,Brandon Carr,CB,active,dallas-cowboys,12217000,2014
11016,1000000,12408000,Tony Romo,QB,active,dallas-cowboys,13408000,2014
11017,5000000,3412000,Jason Witten,TE,active,dallas-cowboys,8412000,2014
11018,3500000,3980000,Doug Free,RT,active,dallas-cowboys,7480000,2014
11019,1079013,3897018,Tyron Smith,LT,active,dallas-cowboys,4976031,2014
11020,1868591,2567182,Morris Claiborne,CB,active,dallas-cowboys,4435773,2014
11021,750000,2950000,Sean Lee,OLB,active,dallas-cowboys,3700000,2014
11022,661764,2851250,Orlando Scandrick,CB,active,dallas-cowboys,3513014,2014
11023,1780000,1368500,Dez Bryant,WR,active,dallas-cowboys,3148500,2014
11024,1100000,2335832,Mackenzy Bernadeau,C,active,dallas-cowboys,3435832,2014
11025,1250000,1109625,Henry Melton,DT,active,dallas-cowboys,2359625,2014
11026,1500000,500000,Barry Church,SS,active,dallas-cowboys,2000000,2014
11027,1500000,333333,Jermey Parnell,RT,active,dallas-cowboys,1833333,2014
11028,900000,800000,Dan Bailey,K,active,dallas-cowboys,1700000,2014
11029,420000,1210509,Zack Martin,G,active,dallas-cowboys,1630509,2014
11030,1406000,190625,DeMarco Murray,RB,active,dallas-cowboys,1596625,2014
11031,717274,844096,Travis Frederick,C,active,dallas-cowboys,1561370,2014
11032,986991,557654,Bruce Carter,ILB,active,dallas-cowboys,1544645,2014
11033,1250000,200000,Justin Durant,OLB,active,dallas-cowboys,1450000,2014
11034,1250000,46875,Anthony Spencer,OLB,active,dallas-cowboys,1296875,2014
11035,1000000,250000,Jeremy Mincey,DE,active,dallas-cowboys,1250000,2014
11036,885000,120000,L.P. Ladouceur,LS,active,dallas-cowboys,1005000,2014
11037,420000,581209,DeMarcus Lawrence,DE,active,dallas-cowboys,1001209,2014
11038,596386,360544,Gavin Escobar,TE,active,dallas-cowboys,956930,2014
11039,750000,100000,Terrell McClain,DE,active,dallas-cowboys,850000,2014
11040,580000,153813,Tyrone Crawford,DE,active,dallas-cowboys,733813,2014
11041,730000,0,Nick Hayden,DT,active,dallas-cowboys,730000,2014
11042,730000,0,George Selvie,DE,active,dallas-cowboys,730000,2014
11043,700000,0,Rolando McClain,ILB,active,dallas-cowboys,700000,2014
11044,520000,164868,Terrance Williams,WR,active,dallas-cowboys,684868,2014
11045,570000,109805,Kyle Wilber,OLB,active,dallas-cowboys,679805,2014
11046,505000,156517,J.J. Wilcox,FS,active,dallas-cowboys,661517,2014
11047,645000,10000,Dwayne Harris,WR,active,dallas-cowboys,655000,2014
11048,645000,0,Tyler Clutts,FB,active,dallas-cowboys,645000,2014
11049,645000,0,Chris Jones,P,active,dallas-cowboys,645000,2014
11050,645000,0,Sterling Moore,CB,active,dallas-cowboys,645000,2014
11051,570000,26213,James Hanna,TE,active,dallas-cowboys,596213,2014
11052,570000,500,Cole Beasley,WR,active,dallas-cowboys,570500,2014
11053,730000,0,C.J. Spillman,S,active,dallas-cowboys,730000,2014
11054,570000,0,Jack Crawford,DE,active,dallas-cowboys,570000,2014
11055,570000,0,Lance Dunbar,RB,active,dallas-cowboys,570000,2014
11056,570000,0,Brandon Weeden,QB,active,dallas-cowboys,570000,2014
11057,495000,47220,Joseph Randle,RB,active,dallas-cowboys,542220,2014
11058,420000,108716,Anthony Hitchens,ILB,active,dallas-cowboys,528716,2014
11059,495000,666,Jeff Heath,FS,active,dallas-cowboys,495666,2014
11060,495000,0,Cameron Lawrence,OLB,active,dallas-cowboys,495000,2014
11061,495000,0,Ron Leary,G,active,dallas-cowboys,495000,2014
11062,730000,0,Tony Hills,LT,active,dallas-cowboys,730000,2014
11063,420000,50493,Devin Street,WR,active,dallas-cowboys,470493,2014
11064,420000,6000,Kenneth Boatright,DE,active,dallas-cowboys,426000,2014
11065,420000,0,Donald Hawkins,G,active,dallas-cowboys,420000,2014
11066,420000,0,Tyler Patmon,CB,active,dallas-cowboys,420000,2014
11067,1000000,0,Dekoda Watson,OLB,active,dallas-cowboys,1000000,2014
11068,303000,14793,Ben Gardner,DE,active,dallas-cowboys,317793,2014
11069,645000,0,Josh Brent,DT,active,dallas-cowboys,645000,2014
11070,420000,0,Keith Smith,FB,active,dallas-cowboys,420000,2014
11071,730000,0,James Anderson,OLB,active,dallas-cowboys,730000,2014
11072,570000,0,Darrion Weems,RT,injured_reserve,dallas-cowboys,570000,2014
11073,318000,26055,DeVonte Holloman,OLB,injured_reserve,dallas-cowboys,344055,2014
11074,0,1666,Chris Whaley,DT,non_fb_injury,dallas-cowboys,1666,2014
11075,730000,0,Amobi Okoye,DT,non_fb_injury,dallas-cowboys,730000,2014
11076,107100,0,Ryan Williams,RB,practice_squad,dallas-cowboys,107100,2014
11077,100800,0,Reggie Dunn,WR,practice_squad,dallas-cowboys,100800,2014
11078,63000,0,Troy Davis,OLB,practice_squad,dallas-cowboys,63000,2014
11079,50400,0,Lavar Edwards,DE,practice_squad,dallas-cowboys,50400,2014
11080,37800,0,Robert Steeples,CB,practice_squad,dallas-cowboys,37800,2014
11081,31500,0,Davon Coleman,DE,practice_squad,dallas-cowboys,31500,2014
11082,31500,0,Will Smith,OLB,practice_squad,dallas-cowboys,31500,2014
11083,25200,0,Chris Boyd,WR,practice_squad,dallas-cowboys,25200,2014
11084,18900,0,Micah Pellerin,CB,practice_squad,dallas-cowboys,18900,2014
11085,12600,0,Mister Alexander,LB,practice_squad,dallas-cowboys,12600,2014
11086,8571500,0,DeMarcus Ware,OLB,dead_cap,dallas-cowboys,8571500,2014
11087,6928000,0,Jay Ratliff,DT,dead_cap,dallas-cowboys,6928000,2014
11088,0,2838750,Nate Livings,G,dead_cap,dallas-cowboys,2838750,2014
11089,0,2749400,Miles Austin,WR,dead_cap,dallas-cowboys,2749400,2014
11090,1400000,0,Marcus Spears,DE,dead_cap,dallas-cowboys,1400000,2014
11091,1200000,0,Sean Lissemore,DT,dead_cap,dallas-cowboys,1200000,2014
11092,0,1127500,Kyle Orton,QB,dead_cap,dallas-cowboys,1127500,2014
11093,303000,500,Jocquel Skinner,CB,dead_cap,dallas-cowboys,303500,2014
11094,296471,500,Davon Coleman,DE,dead_cap,dallas-cowboys,296971,2014
11095,262059,0,Lavar Edwards,DE,dead_cap,dallas-cowboys,262059,2014
11096,235941,11474,Ken Bishop,DT,dead_cap,dallas-cowboys,247415,2014
11097,231706,500,Jordan Najvar,TE,dead_cap,dallas-cowboys,232206,2014
11098,113400,113400,David Arkin,G,dead_cap,dallas-cowboys,226800,2014
11099,225000,0,Phil Costa,C,dead_cap,dallas-cowboys,225000,2014
11100,204442,666,Keith Smith,FB,dead_cap,dallas-cowboys,205108,2014
11101,172941,0,Korey Toomer,ILB,dead_cap,dallas-cowboys,172941,2014
11102,156653,0,Micah Pellerin,CB,dead_cap,dallas-cowboys,156653,2014
11103,140922,1666,Jarrod Pughsley,LT,dead_cap,dallas-cowboys,142588,2014
11104,0,110845,B.W. Webb,CB,dead_cap,dallas-cowboys,110845,2014
11105,106941,666,Ben Malena,RB,dead_cap,dallas-cowboys,107607,2014
11106,88200,0,Kenneth Boatright,DE,dead_cap,dallas-cowboys,88200,2014
11107,0,75146,Matt Johnson,S,dead_cap,dallas-cowboys,75146,2014
11108,67059,0,Tim Dobbins,ILB,dead_cap,dallas-cowboys,67059,2014
11109,56700,0,Nikita Whitlock,FB,dead_cap,dallas-cowboys,56700,2014
11110,53471,500,Brian Clarke,G,dead_cap,dallas-cowboys,53971,2014
11111,50400,0,Kerry Taylor,WR,dead_cap,dallas-cowboys,50400,2014
11112,44100,0,Michael Sam,DE,dead_cap,dallas-cowboys,44100,2014
11113,39176,0,Orie Lemon,ILB,dead_cap,dallas-cowboys,39176,2014
11114,37412,0,Korey Lindsey,CB,dead_cap,dallas-cowboys,37412,2014
11115,31500,0,Tim Benford,WR,dead_cap,dallas-cowboys,31500,2014
11116,31500,0,Rishaw  Johnson,G,dead_cap,dallas-cowboys,31500,2014
11117,18900,12588,Will Smith,OLB,dead_cap,dallas-cowboys,31488,2014
11118,29700,0,Caleb McSurdy,ILB,dead_cap,dallas-cowboys,29700,2014
11119,25200,500,Ronald Patrick,C,dead_cap,dallas-cowboys,25700,2014
11120,18900,0,Jeff Baca,G,dead_cap,dallas-cowboys,18900,2014
11121,17824,0,Lance Lewis,WR,dead_cap,dallas-cowboys,17824,2014
11122,15000,0,Drake Nevis,DE,dead_cap,dallas-cowboys,15000,2014
11123,12600,0,Jemea Thomas,CB,dead_cap,dallas-cowboys,12600,2014
11124,0,11474,Ahmad Dixon,S,dead_cap,dallas-cowboys,11474,2014
11125,0,11474,Terrance Mitchell,CB,dead_cap,dallas-cowboys,11474,2014
11126,6667,0,Jakar Hamilton,S,dead_cap,dallas-cowboys,6667,2014
11127,6300,0,Laron Byrd,WR,dead_cap,dallas-cowboys,6300,2014
11128,0,5747,Ben Bass,DT,dead_cap,dallas-cowboys,5747,2014
11129,4334,0,Taylor Reed,OLB,dead_cap,dallas-cowboys,4334,2014
11130,3334,0,Brandon Magee,ILB,dead_cap,dallas-cowboys,3334,2014
11131,0,2500,Dashaun Phillips,CB,dead_cap,dallas-cowboys,2500,2014
11132,2334,0,Deon Lacey,OLB,dead_cap,dallas-cowboys,2334,2014
11133,0,2333,L'Damian Washington,WR,dead_cap,dallas-cowboys,2333,2014
11134,1667,0,Eric Rogers,WR,dead_cap,dallas-cowboys,1667,2014
11135,0,1666,Josh Aladenoye,RT,dead_cap,dallas-cowboys,1666,2014
11136,1334,0,Cameron Lawrence,OLB,dead_cap,dallas-cowboys,1334,2014
11137,0,1166,Chris Boyd,WR,dead_cap,dallas-cowboys,1166,2014
11138,0,1000,Andre Cureton,G,dead_cap,dallas-cowboys,1000,2014
11139,1000,0,Devin Smith,CB,dead_cap,dallas-cowboys,1000,2014
11140,0,833,Evan Wilson,TE,dead_cap,dallas-cowboys,833,2014
11141,667,0,Spencer Benton,KR,dead_cap,dallas-cowboys,667,2014
11142,667,0,Xavier Brewer,CB,dead_cap,dallas-cowboys,667,2014
11143,667,0,Paul Freedman,TE,dead_cap,dallas-cowboys,667,2014
11144,0,666,J.C. Copeland,FB,dead_cap,dallas-cowboys,666,2014
11145,0,666,Cody Mandell,P,dead_cap,dallas-cowboys,666,2014
11146,0,666,Marvin Robinson,S,dead_cap,dallas-cowboys,666,2014
11147,0,500,Casey Kreiter,LS,dead_cap,dallas-cowboys,500,2014
11148,0,500,Ryan Smith,S,dead_cap,dallas-cowboys,500,2014
11149,0,500,Joe Windsor,OLB,dead_cap,dallas-cowboys,500,2014
11150,334,0,Kendial Lawrence,RB,dead_cap,dallas-cowboys,334,2014
11151,334,0,Dalton Williams,QB,dead_cap,dallas-cowboys,334,2014
11152,0,333,Dontavis Sapp,OLB,dead_cap,dallas-cowboys,333,2014
11153,8000000,4717000,Brandon Carr,CB,active,dallas-cowboys,12717000,2015
11154,1500000,4612000,Jason Witten,TE,active,dallas-cowboys,6112000,2015
11155,2500000,2950000,Sean Lee,OLB,active,dallas-cowboys,5450000,2015
11156,2607887,2567182,Morris Claiborne,CB,active,dallas-cowboys,5175069,2015
11157,1039000,4000000,Tyron Smith,LT,active,dallas-cowboys,5039000,2015
11158,1000000,3382271,Orlando Scandrick,CB,active,dallas-cowboys,4382271,2015
11159,573529,2467850,Greg Hardy,DE,active,dallas-cowboys,3041379,2015
11160,1500000,1500000,Doug Free,RT,active,dallas-cowboys,3000000,2015
11161,675000,2153813,Tyrone Crawford,DE,active,dallas-cowboys,2828813,2015
11162,1500000,1835832,Mackenzy Bernadeau,C,active,dallas-cowboys,3335832,2015
11163,573529,2062500,Rolando McClain,ILB,active,dallas-cowboys,2636029,2015
11164,1700000,800000,Dan Bailey,K,active,dallas-cowboys,2500000,2015
11165,2000000,250000,Jeremy Mincey,DE,active,dallas-cowboys,2250000,2015
11166,827627,1210509,Zack Martin,G,active,dallas-cowboys,2038136,2015
11167,1000000,1000000,Cole Beasley,WR,active,dallas-cowboys,2000000,2015
11168,1029548,844096,Travis Frederick,C,active,dallas-cowboys,1873644,2015
11169,1764705,0,Matt Cassel,QB,active,dallas-cowboys,1764705,2015
11170,1000000,600000,Andrew Gachkar,OLB,active,dallas-cowboys,1600000,2015
11171,435000,1128989,Byron Jones,CB,active,dallas-cowboys,1563989,2015
11172,1542000,0,Lance Dunbar,RB,active,dallas-cowboys,1542000,2015
11173,670302,581209,DeMarcus Lawrence,DE,active,dallas-cowboys,1251511,2015
11174,900000,250000,Darren McFadden,RB,active,dallas-cowboys,1150000,2015
11175,1000000,120000,L.P. Ladouceur,LS,active,dallas-cowboys,1120000,2015
11176,1000000,100000,Terrell McClain,DE,active,dallas-cowboys,1100000,2015
11177,750000,250000,Chris Jones,P,active,dallas-cowboys,1000000,2015
11178,615000,164868,Terrance Williams,WR,active,dallas-cowboys,779868,2015
11179,660000,109805,Kyle Wilber,OLB,active,dallas-cowboys,769805,2015
11180,595000,156517,J.J. Wilcox,FS,active,dallas-cowboys,751517,2015
11181,435000,258624,Randy Gregory,OLB,active,dallas-cowboys,693624,2015
11182,660000,26213,James Hanna,TE,active,dallas-cowboys,686213,2015
11183,745000,80000,Nick Hayden,DT,active,dallas-cowboys,825000,2015
11184,745000,80000,Danny McCray,SS,active,dallas-cowboys,825000,2015
11185,660000,0,Jack Crawford,DE,active,dallas-cowboys,660000,2015
11186,510000,108716,Anthony Hitchens,ILB,active,dallas-cowboys,618716,2015
11187,585000,668,Jeff Heath,FS,active,dallas-cowboys,585668,2015
11188,585000,0,Tyler Clutts,FB,active,dallas-cowboys,585000,2015
11189,585000,0,Ron Leary,G,active,dallas-cowboys,585000,2015
11190,510000,50493,Devin Street,WR,active,dallas-cowboys,560493,2015
11191,435000,116578,Damien Wilson,OLB,active,dallas-cowboys,551578,2015
11192,701176,0,Charles Brown,LT,active,dallas-cowboys,701176,2015
11193,550588,0,Brice Butler,WR,active,dallas-cowboys,550588,2015
11194,393707,156092,Chaz Green,G,active,dallas-cowboys,549799,2015
11195,435000,13683,Geoff Swaim,TE,active,dallas-cowboys,448683,2015
11196,435000,7000,La'el Collins,RT,active,dallas-cowboys,442000,2015
11197,435000,3333,Lucky Whitehead,WR,active,dallas-cowboys,438333,2015
11198,393706,16087,Mark Nzeocha,ILB,active,dallas-cowboys,409793,2015
11199,307058,0,Rod Smith,RB,active,dallas-cowboys,307058,2015
11200,271764,0,Robert Turbin,RB,active,dallas-cowboys,271764,2015
11201,232941,0,Kellen Moore,QB,active,dallas-cowboys,232941,2015
11202,179117,0,Deji Olatoye,CB,active,dallas-cowboys,179117,2015
11203,90000,0,Terrance Mitchell,CB,active,dallas-cowboys,90000,2015
11204,51176,0,Jameill Showers,QB,active,dallas-cowboys,51176,2015
11205,51176,0,Casey Walker,DT,active,dallas-cowboys,51176,2015
11206,38823,0,Joshua Thomas,CB,active,dallas-cowboys,38823,2015
11207,34411,0,Rodney Smith,WR,active,dallas-cowboys,34411,2015
11208,25588,0,Vince Mayle,WR,active,dallas-cowboys,25588,2015
11209,1000000,15608000,Tony Romo,QB,injured_reserve,dallas-cowboys,16608000,2015
11210,3000000,4000000,Dez Bryant,WR,injured_reserve,dallas-cowboys,7000000,2015
11211,2750000,500000,Barry Church,SS,injured_reserve,dallas-cowboys,3250000,2015
11212,787772,360545,Gavin Escobar,TE,injured_reserve,dallas-cowboys,1148317,2015
11213,400588,50746,Ryan Russell,DE,injured_reserve,dallas-cowboys,451334,2015
11214,358235,0,David Irving,DT,injured_reserve,dallas-cowboys,358235,2015
11215,333000,6000,Kenneth Boatright,DE,injured_reserve,dallas-cowboys,339000,2015
11216,333000,0,Ka'lial Glaud,OLB,injured_reserve,dallas-cowboys,333000,2015
11217,318000,1666,Chris Whaley,DT,injured_reserve,dallas-cowboys,319666,2015
11218,318000,0,Cody Clay,G,injured_reserve,dallas-cowboys,318000,2015
11219,318000,0,Reshod Fortenberry,G,injured_reserve,dallas-cowboys,318000,2015
11220,0,5106200,Miles Austin,WR,dead_cap,dallas-cowboys,5106200,2015
11221,0,5900000,Doug Free,RT,dead_cap,dallas-cowboys,5900000,2015
11222,0,2255000,Kyle Orton,QB,dead_cap,dallas-cowboys,2255000,2015
11223,750000,625000,Jasper Brinkley,ILB,dead_cap,dallas-cowboys,1375000,2015
11224,175782,750750,Henry Melton,DT,dead_cap,dallas-cowboys,926532,2015
11225,907058,0,Corey White,CB,dead_cap,dallas-cowboys,907058,2015
11226,420000,0,Tyler Patmon,CB,dead_cap,dallas-cowboys,420000,2015
11227,418686,0,Christine Michael,RB,dead_cap,dallas-cowboys,418686,2015
11228,388235,0,Brandon Weeden,QB,dead_cap,dallas-cowboys,388235,2015
11229,275294,47220,Joseph Randle,RB,dead_cap,dallas-cowboys,322514,2015
11230,265941,0,Kellen Moore,QB,dead_cap,dallas-cowboys,265941,2015
11231,0,221690,B.W. Webb,CB,dead_cap,dallas-cowboys,221690,2015
11232,199200,1334,Keith Smith,FB,dead_cap,dallas-cowboys,200534,2015
11233,120000,34422,Ken Bishop,DT,dead_cap,dallas-cowboys,154422,2015
11234,140011,0,Darrion Weems,RT,dead_cap,dallas-cowboys,140011,2015
11235,18705,120000,Ryan Williams,RB,dead_cap,dallas-cowboys,138705,2015
11236,131188,0,Vince Mayle,WR,dead_cap,dallas-cowboys,131188,2015
11237,112200,0,Dakorey Johnson,LB,dead_cap,dallas-cowboys,112200,2015
11238,105600,0,Rodney Smith,WR,dead_cap,dallas-cowboys,105600,2015
11239,102352,0,Trey Williams,RB,dead_cap,dallas-cowboys,102352,2015
11240,99000,1666,Jameill Showers,QB,dead_cap,dallas-cowboys,100666,2015
11241,99000,0,Efe Obada,DE,dead_cap,dallas-cowboys,99000,2015
11242,90000,1000,Davon Coleman,DE,dead_cap,dallas-cowboys,91000,2015
11243,0,80000,Keith Rivers,OLB,dead_cap,dallas-cowboys,80000,2015
11244,37412,37764,Will Smith,OLB,dead_cap,dallas-cowboys,75176,2015
11245,0,75146,Matt Johnson,S,dead_cap,dallas-cowboys,75146,2015
11246,66000,0,Lavar Edwards,DE,dead_cap,dallas-cowboys,66000,2015
11247,66000,0,Deji Olatoye,CB,dead_cap,dallas-cowboys,66000,2015
11248,0,65000,Jed Collins,FB,dead_cap,dallas-cowboys,65000,2015
11249,0,65000,Uche Nwaneri,G,dead_cap,dallas-cowboys,65000,2015
11250,59400,0,Casey Walker,DT,dead_cap,dallas-cowboys,59400,2015
11251,59400,0,John Wetzel,RT,dead_cap,dallas-cowboys,59400,2015
11252,58764,0,Rod Sweeting,CB,dead_cap,dallas-cowboys,58764,2015
11253,52800,0,Darius Eubanks,S,dead_cap,dallas-cowboys,52800,2015
11254,0,52110,DeVonte Holloman,OLB,dead_cap,dallas-cowboys,52110,2015
11255,13200,34422,Terrance Mitchell,CB,dead_cap,dallas-cowboys,47622,2015
11256,40000,5000,George Farmer,WR,dead_cap,dallas-cowboys,45000,2015
11257,37412,666,Ray Vinopal,FS,dead_cap,dallas-cowboys,38078,2015
11258,0,34422,Ahmad Dixon,S,dead_cap,dallas-cowboys,34422,2015
11259,34411,0,Jordan Mills,RT,dead_cap,dallas-cowboys,34411,2015
11260,33000,1334,Ben Malena,RB,dead_cap,dallas-cowboys,34334,2015
11261,33000,0,Gus Johnson,RB,dead_cap,dallas-cowboys,33000,2015
11262,30000,0,Ryan Miller,RT,dead_cap,dallas-cowboys,30000,2015
11263,19800,1500,Tim Scott,SS,dead_cap,dallas-cowboys,21300,2015
11264,0,14794,Ben Gardner,DE,dead_cap,dallas-cowboys,14794,2015
11265,13200,1000,Ronald Patrick,C,dead_cap,dallas-cowboys,14200,2015
11266,0,14088,Laurence Gibson,T,dead_cap,dallas-cowboys,14088,2015
11267,13200,0,Dere Akunne,OLB,dead_cap,dallas-cowboys,13200,2015
11268,13200,0,Buddy Jackson,CB,dead_cap,dallas-cowboys,13200,2015
11269,13200,0,Joe Thomas,ILB,dead_cap,dallas-cowboys,13200,2015
11270,0,9334,Jakar Hamilton,S,dead_cap,dallas-cowboys,9334,2015
11271,6600,0,Donte Foster,WR,dead_cap,dallas-cowboys,6600,2015
11272,6600,0,Antonio Johnson,T,dead_cap,dallas-cowboys,6600,2015
11273,6600,0,Michael McAdoo,DE,dead_cap,dallas-cowboys,6600,2015
11274,6600,0,Brandon McGee,CB,dead_cap,dallas-cowboys,6600,2015
11275,0,5000,Dashaun Phillips,CB,dead_cap,dallas-cowboys,5000,2015
11276,0,4667,L'Damian Washington,WR,dead_cap,dallas-cowboys,4667,2015
11277,0,3334,Josh Aladenoye,RT,dead_cap,dallas-cowboys,3334,2015
11278,0,3334,Jarrod Pughsley,LT,dead_cap,dallas-cowboys,3334,2015
11279,0,2500,Antwan Goodley,WR,dead_cap,dallas-cowboys,2500,2015
11280,0,2334,Chris Boyd,WR,dead_cap,dallas-cowboys,2334,2015
11281,0,2000,Andre Cureton,G,dead_cap,dallas-cowboys,2000,2015
11282,0,1667,Evan Wilson,TE,dead_cap,dallas-cowboys,1667,2015
11283,0,1666,Nick Harwell,WR,dead_cap,dallas-cowboys,1666,2015
11284,0,1666,Shane McDermott,C,dead_cap,dallas-cowboys,1666,2015
11285,0,1666,Dustin Vaughan,QB,dead_cap,dallas-cowboys,1666,2015
11286,0,1500,Daniel Quave,G,dead_cap,dallas-cowboys,1500,2015
11287,0,1334,J.C. Copeland,FB,dead_cap,dallas-cowboys,1334,2015
11288,0,1334,Cody Mandell,P,dead_cap,dallas-cowboys,1334,2015
11289,0,1334,Marvin Robinson,S,dead_cap,dallas-cowboys,1334,2015
11290,0,1000,Brian Clarke,G,dead_cap,dallas-cowboys,1000,2015
11291,0,1000,Casey Kreiter,LS,dead_cap,dallas-cowboys,1000,2015
11292,0,1000,Jordan Najvar,TE,dead_cap,dallas-cowboys,1000,2015
11293,0,1000,Jocquel Skinner,CB,dead_cap,dallas-cowboys,1000,2015
11294,0,1000,Ryan Smith,S,dead_cap,dallas-cowboys,1000,2015
11295,0,1000,Joe Windsor,OLB,dead_cap,dallas-cowboys,1000,2015
11296,0,833,Synyn Days,RB,dead_cap,dallas-cowboys,833,2015
11297,0,833,Ray Hamilton,TE,dead_cap,dallas-cowboys,833,2015
11298,0,667,Dontavis Sapp,OLB,dead_cap,dallas-cowboys,667,2015
11299,0,666,Deontay Greenberry,WR,dead_cap,dallas-cowboys,666,2015
11300,0,333,Joel Ross,CB,dead_cap,dallas-cowboys,333,2015
11301,0,333,Jason Wilson,CB,dead_cap,dallas-cowboys,333,2015
11302,8500000,13970000,Tony Romo,QB,active,dallas-cowboys,22470000,2016
11303,9000000,4000000,Dez Bryant,WR,active,dallas-cowboys,13000000,2016
11304,4250000,5967000,Brandon Carr,CB,active,dallas-cowboys,10217000,2016
11305,1000000,5800000,Tyron Smith,LT,active,dallas-cowboys,6800000,2016
11306,1000000,5200000,Sean Lee,OLB,active,dallas-cowboys,6200000,2016
11307,1000000,4862000,Jason Witten,TE,active,dallas-cowboys,5862000,2016
11308,1000000,3796385,Orlando Scandrick,CB,active,dallas-cowboys,4796385,2016
11309,4250000,500000,Barry Church,SS,active,dallas-cowboys,4750000,2016
11310,450000,4087516,Ezekiel Elliott,RB,active,dallas-cowboys,4537516,2016
11311,2000000,2500000,Doug Free,RT,active,dallas-cowboys,4500000,2016
11312,1250000,3100000,Tyrone Crawford,DE,active,dallas-cowboys,4350000,2016
11313,2356000,1000000,Cole Beasley,WR,active,dallas-cowboys,3356000,2016
11314,2500000,800000,Dan Bailey,K,active,dallas-cowboys,3300000,2016
11315,1250000,1437500,Morris Claiborne,CB,active,dallas-cowboys,2687500,2016
11316,2553000,0,Ron Leary,G,active,dallas-cowboys,2553000,2016
11317,1235255,1210509,Zack Martin,G,active,dallas-cowboys,2445764,2016
11318,1000000,1250000,Cedric Thornton,DT,active,dallas-cowboys,2250000,2016
11319,691882,1494096,Travis Frederick,C,active,dallas-cowboys,2185978,2016
11320,1250000,900000,Darren McFadden,RB,active,dallas-cowboys,2150000,2016
11321,2000000,0,Mark Sanchez,QB,active,dallas-cowboys,2000000,2016
11322,825998,1128989,Byron Jones,CB,active,dallas-cowboys,1954987,2016
11323,1300000,600000,Andrew Gachkar,OLB,active,dallas-cowboys,1900000,2016
11324,1661000,164868,Terrance Williams,WR,active,dallas-cowboys,1825868,2016
11325,1661000,156517,J.J. Wilcox,FS,active,dallas-cowboys,1817517,2016
11326,700000,1100000,Benson Mayowa,DE,active,dallas-cowboys,1800000,2016
11327,1000000,500000,Kyle Wilber,OLB,active,dallas-cowboys,1500000,2016
11328,1200000,250000,Chris Jones,P,active,dallas-cowboys,1450000,2016
11329,900000,450000,Jeff Heath,FS,active,dallas-cowboys,1350000,2016
11330,979158,360545,Gavin Escobar,TE,active,dallas-cowboys,1339703,2016
11331,800000,500000,Alfred Morris,RB,active,dallas-cowboys,1300000,2016
11332,703992,581209,DeMarcus Lawrence,DE,active,dallas-cowboys,1285201,2016
11333,1050000,120000,L.P. Ladouceur,LS,active,dallas-cowboys,1170000,2016
11334,1000000,100000,Terrell McClain,DE,active,dallas-cowboys,1100000,2016
11335,860000,240000,Jack Crawford,DE,active,dallas-cowboys,1100000,2016
11336,800000,187500,Lance Dunbar,RB,active,dallas-cowboys,987500,2016
11337,775000,50000,Joe Looney,G,active,dallas-cowboys,825000,2016
11338,600000,108716,Anthony Hitchens,ILB,active,dallas-cowboys,708716,2016
11339,885000,80000,Justin Durant,OLB,active,dallas-cowboys,965000,2016
11340,675000,0,Brice Butler,WR,active,dallas-cowboys,675000,2016
11341,450000,220288,Maliek Collins,DT,active,dallas-cowboys,670288,2016
11342,525000,116578,Damien Wilson,OLB,active,dallas-cowboys,641578,2016
11343,600000,0,Keith Smith,FB,active,dallas-cowboys,600000,2016
11344,450000,95848,Dak Prescott,QB,active,dallas-cowboys,545848,2016
11345,525000,16087,Mark Nzeocha,ILB,active,dallas-cowboys,541087,2016
11346,525000,3333,Lucky Whitehead,WR,active,dallas-cowboys,528333,2016
11347,525000,0,David Irving,DT,active,dallas-cowboys,525000,2016
11348,450000,33736,Anthony Brown,CB,active,dallas-cowboys,483736,2016
11349,450000,25089,Kavon Frazier,S,active,dallas-cowboys,475089,2016
11350,432348,0,Emmett Cleary,RT,active,dallas-cowboys,432348,2016
11351,347823,0,Leon McFadden,CB,active,dallas-cowboys,347823,2016
11352,26470,0,Richard Ash,DT,active,dallas-cowboys,26470,2016
11353,760000,0,Kellen Moore,QB,injured_reserve,dallas-cowboys,760000,2016
11354,540375,156092,Chaz Green,G,injured_reserve,dallas-cowboys,696467,2016
11355,675000,0,Ryan Davis,DE,injured_reserve,dallas-cowboys,675000,2016
11356,525000,13683,Geoff Swaim,TE,injured_reserve,dallas-cowboys,538683,2016
11357,526750,7000,La'el Collins,RT,injured_reserve,dallas-cowboys,533750,2016
11358,353645,154470,Charles Tapper,DE,injured_reserve,dallas-cowboys,508115,2016
11359,428000,0,Joshua Thomas,CB,injured_reserve,dallas-cowboys,428000,2016
11360,348000,0,James Morris,ILB,injured_reserve,dallas-cowboys,348000,2016
11361,333000,0,Chris Brown,WR,injured_reserve,dallas-cowboys,333000,2016
11362,450000,730903,Jaylon Smith,ILB,non_fb_injury,dallas-cowboys,1180903,2016
11363,0,625000,Jasper Brinkley,ILB,dead_cap,dallas-cowboys,625000,2016
11364,370580,25089,Darius Jackson,RB,dead_cap,dallas-cowboys,395669,2016
11365,309158,0,Rod Smith,RB,dead_cap,dallas-cowboys,309158,2016
11366,227820,0,Vince Mayle,WR,dead_cap,dallas-cowboys,227820,2016
11367,158364,0,Zach Moore,DE,dead_cap,dallas-cowboys,158364,2016
11368,117300,25089,Rico Gathers,TE,dead_cap,dallas-cowboys,142389,2016
11369,136870,3334,Jameill Showers,QB,dead_cap,dallas-cowboys,140204,2016
11370,117300,5000,Andy Jones,WR,dead_cap,dallas-cowboys,122300,2016
11371,0,120000,Ryan Williams,RB,dead_cap,dallas-cowboys,120000,2016
11372,117300,0,Jeremiah George,ILB,dead_cap,dallas-cowboys,117300,2016
11373,111194,0,Ryan Seymour,G,dead_cap,dallas-cowboys,111194,2016
11374,110400,0,Sammy Seamster,CB,dead_cap,dallas-cowboys,110400,2016
11375,89760,0,Clay DeBord,T,dead_cap,dallas-cowboys,89760,2016
11376,55200,3334,Shane McDermott,C,dead_cap,dallas-cowboys,58534,2016
11377,6900,50747,Ryan Russell,DE,dead_cap,dallas-cowboys,57647,2016
11378,55200,0,Kadeem Edwards,G,dead_cap,dallas-cowboys,55200,2016
11379,0,50493,Devin Street,WR,dead_cap,dallas-cowboys,50493,2016
11380,0,47220,Joseph Randle,RB,dead_cap,dallas-cowboys,47220,2016
11381,0,42264,Laurence Gibson,T,dead_cap,dallas-cowboys,42264,2016
11382,41400,0,Keavon Milton,T,dead_cap,dallas-cowboys,41400,2016
11383,0,29588,Ben Gardner,DE,dead_cap,dallas-cowboys,29588,2016
11384,26470,0,Michael McAdoo,DE,dead_cap,dallas-cowboys,26470,2016
11385,20700,0,Chris McCain,OLB,dead_cap,dallas-cowboys,20700,2016
11386,16470,0,Dax Swanson,SS,dead_cap,dallas-cowboys,16470,2016
11387,13906,0,Brandon McGee,CB,dead_cap,dallas-cowboys,13906,2016
11388,13800,0,Jake Brendel,C,dead_cap,dallas-cowboys,13800,2016
11389,13800,0,Shelby Harris,DE,dead_cap,dallas-cowboys,13800,2016
11390,13800,0,Austin Traylor,TE,dead_cap,dallas-cowboys,13800,2016
11391,0,10000,George Farmer,WR,dead_cap,dallas-cowboys,10000,2016
11392,6900,2000,Deon King,OLB,dead_cap,dallas-cowboys,8900,2016
11393,6900,0,Leon McFadden,CB,dead_cap,dallas-cowboys,6900,2016
11394,0,6000,Kenneth Boatright,DE,dead_cap,dallas-cowboys,6000,2016
11395,0,5000,Antwan Goodley,WR,dead_cap,dallas-cowboys,5000,2016
11396,0,3334,Nick Harwell,WR,dead_cap,dallas-cowboys,3334,2016
11397,0,3334,Dustin Vaughan,QB,dead_cap,dallas-cowboys,3334,2016
11398,0,3000,Tim Scott,SS,dead_cap,dallas-cowboys,3000,2016
11399,0,2500,Jeremiah McKinnon,CB,dead_cap,dallas-cowboys,2500,2016
11400,0,2500,Rolan Milligan,S,dead_cap,dallas-cowboys,2500,2016
11401,0,1668,Chris Whaley,DT,dead_cap,dallas-cowboys,1668,2016
11402,0,1667,Synyn Days,RB,dead_cap,dallas-cowboys,1667,2016
11403,0,1667,Ray Hamilton,TE,dead_cap,dallas-cowboys,1667,2016
11404,0,1666,Caleb Azubike,DE,dead_cap,dallas-cowboys,1666,2016
11405,0,1666,David Hedelin,T,dead_cap,dallas-cowboys,1666,2016
11406,0,1334,Deontay Greenberry,WR,dead_cap,dallas-cowboys,1334,2016
11407,0,1334,Ray Vinopal,FS,dead_cap,dallas-cowboys,1334,2016
11408,0,667,Joel Ross,CB,dead_cap,dallas-cowboys,667,2016
11409,0,667,Jason Wilson,CB,dead_cap,dallas-cowboys,667,2016
11410,0,500,Boston Stiverson,G,dead_cap,dallas-cowboys,500,2016
11411,0,333,Ryan Mack,T,dead_cap,dallas-cowboys,333,2016
11412,13000000,4000000,Dez Bryant,WR,active,dallas-cowboys,17000000,2017
11413,7400000,4862000,Jason Witten,TE,active,dallas-cowboys,12262000,2017
11414,7250000,3100000,Tyrone Crawford,DE,active,dallas-cowboys,10350000,2017
11415,1300000,6025000,Sean Lee,OLB,active,dallas-cowboys,7325000,2017
11416,1584379,4087516,Ezekiel Elliott,RB,active,dallas-cowboys,5671895,2017
11417,1296000,3235000,Travis Frederick,C,active,dallas-cowboys,4531000,2017
11418,3500000,1000000,Cole Beasley,WR,active,dallas-cowboys,4500000,2017
11419,3200000,800000,Dan Bailey,K,active,dallas-cowboys,4000000,2017
11420,2250000,750000,James Hanna,TE,active,dallas-cowboys,3000000,2017
11421,1642882,1210509,Zack Martin,G,active,dallas-cowboys,2853391,2017
11422,1500000,1100000,Benson Mayowa,DE,active,dallas-cowboys,2600000,2017
11423,1216995,1128989,Byron Jones,CB,active,dallas-cowboys,2345984,2017
11424,1000000,1340333,La'el Collins,RT,active,dallas-cowboys,2340333,2017
11425,1000000,1250000,Terrance Williams,WR,active,dallas-cowboys,2250000,2017
11426,1200000,937500,Alfred Morris,RB,active,dallas-cowboys,2137500,2017
11427,1471000,450000,Jeff Heath,FS,active,dallas-cowboys,1921000,2017
11428,1797000,108716,Anthony Hitchens,ILB,active,dallas-cowboys,1905716,2017
11429,465000,1358343,Taco Charlton,DE,active,dallas-cowboys,1823343,2017
11430,1000000,775000,Byron Bell,RT,active,dallas-cowboys,1775000,2017
11431,1170907,581209,DeMarcus Lawrence,DE,active,dallas-cowboys,1752116,2017
11432,1250000,500000,Kyle Wilber,OLB,active,dallas-cowboys,1750000,2017
11433,1000000,656250,Jonathan Cooper,G,active,dallas-cowboys,1656250,2017
11434,800000,750000,Chris Jones,P,active,dallas-cowboys,1550000,2017
11435,745226,730903,Jaylon Smith,ILB,active,dallas-cowboys,1476129,2017
11436,1100000,120000,L.P. Ladouceur,LS,active,dallas-cowboys,1220000,2017
11437,800000,300000,Brice Butler,WR,active,dallas-cowboys,1100000,2017
11438,800000,50000,Joe Looney,G,active,dallas-cowboys,850000,2017
11439,612500,220288,Maliek Collins,DT,active,dallas-cowboys,832788,2017
11440,630375,156092,Chaz Green,G,active,dallas-cowboys,786467,2017
11441,465000,313834,Chidobe Awuzie,CB,active,dallas-cowboys,778834,2017
11442,615000,116578,Damien Wilson,OLB,active,dallas-cowboys,731578,2017
11443,690000,0,Bene Benwikere,CB,active,dallas-cowboys,690000,2017
11444,690000,0,Keith Smith,FB,active,dallas-cowboys,690000,2017
11445,465000,188357,Jourdan Lewis,CB,active,dallas-cowboys,653357,2017
11446,540000,95848,Dak Prescott,QB,active,dallas-cowboys,635848,2017
11447,615000,13683,Geoff Swaim,TE,active,dallas-cowboys,628683,2017
11448,615000,0,Rod Smith,RB,active,dallas-cowboys,615000,2017
11449,465000,141496,Ryan Switzer,WR,active,dallas-cowboys,606496,2017
11450,540000,33736,Anthony Brown,CB,active,dallas-cowboys,573736,2017
11451,540000,25089,Kavon Frazier,S,active,dallas-cowboys,565089,2017
11452,465000,39972,Xavier Woods,SS,active,dallas-cowboys,504972,2017
11453,465000,17984,Noah Brown,WR,active,dallas-cowboys,482984,2017
11454,470294,0,David Irving,DT,active,dallas-cowboys,470294,2017
11455,465000,1666,Cooper Rush,QB,active,dallas-cowboys,466666,2017
11456,381176,0,Justin March,ILB,active,dallas-cowboys,381176,2017
11457,349415,0,Richard Ash,DT,active,dallas-cowboys,349415,2017
11458,273530,8866,Blake Jarwin,TE,active,dallas-cowboys,282396,2017
11459,218824,0,Daniel Ross,DE,active,dallas-cowboys,218824,2017
11460,218824,0,Lewis Neal,DE,active,dallas-cowboys,218824,2017
11461,227941,0,Datone Jones,DE,active,dallas-cowboys,227941,2017
11462,95294,0,Trey Williams,RB,active,dallas-cowboys,95294,2017
11463,27353,0,Kadeem Edwards,G,active,dallas-cowboys,27353,2017
11464,27353,0,Tre'Von Johnson,OLB,active,dallas-cowboys,27353,2017
11465,27353,0,Lance Lenoir,WR,active,dallas-cowboys,27353,2017
11466,1275000,7545000,Tyron Smith,LT,injured_reserve,dallas-cowboys,8820000,2017
11467,3000000,2281021,Orlando Scandrick,CB,injured_reserve,dallas-cowboys,5281021,2017
11468,615000,0,Zac Dysert,QB,injured_reserve,dallas-cowboys,615000,2017
11469,404648,154470,Charles Tapper,DE,injured_reserve,dallas-cowboys,559118,2017
11470,456709,0,Brian Price,DT,injured_reserve,dallas-cowboys,456709,2017
11471,348000,16666,Rico Gathers,TE,injured_reserve,dallas-cowboys,364666,2017
11472,348000,0,Duke Thomas,S,injured_reserve,dallas-cowboys,348000,2017
11473,72000,0,Kellen Moore,QB,practice_squad,dallas-cowboys,72000,2017
11474,0,10700000,Tony Romo,QB,dead_cap,dallas-cowboys,10700000,2017
11475,2250000,1250000,Cedric Thornton,DT,dead_cap,dallas-cowboys,3500000,2017
11476,2717000,0,Brandon Carr,CB,dead_cap,dallas-cowboys,2717000,2017
11477,0,2500000,Doug Free,RT,dead_cap,dallas-cowboys,2500000,2017
11478,1000000,1000000,Nolan Carroll,CB,dead_cap,dallas-cowboys,2000000,2017
11479,950000,31250,Jayrone Elliott,OLB,dead_cap,dallas-cowboys,981250,2017
11480,775000,0,Kellen Moore,QB,dead_cap,dallas-cowboys,775000,2017
11481,1000000,80000,Justin Durant,OLB,dead_cap,dallas-cowboys,1080000,2017
11482,900000,80000,Darren McFadden,RB,dead_cap,dallas-cowboys,980000,2017
11483,227941,50000,Damontre Moore,DE,dead_cap,dallas-cowboys,277941,2017
11484,294118,0,Mike Nugent,K,dead_cap,dallas-cowboys,294118,2017
11485,122400,27503,Marquez White,CB,dead_cap,dallas-cowboys,149903,2017
11486,122400,0,Brian Brown,WR,dead_cap,dallas-cowboys,122400,2017
11487,115200,0,Kadeem Edwards,G,dead_cap,dallas-cowboys,115200,2017
11488,115200,0,Lance Lenoir,WR,dead_cap,dallas-cowboys,115200,2017
11489,108000,0,Jameill Showers,QB,dead_cap,dallas-cowboys,108000,2017
11490,0,101494,Ryan Russell,DE,dead_cap,dallas-cowboys,101494,2017
11491,100800,0,Jarron Jones,DT,dead_cap,dallas-cowboys,100800,2017
11492,93600,0,Tre'Von Johnson,OLB,dead_cap,dallas-cowboys,93600,2017
11493,0,80000,Robert Blanton,SS,dead_cap,dallas-cowboys,80000,2017
11494,0,80000,Luke McCown,QB,dead_cap,dallas-cowboys,80000,2017
11495,0,75267,Rico Gathers,TE,dead_cap,dallas-cowboys,75267,2017
11496,0,75267,Darius Jackson,RB,dead_cap,dallas-cowboys,75267,2017
11497,64800,0,Lewis Neal,DE,dead_cap,dallas-cowboys,64800,2017
11498,50400,5000,Blake Jarwin,TE,dead_cap,dallas-cowboys,55400,2017
11499,0,50493,Devin Street,WR,dead_cap,dallas-cowboys,50493,2017
11500,43200,0,Richard Ash,DT,dead_cap,dallas-cowboys,43200,2017
11501,21600,16087,Mark Nzeocha,ILB,dead_cap,dallas-cowboys,37687,2017
11502,28800,0,Trey Williams,RB,dead_cap,dallas-cowboys,28800,2017
11503,0,21622,Joey Ivie,DT,dead_cap,dallas-cowboys,21622,2017
11504,21600,0,Aaron Green,T,dead_cap,dallas-cowboys,21600,2017
11505,0,16871,Jordan Carrell,DT,dead_cap,dallas-cowboys,16871,2017
11506,14400,0,Dan Skipper,T,dead_cap,dallas-cowboys,14400,2017
11507,14400,0,Nate Theaker,G,dead_cap,dallas-cowboys,14400,2017
11508,0,10000,Andy Jones,WR,dead_cap,dallas-cowboys,10000,2017
11509,7200,0,K.D. Cannon,WR,dead_cap,dallas-cowboys,7200,2017
11510,7200,0,Stansly Maponga,DE,dead_cap,dallas-cowboys,7200,2017
11511,0,5000,Jeremiah McKinnon,CB,dead_cap,dallas-cowboys,5000,2017
11512,0,5000,Rolan Milligan,S,dead_cap,dallas-cowboys,5000,2017
11513,0,4000,Deon King,OLB,dead_cap,dallas-cowboys,4000,2017
11514,0,3334,Caleb Azubike,DE,dead_cap,dallas-cowboys,3334,2017
11515,0,3334,David Hedelin,T,dead_cap,dallas-cowboys,3334,2017
11516,0,3334,Lucky Whitehead,WR,dead_cap,dallas-cowboys,3334,2017
11517,0,1000,Boston Stiverson,G,dead_cap,dallas-cowboys,1000,2017
11518,0,667,Ryan Mack,T,dead_cap,dallas-cowboys,667,2017
11519,10000000,7545000,Tyron Smith,LT,active,dallas-cowboys,17545000,2018
11520,17143000,0,DeMarcus Lawrence,DE,active,dallas-cowboys,17143000,2018
11521,7000000,4025000,Sean Lee,OLB,active,dallas-cowboys,11025000,2018
11522,6000000,3100000,Tyrone Crawford,DE,active,dallas-cowboys,9100000,2018
11523,2718758,4087516,Ezekiel Elliott,RB,active,dallas-cowboys,6806274,2018
11524,2000000,4000000,Zack Martin,G,active,dallas-cowboys,6000000,2018
11525,4350000,1408333,La'el Collins,RT,active,dallas-cowboys,5758333,2018
11526,3250000,1000000,Cole Beasley,WR,active,dallas-cowboys,4250000,2018
11527,1607991,1128990,Byron Jones,CB,active,dallas-cowboys,2736981,2018
11528,1500000,950000,Jeff Heath,SS,active,dallas-cowboys,2450000,2018
11529,1000000,1437500,Cameron Fleming,T,active,dallas-cowboys,2437500,2018
11530,920836,1358343,Taco Charlton,DE,active,dallas-cowboys,2279179,2018
11531,2228352,0,David Irving,DT,active,dallas-cowboys,2228352,2018
11532,480000,1674142,Leighton Vander Esch,LB,active,dallas-cowboys,2154142,2018
11533,1000000,875000,Tavon Austin,WR,active,dallas-cowboys,1875000,2018
11534,1040452,730903,Jaylon Smith,ILB,active,dallas-cowboys,1771355,2018
11535,1200000,500000,Chris Jones,P,active,dallas-cowboys,1700000,2018
11536,1540000,100000,Jamize Olawale,FB,active,dallas-cowboys,1640000,2018
11537,900000,375000,Joe Thomas,ILB,active,dallas-cowboys,1275000,2018
11538,850000,375000,Joe Looney,C,active,dallas-cowboys,1225000,2018
11539,781813,231782,Randy Gregory,OLB,active,dallas-cowboys,1013595,2018
11540,480000,517998,Connor Williams,G,active,dallas-cowboys,997998,2018
11541,755000,220288,Maliek Collins,DT,active,dallas-cowboys,975288,2018
11542,659709,313834,Chidobe Awuzie,CB,active,dallas-cowboys,973543,2018
11543,705000,116581,Damien Wilson,OLB,active,dallas-cowboys,821581,2018
11544,743529,25000,Xavier Su'a-Filo,G,active,dallas-cowboys,768529,2018
11545,580000,188357,Jourdan Lewis,CB,active,dallas-cowboys,768357,2018
11546,630000,95848,Dak Prescott,QB,active,dallas-cowboys,725848,2018
11547,1015000,90000,L.P. Ladouceur,LS,active,dallas-cowboys,1105000,2018
11548,705000,0,Rod Smith,RB,active,dallas-cowboys,705000,2018
11549,480000,222495,Michael Gallup,WR,active,dallas-cowboys,702495,2018
11550,630000,33736,Anthony Brown,CB,active,dallas-cowboys,663736,2018
11551,630000,25089,Kavon Frazier,S,active,dallas-cowboys,655089,2018
11552,480000,167499,Dorance Armstrong,DE,active,dallas-cowboys,647499,2018
11553,630000,0,Justin March,ILB,active,dallas-cowboys,630000,2018
11554,555000,39972,Xavier Woods,FS,active,dallas-cowboys,594972,2018
11555,480000,113089,Dalton Schultz,TE,active,dallas-cowboys,593089,2018
11556,555000,8866,Blake Jarwin,TE,active,dallas-cowboys,563866,2018
11557,555000,1666,Cooper Rush,QB,active,dallas-cowboys,556666,2018
11558,555000,0,Daniel Ross,DT,active,dallas-cowboys,555000,2018
11559,480000,54388,Mike White,QB,active,dallas-cowboys,534388,2018
11560,480000,39077,Chris Covington,OLB,active,dallas-cowboys,519077,2018
11561,650594,0,Caraun Reid,DE,active,dallas-cowboys,650594,2018
11562,480000,16666,Rico Gathers,TE,active,dallas-cowboys,496666,2018
11563,480000,0,Brett Maher,K,active,dallas-cowboys,480000,2018
11564,480000,0,Adam Redmond,G,active,dallas-cowboys,480000,2018
11565,480000,0,Antwaun Woods,DT,active,dallas-cowboys,480000,2018
11566,461294,17984,Noah Brown,WR,active,dallas-cowboys,479278,2018
11567,444708,0,C.J. Goodwin,S,active,dallas-cowboys,444708,2018
11568,411765,0,Amari Cooper,WR,active,dallas-cowboys,411765,2018
11569,222353,0,Darian Thompson,FS,active,dallas-cowboys,222353,2018
11570,65294,0,Darius Jackson,RB,active,dallas-cowboys,65294,2018
11571,1300000,4975000,Travis Frederick,C,injured_reserve,dallas-cowboys,6275000,2018
11572,2500000,2250000,Allen Hurns,WR,injured_reserve,dallas-cowboys,4750000,2018
11573,2882353,1250000,Terrance Williams,WR,injured_reserve,dallas-cowboys,4132353,2018
11574,790000,0,Datone Jones,DT,injured_reserve,dallas-cowboys,790000,2018
11575,790000,0,Marcus Martin,G,injured_reserve,dallas-cowboys,790000,2018
11576,705000,13685,Geoff Swaim,TE,injured_reserve,dallas-cowboys,718685,2018
11577,705000,0,Marqueston Huff,FS,injured_reserve,dallas-cowboys,705000,2018
11578,630000,0,Parker Ehinger,G,injured_reserve,dallas-cowboys,630000,2018
11579,363000,29602,Cedrick Wilson,WR,injured_reserve,dallas-cowboys,392602,2018
11580,363000,0,Korren Kirven,T,injured_reserve,dallas-cowboys,363000,2018
11581,363000,0,Jameill Showers,QB,injured_reserve,dallas-cowboys,363000,2018
11582,363000,0,Dustin Stanton,T,injured_reserve,dallas-cowboys,363000,2018
11583,0,8900000,Tony Romo,QB,dead_cap,dallas-cowboys,8900000,2018
11584,0,8000000,Dez Bryant,WR,dead_cap,dallas-cowboys,8000000,2018
11585,0,2500000,Cedric Thornton,DT,dead_cap,dallas-cowboys,2500000,2018
11586,0,2281021,Orlando Scandrick,CB,dead_cap,dallas-cowboys,2281021,2018
11587,0,2000000,Nolan Carroll,CB,dead_cap,dallas-cowboys,2000000,2018
11588,790000,1000000,Deonte Thompson,WR,dead_cap,dallas-cowboys,1790000,2018
11589,0,1100000,Benson Mayowa,DE,dead_cap,dallas-cowboys,1100000,2018
11590,0,800000,Dan Bailey,K,dead_cap,dallas-cowboys,800000,2018
11591,0,750000,James Hanna,TE,dead_cap,dallas-cowboys,750000,2018
11592,555000,0,Kadeem Edwards,G,dead_cap,dallas-cowboys,555000,2018
11593,0,424491,Ryan Switzer,WR,dead_cap,dallas-cowboys,424491,2018
11594,322515,0,Lance Lenoir,WR,dead_cap,dallas-cowboys,322515,2018
11595,0,250000,Kony Ealy,DT,dead_cap,dallas-cowboys,250000,2018
11596,232353,0,Brice Butler,WR,dead_cap,dallas-cowboys,232353,2018
11597,213529,0,Trey Williams,RB,dead_cap,dallas-cowboys,213529,2018
11598,207355,0,Ibraheim Campbell,SS,dead_cap,dallas-cowboys,207355,2018
11599,207353,0,Darian Thompson,FS,dead_cap,dallas-cowboys,207353,2018
11600,164095,0,Treston Decoud,S,dead_cap,dallas-cowboys,164095,2018
11601,156777,0,Christian Ringo,DT,dead_cap,dallas-cowboys,156777,2018
11602,0,156095,Chaz Green,G,dead_cap,dallas-cowboys,156095,2018
11603,0,154470,Charles Tapper,DE,dead_cap,dallas-cowboys,154470,2018
11604,147670,0,Tyree Robinson,S,dead_cap,dallas-cowboys,147670,2018
11605,129200,0,Jordan Chunn,RB,dead_cap,dallas-cowboys,129200,2018
11606,129200,0,Donovan Olumba,CB,dead_cap,dallas-cowboys,129200,2018
11607,129200,0,Kyle Queiro,LB,dead_cap,dallas-cowboys,129200,2018
11608,129200,0,Cody Wichmann,G,dead_cap,dallas-cowboys,129200,2018
11609,115588,0,Richard Ash,DT,dead_cap,dallas-cowboys,115588,2018
11610,107271,0,Thomas DeCoud,S,dead_cap,dallas-cowboys,107271,2018
11611,0,82512,Marquez White,CB,dead_cap,dallas-cowboys,82512,2018
11612,76000,0,Darius Jackson,RB,dead_cap,dallas-cowboys,76000,2018
11613,68400,0,Aziz Shittu,DT,dead_cap,dallas-cowboys,68400,2018
11614,0,64867,Joey Ivie,DT,dead_cap,dallas-cowboys,64867,2018
11615,0,50613,Jordan Carrell,DT,dead_cap,dallas-cowboys,50613,2018
11616,0,50000,Damontre Moore,DE,dead_cap,dallas-cowboys,50000,2018
11617,38000,0,Bo Scarbrough,RB,dead_cap,dallas-cowboys,38000,2018
11618,22800,0,Oni Omoile,G,dead_cap,dallas-cowboys,22800,2018
11619,0,16087,Mark Nzeocha,ILB,dead_cap,dallas-cowboys,16087,2018
11620,15200,0,Dres Anderson,WR,dead_cap,dallas-cowboys,15200,2018
11621,0,10000,Blake Jarwin,TE,dead_cap,dallas-cowboys,10000,2018
11622,7600,0,Adolphus Washington,DT,dead_cap,dallas-cowboys,7600,2018
11623,0,333,Bryce Johnson,G,dead_cap,dallas-cowboys,333,2018
11624,10000000,5545000,Tyron Smith,LT,active,dallas-cowboys,15545000,2019
11625,10000000,4000000,Zack Martin,G,active,dallas-cowboys,14000000,2019
11626,13924000,0,Amari Cooper,WR,active,dallas-cowboys,13924000,2019
11627,1500000,9600000,DeMarcus Lawrence,DE,active,dallas-cowboys,11100000,2019
11628,6000000,4975000,Travis Frederick,C,active,dallas-cowboys,10975000,2019
11629,5294118,2628789,Robert Quinn,DE,active,dallas-cowboys,7922907,2019
11630,2000000,5575000,Sean Lee,OLB,active,dallas-cowboys,7575000,2019
11631,752137,5587518,Ezekiel Elliott,RB,active,dallas-cowboys,6339655,2019
11632,6266000,0,Byron Jones,CB,active,dallas-cowboys,6266000,2019
11633,2000000,2937500,Randall Cobb,WR,active,dallas-cowboys,4937500,2019
11634,2000000,2250000,Jason Witten,TE,active,dallas-cowboys,4250000,2019
11635,1016000,3208334,La'el Collins,RT,active,dallas-cowboys,4224334,2019
11636,1764706,1406250,Michael Bennett,DE,active,dallas-cowboys,3170956,2019
11637,2000000,700000,Jeff Heath,SS,active,dallas-cowboys,2700000,2019
11638,835678,1730906,Jaylon Smith,ILB,active,dallas-cowboys,2566584,2019
11639,1800000,500000,Chris Jones,P,active,dallas-cowboys,2300000,2019
11640,1750000,534375,Joe Thomas,ILB,active,dallas-cowboys,2284375,2019
11641,2025000,220288,Maliek Collins,DT,active,dallas-cowboys,2245288,2019
11642,1000000,1187500,Cameron Fleming,T,active,dallas-cowboys,2187500,2019
11643,2025000,95849,Dak Prescott,QB,active,dallas-cowboys,2120849,2019
11644,1000000,750000,Christian Covington,DT,active,dallas-cowboys,1750000,2019
11645,1000000,700000,Jamize Olawale,FB,active,dallas-cowboys,1700000,2019
11646,1000000,656250,Tavon Austin,WR,active,dallas-cowboys,1656250,2019
11647,1000000,625000,Joe Looney,C,active,dallas-cowboys,1625000,2019
11648,854417,313834,Chidobe Awuzie,CB,active,dallas-cowboys,1168251,2019
11649,700000,300000,Kerry Hyder,DE,active,dallas-cowboys,1000000,2019
11650,495000,390450,Trysten Hill,DT,active,dallas-cowboys,885450,2019
11651,675000,188357,Jourdan Lewis,CB,active,dallas-cowboys,863357,2019
11652,629000,222495,Michael Gallup,WR,active,dallas-cowboys,851495,2019
11653,570000,167499,Dorance Armstrong,DE,active,dallas-cowboys,737499,2019
11654,1030000,90000,L.P. Ladouceur,LS,active,dallas-cowboys,1120000,2019
11655,720000,0,C.J. Goodwin,CB,active,dallas-cowboys,720000,2019
11656,720000,0,Justin March,OLB,active,dallas-cowboys,720000,2019
11657,720000,0,Darian Thompson,FS,active,dallas-cowboys,720000,2019
11658,645000,39972,Xavier Woods,FS,active,dallas-cowboys,684972,2019
11659,570000,113089,Dalton Schultz,TE,active,dallas-cowboys,683089,2019
11660,495000,166945,Tony Pollard,RB,active,dallas-cowboys,661945,2019
11661,645000,8868,Blake Jarwin,TE,active,dallas-cowboys,653868,2019
11662,645000,1668,Cooper Rush,QB,active,dallas-cowboys,646668,2019
11663,645000,0,Devin Smith,WR,active,dallas-cowboys,645000,2019
11664,570000,0,Antwaun Woods,DT,active,dallas-cowboys,570000,2019
11665,495000,71422,Joe Jackson,DE,active,dallas-cowboys,566422,2019
11666,495000,31839,Donovan Wilson,S,active,dallas-cowboys,526839,2019
11667,495000,1666,Brandon Knight,G,active,dallas-cowboys,496666,2019
11668,378529,0,Ventell Bryant,WR,active,dallas-cowboys,378529,2019
11669,201176,0,Deante Burton,WR,active,dallas-cowboys,201176,2019
11670,164118,0,Kai Forbath,K,active,dallas-cowboys,164118,2019
11671,109412,0,Malcolm Smith,OLB,active,dallas-cowboys,109412,2019
11672,100588,0,Chris Covington,OLB,active,dallas-cowboys,100588,2019
11673,87353,0,Mitch Hyatt,T,active,dallas-cowboys,87353,2019
11674,47353,0,Ray-Ray Armstrong,ILB,active,dallas-cowboys,47353,2019
11675,29118,0,Wyatt Miller,T,active,dallas-cowboys,29118,2019
11676,29118,0,Donovan Olumba,CB,active,dallas-cowboys,29118,2019
11677,7000000,3100000,Tyrone Crawford,DT,injured_reserve,dallas-cowboys,10100000,2019
11678,1018535,1674142,Leighton Vander Esch,OLB,injured_reserve,dallas-cowboys,2692677,2019
11679,2025000,33739,Anthony Brown,CB,injured_reserve,dallas-cowboys,2058739,2019
11680,729500,517998,Connor Williams,G,injured_reserve,dallas-cowboys,1247498,2019
11681,805000,25000,Xavier Su'a-Filo,G,injured_reserve,dallas-cowboys,830000,2019
11682,720000,25089,Kavon Frazier,S,injured_reserve,dallas-cowboys,745089,2019
11683,645000,0,Daniel Ross,DT,injured_reserve,dallas-cowboys,645000,2019
11684,378000,220527,Connor McGovern,C,injured_reserve,dallas-cowboys,598527,2019
11685,547412,0,Adam Redmond,C,injured_reserve,dallas-cowboys,547412,2019
11686,495000,1666,Luke Gifford,LB,injured_reserve,dallas-cowboys,496666,2019
11687,445235,0,Cedrick Wilson,WR,injured_reserve,dallas-cowboys,445235,2019
11688,408000,0,Cody Wichmann,G,injured_reserve,dallas-cowboys,408000,2019
11689,378000,19667,Jalen Jelks,OLB,injured_reserve,dallas-cowboys,397667,2019
11690,393000,0,Lance Lenoir,WR,injured_reserve,dallas-cowboys,393000,2019
11691,378000,3333,Jon’Vea Johnson,WR,injured_reserve,dallas-cowboys,381333,2019
11692,378000,3333,Chris Westry,CB,injured_reserve,dallas-cowboys,381333,2019
11693,0,2389706,Terrance Williams,WR,dead_cap,dallas-cowboys,2389706,2019
11694,0,1600000,Orlando Scandrick,CB,dead_cap,dallas-cowboys,1600000,2019
11695,161961,1358343,Taco Charlton,DE,dead_cap,dallas-cowboys,1520304,2019
11696,0,1250000,Allen Hurns,WR,dead_cap,dallas-cowboys,1250000,2019
11697,469406,0,Brett Maher,K,dead_cap,dallas-cowboys,469406,2019
11698,210000,90000,George Iloka,FS,dead_cap,dallas-cowboys,300000,2019
11699,242000,6666,Mitch Hyatt,T,dead_cap,dallas-cowboys,248666,2019
11700,226000,3333,Daniel Wise,DT,dead_cap,dallas-cowboys,229333,2019
11701,227647,0,Josh Jones,S,dead_cap,dallas-cowboys,227647,2019
11702,137529,39077,Chris Covington,OLB,dead_cap,dallas-cowboys,176606,2019
11703,136000,27098,Mike Weber,RB,dead_cap,dallas-cowboys,163098,2019
11704,0,154470,Charles Tapper,DE,dead_cap,dallas-cowboys,154470,2019
11705,149118,0,Jordan Chunn,RB,dead_cap,dallas-cowboys,149118,2019
11706,64000,75855,Michael Jackson,CB,dead_cap,dallas-cowboys,139855,2019
11707,136000,0,Cole Hikutini,TE,dead_cap,dallas-cowboys,136000,2019
11708,136000,0,Clayton Thorson,QB,dead_cap,dallas-cowboys,136000,2019
11709,128000,0,Donovan Olumba,CB,dead_cap,dallas-cowboys,128000,2019
11710,37941,90000,Alfred Morris,RB,dead_cap,dallas-cowboys,127941,2019
11711,72000,0,D.J. White,CB,dead_cap,dallas-cowboys,72000,2019
11712,66706,1000,Derrick Puni,T,dead_cap,dallas-cowboys,67706,2019
11713,0,54388,Mike White,QB,dead_cap,dallas-cowboys,54388,2019
11714,48000,0,Marcus Henry,C,dead_cap,dallas-cowboys,48000,2019
11715,45000,1666,Andrew Dowell,LB,dead_cap,dallas-cowboys,46666,2019
11716,45000,1666,Ricky Walker,DE,dead_cap,dallas-cowboys,46666,2019
11717,42353,0,Caleb Benenoch,RT,dead_cap,dallas-cowboys,42353,2019
11718,37941,0,Justin Hamilton,DT,dead_cap,dallas-cowboys,37941,2019
11719,8000,29602,Cedrick Wilson,WR,dead_cap,dallas-cowboys,37602,2019
11720,32000,0,Ventell Bryant,WR,dead_cap,dallas-cowboys,32000,2019
11721,22235,0,Jameill Showers,QB,dead_cap,dallas-cowboys,22235,2019
11722,0,16668,Rico Gathers,TE,dead_cap,dallas-cowboys,16668,2019
11723,16000,0,Darius Jackson,RB,dead_cap,dallas-cowboys,16000,2019
11724,16000,0,Tyler Jones,T,dead_cap,dallas-cowboys,16000,2019
11725,16000,0,Tevin Jones,WR,dead_cap,dallas-cowboys,16000,2019
11726,8000,0,Cyril Grayson,WR,dead_cap,dallas-cowboys,8000,2019
11727,0,1666,Larry Allen Jr.,G,dead_cap,dallas-cowboys,1666,2019
11728,0,1666,Nate Hall,LB,dead_cap,dallas-cowboys,1666,2019
11729,0,667,Bryce Johnson,G,dead_cap,dallas-cowboys,667,2019
11730,16900000,5000000,DeMarcus Lawrence,DE,active,dallas-cowboys,21900000,2020
11731,11000000,4000000,Zack Martin,G,active,dallas-cowboys,15000000,2020
11732,10000000,3545000,Tyron Smith,LT,active,dallas-cowboys,13545000,2020
11733,7000000,4975000,Travis Frederick,C,active,dallas-cowboys,11975000,2020
11734,6800000,6700000,Ezekiel Elliott,RB,active,dallas-cowboys,13500000,2020
11735,8000000,1100000,Tyrone Crawford,DT,active,dallas-cowboys,9100000,2020
11736,6450000,3200000,La'el Collins,RT,active,dallas-cowboys,9650000,2020
11737,5171000,4200000,Jaylon Smith,ILB,active,dallas-cowboys,9371000,2020
11738,4000000,1187500,Cameron Fleming,T,active,dallas-cowboys,5187500,2020
11739,1557071,1674142,Leighton Vander Esch,OLB,active,dallas-cowboys,3231213,2020
11740,1900000,500000,Chris Jones,P,active,dallas-cowboys,2400000,2020
11741,1000000,700000,Jamize Olawale,FB,active,dallas-cowboys,1700000,2020
11742,978999,517998,Connor Williams,G,active,dallas-cowboys,1496997,2020
11743,1049126,313834,Chidobe Awuzie,CB,active,dallas-cowboys,1362960,2020
11744,716362,390450,Trysten Hill,DT,active,dallas-cowboys,1106812,2020
11745,775000,188357,Jourdan Lewis,CB,active,dallas-cowboys,963357,2020
11746,721000,222495,Michael Gallup,WR,active,dallas-cowboys,943495,2020
11747,735000,155000,Randy Gregory,OLB,active,dallas-cowboys,890000,2020
11748,657000,220527,Connor McGovern,C,active,dallas-cowboys,877527,2020
11749,660000,167499,Dorance Armstrong,DE,active,dallas-cowboys,827499,2020
11750,735000,39972,Xavier Woods,FS,active,dallas-cowboys,774972,2020
11751,660000,113089,Dalton Schultz,TE,active,dallas-cowboys,773089,2020
11752,735000,17986,Noah Brown,WR,active,dallas-cowboys,752986,2020
11753,585000,166945,Tony Pollard,RB,active,dallas-cowboys,751945,2020
11754,735000,0,Devin Smith,WR,active,dallas-cowboys,735000,2020
11755,735000,0,D.J. White,CB,active,dallas-cowboys,735000,2020
11756,660000,0,Deante Burton,WR,active,dallas-cowboys,660000,2020
11757,660000,0,Chris Covington,OLB,active,dallas-cowboys,660000,2020
11758,660000,0,Cody Wichmann,G,active,dallas-cowboys,660000,2020
11759,585000,71422,Joe Jackson,DE,active,dallas-cowboys,656422,2020
11760,585000,31839,Donovan Wilson,S,active,dallas-cowboys,616839,2020
11761,585000,2500,Tevin Jones,WR,active,dallas-cowboys,587500,2020
11762,585000,1666,Luke Gifford,LB,active,dallas-cowboys,586666,2020
11763,585000,1666,Brandon Knight,G,active,dallas-cowboys,586666,2020
11764,585000,0,Ventell Bryant,WR,active,dallas-cowboys,585000,2020
11765,585000,0,Cole Hikutini,TE,active,dallas-cowboys,585000,2020
11766,585000,0,Mitch Hyatt,T,active,dallas-cowboys,585000,2020
11767,585000,0,Lance Lenoir,WR,active,dallas-cowboys,585000,2020
11768,585000,0,Cedrick Wilson,WR,active,dallas-cowboys,585000,2020
11769,510000,25000,Clayton Thorson,QB,active,dallas-cowboys,535000,2020
11770,510000,19667,Jalen Jelks,OLB,active,dallas-cowboys,529667,2020
11771,510000,3333,Jon’Vea Johnson,WR,active,dallas-cowboys,513333,2020
11772,510000,3333,Chris Westry,CB,active,dallas-cowboys,513333,2020
11773,510000,0,Jordan Chunn,RB,active,dallas-cowboys,510000,2020
11774,510000,0,Marcus Henry,C,active,dallas-cowboys,510000,2020
11775,510000,0,Wyatt Miller,T,active,dallas-cowboys,510000,2020
11776,510000,0,Donovan Olumba,CB,active,dallas-cowboys,510000,2020
11777,510000,0,Daniel Wise,DT,active,dallas-cowboys,510000,2020
11778,0,1358343,Taco Charlton,DE,dead_cap,dallas-cowboys,1358343,2020
11779,0,227565,Michael Jackson,CB,dead_cap,dallas-cowboys,227565,2020
11780,0,108777,Mike White,QB,dead_cap,dallas-cowboys,108777,2020
11781,0,81294,Mike Weber,RB,dead_cap,dallas-cowboys,81294,2020
11782,0,78154,Chris Covington,OLB,dead_cap,dallas-cowboys,78154,2020
11783,0,59204,Cedrick Wilson,WR,dead_cap,dallas-cowboys,59204,2020
11784,0,13334,Mitch Hyatt,T,dead_cap,dallas-cowboys,13334,2020
11785,0,6667,Daniel Wise,DT,dead_cap,dallas-cowboys,6667,2020
11786,0,3334,Larry Allen Jr.,G,dead_cap,dallas-cowboys,3334,2020
11787,0,3334,Andrew Dowell,LB,dead_cap,dallas-cowboys,3334,2020
11788,0,3334,Nate Hall,LB,dead_cap,dallas-cowboys,3334,2020
11789,0,3334,Ricky Walker,DE,dead_cap,dallas-cowboys,3334,2020
11790,0,2000,Derrick Puni,T,dead_cap,dallas-cowboys,2000,2020
11791,720000,7091575,Champ Bailey,CB,active,denver-broncos,7811575,2007
11792,1500000,516666,John Lynch,S,active,denver-broncos,2016666,2007
11793,600000,2200000,Daniel Graham,TE,active,denver-broncos,2800000,2007
11794,600000,4100000,Javon Walker,WR,active,denver-broncos,4700000,2007
11795,360000,3155000,Jay Cutler,QB,active,denver-broncos,3515000,2007
11796,595000,1200000,Travis Henry,RB,active,denver-broncos,1795000,2007
11797,650000,1705000,D.J. Williams,ILB,active,denver-broncos,2355000,2007
11798,720000,643750,Brandon Stokley,WR,active,denver-broncos,1363750,2007
11799,595000,727500,Patrick Ramsey,QB,active,denver-broncos,1322500,2007
11800,285000,259250,Tim Crowder,DE,active,denver-broncos,544250,2007
11801,720000,75000,Mike Leach,LS,active,denver-broncos,795000,2007
11802,360000,409000,Tony Scheffler,TE,active,denver-broncos,769000,2007
11803,435000,185000,Karl Paymah,CB,active,denver-broncos,620000,2007
11804,595000,0,Montrae Holland,G,active,denver-broncos,595000,2007
11805,595000,0,Kenny Peterson,DT,active,denver-broncos,595000,2007
11806,435000,143433,Domonique Foxworth,CB,active,denver-broncos,578433,2007
11807,285000,201250,Ryan Harris,LT,active,denver-broncos,486250,2007
11808,360000,105000,Brandon Marshall,WR,active,denver-broncos,465000,2007
11809,360000,99750,Elvis Dumervil,OLB,active,denver-broncos,459750,2007
11810,435000,0,Hamza Abdullah,CB,active,denver-broncos,435000,2007
11811,435000,0,Chris Myers,C,active,denver-broncos,435000,2007
11812,435000,0,Marviel Underwood,S,active,denver-broncos,435000,2007
11813,360000,38750,Chris Kuper,G,active,denver-broncos,398750,2007
11814,285000,107000,Marcus Thomas,DT,active,denver-broncos,392000,2007
11815,360000,0,Paul Ernster,K,active,denver-broncos,360000,2007
11816,360000,0,Erik Pears,RT,active,denver-broncos,360000,2007
11817,285000,0,Matt Prater,K,active,denver-broncos,285000,2007
11818,232941,0,Jordan Beck,LB,active,denver-broncos,232941,2007
11819,1500000,2046428,Rod Smith,WR,injured_reserve,denver-broncos,3546428,2007
11820,285000,1015000,Jarvis Moss,DE,injured_reserve,denver-broncos,1300000,2007
11821,0,11712000,Jake Plummer,QB,dead_cap,denver-broncos,11712000,2007
11822,2400000,0,Travis Henry,RB,dead_cap,denver-broncos,2400000,2007
11823,0,1547250,Courtney Brown,DE,dead_cap,denver-broncos,1547250,2007
11824,0,1140000,George Foster,T,dead_cap,denver-broncos,1140000,2007
11825,0,990000,Ashley Lelie,WR,dead_cap,denver-broncos,990000,2007
11826,0,500000,Ron Dayne,RB,dead_cap,denver-broncos,500000,2007
11827,287250,0,Domenik Hixon,WR,dead_cap,denver-broncos,287250,2007
11828,100000,0,Cornell Green,T,dead_cap,denver-broncos,100000,2007
11829,21125,0,Greg Eslinger,C,dead_cap,denver-broncos,21125,2007
11830,7000,0,Brandon Browner,CB,dead_cap,denver-broncos,7000,2007
11831,7500000,7590050,Champ Bailey,CB,active,denver-broncos,15090050,2008
11832,700000,4700000,Daniel Graham,TE,active,denver-broncos,5400000,2008
11833,900000,3000000,Dewayne Robertson,DT,active,denver-broncos,3900000,2008
11834,830000,1815416,Brandon Stokley,WR,active,denver-broncos,2645416,2008
11835,647500,3255000,Jay Cutler,QB,active,denver-broncos,3902500,2008
11836,850000,1930000,D.J. Williams,ILB,active,denver-broncos,2780000,2008
11837,295000,1418000,Ryan Clady,LT,active,denver-broncos,1713000,2008
11838,370000,2330000,Jarvis Moss,DE,active,denver-broncos,2700000,2008
11839,927000,0,Chris Myers,C,active,denver-broncos,927000,2008
11840,927000,0,Karl Paymah,CB,active,denver-broncos,927000,2008
11841,730000,75000,Mike Leach,LS,active,denver-broncos,805000,2008
11842,445000,248000,Tony Scheffler,TE,active,denver-broncos,693000,2008
11843,295000,383250,Eddie Royal,WR,active,denver-broncos,678250,2008
11844,370000,259250,Tim Crowder,DE,active,denver-broncos,629250,2008
11845,605000,0,Mario Haggan,LB,active,denver-broncos,605000,2008
11846,605000,0,Kenny Peterson,DT,active,denver-broncos,605000,2008
11847,370000,201250,Ryan Harris,LT,active,denver-broncos,571250,2008
11848,445000,105000,Brandon Marshall,WR,active,denver-broncos,550000,2008
11849,445000,99750,Elvis Dumervil,OLB,active,denver-broncos,544750,2008
11850,520000,0,Dylan Gandy,G,active,denver-broncos,520000,2008
11851,445000,38750,Chris Kuper,G,active,denver-broncos,483750,2008
11852,370000,107000,Marcus Thomas,DT,active,denver-broncos,477000,2008
11853,445000,0,Chad Jackson,WR,active,denver-broncos,445000,2008
11854,445000,0,Erik Pears,RT,active,denver-broncos,445000,2008
11855,295000,121312,Kory Lichtensteiger,C,active,denver-broncos,416312,2008
11856,295000,113000,Jack Williams,CB,active,denver-broncos,408000,2008
11857,389375,0,Calvin Lowry,S,active,denver-broncos,389375,2008
11858,370000,0,Matt Prater,K,active,denver-broncos,370000,2008
11859,320000,45065,Carlton Powell,DT,active,denver-broncos,365065,2008
11860,295000,24381,Spencer Larsen,RB,active,denver-broncos,319381,2008
11861,295000,7333,Tyler Polumbus,LT,active,denver-broncos,302333,2008
11862,295000,6667,Wesley Woodyard,ILB,active,denver-broncos,301667,2008
11863,295000,5000,Brett Kern,P,active,denver-broncos,300000,2008
11864,295000,6667,Anthony Alridge,RB,active,denver-broncos,301667,2008
11865,104117,0,Josh Barrett,S,active,denver-broncos,104117,2008
11866,700000,2477500,Patrick Ramsey,QB,injured_reserve,denver-broncos,3177500,2008
11867,605000,860000,Boss Bailey,LB,injured_reserve,denver-broncos,1465000,2008
11868,295000,12450,Peyton Hillis,RB,injured_reserve,denver-broncos,307450,2008
11869,88400,0,Josh Barrett,S,practice_squad,denver-broncos,88400,2008
11870,88400,0,Ryan McBean,DE,practice_squad,denver-broncos,88400,2008
11871,0,13600000,Javon Walker,WR,dead_cap,denver-broncos,13600000,2008
11872,3091665,0,Gerard Warren,DT,dead_cap,denver-broncos,3091665,2008
11873,2400000,0,Travis Henry,RB,dead_cap,denver-broncos,2400000,2008
11874,0,2046428,Rod Smith,WR,dead_cap,denver-broncos,2046428,2008
11875,1016666,0,John Lynch,S,dead_cap,denver-broncos,1016666,2008
11876,833333,0,Keary Colbert,WR,dead_cap,denver-broncos,833333,2008
11877,0,1140000,George Foster,T,dead_cap,denver-broncos,1140000,2008
11878,42250,0,Greg Eslinger,C,dead_cap,denver-broncos,42250,2008
11879,14075,0,Josh Barrett,S,dead_cap,denver-broncos,14075,2008
11880,10975,0,Cory Boyd,RB,dead_cap,denver-broncos,10975,2008
11881,10400,0,Steve Baylark,RB,dead_cap,denver-broncos,10400,2008
11882,6500000,9588525,Champ Bailey,CB,active,denver-broncos,16088525,2009
11883,3200000,4700000,Daniel Graham,TE,active,denver-broncos,7900000,2009
11884,4100000,1930000,D.J. Williams,ILB,active,denver-broncos,6030000,2009
11885,4080000,600000,Andre' Goodman,CB,active,denver-broncos,4680000,2009
11886,1410000,2345416,Brandon Stokley,WR,active,denver-broncos,3755416,2009
11887,2500000,375000,Jabar Gaffney,WR,active,denver-broncos,2875000,2009
11888,385000,2748125,Ryan Clady,LT,active,denver-broncos,3133125,2009
11889,1400000,1256000,Brian Dawkins,S,active,denver-broncos,2656000,2009
11890,2198000,105000,Brandon Marshall,WR,active,denver-broncos,2303000,2009
11891,1500000,775000,Ronald Fields,DT,active,denver-broncos,2275000,2009
11892,2000000,0,Justin Bannan,DT,active,denver-broncos,2000000,2009
11893,660000,2300000,Jarvis Moss,DE,active,denver-broncos,2960000,2009
11894,920000,832000,Knowshon Moreno,RB,active,denver-broncos,1752000,2009
11895,1200000,450000,Correll Buckhalter,RB,active,denver-broncos,1650000,2009
11896,1200000,270000,Andra Davis,LB,active,denver-broncos,1470000,2009
11897,310000,1060000,Robert Ayers,DE,active,denver-broncos,1370000,2009
11898,770000,373333,Mario Haggan,LB,active,denver-broncos,1143333,2009
11899,995000,100000,Kyle Orton,QB,active,denver-broncos,1095000,2009
11900,1010000,38750,Chris Kuper,G,active,denver-broncos,1048750,2009
11901,385000,620526,Eddie Royal,WR,active,denver-broncos,1005526,2009
11902,845000,150000,Vonnie Holliday,DT,active,denver-broncos,995000,2009
11903,800000,166666,Kenny Peterson,DT,active,denver-broncos,966666,2009
11904,745000,182600,Lonie Paxton,LS,active,denver-broncos,927600,2009
11905,310000,232500,Richard Quinn,TE,active,denver-broncos,542500,2009
11906,310000,537500,Alphonso Smith,CB,active,denver-broncos,847500,2009
11907,535000,248000,Tony Scheffler,TE,active,denver-broncos,783000,2009
11908,745000,0,Russ Hochstein,G,active,denver-broncos,745000,2009
11909,310000,386000,Darcel McBath,S,active,denver-broncos,696000,2009
11910,460000,201250,Ryan Harris,LT,active,denver-broncos,661250,2009
11911,535000,99750,Elvis Dumervil,OLB,active,denver-broncos,634750,2009
11912,460000,107000,Marcus Thomas,DT,active,denver-broncos,567000,2009
11913,535000,0,Le Kevin Smith,DT,active,denver-broncos,535000,2009
11914,497058,0,Mitch Berger,P,active,denver-broncos,497058,2009
11915,460000,0,Matt Prater,K,active,denver-broncos,460000,2009
11916,310000,120600,David Bruton,SS,active,denver-broncos,430600,2009
11917,310000,103530,Seth Olsen,G,active,denver-broncos,413530,2009
11918,385000,24381,Spencer Larsen,RB,active,denver-broncos,409381,2009
11919,385000,12450,Peyton Hillis,RB,active,denver-broncos,397450,2009
11920,385000,7333,Tyler Polumbus,LT,active,denver-broncos,392333,2009
11921,385000,6667,Wesley Woodyard,ILB,active,denver-broncos,391667,2009
11922,385000,0,Josh Barrett,S,active,denver-broncos,385000,2009
11923,385000,0,Ryan McBean,DE,active,denver-broncos,385000,2009
11924,310000,50050,Kenny McKinley,WR,active,denver-broncos,360050,2009
11925,310000,45970,Cornelius Ingram,TE,active,denver-broncos,355970,2009
11926,310000,45970,Cornelius Ingram,TE,active,denver-broncos,355970,2009
11927,310000,41333,Tom Brandstater,QB,active,denver-broncos,351333,2009
11928,310000,5000,Chris Baker,DT,active,denver-broncos,315000,2009
11929,310000,0,Britton Colquitt,P,active,denver-broncos,310000,2009
11930,46800,0,Lance Ball,RB,practice_squad,denver-broncos,46800,2009
11931,4732500,0,Jay Cutler,QB,dead_cap,denver-broncos,4732500,2009
11932,1666666,0,Keary Colbert,WR,dead_cap,denver-broncos,1666666,2009
11933,860000,0,Boss Bailey,LB,dead_cap,denver-broncos,860000,2009
11934,259250,0,Tim Crowder,DE,dead_cap,denver-broncos,259250,2009
11935,121312,0,Kory Lichtensteiger,C,dead_cap,denver-broncos,121312,2009
11936,0,100000,J.J. Arrington,RB,dead_cap,denver-broncos,100000,2009
11937,75000,0,Mike Leach,LS,dead_cap,denver-broncos,75000,2009
11938,45065,0,Carlton Powell,DT,dead_cap,denver-broncos,45065,2009
11939,42225,0,Josh Barrett,S,dead_cap,denver-broncos,42225,2009
11940,32925,0,Cory Boyd,RB,dead_cap,denver-broncos,32925,2009
11941,14321,0,Blake Schlueter,C,dead_cap,denver-broncos,14321,2009
11942,10400,0,D'Anthony Batiste,G,dead_cap,denver-broncos,10400,2009
11943,5000,0,Brett Kern,P,dead_cap,denver-broncos,5000,2009
11944,13000000,7095000,Champ Bailey,CB,active,denver-broncos,20095000,2010
11945,3800000,5200000,Daniel Graham,TE,active,denver-broncos,9000000,2010
11946,395000,6615600,Knowshon Moreno,RB,active,denver-broncos,7010600,2010
11947,395000,4786250,Robert Ayers,DE,active,denver-broncos,5181250,2010
11948,3670000,1250000,D.J. Williams,ILB,active,denver-broncos,4920000,2010
11949,4080000,600000,Andre' Goodman,CB,active,denver-broncos,4680000,2010
11950,1105000,2748125,Ryan Clady,LT,active,denver-broncos,3853125,2010
11951,1820000,1256000,Brian Dawkins,S,active,denver-broncos,3076000,2010
11952,2500000,375000,Jabar Gaffney,WR,active,denver-broncos,2875000,2010
11953,1950000,775000,Ronald Fields,DT,active,denver-broncos,2725000,2010
11954,2612000,0,Kyle Orton,QB,active,denver-broncos,2612000,2010
11955,2512000,0,Brandon Marshall,WR,active,denver-broncos,2512000,2010
11956,1560000,450000,Correll Buckhalter,RB,active,denver-broncos,2010000,2010
11957,755000,1249000,Justin Bannan,DT,active,denver-broncos,2004000,2010
11958,1500000,373333,Mario Haggan,LB,active,denver-broncos,1873333,2010
11959,1295000,472500,Tim Tebow,QB,active,denver-broncos,1767500,2010
11960,755000,50000,Justin Fargas,RB,active,denver-broncos,805000,2010
11961,1310000,0,Demaryius Thomas,WR,active,denver-broncos,1310000,2010
11962,630000,500000,Elvis Dumervil,OLB,active,denver-broncos,1130000,2010
11963,470000,620526,Eddie Royal,WR,active,denver-broncos,1090526,2010
11964,630000,415166,Chris Kuper,G,active,denver-broncos,1045166,2010
11965,855000,182600,Lonie Paxton,LS,active,denver-broncos,1037600,2010
11966,755000,250000,Brandon Lloyd,WR,active,denver-broncos,1005000,2010
11967,630000,250000,Nathan Jones,CB,active,denver-broncos,880000,2010
11968,395000,386000,Darcel McBath,S,active,denver-broncos,781000,2010
11969,776470,0,Laurence Maroney,RB,active,denver-broncos,776470,2010
11970,755000,0,Russ Hochstein,G,active,denver-broncos,755000,2010
11971,550000,201250,Ryan Harris,LT,active,denver-broncos,751250,2010
11972,320000,430000,Zane Beadles,G,active,denver-broncos,750000,2010
11973,700000,0,Brady Quinn,QB,active,denver-broncos,700000,2010
11974,630000,50000,J.J. Arrington,RB,active,denver-broncos,680000,2010
11975,550000,107000,Marcus Thomas,DT,active,denver-broncos,657000,2010
11976,630000,0,Jason Hunter,DE,active,denver-broncos,630000,2010
11977,395000,232500,Richard Quinn,TE,active,denver-broncos,627500,2010
11978,545000,0,Matt Prater,K,active,denver-broncos,545000,2010
11979,541764,0,Lendale White,RB,active,denver-broncos,541764,2010
11980,320000,199625,J.D. Walton,C,active,denver-broncos,519625,2010
11981,395000,120600,David Bruton,SS,active,denver-broncos,515600,2010
11982,320000,183037,Eric Decker,WR,active,denver-broncos,503037,2010
11983,470000,24381,Spencer Larsen,RB,active,denver-broncos,494381,2010
11984,475000,6667,Wesley Woodyard,ILB,active,denver-broncos,481667,2010
11985,470000,0,Ryan McBean,DE,active,denver-broncos,470000,2010
11986,395000,50050,Kenny McKinley,WR,active,denver-broncos,445050,2010
11987,395000,26500,Eric Olsen,C,active,denver-broncos,421500,2010
11988,395000,8667,Dan Gronkowski,TE,active,denver-broncos,403667,2010
11989,320000,50500,Perrish Cox,CB,active,denver-broncos,370500,2010
11990,320000,45970,Cornelius Ingram,TE,active,denver-broncos,365970,2010
11991,320000,45970,Cornelius Ingram,TE,active,denver-broncos,365970,2010
11992,357800,0,Lance Ball,RB,active,denver-broncos,357800,2010
11993,320000,14212,Syd'Quan Thompson,CB,active,denver-broncos,334212,2010
11994,320000,3333,Cassius Vaughn,CB,active,denver-broncos,323333,2010
11995,320000,666,Ben Garland,G,active,denver-broncos,320666,2010
11996,320000,0,Britton Colquitt,P,active,denver-broncos,320000,2010
11997,152565,0,Mitch Unrein,DE,active,denver-broncos,152565,2010
11998,1400000,3663065,Brandon Stokley,WR,injured_reserve,denver-broncos,5063065,2010
11999,88400,0,Lionel Dotson,DE,practice_squad,denver-broncos,88400,2010
12000,88400,0,Bruce Hall,RB,practice_squad,denver-broncos,88400,2010
12001,22100,0,Mitch Unrein,DE,practice_squad,denver-broncos,22100,2010
12002,2580000,0,Boss Bailey,LB,dead_cap,denver-broncos,2580000,2010
12003,205000,2350000,Jarvis Moss,DE,dead_cap,denver-broncos,2555000,2010
12004,407647,0,D'Anthony Batiste,G,dead_cap,denver-broncos,407647,2010
12005,0,333334,Kenny Peterson,DT,dead_cap,denver-broncos,333334,2010
12006,270000,0,Andra Davis,LB,dead_cap,denver-broncos,270000,2010
12007,259250,0,Tim Crowder,DE,dead_cap,denver-broncos,259250,2010
12008,242624,0,Kory Lichtensteiger,C,dead_cap,denver-broncos,242624,2010
12009,123999,0,Tom Brandstater,QB,dead_cap,denver-broncos,123999,2010
12010,103530,0,Seth Olsen,G,dead_cap,denver-broncos,103530,2010
12011,91940,0,Cornelius Ingram,TE,dead_cap,denver-broncos,91940,2010
12012,90130,0,Carlton Powell,DT,dead_cap,denver-broncos,90130,2010
12013,42963,0,Blake Schlueter,C,dead_cap,denver-broncos,42963,2010
12014,24900,0,Peyton Hillis,RB,dead_cap,denver-broncos,24900,2010
12015,0,12350,Jammie Kirlew,DE,dead_cap,denver-broncos,12350,2010
12016,7333,0,Tyler Polumbus,LT,dead_cap,denver-broncos,7333,2010
12017,0,5000,Chris Baker,DT,dead_cap,denver-broncos,5000,2010
12018,5000,0,Brett Kern,P,dead_cap,denver-broncos,5000,2010
12019,3666,0,Nathan Overbay,TE,dead_cap,denver-broncos,3666,2010
12020,14000000,2746000,Elvis Dumervil,OLB,active,denver-broncos,16746000,2011
12021,6500000,4500000,Champ Bailey,CB,active,denver-broncos,11000000,2011
12022,4900000,1250000,D.J. Williams,ILB,active,denver-broncos,6150000,2011
12023,4000000,415166,Chris Kuper,G,active,denver-broncos,4415166,2011
12024,2550000,2748125,Ryan Clady,LT,active,denver-broncos,5298125,2011
12025,375000,3443251,Von Miller,OLB,active,denver-broncos,3818251,2011
12026,2880000,600000,Andre' Goodman,CB,active,denver-broncos,3480000,2011
12027,1600000,1556000,Brian Dawkins,S,active,denver-broncos,3156000,2011
12028,1500000,1250000,Ty Warren,DT,active,denver-broncos,2750000,2011
12029,1000000,2345600,Knowshon Moreno,RB,active,denver-broncos,3345600,2011
12030,1930000,373333,Mario Haggan,LB,active,denver-broncos,2303333,2011
12031,405000,1756250,Demaryius Thomas,WR,active,denver-broncos,2161250,2011
12032,542500,1569375,Tim Tebow,QB,active,denver-broncos,2111875,2011
12033,880000,1181250,Robert Ayers,DE,active,denver-broncos,2061250,2011
12034,635000,2570000,Brodrick Bunkley,DT,active,denver-broncos,3205000,2011
12035,1000000,875000,Kevin Vickerson,DT,active,denver-broncos,1875000,2011
12036,1835000,0,Matt Prater,K,active,denver-broncos,1835000,2011
12037,1835000,0,Wesley Woodyard,ILB,active,denver-broncos,1835000,2011
12038,1000000,500000,Willis McGahee,RB,active,denver-broncos,1500000,2011
12039,600000,620528,Eddie Royal,WR,active,denver-broncos,1220528,2011
12040,865000,182600,Lonie Paxton,LS,active,denver-broncos,1047600,2011
12041,900000,100000,Marcus Thomas,DT,active,denver-broncos,1000000,2011
12042,865000,0,Russ Hochstein,G,active,denver-broncos,865000,2011
12043,865000,0,Jason Hunter,DE,active,denver-broncos,865000,2011
12044,405000,430000,Zane Beadles,G,active,denver-broncos,835000,2011
12045,375000,433750,Rahim Moore,FS,active,denver-broncos,808750,2011
12046,375000,417000,Orlando Franklin,G,active,denver-broncos,792000,2011
12047,700000,0,Brady Quinn,QB,active,denver-broncos,700000,2011
12048,685000,0,Manuel Ramirez,G,active,denver-broncos,685000,2011
12049,600000,50000,Derrick Harvey,DE,active,denver-broncos,650000,2011
12050,640000,0,Lendale White,RB,active,denver-broncos,640000,2011
12051,405000,199625,J.D. Walton,C,active,denver-broncos,604625,2011
12052,480000,120600,David Bruton,SS,active,denver-broncos,600600,2011
12053,555000,45250,Alvin Bowen,LB,active,denver-broncos,600250,2011
12054,600000,0,Steven Hauschka,K,active,denver-broncos,600000,2011
12055,600000,0,Ryan McBean,DE,active,denver-broncos,600000,2011
12056,405000,183037,Eric Decker,WR,active,denver-broncos,588037,2011
12057,555000,24381,Spencer Larsen,RB,active,denver-broncos,579381,2011
12058,375000,173750,Nate Irving,ILB,active,denver-broncos,548750,2011
12059,685000,0,Dante Rosario,TE,active,denver-broncos,685000,2011
12060,375000,113750,Quinton Carter,S,active,denver-broncos,488750,2011
12061,480000,0,Jeremy Jarmon,DT,active,denver-broncos,480000,2011
12062,480000,0,Matt Willis,WR,active,denver-broncos,480000,2011
12063,375000,96000,Julius Thomas,TE,active,denver-broncos,471000,2011
12064,450000,3333,Cassius Vaughn,CB,active,denver-broncos,453333,2011
12065,450000,0,Lance Ball,RB,active,denver-broncos,450000,2011
12066,405000,14212,Syd'Quan Thompson,CB,active,denver-broncos,419212,2011
12067,405000,666,Ben Garland,G,active,denver-broncos,405666,2011
12068,405000,0,Chris Clark,LT,active,denver-broncos,405000,2011
12069,405000,0,Britton Colquitt,P,active,denver-broncos,405000,2011
12070,405000,0,Dan Gronkowski,TE,active,denver-broncos,405000,2011
12071,375000,16236,Virgil Green,TE,active,denver-broncos,391236,2011
12072,375000,3333,Mark Dell,WR,active,denver-broncos,378333,2011
12073,375000,3333,Mario Fannin,RB,active,denver-broncos,378333,2011
12074,375000,668,Chris Harris,CB,active,denver-broncos,375668,2011
12075,375000,0,D'Andre Goodwin,WR,active,denver-broncos,375000,2011
12076,375000,0,Mike Mohamed,ILB,active,denver-broncos,375000,2011
12077,375000,0,Mitch Unrein,DE,active,denver-broncos,375000,2011
12078,330000,0,Lee Robinson,ILB,active,denver-broncos,330000,2011
12079,262058,0,Rafael Bush,FS,active,denver-broncos,262058,2011
12080,4996000,0,Justin Bannan,DT,dead_cap,denver-broncos,4996000,2011
12081,0,4500000,Daniel Graham,TE,dead_cap,denver-broncos,4500000,2011
12082,0,2300000,Jarvis Moss,DE,dead_cap,denver-broncos,2300000,2011
12083,492352,250000,Brandon Lloyd,WR,dead_cap,denver-broncos,742352,2011
12084,450000,0,Correll Buckhalter,RB,dead_cap,denver-broncos,450000,2011
12085,386000,0,Darcel McBath,S,dead_cap,denver-broncos,386000,2011
12086,250000,0,Nathan Jones,CB,dead_cap,denver-broncos,250000,2011
12087,232500,0,Richard Quinn,TE,dead_cap,denver-broncos,232500,2011
12088,207060,0,Seth Olsen,G,dead_cap,denver-broncos,207060,2011
12089,91940,0,Cornelius Ingram,TE,dead_cap,denver-broncos,91940,2011
12090,0,67333,Perrish Cox,CB,dead_cap,denver-broncos,67333,2011
12091,0,37050,Jammie Kirlew,DE,dead_cap,denver-broncos,37050,2011
12092,0,26500,Eric Olsen,C,dead_cap,denver-broncos,26500,2011
12093,0,11475,Jeremy Beal,DE,dead_cap,denver-broncos,11475,2011
12094,7334,0,Nathan Overbay,TE,dead_cap,denver-broncos,7334,2011
12095,0,5000,Chris Baker,DT,dead_cap,denver-broncos,5000,2011
12096,0,4050,Mike Mohamed,ILB,dead_cap,denver-broncos,4050,2011
12097,18000000,0,Peyton Manning,QB,active,denver-broncos,18000000,2012
12098,14000000,2746000,Elvis Dumervil,OLB,active,denver-broncos,16746000,2012
12099,8000000,3250000,Champ Bailey,CB,active,denver-broncos,11250000,2012
12100,4900000,1600000,D.J. Williams,ILB,active,denver-broncos,6500000,2012
12101,3500000,2748125,Ryan Clady,LT,active,denver-broncos,6248125,2012
12102,1329563,3443251,Von Miller,OLB,active,denver-broncos,4772814,2012
12103,3500000,415166,Chris Kuper,G,active,denver-broncos,3915166,2012
12104,3000000,1000000,Tracy Porter,CB,active,denver-broncos,4000000,2012
12105,642250,3018000,Demaryius Thomas,WR,active,denver-broncos,3660250,2012
12106,3294117,166667,Joe Mays,ILB,active,denver-broncos,3460784,2012
12107,2000000,500000,Willis McGahee,RB,active,denver-broncos,2500000,2012
12108,855000,2345600,Knowshon Moreno,RB,active,denver-broncos,3200600,2012
12109,965000,1181250,Robert Ayers,DE,active,denver-broncos,2146250,2012
12110,2000000,0,Mike Adams,SS,active,denver-broncos,2000000,2012
12111,1000000,812500,Matt Prater,K,active,denver-broncos,1812500,2012
12112,1500000,250000,Wesley Woodyard,ILB,active,denver-broncos,1750000,2012
12113,1200000,500000,Kevin Vickerson,DT,active,denver-broncos,1700000,2012
12114,1000000,666666,Joel Dreessen,TE,active,denver-broncos,1666666,2012
12115,1000000,500000,Jacob Tamme,TE,active,denver-broncos,1500000,2012
12116,1260000,0,Matt Willis,WR,active,denver-broncos,1260000,2012
12117,1000000,125000,Caleb Hanie,QB,active,denver-broncos,1125000,2012
12118,577188,433750,Rahim Moore,FS,active,denver-broncos,1010938,2012
12119,1000000,0,Justin Bannan,DT,active,denver-broncos,1000000,2012
12120,1000000,0,Keith Brooking,LB,active,denver-broncos,1000000,2012
12121,573000,417000,Orlando Franklin,G,active,denver-broncos,990000,2012
12122,390000,556691,Derek Wolfe,DE,active,denver-broncos,946691,2012
12123,490000,430000,Zane Beadles,G,active,denver-broncos,920000,2012
12124,825000,0,Dan Koppen,C,active,denver-broncos,825000,2012
12125,700000,100000,Andre Caldwell,WR,active,denver-broncos,800000,2012
12126,615000,120600,David Bruton,SS,active,denver-broncos,735600,2012
12127,700000,0,Manuel Ramirez,G,active,denver-broncos,700000,2012
12128,490000,199625,J.D. Walton,C,active,denver-broncos,689625,2012
12129,490000,183037,Eric Decker,WR,active,denver-broncos,673037,2012
12130,825000,65000,Jim Leonhard,S,active,denver-broncos,890000,2012
12131,390000,249396,Brock Osweiler,QB,active,denver-broncos,639396,2012
12132,465000,173750,Nate Irving,ILB,active,denver-broncos,638750,2012
12133,615000,0,Tony Carter,CB,active,denver-broncos,615000,2012
12134,465000,113750,Quinton Carter,S,active,denver-broncos,578750,2012
12135,390000,172708,Ronnie Hillman,RB,active,denver-broncos,562708,2012
12136,465000,96000,Julius Thomas,TE,active,denver-broncos,561000,2012
12137,925000,0,Brandon Stokley,WR,active,denver-broncos,925000,2012
12138,540000,0,Lance Ball,RB,active,denver-broncos,540000,2012
12139,540000,0,Chris Clark,LT,active,denver-broncos,540000,2012
12140,540000,0,Britton Colquitt,P,active,denver-broncos,540000,2012
12141,540000,0,Chris Gronkowski,RB,active,denver-broncos,540000,2012
12142,390000,118607,Omar Bolden,FS,active,denver-broncos,508607,2012
12143,465000,16236,Virgil Green,TE,active,denver-broncos,481236,2012
12144,465000,668,Chris Harris,CB,active,denver-broncos,465668,2012
12145,465000,0,C.J. Davis,C,active,denver-broncos,465000,2012
12146,390000,53403,Malik Jackson,DT,active,denver-broncos,443403,2012
12147,390000,26018,Danny Trevathan,ILB,active,denver-broncos,416018,2012
12148,415000,0,Mitch Unrein,DE,active,denver-broncos,415000,2012
12149,390000,4000,Steven Johnson,ILB,active,denver-broncos,394000,2012
12150,390000,1333,Aaron Brewer,LS,active,denver-broncos,391333,2012
12151,390000,667,Austin Wuebbels,G,active,denver-broncos,390667,2012
12152,390000,0,Jeremy Beal,DE,active,denver-broncos,390000,2012
12153,390000,0,Trindon Holliday,KR,active,denver-broncos,390000,2012
12154,390000,0,Sealver Siliga,DT,active,denver-broncos,390000,2012
12155,390000,0,Duke Ihenacho,SS,active,denver-broncos,390000,2012
12156,700000,0,Jacob Hester,RB,active,denver-broncos,700000,2012
12157,1250000,1500000,Ty Warren,DT,injured_reserve,denver-broncos,2750000,2012
12158,700000,0,Jason Hunter,DE,injured_reserve,denver-broncos,700000,2012
12159,390000,3333,Mario Fannin,RB,injured_reserve,denver-broncos,393333,2012
12160,195000,113400,Philip Blake,G,injured_reserve,denver-broncos,308400,2012
12161,1250000,0,Ty Warren,DT,dead_cap,denver-broncos,1250000,2012
12162,1200000,0,Andre' Goodman,CB,dead_cap,denver-broncos,1200000,2012
12163,0,1156000,Brian Dawkins,S,dead_cap,denver-broncos,1156000,2012
12164,750000,0,Drayton Florence,CB,dead_cap,denver-broncos,750000,2012
12165,500000,0,Nathan Jones,CB,dead_cap,denver-broncos,500000,2012
12166,450000,0,Correll Buckhalter,RB,dead_cap,denver-broncos,450000,2012
12167,386000,0,Darcel McBath,S,dead_cap,denver-broncos,386000,2012
12168,375000,0,Jabar Gaffney,WR,dead_cap,denver-broncos,375000,2012
12169,232500,0,Richard Quinn,TE,dead_cap,denver-broncos,232500,2012
12170,182600,0,Lonie Paxton,LS,dead_cap,denver-broncos,182600,2012
12171,0,134666,Perrish Cox,CB,dead_cap,denver-broncos,134666,2012
12172,130375,0,Duke Ihenacho,SS,dead_cap,denver-broncos,130375,2012
12173,0,53000,Eric Olsen,C,dead_cap,denver-broncos,53000,2012
12174,0,34425,Jeremy Beal,DE,dead_cap,denver-broncos,34425,2012
12175,0,14212,Syd'Quan Thompson,CB,dead_cap,denver-broncos,14212,2012
12176,0,12150,Mike Mohamed,ILB,dead_cap,denver-broncos,12150,2012
12177,10000,0,Jamie Blatnick,DE,dead_cap,denver-broncos,10000,2012
12178,10000,0,Jerry Franklin,OLB,dead_cap,denver-broncos,10000,2012
12179,10000,0,Coryell Judie,CB,dead_cap,denver-broncos,10000,2012
12180,3500,0,Gerell Robinson,WR,dead_cap,denver-broncos,3500,2012
12181,0,3334,Cassius Vaughn,CB,dead_cap,denver-broncos,3334,2012
12182,3000,0,Elliot Coffey,ILB,dead_cap,denver-broncos,3000,2012
12183,2000,0,Wayne Tribue,G,dead_cap,denver-broncos,2000,2012
12184,1666,0,Anthony Miller,TE,dead_cap,denver-broncos,1666,2012
12185,1666,0,Mike Remmers,RT,dead_cap,denver-broncos,1666,2012
12186,1334,0,Austin Wuebbels,G,dead_cap,denver-broncos,1334,2012
12187,1085,0,Eric Page,WR,dead_cap,denver-broncos,1085,2012
12188,666,0,Ben Garland,G,dead_cap,denver-broncos,666,2012
12189,15000000,2500000,Peyton Manning,QB,active,denver-broncos,17500000,2013
12190,1500000,11100000,Ryan Clady,LT,active,denver-broncos,12600000,2013
12191,9500000,1250000,Champ Bailey,CB,active,denver-broncos,10750000,2013
12192,1477964,3443251,Von Miller,OLB,active,denver-broncos,4921215,2013
12193,2000000,2150000,Wes Welker,WR,active,denver-broncos,4150000,2013
12194,2500000,1166666,Joel Dreessen,TE,active,denver-broncos,3666666,2013
12195,2500000,812500,Matt Prater,K,active,denver-broncos,3312500,2013
12196,1700000,2345600,Knowshon Moreno,RB,active,denver-broncos,4045600,2013
12197,3000000,250000,Wesley Woodyard,ILB,active,denver-broncos,3250000,2013
12198,2000000,1250000,Louis Vasquez,G,active,denver-broncos,3250000,2013
12199,2625000,500000,Jacob Tamme,TE,active,denver-broncos,3125000,2013
12200,800000,2100000,Dominique Rodgers-Cromartie,CB,active,denver-broncos,2900000,2013
12201,836500,1756250,Demaryius Thomas,WR,active,denver-broncos,2592750,2013
12202,1000000,1500000,Kevin Vickerson,DT,active,denver-broncos,2500000,2013
12203,1060000,1181250,Robert Ayers,DE,active,denver-broncos,2241250,2013
12204,1050000,415166,Chris Kuper,G,active,denver-broncos,1465166,2013
12205,1750000,250000,Mike Adams,SS,active,denver-broncos,2000000,2013
12206,1250000,750000,Britton Colquitt,P,active,denver-broncos,2000000,2013
12207,1000000,750000,Terrance Knighton,DT,active,denver-broncos,1750000,2013
12208,1323000,225666,Chris Clark,LT,active,denver-broncos,1548666,2013
12209,940000,600000,Paris Lenon,ILB,active,denver-broncos,1540000,2013
12210,1323000,183037,Eric Decker,WR,active,denver-broncos,1506037,2013
12211,1000000,500000,Quentin Jammer,S,active,denver-broncos,1500000,2013
12212,1000000,400000,Shaun Phillips,DE,active,denver-broncos,1400000,2013
12213,405000,973500,Sylvester Williams,DT,active,denver-broncos,1378500,2013
12214,815000,416666,Manuel Ramirez,G,active,denver-broncos,1231666,2013
12215,779375,433750,Rahim Moore,FS,active,denver-broncos,1213125,2013
12216,800000,400000,David Bruton,SS,active,denver-broncos,1200000,2013
12217,771000,417000,Orlando Franklin,G,active,denver-broncos,1188000,2013
12218,480000,703363,Derek Wolfe,DE,active,denver-broncos,1183363,2013
12219,630000,430000,Zane Beadles,G,active,denver-broncos,1060000,2013
12220,900000,100000,Andre Caldwell,WR,active,denver-broncos,1000000,2013
12221,840000,250000,Winston Justice,LT,active,denver-broncos,1090000,2013
12222,549848,249396,Brock Osweiler,QB,active,denver-broncos,799244,2013
12223,555000,173750,Nate Irving,ILB,active,denver-broncos,728750,2013
12224,715000,0,Tony Carter,CB,active,denver-broncos,715000,2013
12225,515000,172708,Ronnie Hillman,RB,active,denver-broncos,687708,2013
12226,555000,113750,Quinton Carter,S,active,denver-broncos,668750,2013
12227,555000,96000,Julius Thomas,TE,active,denver-broncos,651000,2013
12228,405000,224878,Montee Ball,RB,active,denver-broncos,629878,2013
12229,480000,118607,Omar Bolden,FS,active,denver-broncos,598607,2013
12230,555000,16236,Virgil Green,TE,active,denver-broncos,571236,2013
12231,555000,668,Chris Harris,CB,active,denver-broncos,555668,2013
12232,715000,0,Steve Vallos,C,active,denver-broncos,715000,2013
12233,555000,0,Mitch Unrein,DE,active,denver-broncos,555000,2013
12234,405000,134950,Kayvon Webster,CB,active,denver-broncos,539950,2013
12235,480000,53403,Malik Jackson,DT,active,denver-broncos,533403,2013
12236,480000,26018,Danny Trevathan,ILB,active,denver-broncos,506018,2013
12237,480000,4000,Steven Johnson,ILB,active,denver-broncos,484000,2013
12238,480000,1333,Aaron Brewer,LS,active,denver-broncos,481333,2013
12239,480000,0,Trindon Holliday,KR,active,denver-broncos,480000,2013
12240,480000,0,Duke Ihenacho,SS,active,denver-broncos,480000,2013
12241,405000,12050,Zac Dysert,QB,active,denver-broncos,417050,2013
12242,405000,4166,C.J. Anderson,RB,active,denver-broncos,409166,2013
12243,840000,0,Michael Huff,S,active,denver-broncos,840000,2013
12244,288000,5666,Lerentee McCray,OLB,active,denver-broncos,293666,2013
12245,555000,0,Sione Fua,DT,active,denver-broncos,555000,2013
12246,480000,0,Brandon Marshall,ILB,active,denver-broncos,480000,2013
12247,405000,0,Vinston Painter,RT,active,denver-broncos,405000,2013
12248,900000,300000,Stewart Bradley,ILB,injured_reserve,denver-broncos,1200000,2013
12249,840000,175000,Dan Koppen,C,injured_reserve,denver-broncos,1015000,2013
12250,288000,48000,Quanterus Smith,DE,injured_reserve,denver-broncos,336000,2013
12251,36000,0,Chad Bumphis,WR,practice_squad,denver-broncos,36000,2013
12252,4869000,0,Elvis Dumervil,OLB,dead_cap,denver-broncos,4869000,2013
12253,2082500,0,D.J. Williams,ILB,dead_cap,denver-broncos,2082500,2013
12254,1366978,0,J.D. Walton,C,dead_cap,denver-broncos,1366978,2013
12255,750000,0,Drayton Florence,CB,dead_cap,denver-broncos,750000,2013
12256,500000,166666,Joe Mays,ILB,dead_cap,denver-broncos,666666,2013
12257,500000,0,Willis McGahee,RB,dead_cap,denver-broncos,500000,2013
12258,367647,0,John Moffitt,G,dead_cap,denver-broncos,367647,2013
12259,182600,0,Lonie Paxton,LS,dead_cap,denver-broncos,182600,2013
12260,169412,0,Adrian Robinson,OLB,dead_cap,denver-broncos,169412,2013
12261,168694,0,Tavarres King,WR,dead_cap,denver-broncos,168694,2013
12262,125000,0,Caleb Hanie,QB,dead_cap,denver-broncos,125000,2013
12263,113400,0,Philip Blake,G,dead_cap,denver-broncos,113400,2013
12264,101671,0,Justin Boren,G,dead_cap,denver-broncos,101671,2013
12265,100000,0,Ryan Lilja,C,dead_cap,denver-broncos,100000,2013
12266,96000,0,Brandon Marshall,ILB,dead_cap,denver-broncos,96000,2013
12267,84705,0,Greg Orton,WR,dead_cap,denver-broncos,84705,2013
12268,66000,0,Edwin Baker,RB,dead_cap,denver-broncos,66000,2013
12269,29483,0,Vinston Painter,RT,dead_cap,denver-broncos,29483,2013
12270,0,14212,Syd'Quan Thompson,CB,dead_cap,denver-broncos,14212,2013
12271,3334,0,Mario Fannin,RB,dead_cap,denver-broncos,3334,2013
12272,3334,0,Anthony Miller,TE,dead_cap,denver-broncos,3334,2013
12273,3334,0,Mike Remmers,RT,dead_cap,denver-broncos,3334,2013
12274,3000,0,Gary Mason Jr.,DE,dead_cap,denver-broncos,3000,2013
12275,2500,0,Aaron Hester,CB,dead_cap,denver-broncos,2500,2013
12276,2000,0,Manase Foketi,G,dead_cap,denver-broncos,2000,2013
12277,1667,0,Quincy McDuffie,WR,dead_cap,denver-broncos,1667,2013
12278,1667,0,Ross Rasner,S,dead_cap,denver-broncos,1667,2013
12279,1500,0,Doug Rippy,LB,dead_cap,denver-broncos,1500,2013
12280,0,1000,Ryan Katz,QB,dead_cap,denver-broncos,1000,2013
12281,1000,0,Uona Kaveinga,OLB,dead_cap,denver-broncos,1000,2013
12282,1000,0,Lucas Reed,TE,dead_cap,denver-broncos,1000,2013
12283,1000,0,John Youboty,DE,dead_cap,denver-broncos,1000,2013
12284,833,0,Lamaar Thomas,WR,dead_cap,denver-broncos,833,2013
12285,0,700,Ryan Doerr,P,dead_cap,denver-broncos,700,2013
12286,0,666,Romney Fuga,DT,dead_cap,denver-broncos,666,2013
12287,0,500,Kemonte' Bateman,WR,dead_cap,denver-broncos,500,2013
12288,15000000,2500000,Peyton Manning,QB,active,denver-broncos,17500000,2014
12289,3000000,6666666,DeMarcus Ware,OLB,active,denver-broncos,9666666,2014
12290,8000000,600000,Ryan Clady,LT,active,denver-broncos,8600000,2014
12291,4500000,3406250,Aqib Talib,CB,active,denver-broncos,7906250,2014
12292,2647059,5000000,Wes Welker,WR,active,denver-broncos,7647059,2014
12293,3000000,4250000,Louis Vasquez,G,active,denver-broncos,7250000,2014
12294,3238688,3374500,Von Miller,OLB,active,denver-broncos,6613188,2014
12295,3275000,1756250,Demaryius Thomas,WR,active,denver-broncos,5031250,2014
12296,2187000,2000000,Chris Harris,CB,active,denver-broncos,4187000,2014
12297,2000000,2000000,Emmanuel Sanders,WR,active,denver-broncos,4000000,2014
12298,2000000,1250000,Britton Colquitt,P,active,denver-broncos,3250000,2014
12299,2000000,1250000,T.J. Ward,SS,active,denver-broncos,3250000,2014
12300,1500000,1250000,Terrance Knighton,DT,active,denver-broncos,2750000,2014
12301,1250000,1166666,Manuel Ramirez,G,active,denver-broncos,2416666,2014
12302,1250000,950000,Jacob Tamme,TE,active,denver-broncos,2200000,2014
12303,1900000,225666,Chris Clark,LT,active,denver-broncos,2125666,2014
12304,1200000,725000,Will Montgomery,C,active,denver-broncos,1925000,2014
12305,749625,973500,Sylvester Williams,DT,active,denver-broncos,1723125,2014
12306,1250000,400000,David Bruton,SS,active,denver-broncos,1650000,2014
12307,1431000,0,Mitch Unrein,DE,active,denver-broncos,1431000,2014
12308,710017,710019,Derek Wolfe,DE,active,denver-broncos,1420036,2014
12309,981563,433750,Rahim Moore,FS,active,denver-broncos,1415313,2014
12310,969000,417000,Orlando Franklin,G,active,denver-broncos,1386000,2014
12311,420000,844096,Bradley Roby,CB,active,denver-broncos,1264096,2014
12312,950000,200000,Andre Caldwell,WR,active,denver-broncos,1150000,2014
12313,570000,389096,Brock Osweiler,QB,active,denver-broncos,959096,2014
12314,645000,173750,Nate Irving,ILB,active,denver-broncos,818750,2014
12315,635000,172708,Ronnie Hillman,RB,active,denver-broncos,807708,2014
12316,645000,113750,Quinton Carter,S,active,denver-broncos,758750,2014
12317,645000,96000,Julius Thomas,TE,active,denver-broncos,741000,2014
12318,570000,118607,Omar Bolden,FS,active,denver-broncos,688607,2014
12319,420000,254300,Cody Latimer,WR,active,denver-broncos,674300,2014
12320,645000,16236,Virgil Green,TE,active,denver-broncos,661236,2014
12321,507000,134950,Kayvon Webster,CB,active,denver-broncos,641950,2014
12322,570000,53403,Malik Jackson,DT,active,denver-broncos,623403,2014
12323,570000,26018,Danny Trevathan,ILB,active,denver-broncos,596018,2014
12324,570000,4000,Steven Johnson,ILB,active,denver-broncos,574000,2014
12325,570000,1333,Aaron Brewer,LS,active,denver-broncos,571333,2014
12326,730000,0,Tony Carter,CB,active,denver-broncos,730000,2014
12327,570000,0,Marvin Austin,DT,active,denver-broncos,570000,2014
12328,420000,130300,Michael Schofield,RT,active,denver-broncos,550300,2014
12329,495000,4166,C.J. Anderson,RB,active,denver-broncos,499166,2014
12330,495000,0,Brandon Marshall,ILB,active,denver-broncos,495000,2014
12331,420000,47790,Lamin Barrow,ILB,active,denver-broncos,467790,2014
12332,420000,12150,Corey Nelson,ILB,active,denver-broncos,432150,2014
12333,420000,5666,Lerentee McCray,OLB,active,denver-broncos,425666,2014
12334,420000,1166,Juwan Thompson,RB,active,denver-broncos,421166,2014
12335,420000,0,Paul Cornick,RT,active,denver-broncos,420000,2014
12336,420000,0,Ben Garland,G,active,denver-broncos,420000,2014
12337,373000,0,Jordan Norwood,WR,active,denver-broncos,373000,2014
12338,303000,833,Kenny Anunike,DE,active,denver-broncos,303833,2014
12339,730000,0,Connor Barth,K,active,denver-broncos,730000,2014
12340,570000,0,Jeremy Stewart,RB,active,denver-broncos,570000,2014
12341,420000,0,Todd Davis,ILB,active,denver-broncos,420000,2014
12342,420000,0,Brandon McManus,K,active,denver-broncos,420000,2014
12343,570000,0,Dominique Jones,TE,active,denver-broncos,570000,2014
12344,570000,0,Josh Bush,SS,active,denver-broncos,570000,2014
12345,562469,224878,Montee Ball,RB,injured_reserve,denver-broncos,787347,2014
12346,420000,48000,Quanterus Smith,DE,injured_reserve,denver-broncos,468000,2014
12347,303000,0,John Youboty,DE,injured_reserve,denver-broncos,303000,2014
12348,170000,0,Zac Dysert,QB,practice_squad,denver-broncos,170000,2014
12349,107100,0,Bennie Fowler,WR,practice_squad,denver-broncos,107100,2014
12350,107100,0,Nathan Palmer,WR,practice_squad,denver-broncos,107100,2014
12351,107100,0,Matt Paradis,C,practice_squad,denver-broncos,107100,2014
12352,107100,0,Zach Thomas,LB,practice_squad,denver-broncos,107100,2014
12353,31500,0,Kapri Bibbs,RB,practice_squad,denver-broncos,31500,2014
12354,18900,0,Isaiah Burse,WR,practice_squad,denver-broncos,18900,2014
12355,18900,0,Gerald Rivers,DE,practice_squad,denver-broncos,18900,2014
12356,12600,0,Jon Halapio,G,practice_squad,denver-broncos,12600,2014
12357,12600,0,DeMarcus Love,LT,practice_squad,denver-broncos,12600,2014
12358,2100000,0,Dominique Rodgers-Cromartie,CB,dead_cap,denver-broncos,2100000,2014
12359,1830332,0,Chris Kuper,G,dead_cap,denver-broncos,1830332,2014
12360,0,812500,Matt Prater,K,dead_cap,denver-broncos,812500,2014
12361,698120,0,Knowshon Moreno,RB,dead_cap,denver-broncos,698120,2014
12362,0,666668,Joel Dreessen,TE,dead_cap,denver-broncos,666668,2014
12363,0,500000,Kevin Vickerson,DT,dead_cap,denver-broncos,500000,2014
12364,500000,0,Willis McGahee,RB,dead_cap,denver-broncos,500000,2014
12365,337548,4167,Isaiah Burse,WR,dead_cap,denver-broncos,341715,2014
12366,302771,0,Brandon McManus,K,dead_cap,denver-broncos,302771,2014
12367,226800,0,Philip Blake,G,dead_cap,denver-broncos,226800,2014
12368,167630,666,Kapri Bibbs,RB,dead_cap,denver-broncos,168296,2014
12369,0,166668,Joe Mays,ILB,dead_cap,denver-broncos,166668,2014
12370,142588,666,Greg Latta,DE,dead_cap,denver-broncos,143254,2014
12371,128610,0,Tavarres King,WR,dead_cap,denver-broncos,128610,2014
12372,125506,1166,Shaquil Barrett,OLB,dead_cap,denver-broncos,126672,2014
12373,115429,0,Dominique Jones,TE,dead_cap,denver-broncos,115429,2014
12374,88449,0,Vinston Painter,RT,dead_cap,denver-broncos,88449,2014
12375,0,75000,Winston Justice,LT,dead_cap,denver-broncos,75000,2014
12376,71294,0,Chase Vaughn,OLB,dead_cap,denver-broncos,71294,2014
12377,69300,0,Zach Thompson,DE,dead_cap,denver-broncos,69300,2014
12378,50400,0,John Boyett,S,dead_cap,denver-broncos,50400,2014
12379,50400,0,Gerald Rivers,DE,dead_cap,denver-broncos,50400,2014
12380,37800,0,Jeremy Stewart,RB,dead_cap,denver-broncos,37800,2014
12381,31500,0,Ryan Miller,RT,dead_cap,denver-broncos,31500,2014
12382,29118,0,Nathan Palmer,WR,dead_cap,denver-broncos,29118,2014
12383,25200,0,Josh Bush,SS,dead_cap,denver-broncos,25200,2014
12384,0,22750,Matt Paradis,C,dead_cap,denver-broncos,22750,2014
12385,18900,0,Mark Asper,LT,dead_cap,denver-broncos,18900,2014
12386,18900,0,Douglas McNeil,WR,dead_cap,denver-broncos,18900,2014
12387,0,12050,Zac Dysert,QB,dead_cap,denver-broncos,12050,2014
12388,6300,0,Kevin McDermott,LS,dead_cap,denver-broncos,6300,2014
12389,6300,0,Gerell Robinson,WR,dead_cap,denver-broncos,6300,2014
12390,5000,0,Aaron Hester,CB,dead_cap,denver-broncos,5000,2014
12391,4000,0,Manase Foketi,G,dead_cap,denver-broncos,4000,2014
12392,3334,0,Quincy McDuffie,WR,dead_cap,denver-broncos,3334,2014
12393,3334,0,Ross Rasner,S,dead_cap,denver-broncos,3334,2014
12394,0,3000,Mister Cobble,DT,dead_cap,denver-broncos,3000,2014
12395,0,2333,Bennie Fowler,WR,dead_cap,denver-broncos,2333,2014
12396,0,2000,James Wilder Jr.,RB,dead_cap,denver-broncos,2000,2014
12397,2000,0,Uona Kaveinga,OLB,dead_cap,denver-broncos,2000,2014
12398,2000,0,Lucas Reed,TE,dead_cap,denver-broncos,2000,2014
12399,2000,0,John Youboty,DE,dead_cap,denver-broncos,2000,2014
12400,1667,0,Lamaar Thomas,WR,dead_cap,denver-broncos,1667,2014
12401,0,1666,Brennan Clay,RB,dead_cap,denver-broncos,1666,2014
12402,0,1666,Louis Young,CB,dead_cap,denver-broncos,1666,2014
12403,0,1334,Romney Fuga,DT,dead_cap,denver-broncos,1334,2014
12404,0,1333,Bryn Renner,QB,dead_cap,denver-broncos,1333,2014
12405,0,1333,Jordan Sullen,FS,dead_cap,denver-broncos,1333,2014
12406,0,1000,Kemonte' Bateman,WR,dead_cap,denver-broncos,1000,2014
12407,0,1000,Steven Clarke,CB,dead_cap,denver-broncos,1000,2014
12408,0,1000,Greg Hardin,WR,dead_cap,denver-broncos,1000,2014
12409,0,833,Aslam Sterling,RT,dead_cap,denver-broncos,833,2014
12410,15000000,2500000,Peyton Manning,QB,active,denver-broncos,17500000,2015
12411,4500000,8700000,Demaryius Thomas,WR,active,denver-broncos,13200000,2015
12412,8500000,2100000,Ryan Clady,LT,active,denver-broncos,10600000,2015
12413,9754000,0,Von Miller,OLB,active,denver-broncos,9754000,2015
12414,7000000,1666666,DeMarcus Ware,OLB,active,denver-broncos,8666666,2015
12415,3764705,3750000,T.J. Ward,SS,active,denver-broncos,7514705,2015
12416,5500000,1468750,Aqib Talib,CB,active,denver-broncos,6968750,2015
12417,5000000,1250000,Louis Vasquez,G,active,denver-broncos,6250000,2015
12418,4850000,1000000,Emmanuel Sanders,WR,active,denver-broncos,5850000,2015
12419,900000,2100000,Chris Harris,CB,active,denver-broncos,3000000,2015
12420,1500000,1421875,Evan Mathis,G,active,denver-broncos,2921875,2015
12421,1750000,1000000,Owen Daniels,TE,active,denver-broncos,2750000,2015
12422,2302941,175000,Vernon Davis,TE,active,denver-broncos,2477941,2015
12423,1600000,750000,Britton Colquitt,P,active,denver-broncos,2350000,2015
12424,1000000,1200000,Virgil Green,TE,active,denver-broncos,2200000,2015
12425,1094250,973500,Sylvester Williams,DT,active,denver-broncos,2067750,2015
12426,1500000,500000,Antonio Smith,DE,active,denver-broncos,2000000,2015
12427,1000000,750000,Vance Walker,DE,active,denver-broncos,1750000,2015
12428,750000,1000000,Darian Stewart,FS,active,denver-broncos,1750000,2015
12429,435000,1222980,Shane Ray,OLB,active,denver-broncos,1657980,2015
12430,1542000,53403,Malik Jackson,DT,active,denver-broncos,1595403,2015
12431,736024,844096,Bradley Roby,CB,active,denver-broncos,1580120,2015
12432,1542000,26018,Danny Trevathan,ILB,active,denver-broncos,1568018,2015
12433,1350000,200000,Andre Caldwell,WR,active,denver-broncos,1550000,2015
12434,870000,550000,Ryan Harris,LT,active,denver-broncos,1420000,2015
12435,1100018,556691,Derek Wolfe,DE,active,denver-broncos,1656709,2015
12436,660000,458944,Brock Osweiler,QB,active,denver-broncos,1118944,2015
12437,770000,172708,Ronnie Hillman,RB,active,denver-broncos,942708,2015
12438,660000,185000,Aaron Brewer,LS,active,denver-broncos,845000,2015
12439,588575,254300,Cody Latimer,WR,active,denver-broncos,842875,2015
12440,745000,0,Jordan Norwood,WR,active,denver-broncos,745000,2015
12441,597000,134950,Kayvon Webster,CB,active,denver-broncos,731950,2015
12442,522000,130300,Michael Schofield,RT,active,denver-broncos,652300,2015
12443,585000,4167,C.J. Anderson,RB,active,denver-broncos,589167,2015
12444,585000,0,Brandon Marshall,ILB,active,denver-broncos,585000,2015
12445,510000,12150,Corey Nelson,ILB,active,denver-broncos,522150,2015
12446,435000,86423,Max Garcia,G,active,denver-broncos,521423,2015
12447,510000,5668,Lerentee McCray,OLB,active,denver-broncos,515668,2015
12448,510000,1166,Juwan Thompson,RB,active,denver-broncos,511166,2015
12449,510000,0,Todd Davis,ILB,active,denver-broncos,510000,2015
12450,510000,0,Brandon McManus,K,active,denver-broncos,510000,2015
12451,435000,49303,Lorenzo Doss,CB,active,denver-broncos,484303,2015
12452,716470,0,Tyler Polumbus,LT,active,denver-broncos,716470,2015
12453,318000,155201,Jeff Heuerman,TE,active,denver-broncos,473201,2015
12454,435000,27889,Darius Kilgo,DT,active,denver-broncos,462889,2015
12455,435000,13195,Trevor Siemian,QB,active,denver-broncos,448195,2015
12456,435000,0,Shaquil Barrett,OLB,active,denver-broncos,435000,2015
12457,435000,0,James Ferentz,C,active,denver-broncos,435000,2015
12458,435000,0,Bennie Fowler,WR,active,denver-broncos,435000,2015
12459,435000,0,Matt Paradis,C,active,denver-broncos,435000,2015
12460,210000,0,Sam Brenner,C,active,denver-broncos,210000,2015
12461,194117,0,Josh Bush,SS,active,denver-broncos,194117,2015
12462,175294,0,Shiloh Keo,SS,active,denver-broncos,175294,2015
12463,25588,0,Robert Myers,G,active,denver-broncos,25588,2015
12464,1250000,400000,David Bruton,SS,injured_reserve,denver-broncos,1650000,2015
12465,660000,118607,Omar Bolden,FS,injured_reserve,denver-broncos,778607,2015
12466,373058,264264,Ty Sambrailo,LT,injured_reserve,denver-broncos,637322,2015
12467,393705,833,Kenny Anunike,DE,injured_reserve,denver-broncos,394538,2015
12468,348000,0,Kyle Williams,WR,injured_reserve,denver-broncos,348000,2015
12469,750000,656250,Shelley Smith,G,dead_cap,denver-broncos,1406250,2015
12470,0,812500,Matt Prater,K,dead_cap,denver-broncos,812500,2015
12471,176470,500000,James Casey,FB,dead_cap,denver-broncos,676470,2015
12472,0,349878,Montee Ball,RB,dead_cap,denver-broncos,349878,2015
12473,271764,0,Marvin Austin,DT,dead_cap,denver-broncos,271764,2015
12474,306764,0,Richard Gordon,TE,dead_cap,denver-broncos,306764,2015
12475,0,225666,Chris Clark,LT,dead_cap,denver-broncos,225666,2015
12476,0,166668,Manuel Ramirez,G,dead_cap,denver-broncos,166668,2015
12477,135600,1334,Kapri Bibbs,RB,dead_cap,denver-broncos,136934,2015
12478,127941,0,Mitchell Henry,TE,dead_cap,denver-broncos,127941,2015
12479,112200,13195,Taurean Nixon,CB,dead_cap,denver-broncos,125395,2015
12480,116470,0,Josh Bush,SS,dead_cap,denver-broncos,116470,2015
12481,112200,2666,Dillon Day,C,dead_cap,denver-broncos,114866,2015
12482,112200,2500,Jordan Taylor,WR,dead_cap,denver-broncos,114700,2015
12483,112200,1666,Zaire Anderson,ILB,dead_cap,denver-broncos,113866,2015
12484,112200,1666,Kyle Roberts,T,dead_cap,denver-broncos,113866,2015
12485,112200,0,George Uko,DT,dead_cap,denver-broncos,112200,2015
12486,0,100000,Steven Johnson,ILB,dead_cap,denver-broncos,100000,2015
12487,0,96000,Quanterus Smith,DE,dead_cap,denver-broncos,96000,2015
12488,79200,0,Arthur Lynch,TE,dead_cap,denver-broncos,79200,2015
12489,87647,0,Christian Ponder,QB,dead_cap,denver-broncos,87647,2015
12490,0,68250,Matt Paradis,C,dead_cap,denver-broncos,68250,2015
12491,66000,0,Antonio Johnson,T,dead_cap,denver-broncos,66000,2015
12492,59400,0,Ryan Murphy,FS,dead_cap,denver-broncos,59400,2015
12493,0,50000,Reggie Walker,ILB,dead_cap,denver-broncos,50000,2015
12494,0,47790,Lamin Barrow,ILB,dead_cap,denver-broncos,47790,2015
12495,39600,0,DeAndre Coleman,DT,dead_cap,denver-broncos,39600,2015
12496,38823,0,Curtis Marsh,CB,dead_cap,denver-broncos,38823,2015
12497,38823,0,Shaun Prater,CB,dead_cap,denver-broncos,38823,2015
12498,33000,1666,Dan Light,TE,dead_cap,denver-broncos,34666,2015
12499,0,24100,Zac Dysert,QB,dead_cap,denver-broncos,24100,2015
12500,19800,0,Cameron Jefferson,T,dead_cap,denver-broncos,19800,2015
12501,19800,0,Danny Mason,OLB,dead_cap,denver-broncos,19800,2015
12502,13200,833,Chuka Ndule,DT,dead_cap,denver-broncos,14033,2015
12503,0,13195,Josh Furman,SS,dead_cap,denver-broncos,13195,2015
12504,0,8334,Isaiah Burse,WR,dead_cap,denver-broncos,8334,2015
12505,0,6667,Shaquil Barrett,OLB,dead_cap,denver-broncos,6667,2015
12506,0,4667,Bennie Fowler,WR,dead_cap,denver-broncos,4667,2015
12507,0,3334,Brennan Clay,RB,dead_cap,denver-broncos,3334,2015
12508,0,3334,Louis Young,CB,dead_cap,denver-broncos,3334,2015
12509,0,2667,Bryn Renner,QB,dead_cap,denver-broncos,2667,2015
12510,0,2667,Jordan Sullen,FS,dead_cap,denver-broncos,2667,2015
12511,0,2500,Matt Miller,WR,dead_cap,denver-broncos,2500,2015
12512,0,2000,Steven Clarke,CB,dead_cap,denver-broncos,2000,2015
12513,0,2000,Greg Hardin,WR,dead_cap,denver-broncos,2000,2015
12514,0,1667,Aslam Sterling,RT,dead_cap,denver-broncos,1667,2015
12515,0,1666,Josh Watson,DT,dead_cap,denver-broncos,1666,2015
12516,0,1334,Greg Latta,DE,dead_cap,denver-broncos,1334,2015
12517,0,833,Connor Rains,T,dead_cap,denver-broncos,833,2015
12518,13000000,2200000,Demaryius Thomas,WR,active,denver-broncos,15200000,2016
12519,2000000,9500000,Von Miller,OLB,active,denver-broncos,11500000,2016
12520,8500000,1468750,Aqib Talib,CB,active,denver-broncos,9968750,2016
12521,6900000,2100000,Chris Harris,CB,active,denver-broncos,9000000,2016
12522,4500000,2300000,Derek Wolfe,DE,active,denver-broncos,6800000,2016
12523,2500000,3687500,Emmanuel Sanders,WR,active,denver-broncos,6187500,2016
12524,4500000,1250000,T.J. Ward,SS,active,denver-broncos,5750000,2016
12525,2000000,3400000,Russell Okung,LT,active,denver-broncos,5400000,2016
12526,2500000,2150000,Darian Stewart,FS,active,denver-broncos,4650000,2016
12527,2553000,2000000,Brandon Marshall,ILB,active,denver-broncos,4553000,2016
12528,3000000,1000000,Donald Stephenson,LT,active,denver-broncos,4000000,2016
12529,2400000,500000,Virgil Green,TE,active,denver-broncos,2900000,2016
12530,1013875,1398500,Sylvester Williams,DT,active,denver-broncos,2412375,2016
12531,849496,1222980,Shane Ray,OLB,active,denver-broncos,2072476,2016
12532,1052048,844096,Bradley Roby,CB,active,denver-broncos,1896144,2016
12533,1000000,750000,Jared Crick,DE,active,denver-broncos,1750000,2016
12534,450000,1272963,Paxton Lynch,QB,active,denver-broncos,1722963,2016
12535,757150,254300,Cody Latimer,WR,active,denver-broncos,1011450,2016
12536,800000,80000,Jordan Norwood,WR,active,denver-broncos,880000,2016
12537,609817,264264,Ty Sambrailo,LT,active,denver-broncos,874081,2016
12538,612000,130300,Michael Schofield,RT,active,denver-broncos,742300,2016
12539,450000,265982,Adam Gotsis,DE,active,denver-broncos,715982,2016
12540,525000,170201,Jeff Heuerman,TE,active,denver-broncos,695201,2016
12541,600000,12150,Corey Nelson,ILB,active,denver-broncos,612150,2016
12542,525000,86423,Max Garcia,G,active,denver-broncos,611423,2016
12543,450000,161355,Justin Simmons,SS,active,denver-broncos,611355,2016
12544,760000,0,Dekoda Watson,OLB,active,denver-broncos,760000,2016
12545,760000,0,Billy Winn,DE,active,denver-broncos,760000,2016
12546,600000,0,Todd Davis,ILB,active,denver-broncos,600000,2016
12547,600000,0,Brandon McManus,K,active,denver-broncos,600000,2016
12548,525000,49303,Lorenzo Doss,CB,active,denver-broncos,574303,2016
12549,450000,95848,Devontae Booker,RB,active,denver-broncos,545848,2016
12550,525000,13195,Trevor Siemian,QB,active,denver-broncos,538195,2016
12551,525000,0,Shaquil Barrett,OLB,active,denver-broncos,525000,2016
12552,525000,0,James Ferentz,C,active,denver-broncos,525000,2016
12553,525000,0,Bennie Fowler,WR,active,denver-broncos,525000,2016
12554,525000,0,Matt Paradis,C,active,denver-broncos,525000,2016
12555,450000,65975,Connor McGovern,G,active,denver-broncos,515975,2016
12556,450000,25089,Will Parks,S,active,denver-broncos,475089,2016
12557,450000,20002,Riley Dixon,P,active,denver-broncos,470002,2016
12558,450000,0,Zaire Anderson,ILB,active,denver-broncos,450000,2016
12559,450000,0,Jordan Taylor,WR,active,denver-broncos,450000,2016
12560,444367,0,Billy Turner,G,active,denver-broncos,444367,2016
12561,352941,0,Juwan Thompson,RB,active,denver-broncos,352941,2016
12562,264700,0,A.J. Derby,TE,active,denver-broncos,264700,2016
12563,312352,0,Thomas Gafford,LS,active,denver-broncos,312352,2016
12564,208235,0,Justin Forsett,RB,active,denver-broncos,208235,2016
12565,132350,0,Kalif Raymond,WR,active,denver-broncos,132350,2016
12566,105880,1,Quentin Gause,ILB,active,denver-broncos,105881,2016
12567,79410,0,Vontarrius Dora,OLB,active,denver-broncos,79410,2016
12568,52940,0,Henry Krieger-Coble,TE,active,denver-broncos,52940,2016
12569,26470,0,Taurean Nixon,CB,active,denver-broncos,26470,2016
12570,26470,0,Kyle Peko,DT,active,denver-broncos,26470,2016
12571,4000000,4010418,DeMarcus Ware,OLB,injured_reserve,denver-broncos,8010418,2016
12572,675000,5325000,C.J. Anderson,RB,injured_reserve,denver-broncos,6000000,2016
12573,1500000,750000,Vance Walker,DE,injured_reserve,denver-broncos,2250000,2016
12574,687000,134950,Kayvon Webster,CB,injured_reserve,denver-broncos,821950,2016
12575,600000,0,Sam Brenner,C,injured_reserve,denver-broncos,600000,2016
12576,525000,0,Kapri Bibbs,RB,injured_reserve,denver-broncos,525000,2016
12577,415580,41077,Andy Janovich,FB,injured_reserve,denver-broncos,456657,2016
12578,450000,0,Casey Kreiter,LS,injured_reserve,denver-broncos,450000,2016
12579,211764,0,Marlon Brown,WR,injured_reserve,denver-broncos,211764,2016
12580,6900,0,Reese Dismukes,G,practice_squad,denver-broncos,6900,2016
12581,0,2500000,Peyton Manning,QB,dead_cap,denver-broncos,2500000,2016
12582,0,2000000,Owen Daniels,TE,dead_cap,denver-broncos,2000000,2016
12583,0,1250000,Louis Vasquez,G,dead_cap,denver-broncos,1250000,2016
12584,1250000,0,Austin Davis,QB,dead_cap,denver-broncos,1250000,2016
12585,0,1200000,Ryan Clady,LT,dead_cap,denver-broncos,1200000,2016
12586,1000000,0,Mark Sanchez,QB,dead_cap,denver-broncos,1000000,2016
12587,0,750000,Britton Colquitt,P,dead_cap,denver-broncos,750000,2016
12588,760000,80000,Garrett Graham,TE,dead_cap,denver-broncos,840000,2016
12589,400000,200000,Ronnie Hillman,RB,dead_cap,denver-broncos,600000,2016
12590,0,555000,Aaron Brewer,LS,dead_cap,denver-broncos,555000,2016
12591,0,500000,Shelley Smith,G,dead_cap,denver-broncos,500000,2016
12592,339702,27889,Darius Kilgo,DT,dead_cap,denver-broncos,367591,2016
12593,402352,0,John Phillips,TE,dead_cap,denver-broncos,402352,2016
12594,0,224878,Montee Ball,RB,dead_cap,denver-broncos,224878,2016
12595,223529,0,Shiloh Keo,SS,dead_cap,denver-broncos,223529,2016
12596,211764,0,Darrion Weems,RT,dead_cap,denver-broncos,211764,2016
12597,169110,39587,Taurean Nixon,CB,dead_cap,denver-broncos,208697,2016
12598,149542,0,Kyle Peko,DT,dead_cap,denver-broncos,149542,2016
12599,135000,3333,Henry Krieger-Coble,TE,dead_cap,denver-broncos,138333,2016
12600,127500,5334,Dillon Day,C,dead_cap,denver-broncos,132834,2016
12601,117300,0,Justin Murray,T,dead_cap,denver-broncos,117300,2016
12602,96600,0,Vontarrius Dora,OLB,dead_cap,denver-broncos,96600,2016
12603,0,95580,Lamin Barrow,ILB,dead_cap,denver-broncos,95580,2016
12604,82800,666,Kalif Raymond,WR,dead_cap,denver-broncos,83466,2016
12605,75900,0,Steven Scheu,TE,dead_cap,denver-broncos,75900,2016
12606,48300,1168,Juwan Thompson,RB,dead_cap,denver-broncos,49468,2016
12607,48300,0,Quentin Gause,ILB,dead_cap,denver-broncos,48300,2016
12608,41400,0,Mose Frazier,WR,dead_cap,denver-broncos,41400,2016
12609,41400,0,Terrell Watson,RB,dead_cap,denver-broncos,41400,2016
12610,0,39585,Josh Furman,SS,dead_cap,denver-broncos,39585,2016
12611,27600,0,Reshard Cliett,OLB,dead_cap,denver-broncos,27600,2016
12612,27600,0,Travis Raciti,DT,dead_cap,denver-broncos,27600,2016
12613,27600,0,Ryan Murphy,FS,dead_cap,denver-broncos,27600,2016
12614,20700,0,Zac Brooks,RB,dead_cap,denver-broncos,20700,2016
12615,20700,0,Kevin Snyder,ILB,dead_cap,denver-broncos,20700,2016
12616,13800,0,Austin Traylor,TE,dead_cap,denver-broncos,13800,2016
12617,6900,0,Iosia Iosia,DE,dead_cap,denver-broncos,6900,2016
12618,6900,0,Kyle Kragen,OLB,dead_cap,denver-broncos,6900,2016
12619,6900,0,Hunter Sharp,WR,dead_cap,denver-broncos,6900,2016
12620,0,5000,Anthony Norris,TE,dead_cap,denver-broncos,5000,2016
12621,0,5000,Jordan Taylor,WR,dead_cap,denver-broncos,5000,2016
12622,0,3334,Zaire Anderson,ILB,dead_cap,denver-broncos,3334,2016
12623,0,3334,Dan Light,TE,dead_cap,denver-broncos,3334,2016
12624,0,3334,Kyle Roberts,T,dead_cap,denver-broncos,3334,2016
12625,0,3334,Josh Watson,DT,dead_cap,denver-broncos,3334,2016
12626,0,1667,Chuka Ndule,DT,dead_cap,denver-broncos,1667,2016
12627,0,1667,Connor Rains,T,dead_cap,denver-broncos,1667,2016
12628,0,834,Kenny Anunike,DE,dead_cap,denver-broncos,834,2016
12629,0,833,Antonio Glover,S,dead_cap,denver-broncos,833,2016
12630,0,833,Nathan Theus,LS,dead_cap,denver-broncos,833,2016
12631,0,666,Calvin Heurtelou,DT,dead_cap,denver-broncos,666,2016
12632,0,666,Dwayne Norman,S,dead_cap,denver-broncos,666,2016
12633,0,333,Shaneil Jenkins,DE,dead_cap,denver-broncos,333,2016
12634,16500000,3400000,Von Miller,OLB,active,denver-broncos,19900000,2017
12635,8500000,4866666,Demaryius Thomas,WR,active,denver-broncos,13366666,2017
12636,10352941,1000000,Aqib Talib,CB,active,denver-broncos,11352941,2017
12637,7400000,2833332,Chris Harris,CB,active,denver-broncos,10233332,2017
12638,6750000,2787500,Emmanuel Sanders,WR,active,denver-broncos,9537500,2017
12639,6000000,1400000,Darian Stewart,FS,active,denver-broncos,7400000,2017
12640,2500000,2000000,Brandon Marshall,ILB,active,denver-broncos,4500000,2017
12641,2500000,1750000,Donald Stephenson,LT,active,denver-broncos,4250000,2017
12642,2800000,500000,Virgil Green,TE,active,denver-broncos,3300000,2017
12643,2800000,500000,Domata Peko,DT,active,denver-broncos,3300000,2017
12644,2900000,100000,C.J. Anderson,RB,active,denver-broncos,3000000,2017
12645,2746000,0,Todd Davis,ILB,active,denver-broncos,2746000,2017
12646,2050000,300000,Allen Barbre,G,active,denver-broncos,2350000,2017
12647,1000000,1250000,Brandon McManus,K,active,denver-broncos,2250000,2017
12648,1018072,1194096,Bradley Roby,CB,active,denver-broncos,2212168,2017
12649,880741,1272963,Paxton Lynch,QB,active,denver-broncos,2153704,2017
12650,465000,1540800,Garett Bolles,LT,active,denver-broncos,2005800,2017
12651,900000,584375,Jamaal Charles,RB,active,denver-broncos,1484375,2017
12652,1000000,437500,Zach Kerr,DE,active,denver-broncos,1437500,2017
12653,925725,254300,Cody Latimer,WR,active,denver-broncos,1180025,2017
12654,465000,457520,DeMarcus Walker,DE,active,denver-broncos,922520,2017
12655,628996,265982,Adam Gotsis,DE,active,denver-broncos,894978,2017
12656,615000,170201,Jeff Heuerman,TE,active,denver-broncos,785201,2017
12657,775000,0,Brock Osweiler,QB,active,denver-broncos,775000,2017
12658,615000,86423,Max Garcia,G,active,denver-broncos,701423,2017
12659,465000,176572,Brendan Langley,CB,active,denver-broncos,641572,2017
12660,540000,95848,Devontae Booker,RB,active,denver-broncos,635848,2017
12661,615000,0,Shaquil Barrett,OLB,active,denver-broncos,615000,2017
12662,615000,0,Bennie Fowler,WR,active,denver-broncos,615000,2017
12663,615000,0,Shelby Harris,DE,active,denver-broncos,615000,2017
12664,615000,0,Matt Paradis,C,active,denver-broncos,615000,2017
12665,540000,65975,Connor McGovern,G,active,denver-broncos,605975,2017
12666,540000,41077,Andy Janovich,FB,active,denver-broncos,581077,2017
12667,540000,25089,Will Parks,S,active,denver-broncos,565089,2017
12668,540000,20002,Riley Dixon,P,active,denver-broncos,560002,2017
12669,540000,0,Zaire Anderson,ILB,active,denver-broncos,540000,2017
12670,540000,0,Casey Kreiter,LS,active,denver-broncos,540000,2017
12671,540000,0,Jordan Taylor,WR,active,denver-broncos,540000,2017
12672,465000,58961,Isaiah McKenzie,WR,active,denver-broncos,523961,2017
12673,465000,36288,De'Angelo Henderson,RB,active,denver-broncos,501288,2017
12674,465000,3333,Jamal Carter,SS,active,denver-broncos,468333,2017
12675,324706,0,Cyrus Kouandjio,RT,active,denver-broncos,324706,2017
12676,300883,0,Jerrol Garcia-Williams,ILB,active,denver-broncos,300883,2017
12677,300883,0,Elijah Wilkinson,T,active,denver-broncos,300883,2017
12678,253232,0,Deiontrez Mount,OLB,active,denver-broncos,253232,2017
12679,218824,0,Joe Jones,OLB,active,denver-broncos,218824,2017
12680,191471,0,Austin Traylor,TE,active,denver-broncos,191471,2017
12681,190588,0,Kyle Peko,DT,active,denver-broncos,190588,2017
12682,136765,0,Marcus Rios,CB,active,denver-broncos,136765,2017
12683,82059,7500,J.J. Dielman,C,active,denver-broncos,89559,2017
12684,82059,0,Matt LaCosse,TE,active,denver-broncos,82059,2017
12685,82059,0,Dymonte Thomas,S,active,denver-broncos,82059,2017
12686,63529,0,Michael Hunter,CB,active,denver-broncos,63529,2017
12687,2500000,5875000,Ron Leary,G,injured_reserve,denver-broncos,8375000,2017
12688,5500000,2362500,Derek Wolfe,DE,injured_reserve,denver-broncos,7862500,2017
12689,1500000,1770833,Menelik Watson,RT,injured_reserve,denver-broncos,3270833,2017
12690,1263991,1222980,Shane Ray,OLB,injured_reserve,denver-broncos,2486971,2017
12691,1500000,750000,Jared Crick,DE,injured_reserve,denver-broncos,2250000,2017
12692,794000,0,Billy Turner,G,injured_reserve,denver-broncos,794000,2017
12693,508769,174355,Justin Simmons,SS,injured_reserve,denver-broncos,683124,2017
12694,615000,13195,Trevor Siemian,QB,injured_reserve,denver-broncos,628195,2017
12695,348000,204496,Carlos Henderson,WR,injured_reserve,denver-broncos,552496,2017
12696,528000,0,Billy Winn,DE,injured_reserve,denver-broncos,528000,2017
12697,514000,12150,Corey Nelson,ILB,injured_reserve,denver-broncos,526150,2017
12698,348000,75234,Jake Butt,TE,injured_reserve,denver-broncos,423234,2017
12699,348000,16067,Chad Kelly,QB,injured_reserve,denver-broncos,364067,2017
12700,0,1250000,T.J. Ward,SS,dead_cap,denver-broncos,1250000,2017
12701,588235,200000,Kasim Edebali,OLB,dead_cap,denver-broncos,788235,2017
12702,510000,0,Jonathan Williams,RB,dead_cap,denver-broncos,510000,2017
12703,397941,49303,Lorenzo Doss,CB,dead_cap,denver-broncos,447244,2017
12704,434118,0,A.J. Derby,TE,dead_cap,denver-broncos,434118,2017
12705,0,264265,Ty Sambrailo,LT,dead_cap,denver-broncos,264265,2017
12706,226588,0,Kyle Peko,DT,dead_cap,denver-broncos,226588,2017
12707,264706,0,Ahtyba Rubin,DT,dead_cap,denver-broncos,264706,2017
12708,0,130300,Michael Schofield,RT,dead_cap,denver-broncos,130300,2017
12709,128153,0,Dillon Day,C,dead_cap,denver-broncos,128153,2017
12710,120953,3333,Tyrique Jarrett,DT,dead_cap,denver-broncos,124286,2017
12711,113753,0,Hunter Sharp,WR,dead_cap,denver-broncos,113753,2017
12712,100800,1333,Dymonte Thomas,S,dead_cap,denver-broncos,102133,2017
12713,86400,1000,Marcus Rios,CB,dead_cap,denver-broncos,87400,2017
12714,72000,0,Deiontrez Mount,OLB,dead_cap,denver-broncos,72000,2017
12715,72000,0,Austin Traylor,TE,dead_cap,denver-broncos,72000,2017
12716,72000,0,Tim Patrick,WR,dead_cap,denver-broncos,72000,2017
12717,0,55778,Darius Kilgo,DT,dead_cap,denver-broncos,55778,2017
12718,54706,0,Kevin Snyder,ILB,dead_cap,denver-broncos,54706,2017
12719,49500,2666,Jerrol Garcia-Williams,ILB,dead_cap,denver-broncos,52166,2017
12720,50400,0,Brian Parker,TE,dead_cap,denver-broncos,50400,2017
12721,43200,0,Stansly Maponga,DE,dead_cap,denver-broncos,43200,2017
12722,43200,0,Elijah Wilkinson,T,dead_cap,denver-broncos,43200,2017
12723,28800,0,Jeremiah Poutasi,RT,dead_cap,denver-broncos,28800,2017
12724,28800,0,Jhaustin Thomas,DT,dead_cap,denver-broncos,28800,2017
12725,21600,0,Michael Hunter,CB,dead_cap,denver-broncos,21600,2017
12726,21600,0,River Cracraft,WR,dead_cap,denver-broncos,21600,2017
12727,14400,0,Gabe Ikard,C,dead_cap,denver-broncos,14400,2017
12728,7200,0,Jordan Leslie,WR,dead_cap,denver-broncos,7200,2017
12729,0,6667,Henry Krieger-Coble,TE,dead_cap,denver-broncos,6667,2017
12730,0,4166,Orion Stewart,CB,dead_cap,denver-broncos,4166,2017
12731,0,2500,Cameron Hunt,T,dead_cap,denver-broncos,2500,2017
12732,0,2333,Deon Hollins,OLB,dead_cap,denver-broncos,2333,2017
12733,0,1667,Antonio Glover,S,dead_cap,denver-broncos,1667,2017
12734,0,1667,Nathan Theus,LS,dead_cap,denver-broncos,1667,2017
12735,0,1666,Erik Austell,T,dead_cap,denver-broncos,1666,2017
12736,0,1666,Dante Barnett,S,dead_cap,denver-broncos,1666,2017
12737,0,1666,Anthony Nash,WR,dead_cap,denver-broncos,1666,2017
12738,0,1334,Calvin Heurtelou,DT,dead_cap,denver-broncos,1334,2017
12739,0,1334,Dwayne Norman,S,dead_cap,denver-broncos,1334,2017
12740,0,1334,Kalif Raymond,WR,dead_cap,denver-broncos,1334,2017
12741,0,1333,Josh Banderas,ILB,dead_cap,denver-broncos,1333,2017
12742,0,1000,Kyle Sloter,QB,dead_cap,denver-broncos,1000,2017
12743,0,833,Shakir Soto,DE,dead_cap,denver-broncos,833,2017
12744,0,667,Shaneil Jenkins,DE,dead_cap,denver-broncos,667,2017
12745,0,666,Dontrell Nelson,CB,dead_cap,denver-broncos,666,2017
12746,8000000,7000000,Case Keenum,QB,active,denver-broncos,15000000,2018
12747,8000000,3425000,Derek Wolfe,DE,active,denver-broncos,11425000,2018
12748,2000000,8125000,Von Miller,OLB,active,denver-broncos,10125000,2018
12749,8526000,0,Bradley Roby,CB,active,denver-broncos,8526000,2018
12750,5000000,2000000,Brandon Marshall,ILB,active,denver-broncos,7000000,2018
12751,6500000,375000,Jared Veldheer,RT,active,denver-broncos,6875000,2018
12752,4500000,1400000,Darian Stewart,SS,active,denver-broncos,5900000,2018
12753,480000,4478407,Bradley Chubb,OLB,active,denver-broncos,4958407,2018
12754,3700000,500000,Domata Peko,DT,active,denver-broncos,4200000,2018
12755,3000000,1000000,Todd Davis,ILB,active,denver-broncos,4000000,2018
12756,2250000,1250000,Brandon McManus,K,active,denver-broncos,3500000,2018
12757,2000000,1000000,Tramaine Brock,CB,active,denver-broncos,3000000,2018
12758,2914000,0,Shaquil Barrett,OLB,active,denver-broncos,2914000,2018
12759,1678484,1222983,Shane Ray,OLB,active,denver-broncos,2901467,2018
12760,966450,1540800,Garett Bolles,LT,active,denver-broncos,2507250,2018
12761,1500000,500000,Billy Turner,G,active,denver-broncos,2000000,2018
12762,1250000,500000,Zach Kerr,DE,active,denver-broncos,1750000,2018
12763,480000,763985,Courtland Sutton,WR,active,denver-broncos,1243985,2018
12764,695630,457520,DeMarcus Walker,DE,active,denver-broncos,1153150,2018
12765,807991,265982,Adam Gotsis,DE,active,denver-broncos,1073973,2018
12766,630000,175355,Justin Simmons,FS,active,denver-broncos,805355,2018
12767,480000,249255,Royce Freeman,RB,active,denver-broncos,729255,2018
12768,630000,95848,Devontae Booker,RB,active,denver-broncos,725848,2018
12769,705000,0,Shelby Harris,DE,active,denver-broncos,705000,2018
12770,630000,65975,Connor McGovern,G,active,denver-broncos,695975,2018
12771,630000,41077,Andy Janovich,FB,active,denver-broncos,671077,2018
12772,480000,190379,Isaac Yiadom,CB,active,denver-broncos,670379,2018
12773,480000,178495,Josey Jewell,ILB,active,denver-broncos,658495,2018
12774,630000,25089,Will Parks,S,active,denver-broncos,655089,2018
12775,651408,0,Su'a Cravens,S,active,denver-broncos,651408,2018
12776,480000,170659,Daesean Hamilton,WR,active,denver-broncos,650659,2018
12777,630000,0,Kevin Hogan,QB,active,denver-broncos,630000,2018
12778,630000,0,Casey Kreiter,LS,active,denver-broncos,630000,2018
12779,555000,0,Joe Jones,OLB,active,denver-broncos,555000,2018
12780,555000,0,Matt LaCosse,TE,active,denver-broncos,555000,2018
12781,555000,0,Dymonte Thomas,S,active,denver-broncos,555000,2018
12782,555000,0,Elijah Wilkinson,T,active,denver-broncos,555000,2018
12783,480000,42138,Sam Jones,C,active,denver-broncos,522138,2018
12784,480000,29602,Keishawn Bierria,ILB,active,denver-broncos,509602,2018
12785,480000,0,Tim Patrick,WR,active,denver-broncos,480000,2018
12786,457058,0,Brian Parker,TE,active,denver-broncos,457058,2018
12787,367055,0,Colby Wadman,P,active,denver-broncos,367055,2018
12788,310588,0,NIco Falah,C,active,denver-broncos,310588,2018
12789,325297,0,Gino Gradkowski,C,active,denver-broncos,325297,2018
12790,254115,0,River Cracraft,WR,active,denver-broncos,254115,2018
12791,195882,0,Brendan Langley,CB,active,denver-broncos,195882,2018
12792,185882,0,Jamar Taylor,CB,active,denver-broncos,185882,2018
12793,185294,0,Temarrick Hemingway,TE,active,denver-broncos,185294,2018
12794,141175,0,Jeff Holland,LB,active,denver-broncos,141175,2018
12795,84705,0,Trey Marshall,S,active,denver-broncos,84705,2018
12796,82941,0,Craig Mager,CB,active,denver-broncos,82941,2018
12797,37059,0,Aaron Wallace,OLB,active,denver-broncos,37059,2018
12798,28235,0,Horace Richardson,CB,active,denver-broncos,28235,2018
12799,8250000,2687500,Emmanuel Sanders,WR,injured_reserve,denver-broncos,10937500,2018
12800,7400000,4333332,Chris Harris,CB,injured_reserve,denver-broncos,11733332,2018
12801,7650000,1068750,Ron Leary,G,injured_reserve,denver-broncos,8718750,2018
12802,2914000,0,Matt Paradis,C,injured_reserve,denver-broncos,2914000,2018
12803,1907000,86423,Max Garcia,G,injured_reserve,denver-broncos,1993423,2018
12804,705000,170203,Jeff Heuerman,TE,injured_reserve,denver-broncos,875203,2018
12805,555000,0,Jerrol Garcia-Williams,ILB,injured_reserve,denver-broncos,555000,2018
12806,473112,5000,Phillip Lindsay,RB,injured_reserve,denver-broncos,478112,2018
12807,378000,75234,Jake Butt,TE,injured_reserve,denver-broncos,453234,2018
12808,363000,70450,Troy Fumagalli,TE,injured_reserve,denver-broncos,433450,2018
12809,433000,0,Deiontrez Mount,OLB,injured_reserve,denver-broncos,433000,2018
12810,378000,3333,Jamal Carter,SS,injured_reserve,denver-broncos,381333,2018
12811,235294,0,Andre Holmes,WR,injured_reserve,denver-broncos,235294,2018
12812,4000000,4866666,Demaryius Thomas,WR,dead_cap,denver-broncos,8866666,2018
12813,5500000,1458333,Menelik Watson,RT,dead_cap,denver-broncos,6958333,2018
12814,1911481,1272963,Paxton Lynch,QB,dead_cap,denver-broncos,3184444,2018
12815,1500000,166667,Marquette King,P,dead_cap,denver-broncos,1666667,2018
12816,0,1000000,Donald Stephenson,LT,dead_cap,denver-broncos,1000000,2018
12817,0,1000000,Aqib Talib,CB,dead_cap,denver-broncos,1000000,2018
12818,1000000,0,Clinton McDonald,DT,dead_cap,denver-broncos,1000000,2018
12819,1015000,0,Adam-Pacman Jones,CB,dead_cap,denver-broncos,1015000,2018
12820,604118,0,Shamarko Thomas,SS,dead_cap,denver-broncos,604118,2018
12821,397459,11666,A.J. Johnson,LB,dead_cap,denver-broncos,409125,2018
12822,110000,199572,Brendan Langley,CB,dead_cap,denver-broncos,309572,2018
12823,298928,0,Jordan Moore,S,dead_cap,denver-broncos,298928,2018
12824,0,264265,Ty Sambrailo,LT,dead_cap,denver-broncos,264265,2018
12825,7600,240496,Carlos Henderson,WR,dead_cap,denver-broncos,248096,2018
12826,225886,16067,Chad Kelly,QB,dead_cap,denver-broncos,241953,2018
12827,179294,58961,Isaiah McKenzie,WR,dead_cap,denver-broncos,238255,2018
12828,132000,5000,Jeff Holland,LB,dead_cap,denver-broncos,137000,2018
12829,129200,1666,Austin Schlottmann,G,dead_cap,denver-broncos,130866,2018
12830,106400,1666,Trey Marshall,S,dead_cap,denver-broncos,108066,2018
12831,92941,0,Cyrus Kouandjio,RT,dead_cap,denver-broncos,92941,2018
12832,76000,0,Garrett Grayson,QB,dead_cap,denver-broncos,76000,2018
12833,76000,0,Andreas Knappe,T,dead_cap,denver-broncos,76000,2018
12834,38000,23495,David Williams,RB,dead_cap,denver-broncos,61495,2018
12835,60800,0,Temarrick Hemingway,TE,dead_cap,denver-broncos,60800,2018
12836,60800,0,Jeremy McNichols,RB,dead_cap,denver-broncos,60800,2018
12837,60800,0,Niles Scott,DT,dead_cap,denver-broncos,60800,2018
12838,53200,0,Avery Gennesy,T,dead_cap,denver-broncos,53200,2018
12839,53200,0,Chad Hansen,WR,dead_cap,denver-broncos,53200,2018
12840,53200,0,River Cracraft,WR,dead_cap,denver-broncos,53200,2018
12841,0,49305,Lorenzo Doss,CB,dead_cap,denver-broncos,49305,2018
12842,44470,2000,Marcus Rios,CB,dead_cap,denver-broncos,46470,2018
12843,45600,0,Linden Stephens,S,dead_cap,denver-broncos,45600,2018
12844,0,40005,Riley Dixon,P,dead_cap,denver-broncos,40005,2018
12845,38000,0,Caushaud Lyons,DE,dead_cap,denver-broncos,38000,2018
12846,38000,0,Dan Skipper,T,dead_cap,denver-broncos,38000,2018
12847,0,36288,De'Angelo Henderson,RB,dead_cap,denver-broncos,36288,2018
12848,30400,0,Khalfani Muhammad,RB,dead_cap,denver-broncos,30400,2018
12849,22235,7500,J.J. Dielman,C,dead_cap,denver-broncos,29735,2018
12850,22800,0,Shay Fields,WR,dead_cap,denver-broncos,22800,2018
12851,22800,0,Brian Parker,TE,dead_cap,denver-broncos,22800,2018
12852,0,13198,Trevor Siemian,QB,dead_cap,denver-broncos,13198,2018
12853,0,8334,Orion Stewart,CB,dead_cap,denver-broncos,8334,2018
12854,7600,0,Kyle Peko,DT,dead_cap,denver-broncos,7600,2018
12855,7600,0,Colby Wadman,P,dead_cap,denver-broncos,7600,2018
12856,7600,0,DeShawn Williams,DT,dead_cap,denver-broncos,7600,2018
12857,0,6667,Tyrique Jarrett,DT,dead_cap,denver-broncos,6667,2018
12858,0,5334,Jerrol Garcia-Williams,ILB,dead_cap,denver-broncos,5334,2018
12859,0,5000,Cameron Hunt,T,dead_cap,denver-broncos,5000,2018
12860,0,4667,Deon Hollins,OLB,dead_cap,denver-broncos,4667,2018
12861,0,3334,Erik Austell,T,dead_cap,denver-broncos,3334,2018
12862,0,3334,Dante Barnett,S,dead_cap,denver-broncos,3334,2018
12863,0,3334,Anthony Nash,WR,dead_cap,denver-broncos,3334,2018
12864,0,3333,Leon Johnson,T,dead_cap,denver-broncos,3333,2018
12865,0,2667,Josh Banderas,ILB,dead_cap,denver-broncos,2667,2018
12866,0,2667,Dymonte Thomas,S,dead_cap,denver-broncos,2667,2018
12867,0,2666,John Diarse,WR,dead_cap,denver-broncos,2666,2018
12868,0,2000,Kyle Sloter,QB,dead_cap,denver-broncos,2000,2018
12869,0,1667,Shakir Soto,DE,dead_cap,denver-broncos,1667,2018
12870,0,1334,Dontrell Nelson,CB,dead_cap,denver-broncos,1334,2018
12871,17000000,8125000,Von Miller,OLB,active,denver-broncos,25125000,2019
12872,9800000,2983336,Chris Harris,CB,active,denver-broncos,12783336,2019
12873,8150000,1162500,Ron Leary,G,active,denver-broncos,9312500,2019
12874,5000000,3000000,Ja'Wuan James,RT,active,denver-broncos,8000000,2019
12875,4000000,1000000,Todd Davis,ILB,active,denver-broncos,5000000,2019
12876,2750000,1250000,Brandon McManus,K,active,denver-broncos,4000000,2019
12877,2000000,1375000,Jeff Heuerman,TE,active,denver-broncos,3375000,2019
12878,3095000,0,Shelby Harris,DT,active,denver-broncos,3095000,2019
12879,1467900,1540800,Garett Bolles,LT,active,denver-broncos,3008700,2019
12880,495000,1794222,Noah Fant,TE,active,denver-broncos,2289222,2019
12881,2025000,176355,Justin Simmons,FS,active,denver-broncos,2201355,2019
12882,2025000,65975,Connor McGovern,C,active,denver-broncos,2090975,2019
12883,2025000,25089,Will Parks,SS,active,denver-broncos,2050089,2019
12884,790996,763985,Courtland Sutton,WR,active,denver-broncos,1554981,2019
12885,926260,457520,DeMarcus Walker,DE,active,denver-broncos,1383780,2019
12886,495000,803597,Dalton Risner,G,active,denver-broncos,1298597,2019
12887,495000,779694,Drew Lock,QB,active,denver-broncos,1274694,2019
12888,1000000,0,Casey Kreiter,LS,active,denver-broncos,1000000,2019
12889,661000,249255,Royce Freeman,RB,active,denver-broncos,910255,2019
12890,720000,95849,Devontae Booker,RB,active,denver-broncos,815849,2019
12891,570000,224129,Isaac Yiadom,CB,active,denver-broncos,794129,2019
12892,495000,266600,Dre'Mont Jones,DE,active,denver-broncos,761600,2019
12893,570000,178495,Josey Jewell,ILB,active,denver-broncos,748495,2019
12894,570000,170659,Daesean Hamilton,WR,active,denver-broncos,740659,2019
12895,695676,0,Duke Dawson,CB,active,denver-broncos,695676,2019
12896,645000,0,Brandon Allen,QB,active,denver-broncos,645000,2019
12897,645000,0,Joe Jones,OLB,active,denver-broncos,645000,2019
12898,645000,0,Mike Purcell,DE,active,denver-broncos,645000,2019
12899,645000,0,Elijah Wilkinson,RT,active,denver-broncos,645000,2019
12900,615588,0,Jeremiah Attaochu,OLB,active,denver-broncos,615588,2019
12901,570000,5000,Phillip Lindsay,RB,active,denver-broncos,575000,2019
12902,495000,76433,Justin Hollins,DE,active,denver-broncos,571433,2019
12903,570000,0,Davontae Harris,CB,active,denver-broncos,570000,2019
12904,570000,0,A.J. Johnson,ILB,active,denver-broncos,570000,2019
12905,570000,0,Trey Marshall,S,active,denver-broncos,570000,2019
12906,570000,0,Tim Patrick,WR,active,denver-broncos,570000,2019
12907,570000,0,Colby Wadman,P,active,denver-broncos,570000,2019
12908,495000,70450,Troy Fumagalli,TE,active,denver-broncos,565450,2019
12909,495000,5000,Malik Reed,OLB,active,denver-broncos,500000,2019
12910,495000,0,Andrew Beck,TE,active,denver-broncos,495000,2019
12911,495000,0,Austin Schlottmann,G,active,denver-broncos,495000,2019
12912,495000,0,Diontae Spencer,WR,active,denver-broncos,495000,2019
12913,465888,0,Jake Rodgers,T,active,denver-broncos,465888,2019
12914,407652,0,Fred Brown,WR,active,denver-broncos,407652,2019
12915,378529,0,Calvin Anderson,T,active,denver-broncos,378529,2019
12916,291176,0,Jonathan Harris,DT,active,denver-broncos,291176,2019
12917,262059,0,Josh Watson,LB,active,denver-broncos,262059,2019
12918,145588,0,Shakial Taylor,CB,active,denver-broncos,145588,2019
12919,134116,0,Patrick Morris,C,active,denver-broncos,134116,2019
12920,113824,0,Kyle Peko,DT,active,denver-broncos,113824,2019
12921,87354,0,Deyon Sizer,DT,active,denver-broncos,87354,2019
12922,58235,0,Alijah Holder,S,active,denver-broncos,58235,2019
12923,29118,0,Quinn Bailey,T,active,denver-broncos,29118,2019
12924,8000000,3300000,Derek Wolfe,DE,injured_reserve,denver-broncos,11300000,2019
12925,2500000,1333333,Bryce Callahan,CB,injured_reserve,denver-broncos,3833333,2019
12926,570000,5628009,Bradley Chubb,OLB,injured_reserve,denver-broncos,6198009,2019
12927,1500000,3400000,Joe Flacco,QB,injured_reserve,denver-broncos,4900000,2019
12928,2000000,250000,Theo Riddick,RB,injured_reserve,denver-broncos,2250000,2019
12929,986987,265984,Adam Gotsis,DE,injured_reserve,denver-broncos,1252971,2019
12930,720000,378577,Andy Janovich,FB,injured_reserve,denver-broncos,1098577,2019
12931,645000,75234,Jake Butt,TE,injured_reserve,denver-broncos,720234,2019
12932,645000,0,Dymonte Thomas,S,injured_reserve,denver-broncos,645000,2019
12933,805000,0,Corey Nelson,ILB,injured_reserve,denver-broncos,805000,2019
12934,474316,42813,Juwann Winfree,WR,injured_reserve,denver-broncos,517129,2019
12935,408000,100000,Billy Winn,DE,injured_reserve,denver-broncos,508000,2019
12936,477706,10000,DeVante Bausby,CB,injured_reserve,denver-broncos,487706,2019
12937,393000,9411,NIco Falah,C,injured_reserve,denver-broncos,402411,2019
12938,378000,1166,Austin Fort,TE,injured_reserve,denver-broncos,379166,2019
12939,378000,0,Horace Richardson,CB,injured_reserve,denver-broncos,378000,2019
12940,410118,0,Cyrus Jones,CB,non_fb_injury,denver-broncos,410118,2019
12941,3500000,3500000,Case Keenum,QB,dead_cap,denver-broncos,7000000,2019
12942,4279412,2687500,Emmanuel Sanders,WR,dead_cap,denver-broncos,6966912,2019
12943,0,4000000,Brandon Marshall,ILB,dead_cap,denver-broncos,4000000,2019
12944,0,4866668,Demaryius Thomas,WR,dead_cap,denver-broncos,4866668,2019
12945,0,2800000,Darian Stewart,FS,dead_cap,denver-broncos,2800000,2019
12946,0,1333334,Menelik Watson,RT,dead_cap,denver-broncos,1333334,2019
12947,0,1272963,Paxton Lynch,QB,dead_cap,denver-broncos,1272963,2019
12948,538939,3333,Brett Rypien,QB,dead_cap,denver-broncos,542272,2019
12949,0,408992,Carlos Henderson,WR,dead_cap,denver-broncos,408992,2019
12950,0,353144,Brendan Langley,CB,dead_cap,denver-broncos,353144,2019
12951,0,333334,Marquette King,P,dead_cap,denver-broncos,333334,2019
12952,0,300000,Kevin Hogan,QB,dead_cap,denver-broncos,300000,2019
12953,0,300000,Zach Kerr,DT,dead_cap,denver-broncos,300000,2019
12954,284118,0,Coty Sensabaugh,CB,dead_cap,denver-broncos,284118,2019
12955,217941,0,Corey Levin,C,dead_cap,denver-broncos,217941,2019
12956,175353,666,Ahmad Gooden,DE,dead_cap,denver-broncos,176019,2019
12957,170000,0,Khalfani Muhammad,RB,dead_cap,denver-broncos,170000,2019
12958,134116,29602,Keishawn Bierria,ILB,dead_cap,denver-broncos,163718,2019
12959,132000,6000,Alijah Holder,S,dead_cap,denver-broncos,138000,2019
12960,128000,1000,Quinn Bailey,T,dead_cap,denver-broncos,129000,2019
12961,0,117922,Isaiah McKenzie,WR,dead_cap,denver-broncos,117922,2019
12962,112000,3333,Trinity Benson,WR,dead_cap,denver-broncos,115333,2019
12963,112000,0,Deyon Sizer,DT,dead_cap,denver-broncos,112000,2019
12964,80000,2500,Josh Watson,LB,dead_cap,denver-broncos,82500,2019
12965,80000,1666,Kelvin McKnight,WR,dead_cap,denver-broncos,81666,2019
12966,0,72576,De'Angelo Henderson,RB,dead_cap,denver-broncos,72576,2019
12967,72000,0,Dadi Nicolas,OLB,dead_cap,denver-broncos,72000,2019
12968,0,70485,David Williams,RB,dead_cap,denver-broncos,70485,2019
12969,67059,0,River Cracraft,WR,dead_cap,denver-broncos,67059,2019
12970,56000,0,Malik Carney,DE,dead_cap,denver-broncos,56000,2019
12971,56000,0,Tyler Jones,T,dead_cap,denver-broncos,56000,2019
12972,56000,0,Tyvis Powell,S,dead_cap,denver-broncos,56000,2019
12973,0,50000,Dekoda Watson,OLB,dead_cap,denver-broncos,50000,2019
12974,0,42138,Sam Jones,C,dead_cap,denver-broncos,42138,2019
12975,0,32134,Chad Kelly,QB,dead_cap,denver-broncos,32134,2019
12976,32000,0,Bug Howard,WR,dead_cap,denver-broncos,32000,2019
12977,30000,0,Fred Brown,WR,dead_cap,denver-broncos,30000,2019
12978,0,23334,A.J. Johnson,LB,dead_cap,denver-broncos,23334,2019
12979,16000,0,P.J. Locke,S,dead_cap,denver-broncos,16000,2019
12980,16000,0,Jay-Tee Tiuli,DT,dead_cap,denver-broncos,16000,2019
12981,0,10000,Jeff Holland,LB,dead_cap,denver-broncos,10000,2019
12982,5000,5000,Brian Wallace,T,dead_cap,denver-broncos,10000,2019
12983,7500,2500,Jaylen Johnson,DE,dead_cap,denver-broncos,10000,2019
12984,8000,666,George Aston,FB,dead_cap,denver-broncos,8666,2019
12985,8000,0,Jake Rodgers,T,dead_cap,denver-broncos,8000,2019
12986,0,6667,Leon Johnson,T,dead_cap,denver-broncos,6667,2019
12987,0,6667,Jimmy Williams,WR,dead_cap,denver-broncos,6667,2019
12988,0,5334,John Diarse,WR,dead_cap,denver-broncos,5334,2019
12989,0,3334,Jamal Carter,SS,dead_cap,denver-broncos,3334,2019
12990,0,3334,Trey Marshall,S,dead_cap,denver-broncos,3334,2019
12991,0,3334,Austin Schlottmann,G,dead_cap,denver-broncos,3334,2019
12992,0,3333,Joe Dineen,LB,dead_cap,denver-broncos,3333,2019
12993,0,2333,Devontae Jackson,RB,dead_cap,denver-broncos,2333,2019
12994,0,1666,John Leglue,G,dead_cap,denver-broncos,1666,2019
12995,0,1000,Romell Guerrier,WR,dead_cap,denver-broncos,1000,2019
12996,17500000,8125000,Von Miller,OLB,active,denver-broncos,25625000,2020
12997,20250000,3400000,Joe Flacco,QB,active,denver-broncos,23650000,2020
12998,11000000,3000000,Kareem Jackson,SS,active,denver-broncos,14000000,2020
12999,10000000,3000000,Ja'Wuan James,RT,active,denver-broncos,13000000,2020
13000,8150000,1162500,Ron Leary,G,active,denver-broncos,9312500,2020
13001,3000000,4833333,Bryce Callahan,CB,active,denver-broncos,7833333,2020
13002,660000,6777611,Bradley Chubb,OLB,active,denver-broncos,7437611,2020
13003,5000000,1000000,Todd Davis,ILB,active,denver-broncos,6000000,2020
13004,3000000,1375000,Jeff Heuerman,TE,active,denver-broncos,4375000,2020
13005,3000000,1250000,Brandon McManus,K,active,denver-broncos,4250000,2020
13006,1969351,1540803,Garett Bolles,LT,active,denver-broncos,3510154,2020
13007,1067306,1794222,Noah Fant,TE,active,denver-broncos,2861528,2020
13008,1101993,763985,Courtland Sutton,WR,active,denver-broncos,1865978,2020
13009,819649,803597,Dalton Risner,G,active,denver-broncos,1623246,2020
13010,1156890,457520,DeMarcus Walker,DE,active,denver-broncos,1614410,2020
13011,813674,779694,Drew Lock,QB,active,denver-broncos,1593368,2020
13012,1150000,431250,Andy Janovich,FB,active,denver-broncos,1581250,2020
13013,832000,249255,Royce Freeman,RB,active,denver-broncos,1081255,2020
13014,685400,266600,Dre'Mont Jones,DE,active,denver-broncos,952000,2020
13015,820000,100000,Billy Winn,DE,active,denver-broncos,920000,2020
13016,911352,0,Duke Dawson,CB,active,denver-broncos,911352,2020
13017,660000,224129,Isaac Yiadom,CB,active,denver-broncos,884129,2020
13018,660000,178495,Josey Jewell,ILB,active,denver-broncos,838495,2020
13019,660000,170659,Daesean Hamilton,WR,active,denver-broncos,830659,2020
13020,735000,75236,Jake Butt,TE,active,denver-broncos,810236,2020
13021,735000,0,Kyle Peko,DT,active,denver-broncos,735000,2020
13022,735000,0,Tyvis Powell,S,active,denver-broncos,735000,2020
13023,660000,70450,Troy Fumagalli,TE,active,denver-broncos,730450,2020
13024,660000,9413,NIco Falah,C,active,denver-broncos,669413,2020
13025,660000,5000,Phillip Lindsay,RB,active,denver-broncos,665000,2020
13026,585000,76433,Justin Hollins,DE,active,denver-broncos,661433,2020
13027,660000,0,A.J. Johnson,ILB,active,denver-broncos,660000,2020
13028,660000,0,Colby Wadman,P,active,denver-broncos,660000,2020
13029,585000,42813,Juwann Winfree,WR,active,denver-broncos,627813,2020
13030,585000,5000,Malik Reed,OLB,active,denver-broncos,590000,2020
13031,585000,0,Calvin Anderson,T,active,denver-broncos,585000,2020
13032,585000,0,Quinn Bailey,T,active,denver-broncos,585000,2020
13033,585000,0,Andrew Beck,TE,active,denver-broncos,585000,2020
13034,585000,0,Fred Brown,WR,active,denver-broncos,585000,2020
13035,585000,0,Trevor Daniel,P,active,denver-broncos,585000,2020
13036,585000,0,Jonathan Harris,DT,active,denver-broncos,585000,2020
13037,585000,0,Alijah Holder,S,active,denver-broncos,585000,2020
13038,585000,0,Patrick Morris,C,active,denver-broncos,585000,2020
13039,585000,0,Brett Rypien,QB,active,denver-broncos,585000,2020
13040,585000,0,Austin Schlottmann,G,active,denver-broncos,585000,2020
13041,585000,0,Deyon Sizer,DT,active,denver-broncos,585000,2020
13042,585000,0,Shakial Taylor,CB,active,denver-broncos,585000,2020
13043,585000,0,Josh Watson,LB,active,denver-broncos,585000,2020
13044,510000,1166,Austin Fort,TE,active,denver-broncos,511166,2020
13045,510000,0,Ka’John Armstrong,T,active,denver-broncos,510000,2020
13046,510000,0,Trinity Benson,WR,active,denver-broncos,510000,2020
13047,510000,0,Malik Carney,DE,active,denver-broncos,510000,2020
13048,510000,0,Jeremy Cox,RB,active,denver-broncos,510000,2020
13049,510000,0,Tre Crawford III,OLB,active,denver-broncos,510000,2020
13050,510000,0,Wes Farnsworth,LS,active,denver-broncos,510000,2020
13051,510000,0,Bug Howard,WR,active,denver-broncos,510000,2020
13052,510000,0,Tyler Jones,T,active,denver-broncos,510000,2020
13053,510000,0,P.J. Locke,S,active,denver-broncos,510000,2020
13054,510000,0,Kelvin McKnight,WR,active,denver-broncos,510000,2020
13055,510000,0,Khalfani Muhammad,RB,active,denver-broncos,510000,2020
13056,510000,0,Horace Richardson,CB,active,denver-broncos,510000,2020
13057,510000,0,Kahani Smith,CB,active,denver-broncos,510000,2020
13058,510000,0,Jay-Tee Tiuli,DT,active,denver-broncos,510000,2020
13059,0,300000,Zach Kerr,DT,dead_cap,denver-broncos,300000,2020
13060,0,84277,Sam Jones,C,dead_cap,denver-broncos,84277,2020
13061,0,59204,Keishawn Bierria,ILB,dead_cap,denver-broncos,59204,2020
13062,0,12000,Alijah Holder,CB,dead_cap,denver-broncos,12000,2020
13063,0,6667,Trinity Benson,WR,dead_cap,denver-broncos,6667,2020
13064,0,6667,Joe Dineen,LB,dead_cap,denver-broncos,6667,2020
13065,0,6667,Brett Rypien,QB,dead_cap,denver-broncos,6667,2020
13066,0,5000,Josh Watson,LB,dead_cap,denver-broncos,5000,2020
13067,0,4667,Devontae Jackson,RB,dead_cap,denver-broncos,4667,2020
13068,0,3334,John Leglue,G,dead_cap,denver-broncos,3334,2020
13069,0,3334,Kelvin McKnight,WR,dead_cap,denver-broncos,3334,2020
13070,0,2000,Quinn Bailey,T,dead_cap,denver-broncos,2000,2020
13071,0,2000,Romell Guerrier,WR,dead_cap,denver-broncos,2000,2020
13072,0,1334,George Aston,FB,dead_cap,denver-broncos,1334,2020
13073,0,1334,Ahmad Gooden,DE,dead_cap,denver-broncos,1334,2020
13074,285000,9676437,Calvin Johnson,WR,active,detroit-lions,9961437,2007
13075,625000,3833333,Cory Redding,DE,active,detroit-lions,4458333,2007
13076,1500000,2200000,Shaun Rogers,DT,active,detroit-lions,3700000,2007
13077,834118,2550000,Jeff Backus,T,active,detroit-lions,3384118,2007
13078,2550000,870000,Dominic Raiola,C,active,detroit-lions,3420000,2007
13079,2335000,35000,George Foster,T,active,detroit-lions,2370000,2007
13080,1450000,875000,Jon Kitna,QB,active,detroit-lions,2325000,2007
13081,1250000,1000000,Travis Fisher,CB,active,detroit-lions,2250000,2007
13082,360000,3680000,Ernie Sims,OLB,active,detroit-lions,4040000,2007
13083,1650000,430000,Jason Hanson,K,active,detroit-lions,2080000,2007
13084,1095000,440000,Boss Bailey,LB,active,detroit-lions,1535000,2007
13085,1100000,500000,T.J. Duckett,RB,active,detroit-lions,1600000,2007
13086,510000,1503750,Kevin Jones,RB,active,detroit-lions,2013750,2007
13087,750000,600000,Paris Lenon,ILB,active,detroit-lions,1350000,2007
13088,285000,856900,Drew Stanton,QB,active,detroit-lions,1141900,2007
13089,285000,210000,Ikaika Alama-Francis,DE,active,detroit-lions,495000,2007
13090,600000,341667,Nick Harris,P,active,detroit-lions,941667,2007
13091,285000,195000,Gerald Alexander,S,active,detroit-lions,480000,2007
13092,360000,0,Daniel Bullocks,S,active,detroit-lions,360000,2007
13093,435000,189350,Stanley Wilson,CB,active,detroit-lions,624350,2007
13094,510000,105000,Don Muhlbach,LS,active,detroit-lions,615000,2007
13095,360000,188250,Brian Calhoun,RB,active,detroit-lions,548250,2007
13096,435000,43800,Dan Orlovsky,QB,active,detroit-lions,478800,2007
13097,720000,0,Troy Walters,WR,active,detroit-lions,720000,2007
13098,435000,0,Etric Pruitt,CB,active,detroit-lions,435000,2007
13099,360000,44333,Jonathan Scott,LT,active,detroit-lions,404333,2007
13100,285000,110333,Manuel Ramirez,G,active,detroit-lions,395333,2007
13101,360000,9233,Anthony Cannon,LB,active,detroit-lions,369233,2007
13102,360000,0,Greg Blue,CB,active,detroit-lions,360000,2007
13103,285000,0,Buster Davis,LB,active,detroit-lions,285000,2007
13104,285000,0,Eric Frampton,S,active,detroit-lions,285000,2007
13105,285000,0,Clark Harris,LS,active,detroit-lions,285000,2007
13106,285000,0,Ramzee Robinson,CB,active,detroit-lions,285000,2007
13107,3385000,5670000,Roy Williams,WR,injured_reserve,detroit-lions,9055000,2007
13108,1500000,515000,Dan Campbell,TE,injured_reserve,detroit-lions,2015000,2007
13109,0,10576000,Mike Williams,WR,dead_cap,detroit-lions,10576000,2007
13110,0,6566670,Charles Rogers,WR,dead_cap,detroit-lions,6566670,2007
13111,1600000,0,James Hall,DE,dead_cap,detroit-lions,1600000,2007
13112,1000000,0,Josh McCown,QB,dead_cap,detroit-lions,1000000,2007
13113,0,766668,Marcus Pollard,TE,dead_cap,detroit-lions,766668,2007
13114,0,333334,Marcus Bell,DT,dead_cap,detroit-lions,333334,2007
13115,119950,0,A.J. Davis,CB,dead_cap,detroit-lions,119950,2007
13116,51750,0,Dee McCann,CB,dead_cap,detroit-lions,51750,2007
13117,41833,0,Johnny Baldwin,LB,dead_cap,detroit-lions,41833,2007
13118,27732,0,Fred Matua,G,dead_cap,detroit-lions,27732,2007
13119,26333,0,Bill Swancutt,DE,dead_cap,detroit-lions,26333,2007
13120,9400,0,Claude Harriott,DE,dead_cap,detroit-lions,9400,2007
13121,8300,0,Ramzee Robinson,CB,dead_cap,detroit-lions,8300,2007
13122,2700000,2550000,Jeff Backus,T,active,detroit-lions,5250000,2008
13123,2900000,1858333,Cory Redding,DE,active,detroit-lions,4758333,2008
13124,1883438,2800000,Calvin Johnson,WR,active,detroit-lions,4683438,2008
13125,3400000,870000,Dominic Raiola,C,active,detroit-lions,4270000,2008
13126,2950000,875000,Jon Kitna,QB,active,detroit-lions,3825000,2008
13127,1750000,1000000,Travis Fisher,CB,active,detroit-lions,2750000,2008
13128,715000,3730000,Ernie Sims,OLB,active,detroit-lions,4445000,2008
13129,1650000,430000,Jason Hanson,K,active,detroit-lions,2080000,2008
13130,800000,1200000,Michael Gaines,TE,active,detroit-lions,2000000,2008
13131,1050000,600000,Paris Lenon,ILB,active,detroit-lions,1650000,2008
13132,295000,1085000,Gosder Cherilus,RT,active,detroit-lions,1380000,2008
13133,950000,341667,Nick Harris,P,active,detroit-lions,1291667,2008
13134,1100000,0,Rudi Johnson,RB,active,detroit-lions,1100000,2008
13135,800000,300000,George Foster,T,active,detroit-lions,1100000,2008
13136,1000000,0,Dante Wesley,CB,active,detroit-lions,1000000,2008
13137,445000,0,Daniel Bullocks,S,active,detroit-lions,445000,2008
13138,927000,0,Dan Orlovsky,QB,active,detroit-lions,927000,2008
13139,927000,0,Stanley Wilson,CB,active,detroit-lions,927000,2008
13140,370000,830000,Drew Stanton,QB,active,detroit-lions,1200000,2008
13141,0,1285000,Kevin Jones,RB,active,detroit-lions,1285000,2008
13142,730000,0,Daunte Culpepper,QB,active,detroit-lions,730000,2008
13143,605000,105000,Don Muhlbach,LS,active,detroit-lions,710000,2008
13144,445000,188250,Brian Calhoun,RB,active,detroit-lions,633250,2008
13145,605000,0,Dexter Wynn,CB,active,detroit-lions,605000,2008
13146,370000,210000,Ikaika Alama-Francis,DE,active,detroit-lions,580000,2008
13147,370000,195000,Gerald Alexander,S,active,detroit-lions,565000,2008
13148,295000,216630,Kevin Smith,RB,active,detroit-lions,511630,2008
13149,370000,110333,Manuel Ramirez,G,active,detroit-lions,480333,2008
13150,295000,170416,Andre Fluellen,DT,active,detroit-lions,465416,2008
13151,295000,161333,Cliff Avril,DE,active,detroit-lions,456333,2008
13152,445000,9233,Anthony Cannon,LB,active,detroit-lions,454233,2008
13153,445000,0,Adam Jennings,WR,active,detroit-lions,445000,2008
13154,370000,0,Buster Davis,LB,active,detroit-lions,370000,2008
13155,370000,0,Eric Frampton,S,active,detroit-lions,370000,2008
13156,370000,0,Clark Harris,LS,active,detroit-lions,370000,2008
13157,370000,0,Ramzee Robinson,CB,active,detroit-lions,370000,2008
13158,295000,45366,Jerome Felton,FB,active,detroit-lions,340366,2008
13159,295000,14583,Landon Cohen,DT,active,detroit-lions,309583,2008
13160,295000,0,Kenneth Moore,WR,active,detroit-lions,295000,2008
13161,1800000,515000,Dan Campbell,TE,injured_reserve,detroit-lions,2315000,2008
13162,1314529,4010000,Roy Williams,WR,dead_cap,detroit-lions,5324529,2008
13163,1400000,0,Shaun Rogers,DT,dead_cap,detroit-lions,1400000,2008
13164,1303921,0,Brian Kelly,CB,dead_cap,detroit-lions,1303921,2008
13165,239900,0,A.J. Davis,CB,dead_cap,detroit-lions,239900,2008
13166,83666,0,Johnny Baldwin,LB,dead_cap,detroit-lions,83666,2008
13167,44333,0,Jonathan Scott,LT,dead_cap,detroit-lions,44333,2008
13168,40000,0,Caleb Campbell,LB,dead_cap,detroit-lions,40000,2008
13169,16600,0,Ramzee Robinson,CB,dead_cap,detroit-lions,16600,2008
13170,2580125,6800000,Calvin Johnson,WR,active,detroit-lions,9380125,2009
13171,4450000,2550000,Jeff Backus,T,active,detroit-lions,7000000,2009
13172,6500000,0,Julian Peterson,LB,active,detroit-lions,6500000,2009
13173,2500000,2500000,Daunte Culpepper,QB,active,detroit-lions,5000000,2009
13174,3400000,1570000,Dominic Raiola,C,active,detroit-lions,4970000,2009
13175,1000000,3500000,Phillip Buchanon,CB,active,detroit-lions,4500000,2009
13176,3000000,265000,Stephen Peterman,G,active,detroit-lions,3265000,2009
13177,3100000,0,Matthew Stafford,QB,active,detroit-lions,3100000,2009
13178,2975000,0,Larry Foote,ILB,active,detroit-lions,2975000,2009
13179,495000,3415000,Gosder Cherilus,RT,active,detroit-lions,3910000,2009
13180,850000,3730000,Ernie Sims,OLB,active,detroit-lions,4580000,2009
13181,2000000,400000,Bryant Johnson,WR,active,detroit-lions,2400000,2009
13182,875000,500000,Maurice Morris,RB,active,detroit-lions,1375000,2009
13183,1400000,875000,Jon Kitna,QB,active,detroit-lions,2275000,2009
13184,1400000,675000,Jason Hanson,K,active,detroit-lions,2075000,2009
13185,1200000,341667,Nick Harris,P,active,detroit-lions,1541667,2009
13186,310000,1025000,Brandon Pettigrew,TE,active,detroit-lions,1335000,2009
13187,530000,0,Daniel Bullocks,S,active,detroit-lions,530000,2009
13188,1010000,0,Jason Hunter,DE,active,detroit-lions,1010000,2009
13189,1000000,0,Daniel Loper,T,active,detroit-lions,1000000,2009
13190,1000000,0,Ko Simpson,S,active,detroit-lions,1000000,2009
13191,1000000,0,Dante Wesley,CB,active,detroit-lions,1000000,2009
13192,525000,830000,Drew Stanton,QB,active,detroit-lions,1355000,2009
13193,310000,545000,Louis Delmas,FS,active,detroit-lions,855000,2009
13194,620000,50000,Shaun Smith,DT,active,detroit-lions,670000,2009
13195,650000,105000,Don Muhlbach,LS,active,detroit-lions,755000,2009
13196,620000,0,Dylan Gandy,G,active,detroit-lions,620000,2009
13197,620000,0,Will Heller,TE,active,detroit-lions,620000,2009
13198,385000,216630,Kevin Smith,RB,active,detroit-lions,601630,2009
13199,460000,110333,Manuel Ramirez,G,active,detroit-lions,570333,2009
13200,385000,170416,Andre Fluellen,DT,active,detroit-lions,555416,2009
13201,385000,161333,Cliff Avril,DE,active,detroit-lions,546333,2009
13202,310000,203566,DeAndre Levy,OLB,active,detroit-lions,513566,2009
13203,310000,190333,Derrick Williams,WR,active,detroit-lions,500333,2009
13204,385000,113000,Jack Williams,CB,active,detroit-lions,498000,2009
13205,460000,0,Yamon Figurs,WR,active,detroit-lions,460000,2009
13206,460000,0,Eric Frampton,S,active,detroit-lions,460000,2009
13207,460000,0,Michael Matthews,TE,active,detroit-lions,460000,2009
13208,460000,0,Turk McBride,DE,active,detroit-lions,460000,2009
13209,385000,45366,Jerome Felton,FB,active,detroit-lions,430366,2009
13210,310000,119500,Sammie Lee Hill,DT,active,detroit-lions,429500,2009
13211,385000,14583,Landon Cohen,DT,active,detroit-lions,399583,2009
13212,385000,0,Kenneth Moore,WR,active,detroit-lions,385000,2009
13213,310000,13200,Lydon Murtha,T,active,detroit-lions,323200,2009
13214,310000,11866,Zack Follett,LB,active,detroit-lions,321866,2009
13215,310000,8667,Dan Gronkowski,TE,active,detroit-lions,318667,2009
13216,285000,0,Adam Jennings,WR,active,detroit-lions,285000,2009
13217,1000000,687500,Eric King,CB,injured_reserve,detroit-lions,1687500,2009
13218,88400,0,Danny Lansanah,ILB,practice_squad,detroit-lions,88400,2009
13219,88400,0,Logan Payne,WR,practice_squad,detroit-lions,88400,2009
13220,9166665,0,Cory Redding,DE,dead_cap,detroit-lions,9166665,2009
13221,0,3910000,Roy Williams,WR,dead_cap,detroit-lions,3910000,2009
13222,2166666,0,Brian Kelly,CB,dead_cap,detroit-lions,2166666,2009
13223,1800000,0,Michael Gaines,TE,dead_cap,detroit-lions,1800000,2009
13224,1500000,0,Travis Fisher,CB,dead_cap,detroit-lions,1500000,2009
13225,0,880000,Dan Campbell,TE,dead_cap,detroit-lions,880000,2009
13226,420000,0,Ikaika Alama-Francis,DE,dead_cap,detroit-lions,420000,2009
13227,195000,0,Gerald Alexander,S,dead_cap,detroit-lions,195000,2009
13228,188250,0,Brian Calhoun,RB,dead_cap,detroit-lions,188250,2009
13229,87647,0,Patrick Ramsey,QB,dead_cap,detroit-lions,87647,2009
13230,80000,0,Caleb Campbell,LB,dead_cap,detroit-lions,80000,2009
13231,52667,0,Kenneth Moore,WR,dead_cap,detroit-lions,52667,2009
13232,395000,16065000,Matthew Stafford,QB,active,detroit-lions,16460000,2010
13233,4000000,7354162,Calvin Johnson,WR,active,detroit-lions,11354162,2010
13234,4950000,2550000,Jeff Backus,T,active,detroit-lions,7500000,2010
13235,7500000,0,Julian Peterson,LB,active,detroit-lions,7500000,2010
13236,745000,5990000,Gosder Cherilus,RT,active,detroit-lions,6735000,2010
13237,3125000,700000,Nate Burleson,WR,active,detroit-lions,3825000,2010
13238,3500000,1437500,Kyle Vanden Bosch,DE,active,detroit-lions,4937500,2010
13239,395000,4733500,Brandon Pettigrew,TE,active,detroit-lions,5128500,2010
13240,1400000,3325000,Dominic Raiola,C,active,detroit-lions,4725000,2010
13241,320000,2780000,Ndamukong Suh,DT,active,detroit-lions,3100000,2010
13242,2600000,400000,Bryant Johnson,WR,active,detroit-lions,3000000,2010
13243,2700000,0,Corey Williams,DT,active,detroit-lions,2700000,2010
13244,2400000,265000,Stephen Peterman,G,active,detroit-lions,2665000,2010
13245,1775000,675000,Jason Hanson,K,active,detroit-lions,2450000,2010
13246,1176000,1200000,Rob Sims,G,active,detroit-lions,2376000,2010
13247,1300000,500000,Maurice Morris,RB,active,detroit-lions,1800000,2010
13248,460000,2044250,Louis Delmas,FS,active,detroit-lions,2504250,2010
13249,1176000,500000,Tony Scheffler,TE,active,detroit-lions,1676000,2010
13250,1300000,341667,Nick Harris,P,active,detroit-lions,1641667,2010
13251,1585000,0,Shaun Hill,QB,active,detroit-lions,1585000,2010
13252,1100000,283333,Will Heller,TE,active,detroit-lions,1383333,2010
13253,320000,950000,Jahvid Best,RB,active,detroit-lions,1270000,2010
13254,1226000,0,Daniel Loper,T,active,detroit-lions,1226000,2010
13255,1176000,0,Dylan Gandy,G,active,detroit-lions,1176000,2010
13256,637000,830000,Drew Stanton,QB,active,detroit-lions,1467000,2010
13257,1010000,0,Manuel Ramirez,G,active,detroit-lions,1010000,2010
13258,675000,105000,Don Muhlbach,LS,active,detroit-lions,780000,2010
13259,690000,0,Tony Ugoh,T,active,detroit-lions,690000,2010
13260,470000,216630,Kevin Smith,RB,active,detroit-lions,686630,2010
13261,470000,170416,Andre Fluellen,DT,active,detroit-lions,640416,2010
13262,470000,161333,Cliff Avril,DE,active,detroit-lions,631333,2010
13263,630000,0,Ceandris Brown,CB,active,detroit-lions,630000,2010
13264,630000,0,Nathan Vasher,CB,active,detroit-lions,630000,2010
13265,405000,203566,DeAndre Levy,OLB,active,detroit-lions,608566,2010
13266,395000,190333,Derrick Williams,WR,active,detroit-lions,585333,2010
13267,470000,113000,Jack Williams,CB,active,detroit-lions,583000,2010
13268,320000,232333,Amari Spievey,S,active,detroit-lions,552333,2010
13269,550000,0,Turk McBride,DE,active,detroit-lions,550000,2010
13270,545000,0,Corey Hilliard,RT,active,detroit-lions,545000,2010
13271,545000,0,Jonathan Wade,CB,active,detroit-lions,545000,2010
13272,545000,0,John Wendling,S,active,detroit-lions,545000,2010
13273,525000,0,Lawrence Jackson,DE,active,detroit-lions,525000,2010
13274,470000,45366,Jerome Felton,FB,active,detroit-lions,515366,2010
13275,395000,119500,Sammie Lee Hill,DT,active,detroit-lions,514500,2010
13276,475000,0,Tyler Polumbus,LT,active,detroit-lions,475000,2010
13277,470000,0,Kenneth Moore,WR,active,detroit-lions,470000,2010
13278,470000,0,Donald Thomas,G,active,detroit-lions,470000,2010
13279,320000,110302,Jason Fox,RT,active,detroit-lions,430302,2010
13280,395000,11866,Zack Follett,LB,active,detroit-lions,406866,2010
13281,395000,0,Stefan Logan,WR,active,detroit-lions,395000,2010
13282,395000,0,Alphonso Smith,CB,active,detroit-lions,395000,2010
13283,320000,16000,Willie Young,OLB,active,detroit-lions,336000,2010
13284,298000,500,Aaron Berry,CB,active,detroit-lions,298500,2010
13285,225000,0,Trevor Canfield,G,injured_reserve,detroit-lions,225000,2010
13286,0,7610000,Ernie Sims,OLB,dead_cap,detroit-lions,7610000,2010
13287,0,1000000,Phillip Buchanon,CB,dead_cap,detroit-lions,1000000,2010
13288,687500,0,Eric King,CB,dead_cap,detroit-lions,687500,2010
13289,411667,0,Tony Ugoh,T,dead_cap,detroit-lions,411667,2010
13290,195000,0,Gerald Alexander,S,dead_cap,detroit-lions,195000,2010
13291,105334,0,Kenneth Moore,WR,dead_cap,detroit-lions,105334,2010
13292,26400,0,Lydon Murtha,T,dead_cap,detroit-lions,26400,2010
13293,14583,0,Landon Cohen,DT,dead_cap,detroit-lions,14583,2010
13294,0,8713,Tim Toone,WR,dead_cap,detroit-lions,8713,2010
13295,8875000,5300000,Calvin Johnson,WR,active,detroit-lions,14175000,2011
13296,1239706,14135000,Ndamukong Suh,DT,active,detroit-lions,15374706,2011
13297,5450000,0,Jeff Backus,T,active,detroit-lions,5450000,2011
13298,525000,9078750,Matthew Stafford,QB,active,detroit-lions,9603750,2011
13299,4900000,0,Corey Williams,DT,active,detroit-lions,4900000,2011
13300,2400000,3325000,Dominic Raiola,C,active,detroit-lions,5725000,2011
13301,3200000,400000,Bryant Johnson,WR,active,detroit-lions,3600000,2011
13302,2000000,1500000,Eric Wright,CB,active,detroit-lions,3500000,2011
13303,810000,2667500,Kyle Vanden Bosch,DE,active,detroit-lions,3477500,2011
13304,3250000,0,Stephen Tulloch,ILB,active,detroit-lions,3250000,2011
13305,2900000,265000,Stephen Peterman,G,active,detroit-lions,3165000,2011
13306,610000,3415000,Gosder Cherilus,RT,active,detroit-lions,4025000,2011
13307,2175000,675000,Jason Hanson,K,active,detroit-lions,2850000,2011
13308,1781765,700000,Nate Burleson,WR,active,detroit-lions,2481765,2011
13309,1325000,1400000,Rob Sims,G,active,detroit-lions,2725000,2011
13310,450000,2973000,Jahvid Best,RB,active,detroit-lions,3423000,2011
13311,2611000,0,Cliff Avril,DE,active,detroit-lions,2611000,2011
13312,1625000,500000,Maurice Morris,RB,active,detroit-lions,2125000,2011
13313,1000000,1375000,Justin Durant,OLB,active,detroit-lions,2375000,2011
13314,2273225,0,Shaun Hill,QB,active,detroit-lions,2273225,2011
13315,1550000,700000,Tony Scheffler,TE,active,detroit-lions,2250000,2011
13316,1000000,1125000,Chris Houston,CB,active,detroit-lions,2125000,2011
13317,728750,2547500,Brandon Pettigrew,TE,active,detroit-lions,3276250,2011
13318,375000,1423000,Nick Fairley,DT,active,detroit-lions,1798000,2011
13319,685000,750000,Dylan Gandy,G,active,detroit-lions,1435000,2011
13320,1100000,283333,Will Heller,TE,active,detroit-lions,1383333,2011
13321,608750,1447500,Louis Delmas,FS,active,detroit-lions,2056250,2011
13322,1200000,0,Jerome Felton,FB,active,detroit-lions,1200000,2011
13323,1200000,0,Andre Fluellen,DT,active,detroit-lions,1200000,2011
13324,910000,0,Leonard Davis,G,active,detroit-lions,910000,2011
13325,685000,208333,John Wendling,S,active,detroit-lions,893333,2011
13326,775000,105000,Don Muhlbach,LS,active,detroit-lions,880000,2011
13327,375000,454331,Titus Young,WR,active,detroit-lions,829331,2011
13328,525000,250000,Stefan Logan,WR,active,detroit-lions,775000,2011
13329,765000,0,Erik Coleman,S,active,detroit-lions,765000,2011
13330,715000,0,Lawrence Jackson,DE,active,detroit-lions,715000,2011
13331,685000,0,Rashied Davis,WR,active,detroit-lions,685000,2011
13332,685000,0,Ben Graham,P,active,detroit-lions,685000,2011
13333,685000,0,Maurice Stovall,WR,active,detroit-lions,685000,2011
13334,480000,203566,DeAndre Levy,OLB,active,detroit-lions,683566,2011
13335,450000,232333,Amari Spievey,S,active,detroit-lions,682333,2011
13336,480000,190333,Derrick Williams,WR,active,detroit-lions,670333,2011
13337,555000,113000,Jack Williams,CB,active,detroit-lions,668000,2011
13338,650000,0,Drew Stanton,QB,active,detroit-lions,650000,2011
13339,375000,249396,Mikel Leshoure,RB,active,detroit-lions,624396,2011
13340,600000,0,Kevin Smith,RB,active,detroit-lions,600000,2011
13341,480000,119500,Sammie Lee Hill,DT,active,detroit-lions,599500,2011
13342,685000,50000,Brandon McDonald,CB,active,detroit-lions,735000,2011
13343,450000,110302,Jason Fox,RT,active,detroit-lions,560302,2011
13344,480000,0,Alphonso Smith,CB,active,detroit-lions,480000,2011
13345,685000,50000,Bobby Carpenter,LB,active,detroit-lions,735000,2011
13346,525000,0,Ashlee Palmer,OLB,active,detroit-lions,525000,2011
13347,450000,50000,Don Carey,SS,active,detroit-lions,500000,2011
13348,480000,11866,Zack Follett,LB,active,detroit-lions,491866,2011
13349,480000,0,Corey Hilliard,RT,active,detroit-lions,480000,2011
13350,480000,0,Nate Hughes,WR,active,detroit-lions,480000,2011
13351,450000,16000,Willie Young,OLB,active,detroit-lions,466000,2011
13352,465000,0,Joique Bell,RB,active,detroit-lions,465000,2011
13353,375000,44527,Douglas Hogue,OLB,active,detroit-lions,419527,2011
13354,405000,0,Keiland Williams,RB,active,detroit-lions,405000,2011
13355,375000,15950,Johnny Culbreath,T,active,detroit-lions,390950,2011
13356,375000,500,Aaron Berry,CB,active,detroit-lions,375500,2011
13357,685000,50000,Jerome Harrison,RB,injured_reserve,detroit-lions,735000,2011
13358,683334,0,Nick Harris,P,dead_cap,detroit-lions,683334,2011
13359,383333,0,Jordon Dizon,LB,dead_cap,detroit-lions,383333,2011
13360,0,17426,Tim Toone,WR,dead_cap,detroit-lions,17426,2011
13361,2333,0,Richard Dickson,TE,dead_cap,detroit-lions,2333,2011
13362,0,1000,Marcus Harris,WR,dead_cap,detroit-lions,1000,2011
13363,1000,0,Ricardo Silva,S,dead_cap,detroit-lions,1000,2011
13364,1250000,10500000,Calvin Johnson,WR,active,detroit-lions,11750000,2012
13365,10605000,0,Cliff Avril,DE,active,detroit-lions,10605000,2012
13366,615000,11800000,Matthew Stafford,QB,active,detroit-lions,12415000,2012
13367,540000,9492500,Ndamukong Suh,DT,active,detroit-lions,10032500,2012
13368,3400000,3325000,Dominic Raiola,C,active,detroit-lions,6725000,2012
13369,4900000,0,Corey Williams,DT,active,detroit-lions,4900000,2012
13370,3000000,1625000,Chris Houston,CB,active,detroit-lions,4625000,2012
13371,2310000,3415000,Gosder Cherilus,RT,active,detroit-lions,5725000,2012
13372,925000,3686250,Kyle Vanden Bosch,DE,active,detroit-lions,4611250,2012
13373,1750000,1875000,Justin Durant,OLB,active,detroit-lions,3625000,2012
13374,2550000,675000,Jason Hanson,K,active,detroit-lions,3225000,2012
13375,1500000,1575000,Rob Sims,G,active,detroit-lions,3075000,2012
13376,2725000,265000,Stephen Peterman,G,active,detroit-lions,2990000,2012
13377,1550000,1000000,Tony Scheffler,TE,active,detroit-lions,2550000,2012
13378,1250000,1300000,Stephen Tulloch,ILB,active,detroit-lions,2550000,2012
13379,1600000,750000,Jeff Backus,T,active,detroit-lions,2350000,2012
13380,1062500,2547500,Brandon Pettigrew,TE,active,detroit-lions,3610000,2012
13381,1750000,500000,Shaun Hill,QB,active,detroit-lions,2250000,2012
13382,824500,1423000,Nick Fairley,DT,active,detroit-lions,2247500,2012
13383,1927000,0,DeAndre Levy,OLB,active,detroit-lions,1927000,2012
13384,850000,1000000,Dylan Gandy,G,active,detroit-lions,1850000,2012
13385,973250,1447500,Louis Delmas,FS,active,detroit-lions,2420750,2012
13386,640500,1873000,Jahvid Best,RB,active,detroit-lions,2513500,2012
13387,465000,1177664,Titus Young,WR,active,detroit-lions,1642664,2012
13388,1500000,0,Drayton Florence,CB,active,detroit-lions,1500000,2012
13389,390000,1063400,Riley Reiff,LT,active,detroit-lions,1453400,2012
13390,1450000,0,Mike Thomas,WR,active,detroit-lions,1450000,2012
13391,1260000,0,Sammie Lee Hill,DT,active,detroit-lions,1260000,2012
13392,1260000,0,Corey Hilliard,RT,active,detroit-lions,1260000,2012
13393,615000,333333,Ashlee Palmer,OLB,active,detroit-lions,948333,2012
13394,925000,0,Nick Harris,P,active,detroit-lions,925000,2012
13395,700000,223333,John Wendling,S,active,detroit-lions,923333,2012
13396,915000,0,Lawrence Jackson,DE,active,detroit-lions,915000,2012
13397,615000,250000,Stefan Logan,WR,active,detroit-lions,865000,2012
13398,465000,315495,Mikel Leshoure,RB,active,detroit-lions,780495,2012
13399,490000,232333,Amari Spievey,S,active,detroit-lions,722333,2012
13400,700000,0,Ron Bartell,CB,active,detroit-lions,700000,2012
13401,700000,0,Tyrell Johnson,S,active,detroit-lions,700000,2012
13402,825000,65000,Kassim Osgood,WR,active,detroit-lions,890000,2012
13403,825000,65000,Erik Coleman,S,active,detroit-lions,890000,2012
13404,825000,65000,Will Heller,TE,active,detroit-lions,890000,2012
13405,825000,65000,Don Muhlbach,LS,active,detroit-lions,890000,2012
13406,700000,65000,Kevin Smith,RB,active,detroit-lions,765000,2012
13407,490000,110302,Jason Fox,RT,active,detroit-lions,600302,2012
13408,540000,50000,Don Carey,SS,active,detroit-lions,590000,2012
13409,540000,0,Joique Bell,RB,active,detroit-lions,540000,2012
13410,490000,16000,Willie Young,OLB,active,detroit-lions,506000,2012
13411,390000,99272,Ronnell Lewis,DE,active,detroit-lions,489272,2012
13412,465000,0,Kris Durham,WR,active,detroit-lions,465000,2012
13413,465000,0,Lance Long,WR,active,detroit-lions,465000,2012
13414,465000,0,Bill Nagy,G,active,detroit-lions,465000,2012
13415,465000,0,Jimmy Saddler-McQueen,DT,active,detroit-lions,465000,2012
13416,465000,0,Ricardo Silva,S,active,detroit-lions,465000,2012
13417,390000,53000,Tahir Whitehead,OLB,active,detroit-lions,443000,2012
13418,390000,48000,Chris Greenwood,CB,active,detroit-lions,438000,2012
13419,390000,24250,Jonte Green,CB,active,detroit-lions,414250,2012
13420,390000,14793,Travis Lewis,ILB,active,detroit-lions,404793,2012
13421,390000,6666,Kellen Moore,QB,active,detroit-lions,396666,2012
13422,700000,0,Justin Miller,CB,active,detroit-lions,700000,2012
13423,390000,0,Ogemdi Nwaguo,DT,active,detroit-lions,390000,2012
13424,390000,0,Nathan Overbay,TE,active,detroit-lions,390000,2012
13425,615000,0,Alphonso Smith,CB,active,detroit-lions,615000,2012
13426,307500,0,Brian Robiskie,WR,active,detroit-lions,307500,2012
13427,615000,0,Pat Lee,CB,active,detroit-lions,615000,2012
13428,700000,0,Andre Fluellen,DT,active,detroit-lions,700000,2012
13429,465000,0,Shaun Chapas,TE,active,detroit-lions,465000,2012
13430,825000,700000,Nate Burleson,WR,injured_reserve,detroit-lions,1525000,2012
13431,1050000,150000,Jacob Lacey,CB,injured_reserve,detroit-lions,1200000,2012
13432,390000,278818,Ryan Broyles,WR,injured_reserve,detroit-lions,668818,2012
13433,390000,137278,Bill Bentley,CB,injured_reserve,detroit-lions,527278,2012
13434,326250,0,Jacques McClendon,C,dead_cap,detroit-lions,326250,2012
13435,202500,0,Keiland Williams,RB,dead_cap,detroit-lions,202500,2012
13436,65000,0,Andre Fluellen,DT,dead_cap,detroit-lions,65000,2012
13437,65000,0,Ben Graham,P,dead_cap,detroit-lions,65000,2012
13438,0,44527,Douglas Hogue,OLB,dead_cap,detroit-lions,44527,2012
13439,0,15950,Johnny Culbreath,T,dead_cap,detroit-lions,15950,2012
13440,2500,0,J.C. Oram,G,dead_cap,detroit-lions,2500,2012
13441,2333,0,Richard Dickson,TE,dead_cap,detroit-lions,2333,2012
13442,0,2000,Marcus Harris,WR,dead_cap,detroit-lions,2000,2012
13443,2000,0,Ricardo Silva,S,dead_cap,detroit-lions,2000,2012
13444,1667,0,Ryan Donahue,P,dead_cap,detroit-lions,1667,2012
13445,1334,0,Rodney Austin,G,dead_cap,detroit-lions,1334,2012
13446,833,0,Carmen Messina,LB,dead_cap,detroit-lions,833,2012
13447,667,0,Quinn Barham,G,dead_cap,detroit-lions,667,2012
13448,667,0,Alex Gottlieb,TE,dead_cap,detroit-lions,667,2012
13449,667,0,Edmon McClam,DT,dead_cap,detroit-lions,667,2012
13450,500,0,Aaron Berry,CB,dead_cap,detroit-lions,500,2012
13451,500,0,Pat Boyle,G,dead_cap,detroit-lions,500,2012
13452,500,0,Jared Karstetter,WR,dead_cap,detroit-lions,500,2012
13453,500,0,Austin Wells,TE,dead_cap,detroit-lions,500,2012
13454,333,0,Troy Burrell,WR,dead_cap,detroit-lions,333,2012
13455,333,0,Michael Cosgrove,DT,dead_cap,detroit-lions,333,2012
13456,333,0,Ronnie Sneed,LB,dead_cap,detroit-lions,333,2012
13457,167,0,Derek Dimke,K,dead_cap,detroit-lions,167,2012
13458,167,0,Stephfon Green,RB,dead_cap,detroit-lions,167,2012
13459,4000000,17300000,Matthew Stafford,QB,active,detroit-lions,21300000,2013
13460,630000,13332500,Ndamukong Suh,DT,active,detroit-lions,13962500,2013
13461,715000,12058000,Calvin Johnson,WR,active,detroit-lions,12773000,2013
13462,3500000,1300000,Stephen Tulloch,ILB,active,detroit-lions,4800000,2013
13463,1946250,2797500,Brandon Pettigrew,TE,active,detroit-lions,4743750,2013
13464,1850000,1575000,Rob Sims,G,active,detroit-lions,3425000,2013
13465,405000,2975818,Ezekiel Ansah,DE,active,detroit-lions,3380818,2013
13466,1000000,3575000,Dominic Raiola,C,active,detroit-lions,4575000,2013
13467,2400000,850000,Shaun Hill,QB,active,detroit-lions,3250000,2013
13468,1274000,1423000,Nick Fairley,DT,active,detroit-lions,2697000,2013
13469,1000000,1300000,Chris Houston,CB,active,detroit-lions,2300000,2013
13470,1000000,1050000,Glover Quin,FS,active,detroit-lions,2050000,2013
13471,1000000,1000000,Reggie Bush,RB,active,detroit-lions,2000000,2013
13472,1000000,1000000,DeAndre Levy,OLB,active,detroit-lions,2000000,2013
13473,1000000,833333,Jason Jones,DE,active,detroit-lions,1833333,2013
13474,753350,1063400,Riley Reiff,LT,active,detroit-lions,1816750,2013
13475,1200000,300000,Willie Young,OLB,active,detroit-lions,1500000,2013
13476,1000000,333333,Ashlee Palmer,OLB,active,detroit-lions,1333333,2013
13477,1323000,0,Jason Fox,RT,active,detroit-lions,1323000,2013
13478,715000,500000,Louis Delmas,FS,active,detroit-lions,1215000,2013
13479,630000,250000,Don Carey,SS,active,detroit-lions,880000,2013
13480,850000,175000,C.J. Mosley,DT,active,detroit-lions,1025000,2013
13481,715000,265000,Corey Hilliard,RT,active,detroit-lions,980000,2013
13482,405000,556691,Darius Slay,CB,active,detroit-lions,961691,2013
13483,555000,384258,Mikel Leshoure,RB,active,detroit-lions,939258,2013
13484,800000,112500,Leroy Harris,C,active,detroit-lions,912500,2013
13485,715000,208333,John Wendling,S,active,detroit-lions,923333,2013
13486,480000,157278,Bill Bentley,CB,active,detroit-lions,637278,2013
13487,630000,0,Joique Bell,RB,active,detroit-lions,630000,2013
13488,940000,65000,David Akers,K,active,detroit-lions,1005000,2013
13489,840000,0,Dylan Gandy,G,active,detroit-lions,840000,2013
13490,840000,65000,Don Muhlbach,LS,active,detroit-lions,905000,2013
13491,405000,174250,Larry Warford,G,active,detroit-lions,579250,2013
13492,940000,0,Rashean Mathis,CB,active,detroit-lions,940000,2013
13493,840000,0,Rocky McIntosh,OLB,active,detroit-lions,840000,2013
13494,555000,0,Kris Durham,WR,active,detroit-lions,555000,2013
13495,555000,0,Dejon Gomes,S,active,detroit-lions,555000,2013
13496,715000,0,Kevin Ogletree,WR,active,detroit-lions,715000,2013
13497,480000,53000,Tahir Whitehead,OLB,active,detroit-lions,533000,2013
13498,480000,24250,Jonte Green,CB,active,detroit-lions,504250,2013
13499,480000,14793,Travis Lewis,ILB,active,detroit-lions,494793,2013
13500,480000,6666,Kellen Moore,QB,active,detroit-lions,486666,2013
13501,405000,75146,Devin Taylor,DE,active,detroit-lions,480146,2013
13502,715000,0,Andre Fluellen,DT,active,detroit-lions,715000,2013
13503,405000,40075,Sam Martin,P,active,detroit-lions,445075,2013
13504,405000,22750,Theo Riddick,RB,active,detroit-lions,427750,2013
13505,405000,4166,Joseph Fauria,TE,active,detroit-lions,409166,2013
13506,405000,3333,LaAdrian Waddle,RT,active,detroit-lions,408333,2013
13507,480000,0,Jeremy Ross,WR,active,detroit-lions,480000,2013
13508,288000,16287,Michael Williams,TE,active,detroit-lions,304287,2013
13509,555000,0,Dorin Dickerson,TE,active,detroit-lions,555000,2013
13510,405000,0,Rodney Austin,G,active,detroit-lions,405000,2013
13511,480000,0,Chris Greenwood,CB,active,detroit-lions,480000,2013
13512,480000,0,Julian Stanford,OLB,active,detroit-lions,480000,2013
13513,715000,0,Micheal Spurlock,WR,active,detroit-lions,715000,2013
13514,555000,0,Akwasi Owusu-Ansah,S,active,detroit-lions,555000,2013
13515,405000,0,Matt Veldman,TE,active,detroit-lions,405000,2013
13516,2000000,700000,Nate Burleson,WR,injured_reserve,detroit-lions,2700000,2013
13517,850000,125000,Montell Owens,FB,injured_reserve,detroit-lions,975000,2013
13518,557205,278818,Ryan Broyles,WR,injured_reserve,detroit-lions,836023,2013
13519,630000,20000,Cory Greenwood,OLB,injured_reserve,detroit-lions,650000,2013
13520,840000,65000,Israel Idonije,DE,injured_reserve,detroit-lions,905000,2013
13521,42000,0,Shaun Chapas,TE,practice_squad,detroit-lions,42000,2013
13522,12000,0,Charles Hawkins,WR,practice_squad,detroit-lions,12000,2013
13523,12000,0,Martell Webb,TE,practice_squad,detroit-lions,12000,2013
13524,7500,0,Michael Brooks,DT,practice_squad,detroit-lions,7500,2013
13525,5723750,0,Kyle Vanden Bosch,DE,dead_cap,detroit-lions,5723750,2013
13526,2450000,500000,Tony Scheffler,TE,dead_cap,detroit-lions,2950000,2013
13527,0,1873000,Jahvid Best,RB,dead_cap,detroit-lions,1873000,2013
13528,1000000,50000,Mike Thomas,WR,dead_cap,detroit-lions,1050000,2013
13529,908662,0,Titus Young,WR,dead_cap,detroit-lions,908662,2013
13530,750000,0,Jeff Backus,T,dead_cap,detroit-lions,750000,2013
13531,620000,0,Justin Bannan,DT,dead_cap,detroit-lions,620000,2013
13532,620000,0,Micheal Spurlock,WR,dead_cap,detroit-lions,620000,2013
13533,156285,0,Patrick Edwards,WR,dead_cap,detroit-lions,156285,2013
13534,148235,0,Austen Lane,DE,dead_cap,detroit-lions,148235,2013
13535,126177,0,Barry Richardson,LT,dead_cap,detroit-lions,126177,2013
13536,108000,0,Chris Greenwood,CB,dead_cap,detroit-lions,108000,2013
13537,99272,0,Ronnell Lewis,DE,dead_cap,detroit-lions,99272,2013
13538,0,89054,Douglas Hogue,OLB,dead_cap,detroit-lions,89054,2013
13539,73334,0,Rodney Austin,G,dead_cap,detroit-lions,73334,2013
13540,56470,0,D'Anthony Smith,DT,dead_cap,detroit-lions,56470,2013
13541,56333,0,Steven Miller,RB,dead_cap,detroit-lions,56333,2013
13542,32647,0,Dorin Dickerson,TE,dead_cap,detroit-lions,32647,2013
13543,0,31866,Johnny Culbreath,T,dead_cap,detroit-lions,31866,2013
13544,30775,0,Corey Fuller,WR,dead_cap,detroit-lions,30775,2013
13545,28000,0,Stephen Peterman,G,dead_cap,detroit-lions,28000,2013
13546,18000,0,Akwasi Owusu-Ansah,S,dead_cap,detroit-lions,18000,2013
13547,11474,0,Brandon Hepburn,OLB,dead_cap,detroit-lions,11474,2013
13548,6000,0,Jeremy Ross,WR,dead_cap,detroit-lions,6000,2013
13549,6000,0,Matt Veldman,TE,dead_cap,detroit-lions,6000,2013
13550,5000,0,J.C. Oram,G,dead_cap,detroit-lions,5000,2013
13551,3334,0,Ryan Donahue,P,dead_cap,detroit-lions,3334,2013
13552,2500,0,Alex Carder,QB,dead_cap,detroit-lions,2500,2013
13553,1667,0,Carmen Messina,LB,dead_cap,detroit-lions,1667,2013
13554,1666,0,Alex Elkins,LB,dead_cap,detroit-lions,1666,2013
13555,1334,0,Quinn Barham,G,dead_cap,detroit-lions,1334,2013
13556,1334,0,Alex Gottlieb,TE,dead_cap,detroit-lions,1334,2013
13557,1334,0,Edmon McClam,DT,dead_cap,detroit-lions,1334,2013
13558,0,1333,Jon Morgan,OLB,dead_cap,detroit-lions,1333,2013
13559,1333,0,Austin Holtz,LT,dead_cap,detroit-lions,1333,2013
13560,1000,0,Skyler Allen,C,dead_cap,detroit-lions,1000,2013
13561,1000,0,Pat Boyle,G,dead_cap,detroit-lions,1000,2013
13562,1000,0,Jared Karstetter,WR,dead_cap,detroit-lions,1000,2013
13563,1000,0,Austin Wells,TE,dead_cap,detroit-lions,1000,2013
13564,1000,0,Cody Wilson,WR,dead_cap,detroit-lions,1000,2013
13565,667,0,Troy Burrell,WR,dead_cap,detroit-lions,667,2013
13566,667,0,Michael Cosgrove,DT,dead_cap,detroit-lions,667,2013
13567,667,0,Ronnie Sneed,LB,dead_cap,detroit-lions,667,2013
13568,334,0,Derek Dimke,K,dead_cap,detroit-lions,334,2013
13569,334,0,Stephfon Green,RB,dead_cap,detroit-lions,334,2013
13570,334,0,Martavius Neloms,S,dead_cap,detroit-lions,334,2013
13571,12550000,13332500,Ndamukong Suh,DT,active,detroit-lions,25882500,2014
13572,2000000,17300000,Matthew Stafford,QB,active,detroit-lions,19300000,2014
13573,5000000,12058000,Calvin Johnson,WR,active,detroit-lions,17058000,2014
13574,3750000,1300000,Stephen Tulloch,ILB,active,detroit-lions,5050000,2014
13575,1250205,2975818,Ezekiel Ansah,DE,active,detroit-lions,4226023,2014
13576,2200000,1575000,Rob Sims,G,active,detroit-lions,3775000,2014
13577,2850000,833333,Jason Jones,DE,active,detroit-lions,3683333,2014
13578,2250000,1000000,DeAndre Levy,OLB,active,detroit-lions,3250000,2014
13579,1723500,1423000,Nick Fairley,DT,active,detroit-lions,3146500,2014
13580,1500000,1600000,Golden Tate,WR,active,detroit-lions,3100000,2014
13581,1166667,1777777,Reggie Bush,RB,active,detroit-lions,2944444,2014
13582,730000,1742500,Glover Quin,FS,active,detroit-lions,2472500,2014
13583,1300000,1000000,Joique Bell,RB,active,detroit-lions,2300000,2014
13584,420000,1807118,Eric Ebron,TE,active,detroit-lions,2227118,2014
13585,1200000,1000000,Brandon Pettigrew,TE,active,detroit-lions,2200000,2014
13586,1116700,1063400,Riley Reiff,LT,active,detroit-lions,2180100,2014
13587,1285000,615000,Corey Hilliard,RT,active,detroit-lions,1900000,2014
13588,1250000,333334,Ashlee Palmer,OLB,active,detroit-lions,1583334,2014
13589,1550000,175000,C.J. Mosley,DT,active,detroit-lions,1725000,2014
13590,1250000,250000,Dominic Raiola,C,active,detroit-lions,1500000,2014
13591,495423,706691,Darius Slay,CB,active,detroit-lions,1202114,2014
13592,750000,400000,James Ihedigbo,SS,active,detroit-lions,1150000,2014
13593,570000,433227,Ryan Broyles,WR,active,detroit-lions,1003227,2014
13594,730000,200000,Don Carey,SS,active,detroit-lions,930000,2014
13595,420000,507654,Kyle Van Noy,ILB,active,detroit-lions,927654,2014
13596,790000,80000,Darryl Tapp,DE,active,detroit-lions,870000,2014
13597,515000,199250,Larry Warford,G,active,detroit-lions,714250,2014
13598,645000,65000,Jed Collins,FB,active,detroit-lions,710000,2014
13599,645000,50000,Isa Abdul-Quddus,FS,active,detroit-lions,695000,2014
13600,870000,80000,Darryl Tapp,DE,active,detroit-lions,950000,2014
13601,955000,65000,Rashean Mathis,CB,active,detroit-lions,1020000,2014
13602,955000,65000,Don Muhlbach,LS,active,detroit-lions,1020000,2014
13603,855000,65000,Dan Orlovsky,QB,active,detroit-lions,920000,2014
13604,570000,53000,Tahir Whitehead,OLB,active,detroit-lions,623000,2014
13605,570000,14793,Travis Lewis,ILB,active,detroit-lions,584793,2014
13606,570000,6668,Kellen Moore,QB,active,detroit-lions,576668,2014
13607,420000,154868,Travis Swanson,C,active,detroit-lions,574868,2014
13608,495000,75146,Devin Taylor,DE,active,detroit-lions,570146,2014
13609,730000,0,George Johnson,DE,active,detroit-lions,730000,2014
13610,730000,0,Cassius Vaughn,CB,active,detroit-lions,730000,2014
13611,570000,0,Jeremy Ross,WR,active,detroit-lions,570000,2014
13612,730000,0,Garrett Reynolds,G,active,detroit-lions,730000,2014
13613,495000,40075,Sam Martin,P,active,detroit-lions,535075,2014
13614,495000,22750,Theo Riddick,RB,active,detroit-lions,517750,2014
13615,570000,0,Julian Stanford,OLB,active,detroit-lions,570000,2014
13616,420000,75146,Larry Webster,DE,active,detroit-lions,495146,2014
13617,495000,3333,LaAdrian Waddle,RT,active,detroit-lions,498333,2014
13618,570000,0,Josh Bynes,OLB,active,detroit-lions,570000,2014
13619,420000,47220,Caraun Reid,DE,active,detroit-lions,467220,2014
13620,420000,6666,Cornelius Lucas,RT,active,detroit-lions,426666,2014
13621,420000,0,Corey Fuller,WR,active,detroit-lions,420000,2014
13622,603529,0,Matt Prater,K,active,detroit-lions,603529,2014
13623,420000,75146,Nevin Lawson,CB,active,detroit-lions,495146,2014
13624,420000,0,Mohammed Seisay,CB,active,detroit-lions,420000,2014
13625,420000,0,George Winn,RB,active,detroit-lions,420000,2014
13626,343529,0,Andre Fluellen,DT,active,detroit-lions,343529,2014
13627,495000,0,Rodney Austin,G,active,detroit-lions,495000,2014
13628,730000,0,Kellen Davis,TE,active,detroit-lions,730000,2014
13629,645000,0,Joshua Thomas,CB,active,detroit-lions,645000,2014
13630,570000,157278,Bill Bentley,CB,injured_reserve,detroit-lions,727278,2014
13631,495000,4166,Joseph Fauria,TE,injured_reserve,detroit-lions,499166,2014
13632,107100,0,Emil Igwenagu,TE,practice_squad,detroit-lions,107100,2014
13633,107100,0,Andrew Peacock,WR,practice_squad,detroit-lions,107100,2014
13634,107100,0,Xavier Proctor,DT,practice_squad,detroit-lions,107100,2014
13635,107100,0,Mohammed Seisay,CB,practice_squad,detroit-lions,107100,2014
13636,107100,0,Michael Williams,TE,practice_squad,detroit-lions,107100,2014
13637,50400,0,Roy Philon,DE,practice_squad,detroit-lions,50400,2014
13638,50400,0,Jordan Thompson,TE,practice_squad,detroit-lions,50400,2014
13639,50400,0,Trevin Wade,CB,practice_squad,detroit-lions,50400,2014
13640,18900,0,Skye Dawson,WR,practice_squad,detroit-lions,18900,2014
13641,18900,0,Jerrell Harris,OLB,practice_squad,detroit-lions,18900,2014
13642,2031645,0,Nate Burleson,WR,dead_cap,detroit-lions,2031645,2014
13643,0,1300000,Chris Houston,CB,dead_cap,detroit-lions,1300000,2014
13644,855000,275000,Montell Owens,FB,dead_cap,detroit-lions,1130000,2014
13645,0,1873000,Jahvid Best,RB,dead_cap,detroit-lions,1873000,2014
13646,570000,65000,Kevin Ogletree,WR,dead_cap,detroit-lions,635000,2014
13647,500000,0,Louis Delmas,FS,dead_cap,detroit-lions,500000,2014
13648,0,440357,Mikel Leshoure,RB,dead_cap,detroit-lions,440357,2014
13649,247583,2000,Jerome Couplin,FS,dead_cap,detroit-lions,249583,2014
13650,234706,0,Danny Gorrer,CB,dead_cap,detroit-lions,234706,2014
13651,198544,0,Ronnell Lewis,DE,dead_cap,detroit-lions,198544,2014
13652,167647,0,Kellen Davis,TE,dead_cap,detroit-lions,167647,2014
13653,141000,1666,Mohammed Seisay,CB,dead_cap,detroit-lions,142666,2014
13654,141180,0,Rodney Austin,G,dead_cap,detroit-lions,141180,2014
13655,140417,0,Nate Ness,FS,dead_cap,detroit-lions,140417,2014
13656,112500,0,Leroy Harris,C,dead_cap,detroit-lions,112500,2014
13657,96000,0,Chris Greenwood,CB,dead_cap,detroit-lions,96000,2014
13658,92325,0,Corey Fuller,WR,dead_cap,detroit-lions,92325,2014
13659,74118,14856,Nate Freese,K,dead_cap,detroit-lions,88974,2014
13660,75882,0,Alex Henery,K,dead_cap,detroit-lions,75882,2014
13661,74118,0,Jordan Thompson,TE,dead_cap,detroit-lions,74118,2014
13662,0,65000,Darryl Tapp,DE,dead_cap,detroit-lions,65000,2014
13663,63000,0,Jerrell Harris,OLB,dead_cap,detroit-lions,63000,2014
13664,37800,0,Darren Keyton,C,dead_cap,detroit-lions,37800,2014
13665,34422,0,Brandon Hepburn,OLB,dead_cap,detroit-lions,34422,2014
13666,31500,0,Patrick Edwards,WR,dead_cap,detroit-lions,31500,2014
13667,25200,0,William Powell,RB,dead_cap,detroit-lions,25200,2014
13668,25200,0,George Winn,RB,dead_cap,detroit-lions,25200,2014
13669,0,24250,Jonte Green,CB,dead_cap,detroit-lions,24250,2014
13670,16941,2667,Jon Morgan,OLB,dead_cap,detroit-lions,19608,2014
13671,18900,0,Mike Harris,CB,dead_cap,detroit-lions,18900,2014
13672,0,16287,Michael Williams,TE,dead_cap,detroit-lions,16287,2014
13673,12600,0,Ifeanyi Momah,TE,dead_cap,detroit-lions,12600,2014
13674,12600,0,Julian Stanford,OLB,dead_cap,detroit-lions,12600,2014
13675,12600,0,Josh Victorian,CB,dead_cap,detroit-lions,12600,2014
13676,6300,0,Derrick Hopkins,DT,dead_cap,detroit-lions,6300,2014
13677,4667,0,Steven Miller,RB,dead_cap,detroit-lions,4667,2014
13678,3334,0,Alex Elkins,LB,dead_cap,detroit-lions,3334,2014
13679,2667,0,Austin Holtz,LT,dead_cap,detroit-lions,2667,2014
13680,0,2500,Chad Abram,FB,dead_cap,detroit-lions,2500,2014
13681,2000,0,Cody Wilson,WR,dead_cap,detroit-lions,2000,2014
13682,0,1000,Jacob Maxwell,TE,dead_cap,detroit-lions,1000,2014
13683,0,833,A.J. Dalton,RT,dead_cap,detroit-lions,833,2014
13684,0,833,Justin Jackson,OLB,dead_cap,detroit-lions,833,2014
13685,0,833,Gabe Lynn,S,dead_cap,detroit-lions,833,2014
13686,0,833,D.J. Morrell,G,dead_cap,detroit-lions,833,2014
13687,0,833,Andrew Peacock,WR,dead_cap,detroit-lions,833,2014
13688,667,0,Martavius Neloms,S,dead_cap,detroit-lions,667,2014
13689,0,666,James Franklin,QB,dead_cap,detroit-lions,666,2014
13690,0,166,Alex Bullard,G,dead_cap,detroit-lions,166,2014
13691,12500000,12058000,Calvin Johnson,WR,active,detroit-lions,24558000,2015
13692,9500000,8221250,Matthew Stafford,QB,active,detroit-lions,17721250,2015
13693,8500000,0,Haloti Ngata,DT,active,detroit-lions,8500000,2015
13694,4500000,1300000,Stephen Tulloch,ILB,active,detroit-lions,5800000,2015
13695,2095414,2975818,Ezekiel Ansah,DE,active,detroit-lions,5071232,2015
13696,3150000,833333,Jason Jones,DE,active,detroit-lions,3983333,2015
13697,745000,2827500,Glover Quin,FS,active,detroit-lions,3572500,2015
13698,2500000,1000000,Joique Bell,RB,active,detroit-lions,3500000,2015
13699,745000,2351250,Golden Tate,WR,active,detroit-lions,3096250,2015
13700,1400000,1600000,Manuel Ramirez,G,active,detroit-lions,3000000,2015
13701,776780,2007118,Eric Ebron,TE,active,detroit-lions,2783898,2015
13702,1155050,1388400,Riley Reiff,LT,active,detroit-lions,2543450,2015
13703,1100000,900000,James Ihedigbo,SS,active,detroit-lions,2000000,2015
13704,1000000,750000,Tyrunn Walker,DT,active,detroit-lions,1750000,2015
13705,435000,1119589,Laken Tomlinson,G,active,detroit-lions,1554589,2015
13706,1200000,300000,Isa Abdul-Quddus,FS,active,detroit-lions,1500000,2015
13707,735846,706691,Darius Slay,CB,active,detroit-lions,1442537,2015
13708,1000000,437500,Matt Prater,K,active,detroit-lions,1437500,2015
13709,601914,557654,Kyle Van Noy,ILB,active,detroit-lions,1159568,2015
13710,745000,250000,Don Carey,SS,active,detroit-lions,995000,2015
13711,650000,199250,Larry Warford,G,active,detroit-lions,849250,2015
13712,660000,125000,Josh Bynes,OLB,active,detroit-lions,785000,2015
13713,435000,320659,Ameer Abdullah,RB,active,detroit-lions,755659,2015
13714,660000,53000,Tahir Whitehead,OLB,active,detroit-lions,713000,2015
13715,660000,14793,Travis Lewis,ILB,active,detroit-lions,674793,2015
13716,970000,80000,Lance Moore,WR,active,detroit-lions,1050000,2015
13717,970000,80000,Don Muhlbach,LS,active,detroit-lions,1050000,2015
13718,970000,80000,Dan Orlovsky,QB,active,detroit-lions,1050000,2015
13719,870000,80000,Darryl Tapp,DE,active,detroit-lions,950000,2015
13720,585000,75146,Devin Taylor,DE,active,detroit-lions,660146,2015
13721,660000,0,Jermelle Cudjo,DT,active,detroit-lions,660000,2015
13722,585000,40075,Sam Martin,P,active,detroit-lions,625075,2015
13723,585000,22750,Theo Riddick,RB,active,detroit-lions,607750,2015
13724,585000,0,Tim Wright,TE,active,detroit-lions,585000,2015
13725,435000,130288,Gabe Wright,DT,active,detroit-lions,565288,2015
13726,510000,47220,Caraun Reid,DE,active,detroit-lions,557220,2015
13727,379941,172186,Alex Carter,S,active,detroit-lions,552127,2015
13728,510000,26550,TJ Jones,WR,active,detroit-lions,536550,2015
13729,510000,6666,Cornelius Lucas,RT,active,detroit-lions,516666,2015
13730,435000,75146,Nevin Lawson,CB,active,detroit-lions,510146,2015
13731,510000,0,Corey Fuller,WR,active,detroit-lions,510000,2015
13732,1050000,0,C.J. Wilson,DT,active,detroit-lions,1050000,2015
13733,435000,46089,Michael Burton,FB,active,detroit-lions,481089,2015
13734,435000,28838,Quandre Diggs,SS,active,detroit-lions,463838,2015
13735,435000,25000,Brandon Copeland,DE,active,detroit-lions,460000,2015
13736,435000,14477,Corey Robinson,LT,active,detroit-lions,449477,2015
13737,348000,80000,Corey Wootton,DT,active,detroit-lions,428000,2015
13738,338411,0,Khyri Thornton,DT,active,detroit-lions,338411,2015
13739,330000,0,Michael Ola,T,active,detroit-lions,330000,2015
13740,330000,0,George Winn,RB,active,detroit-lions,330000,2015
13741,350588,0,Crezdon Butler,CB,active,detroit-lions,350588,2015
13742,204705,0,Isaiah Johnson,FS,active,detroit-lions,204705,2015
13743,131470,0,Bear Pascoe,TE,active,detroit-lions,131470,2015
13744,90000,0,Gabe Ikard,C,active,detroit-lions,90000,2015
13745,25588,0,Braxston Cave,C,active,detroit-lions,25588,2015
13746,25588,0,Kerry Hyder,DE,active,detroit-lions,25588,2015
13747,1000000,3400000,DeAndre Levy,OLB,injured_reserve,detroit-lions,4400000,2015
13748,2800000,1000000,Brandon Pettigrew,TE,injured_reserve,detroit-lions,3800000,2015
13749,1000000,625000,Rashean Mathis,CB,injured_reserve,detroit-lions,1625000,2015
13750,520000,179868,Travis Swanson,C,injured_reserve,detroit-lions,699868,2015
13751,870000,80000,Josh Wilson,CB,injured_reserve,detroit-lions,950000,2015
13752,359294,1666,Zach Zenner,RB,injured_reserve,detroit-lions,360960,2015
13753,318000,0,Darren Keyton,C,injured_reserve,detroit-lions,318000,2015
13754,318000,0,Jordan Thompson,TE,injured_reserve,detroit-lions,318000,2015
13755,0,13207500,Ndamukong Suh,DT,dead_cap,detroit-lions,13207500,2015
13756,0,3900000,Chris Houston,CB,dead_cap,detroit-lions,3900000,2015
13757,0,3555883,Reggie Bush,RB,dead_cap,detroit-lions,3555883,2015
13758,181614,328818,Ryan Broyles,WR,dead_cap,detroit-lions,510432,2015
13759,481764,3334,LaAdrian Waddle,RT,dead_cap,detroit-lions,485098,2015
13760,232941,137278,Bill Bentley,CB,dead_cap,detroit-lions,370219,2015
13761,460588,0,Andre Fluellen,DT,dead_cap,detroit-lions,460588,2015
13762,206470,0,Taylor Boggs,G,dead_cap,detroit-lions,206470,2015
13763,112200,75146,Larry Webster,DE,dead_cap,detroit-lions,187346,2015
13764,0,170000,Kellen Moore,QB,dead_cap,detroit-lions,170000,2015
13765,155294,0,Ishmaa'ily Kitchen,DT,dead_cap,detroit-lions,155294,2015
13766,137647,0,Phillip Hunt,DE,dead_cap,detroit-lions,137647,2015
13767,112200,2333,Casey Pierce,TE,dead_cap,detroit-lions,114533,2015
13768,112200,0,Ricky Stanzi,QB,dead_cap,detroit-lions,112200,2015
13769,105600,0,Braxston Cave,C,dead_cap,detroit-lions,105600,2015
13770,105600,0,Kerry Hyder,DE,dead_cap,detroit-lions,105600,2015
13771,102352,0,Christopher Owens,CB,dead_cap,detroit-lions,102352,2015
13772,93529,333,Kevin Snyder,ILB,dead_cap,detroit-lions,93862,2015
13773,92400,0,Stanley Jean-Baptiste,CB,dead_cap,detroit-lions,92400,2015
13774,72600,0,Ryan Spadola,WR,dead_cap,detroit-lions,72600,2015
13775,0,65000,Vaughn Martin,DE,dead_cap,detroit-lions,65000,2015
13776,59400,4000,Isaiah Johnson,FS,dead_cap,detroit-lions,63400,2015
13777,52800,0,Kaelin Clay,WR,dead_cap,detroit-lions,52800,2015
13778,52800,0,Tyrus Thompson,T,dead_cap,detroit-lions,52800,2015
13779,46200,0,Khaseem Greene,OLB,dead_cap,detroit-lions,46200,2015
13780,46200,0,Corey Washington,WR,dead_cap,detroit-lions,46200,2015
13781,0,44568,Nate Freese,K,dead_cap,detroit-lions,44568,2015
13782,39600,0,George Winn,RB,dead_cap,detroit-lions,39600,2015
13783,38823,0,James-Michael Johnson,OLB,dead_cap,detroit-lions,38823,2015
13784,33000,0,Jordan Mills,RT,dead_cap,detroit-lions,33000,2015
13785,0,32574,Michael Williams,TE,dead_cap,detroit-lions,32574,2015
13786,0,24250,Jonte Green,CB,dead_cap,detroit-lions,24250,2015
13787,22824,0,David Ausberry,TE,dead_cap,detroit-lions,22824,2015
13788,20470,0,Greg Salas,WR,dead_cap,detroit-lions,20470,2015
13789,19800,0,Marion Grice,RB,dead_cap,detroit-lions,19800,2015
13790,19800,0,Kendall James,CB,dead_cap,detroit-lions,19800,2015
13791,13200,0,Saalim Hakim,WR,dead_cap,detroit-lions,13200,2015
13792,13200,0,Kendrick Ings,WR,dead_cap,detroit-lions,13200,2015
13793,0,10000,Garrett Gilbert,QB,dead_cap,detroit-lions,10000,2015
13794,6600,1667,Andrew Peacock,WR,dead_cap,detroit-lions,8267,2015
13795,0,5000,Chad Abram,FB,dead_cap,detroit-lions,5000,2015
13796,0,4167,Joseph Fauria,TE,dead_cap,detroit-lions,4167,2015
13797,0,4000,Jerome Couplin,FS,dead_cap,detroit-lions,4000,2015
13798,0,3666,Torrian Wilson,T,dead_cap,detroit-lions,3666,2015
13799,0,3334,Mohammed Seisay,CB,dead_cap,detroit-lions,3334,2015
13800,0,3333,Vernon Johnson,WR,dead_cap,detroit-lions,3333,2015
13801,0,2500,Kyle Brindza,K,dead_cap,detroit-lions,2500,2015
13802,0,2500,Crezdon Butler,CB,dead_cap,detroit-lions,2500,2015
13803,0,2500,Rasheed Williams,RB,dead_cap,detroit-lions,2500,2015
13804,0,2000,Al Bond,G,dead_cap,detroit-lions,2000,2015
13805,0,2000,Jacob Maxwell,TE,dead_cap,detroit-lions,2000,2015
13806,0,1667,A.J. Dalton,RT,dead_cap,detroit-lions,1667,2015
13807,0,1667,Justin Jackson,OLB,dead_cap,detroit-lions,1667,2015
13808,0,1667,Gabe Lynn,S,dead_cap,detroit-lions,1667,2015
13809,0,1667,D.J. Morrell,G,dead_cap,detroit-lions,1667,2015
13810,0,1334,James Franklin,QB,dead_cap,detroit-lions,1334,2015
13811,0,1000,Anthony Boone,QB,dead_cap,detroit-lions,1000,2015
13812,0,833,Brian Suite,SS,dead_cap,detroit-lions,833,2015
13813,0,334,Alex Bullard,G,dead_cap,detroit-lions,334,2015
13814,17000000,5500000,Matthew Stafford,QB,active,detroit-lions,22500000,2016
13815,8070000,0,Riley Reiff,LT,active,detroit-lions,8070000,2016
13816,5250000,2400000,DeAndre Levy,OLB,active,detroit-lions,7650000,2016
13817,4000000,3577500,Glover Quin,FS,active,detroit-lions,7577500,2016
13818,4750000,2351250,Golden Tate,WR,active,detroit-lions,7101250,2016
13819,3000000,3600000,Marvin Jones,WR,active,detroit-lions,6600000,2016
13820,2940621,2975818,Ezekiel Ansah,DE,active,detroit-lions,5916439,2016
13821,1000000,3606691,Darius Slay,CB,active,detroit-lions,4606691,2016
13822,2000000,2218750,Haloti Ngata,DT,active,detroit-lions,4218750,2016
13823,1233558,2107118,Eric Ebron,TE,active,detroit-lions,3340676,2016
13824,1750000,1500000,Tahir Whitehead,OLB,active,detroit-lions,3250000,2016
13825,2250000,1300000,Matt Prater,K,active,detroit-lions,3550000,2016
13826,1550000,1143750,Anquan Boldin,WR,active,detroit-lions,2693750,2016
13827,1100000,1050000,Johnson Bademosi,CB,active,detroit-lions,2150000,2016
13828,450000,1543996,Taylor Decker,T,active,detroit-lions,1993996,2016
13829,823648,1119589,Laken Tomlinson,G,active,detroit-lions,1943237,2016
13830,1646000,199250,Larry Warford,G,active,detroit-lions,1845250,2016
13831,800000,537500,Tyrunn Walker,DT,active,detroit-lions,1337500,2016
13832,1000000,265625,Rafael Bush,FS,active,detroit-lions,1265625,2016
13833,675000,540075,Sam Martin,P,active,detroit-lions,1215075,2016
13834,760000,437500,Don Carey,SS,active,detroit-lions,1197500,2016
13835,800000,250000,Tavon Wilson,SS,active,detroit-lions,1050000,2016
13836,450000,501570,A'Shawn Robinson,DT,active,detroit-lions,951570,2016
13837,615000,179868,Travis Swanson,C,active,detroit-lions,794868,2016
13838,675000,75146,Devin Taylor,DE,active,detroit-lions,750146,2016
13839,985000,80000,Don Muhlbach,LS,active,detroit-lions,1065000,2016
13840,985000,80000,Dan Orlovsky,QB,active,detroit-lions,1065000,2016
13841,676764,0,Clay Harbor,TE,active,detroit-lions,676764,2016
13842,600000,75146,Nevin Lawson,CB,active,detroit-lions,675146,2016
13843,900000,0,Garrett Reynolds,G,active,detroit-lions,900000,2016
13844,450000,161355,Graham Glasgow,G,active,detroit-lions,611355,2016
13845,600000,6668,Cornelius Lucas,RT,active,detroit-lions,606668,2016
13846,760000,0,Andre Roberts,WR,active,detroit-lions,760000,2016
13847,450000,144641,Miles Killebrew,S,active,detroit-lions,594641,2016
13848,525000,46089,Michael Burton,FB,active,detroit-lions,571089,2016
13849,525000,14477,Corey Robinson,LT,active,detroit-lions,539477,2016
13850,525000,1666,Zach Zenner,RB,active,detroit-lions,526666,2016
13851,525000,0,Thurston Armbrister,OLB,active,detroit-lions,525000,2016
13852,525000,0,Brandon Copeland,DE,active,detroit-lions,525000,2016
13853,525000,0,Khyri Thornton,DT,active,detroit-lions,525000,2016
13854,450000,61478,Joe Dahl,G,active,detroit-lions,511478,2016
13855,450000,51115,Antwione Williams,OLB,active,detroit-lions,501115,2016
13856,450000,30930,Anthony Zettel,DE,active,detroit-lions,480930,2016
13857,450000,18941,Dwayne Washington,RB,active,detroit-lions,468941,2016
13858,468531,0,Matthew Mulligan,TE,active,detroit-lions,468531,2016
13859,450000,0,Kerry Hyder,DE,active,detroit-lions,450000,2016
13860,447058,0,Josh Bynes,OLB,active,detroit-lions,447058,2016
13861,178823,0,Joique Bell,RB,active,detroit-lions,178823,2016
13862,176470,0,TJ Jones,WR,active,detroit-lions,176470,2016
13863,158820,0,Jake Rudock,QB,active,detroit-lions,158820,2016
13864,52941,0,Alex Carter,S,active,detroit-lions,52941,2016
13865,44705,0,Crezdon Butler,CB,active,detroit-lions,44705,2016
13866,26470,0,Jace Billingsley,WR,active,detroit-lions,26470,2016
13867,800000,985250,Theo Riddick,RB,injured_reserve,detroit-lions,1785250,2016
13868,1000000,750000,Stefan Charles,DT,injured_reserve,detroit-lions,1750000,2016
13869,573915,370659,Ameer Abdullah,RB,injured_reserve,detroit-lions,944574,2016
13870,842381,100000,Jon Bostic,ILB,injured_reserve,detroit-lions,942381,2016
13871,675000,96250,Tim Wright,TE,injured_reserve,detroit-lions,771250,2016
13872,525000,28838,Quandre Diggs,SS,injured_reserve,detroit-lions,553838,2016
13873,516176,16375,Armonty Bryant,DE,injured_reserve,detroit-lions,532551,2016
13874,450000,3333,Cole Wick,TE,injured_reserve,detroit-lions,453333,2016
13875,333000,25089,Jimmy Landes,LS,injured_reserve,detroit-lions,358089,2016
13876,348000,0,Ryan Spadola,WR,injured_reserve,detroit-lions,348000,2016
13877,333000,0,Ian Wells,CB,injured_reserve,detroit-lions,333000,2016
13878,178823,0,Asa Jackson,CB,injured_reserve,detroit-lions,178823,2016
13879,0,20916000,Calvin Johnson,WR,dead_cap,detroit-lions,20916000,2016
13880,0,1800000,Stephen Tulloch,ILB,dead_cap,detroit-lions,1800000,2016
13881,1677000,100000,Brandon Pettigrew,TE,dead_cap,detroit-lions,1777000,2016
13882,885000,365000,Wallace Gilberry,DE,dead_cap,detroit-lions,1250000,2016
13883,0,1000000,Joique Bell,RB,dead_cap,detroit-lions,1000000,2016
13884,312458,632654,Kyle Van Noy,ILB,dead_cap,detroit-lions,945112,2016
13885,415834,0,Corey Fuller,WR,dead_cap,detroit-lions,415834,2016
13886,391280,0,Adairius Barnes,CB,dead_cap,detroit-lions,391280,2016
13887,0,375000,Rashean Mathis,CB,dead_cap,detroit-lions,375000,2016
13888,364411,0,Justin Forsett,RB,dead_cap,detroit-lions,364411,2016
13889,333141,0,Khari Lee,TE,dead_cap,detroit-lions,333141,2016
13890,103500,187186,Alex Carter,S,dead_cap,detroit-lions,290686,2016
13891,200000,80000,Stevan Ridley,RB,dead_cap,detroit-lions,280000,2016
13892,120000,80000,Geoff Schwartz,G,dead_cap,detroit-lions,200000,2016
13893,199881,0,Johnthan Banks,CB,dead_cap,detroit-lions,199881,2016
13894,0,170000,Kellen Moore,QB,dead_cap,detroit-lions,170000,2016
13895,0,150292,Larry Webster,DE,dead_cap,detroit-lions,150292,2016
13896,141176,0,Orson Charles,FB,dead_cap,detroit-lions,141176,2016
13897,136870,0,Steve Longa,OLB,dead_cap,detroit-lions,136870,2016
13898,0,130288,Gabe Wright,DT,dead_cap,detroit-lions,130288,2016
13899,0,125000,Josh Bynes,OLB,dead_cap,detroit-lions,125000,2016
13900,117300,0,Brandon Thomas,G,dead_cap,detroit-lions,117300,2016
13901,110400,0,Jace Billingsley,WR,dead_cap,detroit-lions,110400,2016
13902,110400,0,Charles Washington,CB,dead_cap,detroit-lions,110400,2016
13903,82800,26550,TJ Jones,WR,dead_cap,detroit-lions,109350,2016
13904,75900,33434,Jake Rudock,QB,dead_cap,detroit-lions,109334,2016
13905,0,90000,Jeremy Kerley,WR,dead_cap,detroit-lions,90000,2016
13906,0,80000,Darrin Walls,CB,dead_cap,detroit-lions,80000,2016
13907,69000,0,Matt Rotheram,G,dead_cap,detroit-lions,69000,2016
13908,55994,0,Zaviar Gooden,ILB,dead_cap,detroit-lions,55994,2016
13909,55200,0,Mike James,RB,dead_cap,detroit-lions,55200,2016
13910,0,47220,Caraun Reid,DE,dead_cap,detroit-lions,47220,2016
13911,41400,0,D'Joun Smith,CB,dead_cap,detroit-lions,41400,2016
13912,40294,0,Corey Lemonier,OLB,dead_cap,detroit-lions,40294,2016
13913,39705,0,Aaron Dobson,WR,dead_cap,detroit-lions,39705,2016
13914,23800,3333,Chase Farris,T,dead_cap,detroit-lions,27133,2016
13915,20700,0,Brian Leonhardt,TE,dead_cap,detroit-lions,20700,2016
13916,20700,0,George Winn,RB,dead_cap,detroit-lions,20700,2016
13917,13800,0,Brandon Chubb,ILB,dead_cap,detroit-lions,13800,2016
13918,13800,0,Isaac Fruechte,WR,dead_cap,detroit-lions,13800,2016
13919,13800,0,Rashad Ross,WR,dead_cap,detroit-lions,13800,2016
13920,13800,0,Andrew Turzilli,WR,dead_cap,detroit-lions,13800,2016
13921,0,8000,Isaiah Johnson,FS,dead_cap,detroit-lions,8000,2016
13922,0,7334,Torrian Wilson,T,dead_cap,detroit-lions,7334,2016
13923,6900,0,Kennard Backman,TE,dead_cap,detroit-lions,6900,2016
13924,6900,0,Jay Lee,WR,dead_cap,detroit-lions,6900,2016
13925,6900,0,Brian Mihalik,T,dead_cap,detroit-lions,6900,2016
13926,0,6667,Vernon Johnson,WR,dead_cap,detroit-lions,6667,2016
13927,0,5000,Kyle Brindza,K,dead_cap,detroit-lions,5000,2016
13928,0,4667,Casey Pierce,TE,dead_cap,detroit-lions,4667,2016
13929,0,4000,Al Bond,G,dead_cap,detroit-lions,4000,2016
13930,0,2000,Anthony Boone,QB,dead_cap,detroit-lions,2000,2016
13931,0,1667,Brian Suite,SS,dead_cap,detroit-lions,1667,2016
13932,0,1000,Quinshad Davis,WR,dead_cap,detroit-lions,1000,2016
13933,0,1000,Andrew Zeller,G,dead_cap,detroit-lions,1000,2016
13934,0,667,Kevin Snyder,ILB,dead_cap,detroit-lions,667,2016
13935,0,666,James Deloatch,DE,dead_cap,detroit-lions,666,2016
13936,1000000,15500000,Matthew Stafford,QB,active,detroit-lions,16500000,2017
13937,12734000,0,Ezekiel Ansah,DE,active,detroit-lions,12734000,2017
13938,4100000,6581250,Darius Slay,CB,active,detroit-lions,10681250,2017
13939,7000000,1600000,Marvin Jones,WR,active,detroit-lions,8600000,2017
13940,6000000,2351250,Golden Tate,WR,active,detroit-lions,8351250,2017
13941,900000,5494166,Glover Quin,FS,active,detroit-lions,6394166,2017
13942,3000000,2900000,Ricky Wagner,RT,active,detroit-lions,5900000,2017
13943,3000000,2869791,T.J. Lang,G,active,detroit-lions,5869791,2017
13944,3150000,2450000,Matt Prater,K,active,detroit-lions,5600000,2017
13945,3050000,1937500,Tahir Whitehead,OLB,active,detroit-lions,4987500,2017
13946,1590337,2307118,Eric Ebron,TE,active,detroit-lions,3897455,2017
13947,2000000,1593750,D.J. Hayden,CB,active,detroit-lions,3593750,2017
13948,2225000,1100000,Sam Martin,P,active,detroit-lions,3325000,2017
13949,2000000,1000000,Paul Worrilow,OLB,active,detroit-lions,3000000,2017
13950,948499,1543996,Taylor Decker,T,active,detroit-lions,2492495,2017
13951,1075000,1325000,Theo Riddick,RB,active,detroit-lions,2400000,2017
13952,1237500,1084375,Cornelius Washington,DE,active,detroit-lions,2321875,2017
13953,1250000,1000000,Akeem Spence,DT,active,detroit-lions,2250000,2017
13954,465000,1529396,Jarrad Davis,ILB,active,detroit-lions,1994396,2017
13955,1797000,75146,Nevin Lawson,CB,active,detroit-lions,1872146,2017
13956,687892,501570,A'Shawn Robinson,DT,active,detroit-lions,1189462,2017
13957,975000,187500,Don Carey,SS,active,detroit-lions,1162500,2017
13958,687830,445659,Ameer Abdullah,RB,active,detroit-lions,1133489,2017
13959,700000,275000,Darren Fells,TE,active,detroit-lions,975000,2017
13960,465000,411905,Jalen Tabor,CB,active,detroit-lions,876905,2017
13961,558500,161355,Graham Glasgow,G,active,detroit-lions,719855,2017
13962,1000000,80000,Don Muhlbach,LS,active,detroit-lions,1080000,2017
13963,540000,144641,Miles Killebrew,S,active,detroit-lions,684641,2017
13964,465000,179706,Kenny Golladay,WR,active,detroit-lions,644706,2017
13965,615000,28838,Quandre Diggs,SS,active,detroit-lions,643838,2017
13966,465000,154721,Jalen Reeves-Maybin,OLB,active,detroit-lions,619721,2017
13967,615000,1668,Zach Zenner,RB,active,detroit-lions,616668,2017
13968,465000,150784,Michael Roberts,TE,active,detroit-lions,615784,2017
13969,729412,0,Nick Bellore,ILB,active,detroit-lions,729412,2017
13970,578824,0,Emmett Cleary,RT,active,detroit-lions,578824,2017
13971,540000,30930,Anthony Zettel,DE,active,detroit-lions,570930,2017
13972,540000,18941,Dwayne Washington,RB,active,detroit-lions,558941,2017
13973,540000,0,Brian Mihalik,T,active,detroit-lions,540000,2017
13974,540000,0,Jake Rudock,QB,active,detroit-lions,540000,2017
13975,465000,64591,Jamal Agnew,CB,active,detroit-lions,529591,2017
13976,446294,61478,Joe Dahl,G,active,detroit-lions,507772,2017
13977,465000,36040,Jeremiah Ledbetter,DT,active,detroit-lions,501040,2017
13978,465000,1666,Tion Green,RB,active,detroit-lions,466666,2017
13979,465000,0,Steve Longa,OLB,active,detroit-lions,465000,2017
13980,465000,0,Charles Washington,CB,active,detroit-lions,465000,2017
13981,352941,0,Dwight Freeney,OLB,active,detroit-lions,352941,2017
13982,190588,0,Christian Ringo,DT,active,detroit-lions,190588,2017
13983,180882,0,Bradley Marquez,WR,active,detroit-lions,180882,2017
13984,82059,0,Rodney Coe,DT,active,detroit-lions,82059,2017
13985,54706,0,Andy Jones,WR,active,detroit-lions,54706,2017
13986,31765,0,Hakeem Valles,TE,active,detroit-lions,31765,2017
13987,27353,0,Jace Billingsley,WR,active,detroit-lions,27353,2017
13988,5500000,2203125,Haloti Ngata,DT,injured_reserve,detroit-lions,7703125,2017
13989,3322377,0,Greg Robinson,LT,injured_reserve,detroit-lions,3322377,2017
13990,1772000,179868,Travis Swanson,C,injured_reserve,detroit-lions,1951868,2017
13991,900000,750000,Tavon Wilson,SS,injured_reserve,detroit-lions,1650000,2017
13992,690000,0,TJ Jones,WR,injured_reserve,detroit-lions,690000,2017
13993,615000,14477,Corey Robinson,LT,injured_reserve,detroit-lions,629477,2017
13994,615000,0,Brandon Copeland,DE,injured_reserve,detroit-lions,615000,2017
13995,615000,0,Zac Kerin,C,injured_reserve,detroit-lions,615000,2017
13996,540000,0,Kerry Hyder,DE,injured_reserve,detroit-lions,540000,2017
13997,378000,40000,Jordan Hill,DT,injured_reserve,detroit-lions,418000,2017
13998,410294,0,Don Barclay,RT,injured_reserve,detroit-lions,410294,2017
13999,378000,0,Mike James,RB,injured_reserve,detroit-lions,378000,2017
14000,354873,0,Kasey Redfern,P,injured_reserve,detroit-lions,354873,2017
14001,348000,1666,Des Lawrence,CB,injured_reserve,detroit-lions,349666,2017
14002,348000,0,Brandon Chubb,ILB,injured_reserve,detroit-lions,348000,2017
14003,0,2400000,DeAndre Levy,OLB,dead_cap,detroit-lions,2400000,2017
14004,0,1119589,Laken Tomlinson,G,dead_cap,detroit-lions,1119589,2017
14005,0,1050000,Johnson Bademosi,CB,dead_cap,detroit-lions,1050000,2017
14006,164706,487500,Khyri Thornton,DT,dead_cap,detroit-lions,652206,2017
14007,0,507654,Kyle Van Noy,ILB,dead_cap,detroit-lions,507654,2017
14008,411765,0,Kasim Edebali,OLB,dead_cap,detroit-lions,411765,2017
14009,361760,0,Jared Abbrederis,WR,dead_cap,detroit-lions,361760,2017
14010,0,344372,Alex Carter,S,dead_cap,detroit-lions,344372,2017
14011,336883,4000,Jeremiah Valoaga,DE,dead_cap,detroit-lions,340883,2017
14012,273529,0,Tim Lelito,G,dead_cap,detroit-lions,273529,2017
14013,262590,0,Hakeem Valles,TE,dead_cap,detroit-lions,262590,2017
14014,0,260576,Gabe Wright,DT,dead_cap,detroit-lions,260576,2017
14015,273529,0,Jeff Locke,P,dead_cap,detroit-lions,273529,2017
14016,182353,0,George Johnson,DE,dead_cap,detroit-lions,182353,2017
14017,180353,0,Thurston Armbrister,OLB,dead_cap,detroit-lions,180353,2017
14018,161259,0,Jace Billingsley,WR,dead_cap,detroit-lions,161259,2017
14019,155506,2000,Alex Barrett,DE,dead_cap,detroit-lions,157506,2017
14020,139765,0,Rolan Milligan,S,dead_cap,detroit-lions,139765,2017
14021,92153,30835,Brad Kaaya,QB,dead_cap,detroit-lions,122988,2017
14022,122400,0,Dontez Ford,WR,dead_cap,detroit-lions,122400,2017
14023,120953,0,Dan Skipper,T,dead_cap,detroit-lions,120953,2017
14024,115200,0,Leo Koloamatangi,T,dead_cap,detroit-lions,115200,2017
14025,108528,0,Jacquies Smith,OLB,dead_cap,detroit-lions,108528,2017
14026,100800,0,Adairius Barnes,CB,dead_cap,detroit-lions,100800,2017
14027,0,100304,Jake Rudock,QB,dead_cap,detroit-lions,100304,2017
14028,0,100000,Brandon Pettigrew,TE,dead_cap,detroit-lions,100000,2017
14029,0,92178,Michael Burton,FB,dead_cap,detroit-lions,92178,2017
14030,40588,47220,Caraun Reid,DE,dead_cap,detroit-lions,87808,2017
14031,86400,0,Andy Jones,WR,dead_cap,detroit-lions,86400,2017
14032,0,80000,Nick Bellore,ILB,dead_cap,detroit-lions,80000,2017
14033,72000,0,Christian Ringo,DT,dead_cap,detroit-lions,72000,2017
14034,0,70588,Armonty Bryant,DE,dead_cap,detroit-lions,70588,2017
14035,0,51117,Antwione Williams,OLB,dead_cap,detroit-lions,51117,2017
14036,0,50178,Jimmy Landes,LS,dead_cap,detroit-lions,50178,2017
14037,48953,0,Storm Norton,T,dead_cap,detroit-lions,48953,2017
14038,45588,0,Bryce Harris,RT,dead_cap,detroit-lions,45588,2017
14039,0,35000,Cyrus Kouandjio,RT,dead_cap,detroit-lions,35000,2017
14040,0,30000,Keshawn Martin,WR,dead_cap,detroit-lions,30000,2017
14041,28800,0,Noel Thomas,WR,dead_cap,detroit-lions,28800,2017
14042,28800,0,Robert Tonyan Jr.,WR,dead_cap,detroit-lions,28800,2017
14043,0,26550,TJ Jones,WR,dead_cap,detroit-lions,26550,2017
14044,20000,3333,Josh Thornton,CB,dead_cap,detroit-lions,23333,2017
14045,7200,16067,Pat O'Connor,DE,dead_cap,detroit-lions,23267,2017
14046,21600,0,Bradley Marquez,WR,dead_cap,detroit-lions,21600,2017
14047,17200,3333,Brandon Barnes,TE,dead_cap,detroit-lions,20533,2017
14048,14400,0,Earl Okine,DE,dead_cap,detroit-lions,14400,2017
14049,7200,3333,Cole Wick,TE,dead_cap,detroit-lions,10533,2017
14050,0,10000,Tony Hills,LT,dead_cap,detroit-lions,10000,2017
14051,7200,0,Toby Johnson,DT,dead_cap,detroit-lions,7200,2017
14052,7200,0,Stefan McClure,S,dead_cap,detroit-lions,7200,2017
14053,7200,0,Brandon Thomas,G,dead_cap,detroit-lions,7200,2017
14054,7200,0,Alex Torgersen,QB,dead_cap,detroit-lions,7200,2017
14055,0,6667,Chase Farris,T,dead_cap,detroit-lions,6667,2017
14056,0,2000,Quinshad Davis,WR,dead_cap,detroit-lions,2000,2017
14057,0,2000,Ian Wells,CB,dead_cap,detroit-lions,2000,2017
14058,0,2000,Andrew Zeller,G,dead_cap,detroit-lions,2000,2017
14059,0,1334,James Deloatch,DE,dead_cap,detroit-lions,1334,2017
14060,9500000,17000000,Matthew Stafford,QB,active,detroit-lions,26500000,2018
14061,3850000,2666666,Glover Quin,FS,active,detroit-lions,6516666,2018
14062,2726269,3384375,Darius Slay,CB,active,detroit-lions,6110644,2018
14063,3000000,2900000,Ricky Wagner,RT,active,detroit-lions,5900000,2018
14064,4558824,0,Damon Harrison,DT,active,detroit-lions,4558824,2018
14065,2250000,2100000,Devon Kennard,OLB,active,detroit-lions,4350000,2018
14066,2700000,1300000,Theo Riddick,RB,active,detroit-lions,4000000,2018
14067,2300000,1625000,Nevin Lawson,CB,active,detroit-lions,3925000,2018
14068,2000000,1200000,Matt Prater,K,active,detroit-lions,3200000,2018
14069,1500000,1628125,Tavon Wilson,SS,active,detroit-lions,3128125,2018
14070,1446998,1543996,Taylor Decker,LT,active,detroit-lions,2990994,2018
14071,2325000,600000,Sam Martin,P,active,detroit-lions,2925000,2018
14072,1500000,1000000,Luke Willson,TE,active,detroit-lions,2500000,2018
14073,963599,1529396,Jarrad Davis,ILB,active,detroit-lions,2492995,2018
14074,1050000,1425000,Christian Jones,OLB,active,detroit-lions,2475000,2018
14075,1000000,1153838,Quandre Diggs,SS,active,detroit-lions,2153838,2018
14076,480000,1661843,Frank Ragnow,G,active,detroit-lions,2141843,2018
14077,1000000,1000000,LeGarrette Blount,RB,active,detroit-lions,2000000,2018
14078,1907000,0,TJ Jones,WR,active,detroit-lions,1907000,2018
14079,1892000,0,Eli Harold,OLB,active,detroit-lions,1892000,2018
14080,1250000,625000,Kenny Wiggins,G,active,detroit-lions,1875000,2018
14081,1000000,500000,Levine Toilolo,TE,active,detroit-lions,1500000,2018
14082,684226,411905,Jalen Tabor,CB,active,detroit-lions,1096131,2018
14083,317647,750000,Marcus Cooper,CB,active,detroit-lions,1067647,2018
14084,648500,161355,Graham Glasgow,C,active,detroit-lions,809855,2018
14085,630000,144641,Miles Killebrew,S,active,detroit-lions,774641,2018
14086,586000,179706,Kenny Golladay,WR,active,detroit-lions,765706,2018
14087,1015000,90000,Matt Cassel,QB,active,detroit-lions,1105000,2018
14088,1015000,90000,Don Muhlbach,LS,active,detroit-lions,1105000,2018
14089,915000,90000,Nick Bellore,ILB,active,detroit-lions,1005000,2018
14090,915000,90000,Ricky Jean Francois,DT,active,detroit-lions,1005000,2018
14091,480000,220497,Tracy Walker,S,active,detroit-lions,700497,2018
14092,630000,61478,Joe Dahl,G,active,detroit-lions,691478,2018
14093,630000,0,Romeo Okwara,DE,active,detroit-lions,630000,2018
14094,555000,0,Kerry Hyder,DE,active,detroit-lions,555000,2018
14095,480000,71920,Tyrell Crosby,G,active,detroit-lions,551920,2018
14096,539123,0,Andrew Donnal,RT,active,detroit-lions,539123,2018
14097,352941,175000,Zach Zenner,RB,active,detroit-lions,527941,2018
14098,461294,64591,Jamal Agnew,CB,active,detroit-lions,525885,2018
14099,480000,4000,Brandon Powell,WR,active,detroit-lions,484000,2018
14100,484412,0,Kelvin Sheppard,ILB,active,detroit-lions,484412,2018
14101,310585,0,Trevor Bates,ILB,active,detroit-lions,310585,2018
14102,228529,0,Andy Jones,WR,active,detroit-lions,228529,2018
14103,197645,0,Michael Ford,CB,active,detroit-lions,197645,2018
14104,185295,0,Nicholas Grigsby,ILB,active,detroit-lions,185295,2018
14105,130588,0,Eric Lee,DE,active,detroit-lions,130588,2018
14106,97941,0,Jerome Cunningham,TE,active,detroit-lions,97941,2018
14107,97941,0,Leo Koloamatangi,T,active,detroit-lions,97941,2018
14108,56470,0,John Atkins,DT,active,detroit-lions,56470,2018
14109,56470,0,Chris Lacy,WR,active,detroit-lions,56470,2018
14110,56470,0,Dee Virgin,CB,active,detroit-lions,56470,2018
14111,28235,0,Andre Chachere,CB,active,detroit-lions,28235,2018
14112,28235,0,Mitchell Loewen,TE,active,detroit-lions,28235,2018
14113,17143000,0,Ezekiel Ansah,DE,injured_reserve,detroit-lions,17143000,2018
14114,8000000,2760416,T.J. Lang,G,injured_reserve,detroit-lions,10760416,2018
14115,3750000,2683333,Marvin Jones,WR,injured_reserve,detroit-lions,6433333,2018
14116,925785,501570,A'Shawn Robinson,DT,injured_reserve,detroit-lions,1427355,2018
14117,466229,702489,Kerryon Johnson,RB,injured_reserve,detroit-lions,1168718,2018
14118,697059,0,Deshawn Shead,FS,injured_reserve,detroit-lions,697059,2018
14119,523764,150784,Michael Roberts,TE,injured_reserve,detroit-lions,674548,2018
14120,511905,154721,Jalen Reeves-Maybin,OLB,injured_reserve,detroit-lions,666626,2018
14121,466229,170491,Da'shawn Hand,DE,injured_reserve,detroit-lions,636720,2018
14122,534176,0,Charles Washington,CB,injured_reserve,detroit-lions,534176,2018
14123,363000,21051,Nick Bawden,FB,injured_reserve,detroit-lions,384051,2018
14124,378000,0,Steve Longa,OLB,injured_reserve,detroit-lions,378000,2018
14125,371765,0,Bruce Ellington,WR,injured_reserve,detroit-lions,371765,2018
14126,3294118,2351250,Golden Tate,WR,dead_cap,detroit-lions,5645368,2018
14127,0,4800000,DeAndre Levy,OLB,dead_cap,detroit-lions,4800000,2018
14128,1400000,2100000,Sylvester Williams,DT,dead_cap,detroit-lions,3500000,2018
14129,500000,1100000,Deshawn Shead,FS,dead_cap,detroit-lions,1600000,2018
14130,0,1500000,Akeem Spence,DT,dead_cap,detroit-lions,1500000,2018
14131,0,1119589,Laken Tomlinson,G,dead_cap,detroit-lions,1119589,2018
14132,464159,445660,Ameer Abdullah,RB,dead_cap,detroit-lions,909819,2018
14133,0,850000,Cornelius Washington,DE,dead_cap,detroit-lions,850000,2018
14134,705000,0,Marquis Flowers,OLB,dead_cap,detroit-lions,705000,2018
14135,333530,0,Crevon LeBlanc,CB,dead_cap,detroit-lions,333530,2018
14136,323824,0,Eric Lee,DE,dead_cap,detroit-lions,323824,2018
14137,261715,12529,Andy Jones,WR,dead_cap,detroit-lions,274244,2018
14138,213235,0,Hakeem Valles,TE,dead_cap,detroit-lions,213235,2018
14139,165884,0,Andrew Donnal,RT,dead_cap,detroit-lions,165884,2018
14140,163235,0,Lenzy Pipkins,CB,dead_cap,detroit-lions,163235,2018
14141,0,162500,Khyri Thornton,DT,dead_cap,detroit-lions,162500,2018
14142,116471,32500,Bradley Marquez,WR,dead_cap,detroit-lions,148971,2018
14143,144118,0,Zach Zenner,RB,dead_cap,detroit-lions,144118,2018
14144,137270,2500,Michael Ford,CB,dead_cap,detroit-lions,139770,2018
14145,129200,0,Jake Rudock,QB,dead_cap,detroit-lions,129200,2018
14146,121000,0,John Atkins,DT,dead_cap,detroit-lions,121000,2018
14147,119435,0,Jamil Demby,G,dead_cap,detroit-lions,119435,2018
14148,114000,0,Chris Lacy,WR,dead_cap,detroit-lions,114000,2018
14149,112941,0,Dee Virgin,CB,dead_cap,detroit-lions,112941,2018
14150,107646,0,Don Carey,SS,dead_cap,detroit-lions,107646,2018
14151,106400,0,Leo Koloamatangi,T,dead_cap,detroit-lions,106400,2018
14152,0,102234,Antwione Williams,OLB,dead_cap,detroit-lions,102234,2018
14153,0,92508,Brad Kaaya,QB,dead_cap,detroit-lions,92508,2018
14154,0,90000,Wesley Johnson,C,dead_cap,detroit-lions,90000,2018
14155,83600,0,Garret Dooley,LB,dead_cap,detroit-lions,83600,2018
14156,92942,0,Marcus Cromartie,CB,dead_cap,detroit-lions,92942,2018
14157,53200,0,David Jones,CB,dead_cap,detroit-lions,53200,2018
14158,0,48202,Pat O'Connor,DE,dead_cap,detroit-lions,48202,2018
14159,45600,0,Trevor Bates,ILB,dead_cap,detroit-lions,45600,2018
14160,0,45000,Jonathan Freeny,OLB,dead_cap,detroit-lions,45000,2018
14161,38000,0,Andre Chachere,CB,dead_cap,detroit-lions,38000,2018
14162,38000,0,Jerome Cunningham,TE,dead_cap,detroit-lions,38000,2018
14163,0,36040,Jeremiah Ledbetter,DT,dead_cap,detroit-lions,36040,2018
14164,0,30930,Anthony Zettel,DE,dead_cap,detroit-lions,30930,2018
14165,30400,0,Deontez Alexander,WR,dead_cap,detroit-lions,30400,2018
14166,22800,4000,Alex Barrett,DE,dead_cap,detroit-lions,26800,2018
14167,0,25089,Jimmy Landes,LS,dead_cap,detroit-lions,25089,2018
14168,22800,0,Joshua Frazier,DT,dead_cap,detroit-lions,22800,2018
14169,22800,0,Jarron Jones,DT,dead_cap,detroit-lions,22800,2018
14170,22800,0,Donnel Pumphrey,RB,dead_cap,detroit-lions,22800,2018
14171,22800,0,Jonathan Wynn,DE,dead_cap,detroit-lions,22800,2018
14172,0,18941,Dwayne Washington,RB,dead_cap,detroit-lions,18941,2018
14173,15200,0,Nicholas Grigsby,ILB,dead_cap,detroit-lions,15200,2018
14174,15200,0,Brandon Reilly,WR,dead_cap,detroit-lions,15200,2018
14175,15200,0,Horace Richardson,CB,dead_cap,detroit-lions,15200,2018
14176,15200,0,Justin Stockton,RB,dead_cap,detroit-lions,15200,2018
14177,0,14477,Corey Robinson,LT,dead_cap,detroit-lions,14477,2018
14178,0,10000,Stefan McClure,S,dead_cap,detroit-lions,10000,2018
14179,0,8000,Jeremiah Valoaga,DE,dead_cap,detroit-lions,8000,2018
14180,7600,0,Brian Brown,WR,dead_cap,detroit-lions,7600,2018
14181,7600,0,Keon Hatcher,WR,dead_cap,detroit-lions,7600,2018
14182,7600,0,Rolan Milligan,S,dead_cap,detroit-lions,7600,2018
14183,7600,0,Darnell Sankey,ILB,dead_cap,detroit-lions,7600,2018
14184,7600,0,Dan Skipper,T,dead_cap,detroit-lions,7600,2018
14185,7600,0,Salesi Uhatafe,G,dead_cap,detroit-lions,7600,2018
14186,0,6667,Brandon Barnes,TE,dead_cap,detroit-lions,6667,2018
14187,0,6667,Josh Thornton,CB,dead_cap,detroit-lions,6667,2018
14188,0,3334,Tion Green,RB,dead_cap,detroit-lions,3334,2018
14189,0,3334,Des Lawrence,CB,dead_cap,detroit-lions,3334,2018
14190,0,3334,Cole Wick,TE,dead_cap,detroit-lions,3334,2018
14191,0,3333,Chad Meredith,LB,dead_cap,detroit-lions,3333,2018
14192,12550000,3368750,Darius Slay,CB,active,detroit-lions,15918750,2019
14193,9000000,2900000,Ricky Wagner,RT,active,detroit-lions,11900000,2019
14194,805000,5614000,Trey Flowers,DE,active,detroit-lions,6419000,2019
14195,3500000,2475000,Devon Kennard,OLB,active,detroit-lions,5975000,2019
14196,4250000,234375,Danny Amendola,WR,active,detroit-lions,4484375,2019
14197,1000000,3218750,Damon Harrison,DT,active,detroit-lions,4218750,2019
14198,1945498,1543997,Taylor Decker,LT,active,detroit-lions,3489495,2019
14199,2200000,1200000,Matt Prater,K,active,detroit-lions,3400000,2019
14200,805000,2079000,Justin Coleman,CB,active,detroit-lions,2884000,2019
14201,1015461,1661843,Frank Ragnow,G,active,detroit-lions,2677304,2019
14202,1000000,1675000,Tavon Wilson,SS,active,detroit-lions,2675000,2019
14203,1700000,600000,Sam Martin,P,active,detroit-lions,2300000,2019
14204,805000,1479000,Jesse James,TE,active,detroit-lions,2284000,2019
14205,2025000,161355,Graham Glasgow,G,active,detroit-lions,2186355,2019
14206,1300000,831250,Rashaan Melvin,CB,active,detroit-lions,2131250,2019
14207,720000,1011035,Romeo Okwara,DE,active,detroit-lions,1731035,2019
14208,1163678,501570,A'Shawn Robinson,DT,active,detroit-lions,1665248,2019
14209,775622,702489,Kerryon Johnson,RB,active,detroit-lions,1478111,2019
14210,1000000,250000,Oday Aboushi,T,active,detroit-lions,1250000,2019
14211,720000,144641,Miles Killebrew,FS,active,detroit-lions,864641,2019
14212,676000,179706,Kenny Golladay,WR,active,detroit-lions,855706,2019
14213,628000,220497,Tracy Walker,S,active,detroit-lions,848497,2019
14214,805000,0,Logan Thomas,TE,active,detroit-lions,805000,2019
14215,645000,154721,Jalen Reeves-Maybin,OLB,active,detroit-lions,799721,2019
14216,1030000,90000,Don Muhlbach,LS,active,detroit-lions,1120000,2019
14217,495000,238061,Will Harris,S,active,detroit-lions,733061,2019
14218,720000,0,J.D. McKissic,WR,active,detroit-lions,720000,2019
14219,645000,64591,Jamal Agnew,CB,active,detroit-lions,709591,2019
14220,570000,71920,Tyrell Crosby,T,active,detroit-lions,641920,2019
14221,419291,182459,Austin Bryant,DE,active,detroit-lions,601750,2019
14222,495000,80526,Amani Oruwariye,CB,active,detroit-lions,575526,2019
14223,570000,0,Michael Ford,CB,active,detroit-lions,570000,2019
14224,570000,0,Dee Virgin,CB,active,detroit-lions,570000,2019
14225,495000,42976,Ty Johnson,RB,active,detroit-lions,537976,2019
14226,495000,3333,Beau Benzschawel,G,active,detroit-lions,498333,2019
14227,495000,2333,C.J. Moore,S,active,detroit-lions,497333,2019
14228,495000,0,David Blough,QB,active,detroit-lions,495000,2019
14229,349412,0,John Atkins,DT,active,detroit-lions,349412,2019
14230,335290,0,Steve Longa,OLB,active,detroit-lions,335290,2019
14231,262059,0,Michael Jackson,CB,active,detroit-lions,262059,2019
14232,203824,0,Bo Scarbrough,RB,active,detroit-lions,203824,2019
14233,174706,0,Isaac Nauta,TE,active,detroit-lions,174706,2019
14234,151765,0,Kyle Sloter,QB,active,detroit-lions,151765,2019
14235,145588,0,Chris Lacy,WR,active,detroit-lions,145588,2019
14236,134116,0,Jason Cabinda,LB,active,detroit-lions,134116,2019
14237,100587,0,Dan Skipper,T,active,detroit-lions,100587,2019
14238,87354,0,Frank Herron,DT,active,detroit-lions,87354,2019
14239,87353,0,Travis Fulgham,WR,active,detroit-lions,87353,2019
14240,87353,0,Wes Hills,RB,active,detroit-lions,87353,2019
14241,84706,0,Jamie Meder,DE,active,detroit-lions,84706,2019
14242,84706,0,Caleb Benenoch,RT,active,detroit-lions,84706,2019
14243,58236,0,Jonathan Wynn,DE,active,detroit-lions,58236,2019
14244,29118,0,Anthony Pittman,LB,active,detroit-lions,29118,2019
14245,13500000,17200000,Matthew Stafford,QB,injured_reserve,detroit-lions,30700000,2019
14246,6500000,2683333,Marvin Jones,WR,injured_reserve,detroit-lions,9183333,2019
14247,7800000,168750,Mike Daniels,DT,injured_reserve,detroit-lions,7968750,2019
14248,1579118,2092500,Christian Jones,ILB,injured_reserve,detroit-lions,3671618,2019
14249,495000,3108859,T.J. Hockenson,TE,injured_reserve,detroit-lions,3603859,2019
14250,2500000,593750,Kenny Wiggins,G,injured_reserve,detroit-lions,3093750,2019
14251,1462198,1529396,Jarrad Davis,ILB,injured_reserve,detroit-lions,2991594,2019
14252,1000000,337500,Jermaine Kearse,WR,injured_reserve,detroit-lions,1337500,2019
14253,495000,758449,Jahlani Tavai,LB,injured_reserve,detroit-lions,1253449,2019
14254,720000,311481,Joe Dahl,C,injured_reserve,detroit-lions,1031481,2019
14255,570000,170491,Da'shawn Hand,DE,injured_reserve,detroit-lions,740491,2019
14256,513353,0,Jeff Driskel,QB,injured_reserve,detroit-lions,513353,2019
14257,495055,0,Marvin Hall,WR,injured_reserve,detroit-lions,495055,2019
14258,453706,21051,Nick Bawden,FB,injured_reserve,detroit-lions,474757,2019
14259,446824,2000,Kevin Strong,DT,injured_reserve,detroit-lions,448824,2019
14260,448000,0,Darius Kilgo,DT,injured_reserve,detroit-lions,448000,2019
14261,32000,0,Joe Callahan,QB,practice_squad,detroit-lions,32000,2019
14262,1094059,2602084,Quandre Diggs,SS,dead_cap,detroit-lions,3696143,2019
14263,0,2666668,T.J. Lang,G,dead_cap,detroit-lions,2666668,2019
14264,0,1666668,Glover Quin,FS,dead_cap,detroit-lions,1666668,2019
14265,1000000,325000,C.J. Anderson,RB,dead_cap,detroit-lions,1325000,2019
14266,0,1125000,Nevin Lawson,CB,dead_cap,detroit-lions,1125000,2019
14267,0,1087500,Theo Riddick,RB,dead_cap,detroit-lions,1087500,2019
14268,0,411906,Jalen Tabor,CB,dead_cap,detroit-lions,411906,2019
14269,354824,0,Paul Perkins,RB,dead_cap,detroit-lions,354824,2019
14270,295391,44538,Travis Fulgham,WR,dead_cap,detroit-lions,339929,2019
14271,295000,0,Zach Zenner,RB,dead_cap,detroit-lions,295000,2019
14272,140000,90000,Marcus Cooper,CB,dead_cap,detroit-lions,230000,2019
14273,199353,0,Tom Kennedy,WR,dead_cap,detroit-lions,199353,2019
14274,135000,40000,Andrew Donnal,G,dead_cap,detroit-lions,175000,2019
14275,145000,6666,Ryan Pope,T,dead_cap,detroit-lions,151666,2019
14276,0,150784,Michael Roberts,TE,dead_cap,detroit-lions,150784,2019
14277,136000,0,Matt Nelson,DT,dead_cap,detroit-lions,136000,2019
14278,130236,0,Chris Lacy,WR,dead_cap,detroit-lions,130236,2019
14279,123500,0,Jason Cabinda,LB,dead_cap,detroit-lions,123500,2019
14280,120000,0,Anthony Pittman,LB,dead_cap,detroit-lions,120000,2019
14281,88000,25016,Isaac Nauta,TE,dead_cap,detroit-lions,113016,2019
14282,112000,0,Jonathan Wynn,DE,dead_cap,detroit-lions,112000,2019
14283,100588,0,Tra Carson,RB,dead_cap,detroit-lions,100588,2019
14284,0,100000,Andrew Adams,S,dead_cap,detroit-lions,100000,2019
14285,0,100000,Tommylee Lewis,WR,dead_cap,detroit-lions,100000,2019
14286,0,90000,Tom Savage,QB,dead_cap,detroit-lions,90000,2019
14287,0,72080,Jeremiah Ledbetter,DT,dead_cap,detroit-lions,72080,2019
14288,64000,0,Wes Hills,RB,dead_cap,detroit-lions,64000,2019
14289,0,60000,Logan Thomas,TE,dead_cap,detroit-lions,60000,2019
14290,56000,0,Steve Longa,OLB,dead_cap,detroit-lions,56000,2019
14291,53118,0,Dan Skipper,T,dead_cap,detroit-lions,53118,2019
14292,50000,0,Robert Ayers,DE,dead_cap,detroit-lions,50000,2019
14293,47500,0,John Atkins,DT,dead_cap,detroit-lions,47500,2019
14294,40000,0,Eric Lee,DE,dead_cap,detroit-lions,40000,2019
14295,32000,0,Victor Bolden,WR,dead_cap,detroit-lions,32000,2019
14296,32000,0,Jack Fox,P,dead_cap,detroit-lions,32000,2019
14297,0,30930,Anthony Zettel,DE,dead_cap,detroit-lions,30930,2019
14298,25000,3333,Malik Carney,DE,dead_cap,detroit-lions,28333,2019
14299,22235,3333,Tre Lamar,LB,dead_cap,detroit-lions,25568,2019
14300,0,24037,P.J. Johnson,DT,dead_cap,detroit-lions,24037,2019
14301,24000,0,Jon Duhart,WR,dead_cap,detroit-lions,24000,2019
14302,24000,0,Matt Wile,P,dead_cap,detroit-lions,24000,2019
14303,0,18941,Dwayne Washington,RB,dead_cap,detroit-lions,18941,2019
14304,16000,0,Marvin Hall,WR,dead_cap,detroit-lions,16000,2019
14305,16000,0,Olive Sagapolu,DT,dead_cap,detroit-lions,16000,2019
14306,16000,0,Christian Sam,ILB,dead_cap,detroit-lions,16000,2019
14307,8000,0,Nick Brossette,RB,dead_cap,detroit-lions,8000,2019
14308,8000,0,Cole Herdman,TE,dead_cap,detroit-lions,8000,2019
14309,8000,0,A.J. Howard,S,dead_cap,detroit-lions,8000,2019
14310,8000,0,Chad Kanoff,QB,dead_cap,detroit-lions,8000,2019
14311,8000,0,Ray Smith,DT,dead_cap,detroit-lions,8000,2019
14312,8000,0,David Williams,RB,dead_cap,detroit-lions,8000,2019
14313,0,6667,Chad Meredith,LB,dead_cap,detroit-lions,6667,2019
14314,0,5000,Michael Ford,CB,dead_cap,detroit-lions,5000,2019
14315,0,4000,Brandon Powell,WR,dead_cap,detroit-lions,4000,2019
14316,7800000,13500000,Matthew Stafford,QB,active,detroit-lions,21300000,2020
14317,11125000,5614000,Trey Flowers,DE,active,detroit-lions,16739000,2020
14318,10000000,3368750,Darius Slay,CB,active,detroit-lions,13368750,2020
14319,9000000,2900000,Ricky Wagner,RT,active,detroit-lions,11900000,2020
14320,8500000,3218750,Damon Harrison,DT,active,detroit-lions,11718750,2020
14321,10350000,0,Taylor Decker,LT,active,detroit-lions,10350000,2020
14322,6500000,2683334,Marvin Jones,WR,active,detroit-lions,9183334,2020
14323,6950000,2079000,Justin Coleman,CB,active,detroit-lions,9029000,2020
14324,4950000,2225000,Devon Kennard,OLB,active,detroit-lions,7175000,2020
14325,3800000,1479000,Jesse James,TE,active,detroit-lions,5279000,2020
14326,585000,3919824,T.J. Hockenson,TE,active,detroit-lions,4504824,2020
14327,2750000,1170416,Romeo Okwara,DE,active,detroit-lions,3920416,2020
14328,2700000,1200000,Matt Prater,K,active,detroit-lions,3900000,2020
14329,1960798,1529399,Jarrad Davis,ILB,active,detroit-lions,3490197,2020
14330,1550922,1661843,Frank Ragnow,G,active,detroit-lions,3212765,2020
14331,820000,2029375,Christian Jones,ILB,active,detroit-lions,2849375,2020
14332,1475000,381250,Joe Dahl,C,active,detroit-lions,1856250,2020
14333,1071245,702489,Kerryon Johnson,RB,active,detroit-lions,1773734,2020
14334,808362,758449,Jahlani Tavai,LB,active,detroit-lions,1566811,2020
14335,720000,220497,Tracy Walker,S,active,detroit-lions,940497,2020
14336,750500,179706,Kenny Golladay,WR,active,detroit-lions,930206,2020
14337,632650,268061,Will Harris,S,active,detroit-lions,900711,2020
14338,735000,154724,Jalen Reeves-Maybin,OLB,active,detroit-lions,889724,2020
14339,660000,170491,Da'shawn Hand,DE,active,detroit-lions,830491,2020
14340,820000,0,Caleb Benenoch,RT,active,detroit-lions,820000,2020
14341,735000,64591,Jamal Agnew,CB,active,detroit-lions,799591,2020
14342,585000,182459,Austin Bryant,DE,active,detroit-lions,767459,2020
14343,735000,0,Marvin Hall,WR,active,detroit-lions,735000,2020
14344,735000,0,Kyle Sloter,QB,active,detroit-lions,735000,2020
14345,735000,0,Matt Wile,P,active,detroit-lions,735000,2020
14346,660000,71920,Tyrell Crosby,T,active,detroit-lions,731920,2020
14347,660000,25000,Tra Carson,RB,active,detroit-lions,685000,2020
14348,660000,21051,Nick Bawden,FB,active,detroit-lions,681051,2020
14349,585000,80526,Amani Oruwariye,CB,active,detroit-lions,665526,2020
14350,820000,0,Russell Bodine,C,active,detroit-lions,820000,2020
14351,660000,0,Victor Bolden,WR,active,detroit-lions,660000,2020
14352,660000,0,Jason Cabinda,LB,active,detroit-lions,660000,2020
14353,660000,0,Steve Longa,OLB,active,detroit-lions,660000,2020
14354,585000,42976,Ty Johnson,RB,active,detroit-lions,627976,2020
14355,585000,3333,Beau Benzschawel,G,active,detroit-lions,588333,2020
14356,585000,2333,C.J. Moore,S,active,detroit-lions,587333,2020
14357,585000,2000,Kevin Strong,DT,active,detroit-lions,587000,2020
14358,585000,0,John Atkins,DT,active,detroit-lions,585000,2020
14359,585000,0,David Blough,QB,active,detroit-lions,585000,2020
14360,585000,0,Travis Fulgham,WR,active,detroit-lions,585000,2020
14361,585000,0,Frank Herron,DT,active,detroit-lions,585000,2020
14362,585000,0,Wes Hills,RB,active,detroit-lions,585000,2020
14363,585000,0,Michael Jackson,CB,active,detroit-lions,585000,2020
14364,585000,0,Chris Lacy,WR,active,detroit-lions,585000,2020
14365,585000,0,Isaac Nauta,TE,active,detroit-lions,585000,2020
14366,585000,0,Bo Scarbrough,RB,active,detroit-lions,585000,2020
14367,585000,0,Dan Skipper,T,active,detroit-lions,585000,2020
14368,585000,0,Jonathan Wynn,DE,active,detroit-lions,585000,2020
14369,510000,0,Paul Butler,TE,active,detroit-lions,510000,2020
14370,510000,0,Jon Duhart,WR,active,detroit-lions,510000,2020
14371,510000,0,James Fisher,LS,active,detroit-lions,510000,2020
14372,510000,0,Jack Fox,P,active,detroit-lions,510000,2020
14373,510000,0,A.J. Howard,S,active,detroit-lions,510000,2020
14374,510000,0,Tom Kennedy,WR,active,detroit-lions,510000,2020
14375,510000,0,Matt Nelson,DT,active,detroit-lions,510000,2020
14376,510000,0,Anthony Pittman,LB,active,detroit-lions,510000,2020
14377,510000,0,Olive Sagapolu,DT,active,detroit-lions,510000,2020
14378,510000,0,Christian Sam,ILB,active,detroit-lions,510000,2020
14379,510000,0,Matt Sokol,TE,active,detroit-lions,510000,2020
14380,510000,0,Casey Tucker,T,active,detroit-lions,510000,2020
14381,0,500000,Sam Martin,P,active,detroit-lions,500000,2020
14382,0,4916668,Quandre Diggs,SS,dead_cap,detroit-lions,4916668,2020
14383,0,411906,Jalen Tabor,CB,dead_cap,detroit-lions,411906,2020
14384,0,150784,Michael Roberts,TE,dead_cap,detroit-lions,150784,2020
14385,0,133614,Travis Fulgham,WR,dead_cap,detroit-lions,133614,2020
14386,0,75048,Isaac Nauta,TE,dead_cap,detroit-lions,75048,2020
14387,0,72111,P.J. Johnson,DT,dead_cap,detroit-lions,72111,2020
14388,0,13337,Ryan Pope,T,dead_cap,detroit-lions,13337,2020
14389,0,6667,Malik Carney,DE,dead_cap,detroit-lions,6667,2020
14390,0,6667,Tre Lamar,LB,dead_cap,detroit-lions,6667,2020
14391,0,4000,Brandon Powell,WR,dead_cap,detroit-lions,4000,2020
14392,11000000,1600000,Brett Favre,QB,active,green-bay-packers,12600000,2007
14393,5000000,3062000,Nick Barnett,ILB,active,green-bay-packers,8062000,2007
14394,3367500,1666666,Chad Clifton,T,active,green-bay-packers,5034166,2007
14395,1250000,2687500,Charles Woodson,SS,active,green-bay-packers,3937500,2007
14396,2700000,1166667,Donald Driver,WR,active,green-bay-packers,3866667,2007
14397,1350000,2450000,Cullen Jenkins,DE,active,green-bay-packers,3800000,2007
14398,360000,4742500,A.J. Hawk,OLB,active,green-bay-packers,5102500,2007
14399,1475000,1025000,Ryan Pickett,DT,active,green-bay-packers,2500000,2007
14400,1400000,1000000,Bubba Franks,TE,active,green-bay-packers,2400000,2007
14401,510000,1425000,Scott Wells,C,active,green-bay-packers,1935000,2007
14402,505000,1805000,Aaron Rodgers,QB,active,green-bay-packers,2310000,2007
14403,285000,962000,Justin Harrell,DT,active,green-bay-packers,1247000,2007
14404,850000,24000,Corey Williams,DT,active,green-bay-packers,874000,2007
14405,435000,120000,Nick Collins,S,active,green-bay-packers,555000,2007
14406,360000,325000,Daryn Colledge,G,active,green-bay-packers,685000,2007
14407,360000,310000,Greg Jennings,WR,active,green-bay-packers,670000,2007
14408,595000,0,Donald Lee,TE,active,green-bay-packers,595000,2007
14409,360000,202000,Abdul Hodge,LB,active,green-bay-packers,562000,2007
14410,360000,185562,Jason Spitz,G,active,green-bay-packers,545562,2007
14411,435000,101750,Brady Poppinga,LB,active,green-bay-packers,536750,2007
14412,310000,185562,James Jones,WR,active,green-bay-packers,495562,2007
14413,435000,43200,Junius Coston,G,active,green-bay-packers,478200,2007
14414,285000,190000,Brandon Jackson,RB,active,green-bay-packers,475000,2007
14415,360000,108375,Will Blackmon,CB,active,green-bay-packers,468375,2007
14416,435000,25500,Michael Montgomery,DE,active,green-bay-packers,460500,2007
14417,285000,162375,Aaron Rouse,S,active,green-bay-packers,447375,2007
14418,360000,36250,Tony Moll,T,active,green-bay-packers,396250,2007
14419,285000,109000,Allen Barbre,G,active,green-bay-packers,394000,2007
14420,385000,0,Vernand Morency,RB,active,green-bay-packers,385000,2007
14421,360000,23650,Johnny Jolly,DE,active,green-bay-packers,383650,2007
14422,360000,11667,Jon Ryan,P,active,green-bay-packers,371667,2007
14423,370000,0,Tony Palmer,G,active,green-bay-packers,370000,2007
14424,360000,6667,Jarrett Bush,CB,active,green-bay-packers,366667,2007
14425,360000,5000,Jason Hunter,DE,active,green-bay-packers,365000,2007
14426,360000,0,Atari Bigby,S,active,green-bay-packers,360000,2007
14427,360000,0,John Kuhn,FB,active,green-bay-packers,360000,2007
14428,360000,0,Ruvell Martin,WR,active,green-bay-packers,360000,2007
14429,310000,0,Ryan Grant,RB,active,green-bay-packers,310000,2007
14430,285000,23612,Korey Hall,RB,active,green-bay-packers,308612,2007
14431,285000,23550,Desmond Bishop,OLB,active,green-bay-packers,308550,2007
14432,285000,23487,Mason Crosby,K,active,green-bay-packers,308487,2007
14433,285000,12726,DeShawn Wynn,RB,active,green-bay-packers,297726,2007
14434,285000,0,Daniel Muir,DT,active,green-bay-packers,285000,2007
14435,285000,0,Tramon Williams,CB,active,green-bay-packers,285000,2007
14436,435000,0,Noah Herron,RB,injured_reserve,green-bay-packers,435000,2007
14437,79900,0,David Clowney,WR,practice_squad,green-bay-packers,79900,2007
14438,79900,0,Onrea Jones,WR,practice_squad,green-bay-packers,79900,2007
14439,0,3270000,Ahmad Carroll,CB,dead_cap,green-bay-packers,3270000,2007
14440,348840,0,Cory Rodgers,WR,dead_cap,green-bay-packers,348840,2007
14441,107500,0,Marviel Underwood,S,dead_cap,green-bay-packers,107500,2007
14442,72000,0,Mike Hawkins,CB,dead_cap,green-bay-packers,72000,2007
14443,43000,0,Ingle Martin IV,QB,dead_cap,green-bay-packers,43000,2007
14444,42500,0,David Clowney,WR,dead_cap,green-bay-packers,42500,2007
14445,26250,0,Dave Tollefson,DE,dead_cap,green-bay-packers,26250,2007
14446,20750,0,Kurt Campbell,LB,dead_cap,green-bay-packers,20750,2007
14447,20500,0,Will Whitticker,G,dead_cap,green-bay-packers,20500,2007
14448,10218,0,Clark Harris,LS,dead_cap,green-bay-packers,10218,2007
14449,12900000,1805000,Aaron Rodgers,QB,active,green-bay-packers,14705000,2008
14450,3367500,1666666,Chad Clifton,T,active,green-bay-packers,5034166,2008
14451,3250000,1800000,Charles Woodson,SS,active,green-bay-packers,5050000,2008
14452,1950000,5242500,A.J. Hawk,OLB,active,green-bay-packers,7192500,2008
14453,750000,0,Ryan Grant,RB,active,green-bay-packers,750000,2008
14454,927000,101750,Brady Poppinga,LB,active,green-bay-packers,1028750,2008
14455,2900000,500000,Donald Driver,WR,active,green-bay-packers,3400000,2008
14456,1100000,275000,Brandon Chillar,LB,active,green-bay-packers,1375000,2008
14457,2000000,1210000,Cullen Jenkins,DE,active,green-bay-packers,3210000,2008
14458,2475000,525000,Ryan Pickett,DT,active,green-bay-packers,3000000,2008
14459,1600000,750000,Donald Lee,TE,active,green-bay-packers,2350000,2008
14460,740000,912500,Scott Wells,C,active,green-bay-packers,1652500,2008
14461,370000,2150000,Justin Harrell,DT,active,green-bay-packers,2520000,2008
14462,295000,785000,Brian Brohm,QB,active,green-bay-packers,1080000,2008
14463,520000,120000,Nick Collins,S,active,green-bay-packers,640000,2008
14464,295000,505000,Jordy Nelson,WR,active,green-bay-packers,800000,2008
14465,445000,325000,Daryn Colledge,G,active,green-bay-packers,770000,2008
14466,445000,310000,Greg Jennings,WR,active,green-bay-packers,755000,2008
14467,445000,185562,Jason Spitz,G,active,green-bay-packers,630562,2008
14468,370000,190000,Brandon Jackson,RB,active,green-bay-packers,560000,2008
14469,370000,185562,James Jones,WR,active,green-bay-packers,555562,2008
14470,445000,108375,Will Blackmon,CB,active,green-bay-packers,553375,2008
14471,520000,25500,Michael Montgomery,DE,active,green-bay-packers,545500,2008
14472,370000,162375,Aaron Rouse,S,active,green-bay-packers,532375,2008
14473,520000,0,Kenneth Pettway,LB,active,green-bay-packers,520000,2008
14474,295000,210000,Pat Lee,CB,active,green-bay-packers,505000,2008
14475,445000,36250,Tony Moll,T,active,green-bay-packers,481250,2008
14476,370000,109000,Allen Barbre,G,active,green-bay-packers,479000,2008
14477,445000,23650,Johnny Jolly,DE,active,green-bay-packers,468650,2008
14478,295000,163250,Jermichael Finley,TE,active,green-bay-packers,458250,2008
14479,445000,6667,Jarrett Bush,CB,active,green-bay-packers,451667,2008
14480,445000,5000,Jason Hunter,DE,active,green-bay-packers,450000,2008
14481,445000,0,Atari Bigby,S,active,green-bay-packers,445000,2008
14482,445000,0,John Kuhn,FB,active,green-bay-packers,445000,2008
14483,445000,0,Ruvell Martin,WR,active,green-bay-packers,445000,2008
14484,295000,125300,Jeremy Thompson,DE,active,green-bay-packers,420300,2008
14485,370000,23612,Korey Hall,RB,active,green-bay-packers,393612,2008
14486,370000,23550,Desmond Bishop,OLB,active,green-bay-packers,393550,2008
14487,370000,23487,Mason Crosby,K,active,green-bay-packers,393487,2008
14488,295000,96000,Josh Sitton,G,active,green-bay-packers,391000,2008
14489,381083,0,Danny Lansanah,ILB,active,green-bay-packers,381083,2008
14490,370000,0,Daniel Muir,DT,active,green-bay-packers,370000,2008
14491,370000,0,Tramon Williams,CB,active,green-bay-packers,370000,2008
14492,295000,44791,Breno Giacomini,RT,active,green-bay-packers,339791,2008
14493,295000,29750,Erik Walden,OLB,active,green-bay-packers,324750,2008
14494,295000,16043,Matt Flynn,QB,active,green-bay-packers,311043,2008
14495,200000,833,J.J. Jansen,LS,active,green-bay-packers,200833,2008
14496,88400,0,Brett Swain,WR,active,green-bay-packers,88400,2008
14497,34705,0,Anthony Toribio,DE,active,green-bay-packers,34705,2008
14498,370000,0,DeShawn Wynn,RB,active,green-bay-packers,370000,2008
14499,2000000,1420000,Nick Barnett,ILB,injured_reserve,green-bay-packers,3420000,2008
14500,88400,0,Danny Lansanah,ILB,practice_squad,green-bay-packers,88400,2008
14501,88400,0,Anthony Toribio,DE,practice_squad,green-bay-packers,88400,2008
14502,0,2000000,Bubba Franks,TE,dead_cap,green-bay-packers,2000000,2008
14503,0,1600000,Brett Favre,QB,dead_cap,green-bay-packers,1600000,2008
14504,202000,0,Abdul Hodge,LB,dead_cap,green-bay-packers,202000,2008
14505,127500,0,David Clowney,WR,dead_cap,green-bay-packers,127500,2008
14506,107500,0,Marviel Underwood,S,dead_cap,green-bay-packers,107500,2008
14507,104376,0,Junius Coston,G,dead_cap,green-bay-packers,104376,2008
14508,86000,0,Ingle Martin IV,QB,dead_cap,green-bay-packers,86000,2008
14509,30654,0,Clark Harris,LS,dead_cap,green-bay-packers,30654,2008
14510,14402,0,Brett Swain,WR,dead_cap,green-bay-packers,14402,2008
14511,12726,0,DeShawn Wynn,RB,dead_cap,green-bay-packers,12726,2008
14512,11667,0,Jon Ryan,P,dead_cap,green-bay-packers,11667,2008
14513,680000,10477000,Aaron Rodgers,QB,active,green-bay-packers,11157000,2009
14514,5000000,3372500,Greg Jennings,WR,active,green-bay-packers,8372500,2009
14515,4367500,1666668,Chad Clifton,T,active,green-bay-packers,6034168,2009
14516,5500000,1800000,Charles Woodson,SS,active,green-bay-packers,7300000,2009
14517,3025000,5242500,A.J. Hawk,OLB,active,green-bay-packers,8267500,2009
14518,1250000,0,Ryan Grant,RB,active,green-bay-packers,1250000,2009
14519,3000000,1570000,Nick Barnett,ILB,active,green-bay-packers,4570000,2009
14520,3900000,500000,Donald Driver,WR,active,green-bay-packers,4400000,2009
14521,2650000,1450000,Cullen Jenkins,DE,active,green-bay-packers,4100000,2009
14522,2975000,500000,Ryan Pickett,DT,active,green-bay-packers,3475000,2009
14523,3045000,120000,Nick Collins,S,active,green-bay-packers,3165000,2009
14524,1350000,675000,Brandon Chillar,LB,active,green-bay-packers,2025000,2009
14525,1900000,0,Brady Poppinga,LB,active,green-bay-packers,1900000,2009
14526,1800000,750000,Donald Lee,TE,active,green-bay-packers,2550000,2009
14527,310000,1740000,B.J. Raji,DT,active,green-bay-packers,2050000,2009
14528,1500000,450000,Scott Wells,C,active,green-bay-packers,1950000,2009
14529,385000,1433750,Jordy Nelson,WR,active,green-bay-packers,1818750,2009
14530,1600000,185562,Jason Spitz,G,active,green-bay-packers,1785562,2009
14531,460000,2306625,Justin Harrell,DT,active,green-bay-packers,2766625,2009
14532,1545000,0,Atari Bigby,S,active,green-bay-packers,1545000,2009
14533,1000000,333333,Jarrett Bush,CB,active,green-bay-packers,1333333,2009
14534,725000,0,Michael Montgomery,DE,active,green-bay-packers,725000,2009
14535,310000,910000,Clay Matthews,OLB,active,green-bay-packers,1220000,2009
14536,1010000,0,John Kuhn,FB,active,green-bay-packers,1010000,2009
14537,525000,375000,Tramon Williams,CB,active,green-bay-packers,900000,2009
14538,535000,325000,Daryn Colledge,G,active,green-bay-packers,860000,2009
14539,845001,0,Ahman Green,RB,active,green-bay-packers,845001,2009
14540,620000,43200,Junius Coston,G,active,green-bay-packers,663200,2009
14541,650000,0,Matt Giordano,S,active,green-bay-packers,650000,2009
14542,460000,190000,Brandon Jackson,RB,active,green-bay-packers,650000,2009
14543,460000,185562,James Jones,WR,active,green-bay-packers,645562,2009
14544,535000,108375,Will Blackmon,CB,active,green-bay-packers,643375,2009
14545,385000,210000,Pat Lee,CB,active,green-bay-packers,595000,2009
14546,460000,109000,Allen Barbre,G,active,green-bay-packers,569000,2009
14547,535000,23650,Johnny Jolly,DE,active,green-bay-packers,558650,2009
14548,385000,163250,Jermichael Finley,TE,active,green-bay-packers,548250,2009
14549,535000,0,Derrick Martin,CB,active,green-bay-packers,535000,2009
14550,385000,125300,Jeremy Thompson,DE,active,green-bay-packers,510300,2009
14551,460000,23612,Korey Hall,RB,active,green-bay-packers,483612,2009
14552,460000,23550,Desmond Bishop,OLB,active,green-bay-packers,483550,2009
14553,460000,23487,Mason Crosby,K,active,green-bay-packers,483487,2009
14554,385000,96000,Josh Sitton,G,active,green-bay-packers,481000,2009
14555,460000,0,Daniel Muir,DT,active,green-bay-packers,460000,2009
14556,315000,125625,T.J. Lang,G,active,green-bay-packers,440625,2009
14557,385000,44791,Breno Giacomini,RT,active,green-bay-packers,429791,2009
14558,385000,29750,Erik Walden,OLB,active,green-bay-packers,414750,2009
14559,385000,16043,Matt Flynn,QB,active,green-bay-packers,401043,2009
14560,310000,48068,Quinn Johnson,FB,active,green-bay-packers,358068,2009
14561,310000,27182,Jarius Wynn,OLB,active,green-bay-packers,337182,2009
14562,310000,25550,Brandon Underwood,CB,active,green-bay-packers,335550,2009
14563,310000,15063,Brad Jones,ILB,active,green-bay-packers,325063,2009
14564,310000,1000,Evan Smith,C,active,green-bay-packers,311000,2009
14565,310000,0,Brett Swain,WR,active,green-bay-packers,310000,2009
14566,172500,0,DeShawn Wynn,RB,active,green-bay-packers,172500,2009
14567,18235,0,Anthony Toribio,DE,active,green-bay-packers,18235,2009
14568,88400,0,Brian Brohm,QB,practice_squad,green-bay-packers,88400,2009
14569,88400,0,Tom Crabtree,TE,practice_squad,green-bay-packers,88400,2009
14570,88400,0,Jamon Meredith,RT,practice_squad,green-bay-packers,88400,2009
14571,88400,0,Ronald Talley,DE,practice_squad,green-bay-packers,88400,2009
14572,88400,0,Anthony Toribio,DE,practice_squad,green-bay-packers,88400,2009
14573,0,1600000,Brett Favre,QB,dead_cap,green-bay-packers,1600000,2009
14574,225000,0,Brian Brohm,QB,dead_cap,green-bay-packers,225000,2009
14575,202000,0,Abdul Hodge,LB,dead_cap,green-bay-packers,202000,2009
14576,162375,0,Aaron Rouse,S,dead_cap,green-bay-packers,162375,2009
14577,43206,0,Brett Swain,WR,dead_cap,green-bay-packers,43206,2009
14578,43200,0,Junius Coston,G,dead_cap,green-bay-packers,43200,2009
14579,43125,0,Jamon Meredith,RT,dead_cap,green-bay-packers,43125,2009
14580,36250,0,Tony Moll,T,dead_cap,green-bay-packers,36250,2009
14581,25452,0,DeShawn Wynn,RB,dead_cap,green-bay-packers,25452,2009
14582,0,833,J.J. Jansen,LS,dead_cap,green-bay-packers,833,2009
14583,1350000,1000000,Nick Collins,S,active,green-bay-packers,2350000,2010
14584,1200000,7237500,Ryan Pickett,DT,active,green-bay-packers,8437500,2010
14585,6700000,1700000,Charles Woodson,SS,active,green-bay-packers,8400000,2010
14586,1000000,0,Donald Driver,WR,active,green-bay-packers,1000000,2010
14587,855000,0,Chad Clifton,T,active,green-bay-packers,855000,2010
14588,5074000,2000000,Tramon Williams,CB,active,green-bay-packers,7074000,2010
14589,4123750,5242500,A.J. Hawk,OLB,active,green-bay-packers,9366250,2010
14590,6000000,500000,Aaron Rodgers,QB,active,green-bay-packers,6500000,2010
14591,4500000,0,Ryan Grant,RB,active,green-bay-packers,4500000,2010
14592,1850000,3912500,Greg Jennings,WR,active,green-bay-packers,5762500,2010
14593,3200000,1370000,Cullen Jenkins,DE,active,green-bay-packers,4570000,2010
14594,2000000,750000,Donald Lee,TE,active,green-bay-packers,2750000,2010
14595,2250000,450000,Scott Wells,C,active,green-bay-packers,2700000,2010
14596,562500,3505000,B.J. Raji,DT,active,green-bay-packers,4067500,2010
14597,550000,2528375,Justin Harrell,DT,active,green-bay-packers,3078375,2010
14598,1759000,0,Daryn Colledge,G,active,green-bay-packers,1759000,2010
14599,1699500,0,Atari Bigby,S,active,green-bay-packers,1699500,2010
14600,395000,2060000,Clay Matthews,OLB,active,green-bay-packers,2455000,2010
14601,1100000,333333,Jarrett Bush,CB,active,green-bay-packers,1433333,2010
14602,550000,823550,Desmond Bishop,OLB,active,green-bay-packers,1373550,2010
14603,390000,970000,Bryan Bulaga,RT,active,green-bay-packers,1360000,2010
14604,1101000,185562,James Jones,WR,active,green-bay-packers,1286562,2010
14605,1176000,0,John Kuhn,FB,active,green-bay-packers,1176000,2010
14606,1176000,0,Jason Spitz,G,active,green-bay-packers,1176000,2010
14607,1101000,23487,Mason Crosby,K,active,green-bay-packers,1124487,2010
14608,550000,190000,Brandon Jackson,RB,active,green-bay-packers,740000,2010
14609,475000,512500,Jordy Nelson,WR,active,green-bay-packers,987500,2010
14610,630000,0,Michael Montgomery,DE,active,green-bay-packers,630000,2010
14611,650000,222500,Derrick Martin,CB,active,green-bay-packers,872500,2010
14612,700000,0,Anthony Smith,S,active,green-bay-packers,700000,2010
14613,327000,100000,Brett Goode,LS,active,green-bay-packers,427000,2010
14614,470000,210000,Pat Lee,CB,active,green-bay-packers,680000,2010
14615,470000,163250,Jermichael Finley,TE,active,green-bay-packers,633250,2010
14616,630000,0,Charlie Peprah,S,active,green-bay-packers,630000,2010
14617,320000,290000,Michael Neal,OLB,active,green-bay-packers,610000,2010
14618,555000,23612,Korey Hall,RB,active,green-bay-packers,578612,2010
14619,470000,96000,Josh Sitton,G,active,green-bay-packers,566000,2010
14620,320000,218775,Morgan Burnett,SS,active,green-bay-packers,538775,2010
14621,390000,125625,T.J. Lang,G,active,green-bay-packers,515625,2010
14622,470000,29750,Erik Walden,OLB,active,green-bay-packers,499750,2010
14623,470000,16043,Matt Flynn,QB,active,green-bay-packers,486043,2010
14624,395000,48068,Quinn Johnson,FB,active,green-bay-packers,443068,2010
14625,390000,37462,Marshall Newhouse,RT,active,green-bay-packers,427462,2010
14626,395000,25550,Brandon Underwood,CB,active,green-bay-packers,420550,2010
14627,390000,15063,Brad Jones,ILB,active,green-bay-packers,405063,2010
14628,395000,0,Brett Swain,WR,active,green-bay-packers,395000,2010
14629,395000,0,Jarius Wynn,OLB,active,green-bay-packers,395000,2010
14630,390000,0,Rob Francois,ILB,active,green-bay-packers,390000,2010
14631,320000,45606,Andrew Quarless,TE,active,green-bay-packers,365606,2010
14632,320000,25075,James Starks,RB,active,green-bay-packers,345075,2010
14633,320000,12590,C.J. Wilson,DT,active,green-bay-packers,332590,2010
14634,320000,2500,Sam Shields,CB,active,green-bay-packers,322500,2010
14635,320000,1166,Frank Zombo,OLB,active,green-bay-packers,321166,2010
14636,320000,0,Tom Crabtree,TE,active,green-bay-packers,320000,2010
14637,320000,0,Tim Masthay,P,active,green-bay-packers,320000,2010
14638,301176,0,Dimitri Nance,RB,active,green-bay-packers,301176,2010
14639,129412,109000,Allen Barbre,G,active,green-bay-packers,238412,2010
14640,175000,0,Will Blackmon,CB,active,green-bay-packers,175000,2010
14641,100000,1000,Josh Gordy,CB,active,green-bay-packers,101000,2010
14642,23235,0,Evan Smith,C,active,green-bay-packers,23235,2010
14643,4000000,1270000,Nick Barnett,ILB,injured_reserve,green-bay-packers,5270000,2010
14644,2350000,400000,Brandon Chillar,LB,injured_reserve,green-bay-packers,2750000,2010
14645,1950000,0,Brady Poppinga,LB,injured_reserve,green-bay-packers,1950000,2010
14646,88400,0,Jay Ross,DT,practice_squad,green-bay-packers,88400,2010
14647,450000,0,Brian Brohm,QB,dead_cap,green-bay-packers,450000,2010
14648,250600,0,Jeremy Thompson,DE,dead_cap,green-bay-packers,250600,2010
14649,222353,0,Matt Giordano,S,dead_cap,green-bay-packers,222353,2010
14650,162375,0,Aaron Rouse,S,dead_cap,green-bay-packers,162375,2010
14651,129375,0,Jamon Meredith,RT,dead_cap,green-bay-packers,129375,2010
14652,89582,0,Breno Giacomini,RT,dead_cap,green-bay-packers,89582,2010
14653,88400,0,Josh Gordy,CB,dead_cap,green-bay-packers,88400,2010
14654,88400,0,Anthony Levine,ILB,dead_cap,green-bay-packers,88400,2010
14655,81546,0,Jarius Wynn,OLB,dead_cap,green-bay-packers,81546,2010
14656,48068,0,Quinn Johnson,FB,dead_cap,green-bay-packers,48068,2010
14657,0,834,J.J. Jansen,LS,dead_cap,green-bay-packers,834,2010
14658,7850000,937500,Charles Woodson,SS,active,green-bay-packers,8787500,2011
14659,3950000,3877500,Greg Jennings,WR,active,green-bay-packers,7827500,2011
14660,7250000,500000,Aaron Rodgers,QB,active,green-bay-packers,7750000,2011
14661,1150000,8142500,A.J. Hawk,OLB,active,green-bay-packers,9292500,2011
14662,5750000,0,Chad Clifton,T,active,green-bay-packers,5750000,2011
14663,4100000,0,Donald Driver,WR,active,green-bay-packers,4100000,2011
14664,1000000,4600000,Tramon Williams,CB,active,green-bay-packers,5600000,2011
14665,700000,4196000,Josh Sitton,G,active,green-bay-packers,4896000,2011
14666,2500000,0,Ryan Grant,RB,active,green-bay-packers,2500000,2011
14667,2900000,1000000,Nick Collins,S,active,green-bay-packers,3900000,2011
14668,2700000,1237500,Ryan Pickett,DT,active,green-bay-packers,3937500,2011
14669,1188000,2243750,Desmond Bishop,OLB,active,green-bay-packers,3431750,2011
14670,2750000,350000,Scott Wells,C,active,green-bay-packers,3100000,2011
14671,955000,3505000,B.J. Raji,DT,active,green-bay-packers,4460000,2011
14672,1300000,1450000,James Jones,WR,active,green-bay-packers,2750000,2011
14673,800000,1800000,John Kuhn,FB,active,green-bay-packers,2600000,2011
14674,1650000,600000,Mason Crosby,K,active,green-bay-packers,2250000,2011
14675,600000,1300000,Jordy Nelson,WR,active,green-bay-packers,1900000,2011
14676,1850000,0,Daniel Muir,DT,active,green-bay-packers,1850000,2011
14677,660000,2110000,Clay Matthews,OLB,active,green-bay-packers,2770000,2011
14678,1400000,333333,Jarrett Bush,CB,active,green-bay-packers,1733333,2011
14679,450000,2151000,Bryan Bulaga,RT,active,green-bay-packers,2601000,2011
14680,1200000,163250,Jermichael Finley,TE,active,green-bay-packers,1363250,2011
14681,375000,825364,Derek Sherrod,RT,active,green-bay-packers,1200364,2011
14682,840000,75000,Charlie Peprah,S,active,green-bay-packers,915000,2011
14683,555000,210000,Pat Lee,CB,active,green-bay-packers,765000,2011
14684,450000,290000,Michael Neal,OLB,active,green-bay-packers,740000,2011
14685,450000,218775,Morgan Burnett,SS,active,green-bay-packers,668775,2011
14686,560500,100000,Brett Goode,LS,active,green-bay-packers,660500,2011
14687,525000,125625,T.J. Lang,G,active,green-bay-packers,650625,2011
14688,600000,16043,Matt Flynn,QB,active,green-bay-packers,616043,2011
14689,555000,29750,Erik Walden,OLB,active,green-bay-packers,584750,2011
14690,375000,208531,Randall Cobb,WR,active,green-bay-packers,583531,2011
14691,685000,0,Derrick Martin,CB,active,green-bay-packers,685000,2011
14692,525000,0,Evan Smith,C,active,green-bay-packers,525000,2011
14693,525000,0,Jarius Wynn,OLB,active,green-bay-packers,525000,2011
14694,375000,128750,Alexander Green,RB,active,green-bay-packers,503750,2011
14695,450000,45606,Andrew Quarless,TE,active,green-bay-packers,495606,2011
14696,480000,15063,Brad Jones,ILB,active,green-bay-packers,495063,2011
14697,463236,25550,Brandon Underwood,CB,active,green-bay-packers,488786,2011
14698,450000,37462,Marshall Newhouse,RT,active,green-bay-packers,487462,2011
14699,450000,2500,Sam Shields,CB,active,green-bay-packers,452500,2011
14700,375000,75145,Davon House,CB,active,green-bay-packers,450145,2011
14701,450000,0,Tom Crabtree,TE,active,green-bay-packers,450000,2011
14702,450000,0,Rob Francois,ILB,active,green-bay-packers,450000,2011
14703,450000,0,Graham Harrell,QB,active,green-bay-packers,450000,2011
14704,405000,25075,James Starks,RB,active,green-bay-packers,430075,2011
14705,375000,49500,D.J. Williams,TE,active,green-bay-packers,424500,2011
14706,405000,12590,C.J. Wilson,DT,active,green-bay-packers,417590,2011
14707,405000,1166,Frank Zombo,OLB,active,green-bay-packers,406166,2011
14708,405000,0,Tim Masthay,P,active,green-bay-packers,405000,2011
14709,375000,25788,D.J. Smith,ILB,active,green-bay-packers,400788,2011
14710,375000,14794,Ryan Taylor,TE,active,green-bay-packers,389794,2011
14711,375000,2833,Vic So'oto,OLB,active,green-bay-packers,377833,2011
14712,375000,1667,Jamari Lattimore,ILB,active,green-bay-packers,376667,2011
14713,375000,833,M.D. Jennings,S,active,green-bay-packers,375833,2011
14714,375000,0,Ray Dominguez,G,active,green-bay-packers,375000,2011
14715,375000,0,Brandon Saine,RB,active,green-bay-packers,375000,2011
14716,258000,11475,Lawrence Guy,DE,active,green-bay-packers,269475,2011
14717,96900,0,Cecil Newton,C,practice_squad,green-bay-packers,96900,2011
14718,96900,0,Brandian Ross,CB,practice_squad,green-bay-packers,96900,2011
14719,1095000,75000,Nick Barnett,ILB,dead_cap,green-bay-packers,1170000,2011
14720,0,2120000,Justin Harrell,DT,dead_cap,green-bay-packers,2120000,2011
14721,400000,0,Brandon Chillar,LB,dead_cap,green-bay-packers,400000,2011
14722,177500,0,Derrick Martin,CB,dead_cap,green-bay-packers,177500,2011
14723,96900,0,Anthony Levine,ILB,dead_cap,green-bay-packers,96900,2011
14724,75000,0,Brady Poppinga,LB,dead_cap,green-bay-packers,75000,2011
14725,48068,0,Quinn Johnson,FB,dead_cap,green-bay-packers,48068,2011
14726,0,26450,Caleb Schlauderaff,C,dead_cap,green-bay-packers,26450,2011
14727,0,22059,Ricky Elmore,OLB,dead_cap,green-bay-packers,22059,2011
14728,1333,0,Nick McDonald,C,dead_cap,green-bay-packers,1333,2011
14729,1000,0,Josh Gordy,CB,dead_cap,green-bay-packers,1000,2011
14730,1000,0,Brandian Ross,CB,dead_cap,green-bay-packers,1000,2011
14731,6500000,4562500,Charles Woodson,SS,active,green-bay-packers,11062500,2012
14732,8000000,500000,Aaron Rodgers,QB,active,green-bay-packers,8500000,2012
14733,3885000,4087500,Greg Jennings,WR,active,green-bay-packers,7972500,2012
14734,2300000,5100000,Tramon Williams,CB,active,green-bay-packers,7400000,2012
14735,4400000,2150000,A.J. Hawk,OLB,active,green-bay-packers,6550000,2012
14736,4500000,1237500,Ryan Pickett,DT,active,green-bay-packers,5737500,2012
14737,3350000,3505000,B.J. Raji,DT,active,green-bay-packers,6855000,2012
14738,950000,3900000,Josh Sitton,G,active,green-bay-packers,4850000,2012
14739,1100000,0,Jeff Saturday,C,active,green-bay-packers,1100000,2012
14740,1000000,2825000,Jordy Nelson,WR,active,green-bay-packers,3825000,2012
14741,2300000,800000,James Jones,WR,active,green-bay-packers,3100000,2012
14742,1650000,750000,Mason Crosby,K,active,green-bay-packers,2400000,2012
14743,1600000,800000,John Kuhn,FB,active,green-bay-packers,2400000,2012
14744,1260000,1100000,T.J. Lang,G,active,green-bay-packers,2360000,2012
14745,1100000,0,Donald Driver,WR,active,green-bay-packers,1100000,2012
14746,950000,1300000,Jermichael Finley,TE,active,green-bay-packers,2250000,2012
14747,800000,2110000,Clay Matthews,OLB,active,green-bay-packers,2910000,2012
14748,583500,2251000,Bryan Bulaga,RT,active,green-bay-packers,2834500,2012
14749,1000000,433333,Jarrett Bush,CB,active,green-bay-packers,1433333,2012
14750,390000,973500,Nick Perry,OLB,active,green-bay-packers,1363500,2012
14751,1000000,75000,Charlie Peprah,S,active,green-bay-packers,1075000,2012
14752,700000,181250,Brett Goode,LS,active,green-bay-packers,881250,2012
14753,540000,290000,Michael Neal,OLB,active,green-bay-packers,830000,2012
14754,540000,240000,Tim Masthay,P,active,green-bay-packers,780000,2012
14755,540000,218775,Morgan Burnett,SS,active,green-bay-packers,758775,2012
14756,520883,208531,Randall Cobb,WR,active,green-bay-packers,729414,2012
14757,390000,327855,Jerel Worthy,DT,active,green-bay-packers,717855,2012
14758,615000,15063,Brad Jones,ILB,active,green-bay-packers,630063,2012
14759,615000,0,Evan Smith,C,active,green-bay-packers,615000,2012
14760,390000,211802,Casey Hayward,CB,active,green-bay-packers,601802,2012
14761,465000,136250,Alexander Green,RB,active,green-bay-packers,601250,2012
14762,540000,45606,Andrew Quarless,TE,active,green-bay-packers,585606,2012
14763,540000,37462,Marshall Newhouse,RT,active,green-bay-packers,577462,2012
14764,540000,2500,Sam Shields,CB,active,green-bay-packers,542500,2012
14765,465000,75145,Davon House,CB,active,green-bay-packers,540145,2012
14766,825000,0,Cedric Benson,RB,active,green-bay-packers,825000,2012
14767,700000,25000,Erik Walden,OLB,active,green-bay-packers,725000,2012
14768,540000,0,Tom Crabtree,TE,active,green-bay-packers,540000,2012
14769,540000,0,Rob Francois,ILB,active,green-bay-packers,540000,2012
14770,540000,0,Graham Harrell,QB,active,green-bay-packers,540000,2012
14771,490000,25075,James Starks,RB,active,green-bay-packers,515075,2012
14772,465000,49500,D.J. Williams,TE,active,green-bay-packers,514500,2012
14773,490000,12590,C.J. Wilson,DT,active,green-bay-packers,502590,2012
14774,490000,1166,Frank Zombo,OLB,active,green-bay-packers,491166,2012
14775,465000,14794,Ryan Taylor,TE,active,green-bay-packers,479794,2012
14776,465000,1667,Jamari Lattimore,ILB,active,green-bay-packers,466667,2012
14777,465000,833,M.D. Jennings,S,active,green-bay-packers,465833,2012
14778,390000,75146,Mike Daniels,DT,active,green-bay-packers,465146,2012
14779,390000,75146,Jerron McMillian,S,active,green-bay-packers,465146,2012
14780,465000,0,DuJuan Harris,RB,active,green-bay-packers,465000,2012
14781,456281,0,Johnny White,RB,active,green-bay-packers,456281,2012
14782,390000,42870,Terrell Manning,ILB,active,green-bay-packers,432870,2012
14783,390000,1166,Dezman Moses,OLB,active,green-bay-packers,391166,2012
14784,390000,833,Don Barclay,RT,active,green-bay-packers,390833,2012
14785,390000,0,Jarrett Boykin,WR,active,green-bay-packers,390000,2012
14786,390000,0,Jordan Miller,DT,active,green-bay-packers,390000,2012
14787,390000,0,Jeremy Ross,WR,active,green-bay-packers,390000,2012
14788,174375,25788,D.J. Smith,ILB,active,green-bay-packers,200163,2012
14789,700001,0,Ryan Grant,RB,active,green-bay-packers,700001,2012
14790,121875,0,Greg Van Roten,G,active,green-bay-packers,121875,2012
14791,390000,0,Johnny Jones,DT,active,green-bay-packers,390000,2012
14792,3001000,1000000,Desmond Bishop,OLB,injured_reserve,green-bay-packers,4001000,2012
14793,390000,1667,Sean Richardson,SS,injured_reserve,green-bay-packers,391667,2012
14794,465000,0,Brandon Saine,RB,injured_reserve,green-bay-packers,465000,2012
14795,96900,0,Lawrence Guy,DE,practice_squad,green-bay-packers,96900,2012
14796,2300000,0,Nick Collins,S,dead_cap,green-bay-packers,2300000,2012
14797,0,2120000,Justin Harrell,DT,dead_cap,green-bay-packers,2120000,2012
14798,800000,0,Brandon Chillar,LB,dead_cap,green-bay-packers,800000,2012
14799,175000,0,Phillip Merling,DE,dead_cap,green-bay-packers,175000,2012
14800,0,79350,Caleb Schlauderaff,C,dead_cap,green-bay-packers,79350,2012
14801,75000,0,Charlie Peprah,S,dead_cap,green-bay-packers,75000,2012
14802,0,66177,Ricky Elmore,OLB,dead_cap,green-bay-packers,66177,2012
14803,65000,0,Daniel Muir,DT,dead_cap,green-bay-packers,65000,2012
14804,25550,0,Brandon Underwood,CB,dead_cap,green-bay-packers,25550,2012
14805,0,11475,Lawrence Guy,DE,dead_cap,green-bay-packers,11475,2012
14806,0,11474,Andrew Datko,LT,dead_cap,green-bay-packers,11474,2012
14807,11474,0,B.J. Coleman,QB,dead_cap,green-bay-packers,11474,2012
14808,2833,0,Tommie Draheim,G,dead_cap,green-bay-packers,2833,2012
14809,2833,0,Vic So'oto,OLB,dead_cap,green-bay-packers,2833,2012
14810,2000,0,Marcus Rivers,WR,dead_cap,green-bay-packers,2000,2012
14811,2000,0,Brandian Ross,CB,dead_cap,green-bay-packers,2000,2012
14812,1666,0,Dale Moss,WR,dead_cap,green-bay-packers,1666,2012
14813,1666,0,Marc Tyler,RB,dead_cap,green-bay-packers,1666,2012
14814,1500,0,Jaymes Brooks,G,dead_cap,green-bay-packers,1500,2012
14815,1334,0,Nick McDonald,C,dead_cap,green-bay-packers,1334,2012
14816,1333,0,Duane Bennett,RB,dead_cap,green-bay-packers,1333,2012
14817,1000,0,Josh Gordy,CB,dead_cap,green-bay-packers,1000,2012
14818,833,0,Eric Lair,TE,dead_cap,green-bay-packers,833,2012
14819,833,0,Mike McCabe,T,dead_cap,green-bay-packers,833,2012
14820,500,0,Nic Cooper,RB,dead_cap,green-bay-packers,500,2012
14821,333,0,Shaky Smithson,WR,dead_cap,green-bay-packers,333,2012
14822,333,0,Dion Turner,CB,dead_cap,green-bay-packers,333,2012
14823,4500000,7150000,Aaron Rodgers,QB,active,green-bay-packers,11650000,2013
14824,5900000,2600000,Tramon Williams,CB,active,green-bay-packers,8500000,2013
14825,1020000,5690000,Clay Matthews,OLB,active,green-bay-packers,6710000,2013
14826,5400000,1300000,Ryan Pickett,DT,active,green-bay-packers,6700000,2013
14827,4490000,3505000,B.J. Raji,DT,active,green-bay-packers,7995000,2013
14828,3400000,2150000,Josh Sitton,G,active,green-bay-packers,5550000,2013
14829,840000,4360000,A.J. Hawk,OLB,active,green-bay-packers,5200000,2013
14830,2700000,1275000,Jordy Nelson,WR,active,green-bay-packers,3975000,2013
14831,2950000,800000,James Jones,WR,active,green-bay-packers,3750000,2013
14832,1323000,1868775,Morgan Burnett,SS,active,green-bay-packers,3191775,2013
14833,750000,2350000,T.J. Lang,G,active,green-bay-packers,3100000,2013
14834,1800000,800000,John Kuhn,FB,active,green-bay-packers,2600000,2013
14835,1000000,1500000,Brad Jones,ILB,active,green-bay-packers,2500000,2013
14836,800000,1550000,Mason Crosby,K,active,green-bay-packers,2350000,2013
14837,862000,2251000,Bryan Bulaga,RT,active,green-bay-packers,3113000,2013
14838,2023000,0,Sam Shields,CB,active,green-bay-packers,2023000,2013
14839,975182,825364,Derek Sherrod,RT,active,green-bay-packers,1800546,2013
14840,1350000,433333,Jarrett Bush,CB,active,green-bay-packers,1783333,2013
14841,730875,973500,Nick Perry,OLB,active,green-bay-packers,1704375,2013
14842,405000,998016,Datone Jones,DE,active,green-bay-packers,1403016,2013
14843,1323000,45606,Andrew Quarless,TE,active,green-bay-packers,1368606,2013
14844,1323000,37462,Marshall Newhouse,RT,active,green-bay-packers,1360462,2013
14845,1323000,0,Evan Smith,C,active,green-bay-packers,1323000,2013
14846,765000,340000,Tim Masthay,P,active,green-bay-packers,1105000,2013
14847,630000,290000,Michael Neal,OLB,active,green-bay-packers,920000,2013
14848,569464,327855,Jerel Worthy,DT,active,green-bay-packers,897319,2013
14849,666766,208531,Randall Cobb,WR,active,green-bay-packers,875297,2013
14850,715000,106250,Brett Goode,LS,active,green-bay-packers,821250,2013
14851,540451,211802,Casey Hayward,CB,active,green-bay-packers,752253,2013
14852,630000,25075,James Starks,RB,active,green-bay-packers,655075,2013
14853,630000,12590,C.J. Wilson,DT,active,green-bay-packers,642590,2013
14854,555000,75145,Davon House,CB,active,green-bay-packers,630145,2013
14855,405000,211802,Eddie Lacy,RB,active,green-bay-packers,616802,2013
14856,555000,14794,Ryan Taylor,TE,active,green-bay-packers,569794,2013
14857,555000,1668,Jamari Lattimore,ILB,active,green-bay-packers,556668,2013
14858,555000,833,M.D. Jennings,S,active,green-bay-packers,555833,2013
14859,480000,75146,Mike Daniels,DT,active,green-bay-packers,555146,2013
14860,555000,0,DuJuan Harris,RB,active,green-bay-packers,555000,2013
14861,405000,113850,David Bakhtiari,LT,active,green-bay-packers,518850,2013
14862,405000,103977,J.C. Tretter,C,active,green-bay-packers,508977,2013
14863,480000,1667,Sean Richardson,SS,active,green-bay-packers,481667,2013
14864,480000,833,Don Barclay,RT,active,green-bay-packers,480833,2013
14865,480000,0,Jarrett Boykin,WR,active,green-bay-packers,480000,2013
14866,405000,44527,Micah Hyde,SS,active,green-bay-packers,449527,2013
14867,405000,36140,Josh Boyd,DT,active,green-bay-packers,441140,2013
14868,405000,24724,Nate Palmer,ILB,active,green-bay-packers,429724,2013
14869,405000,12250,Sam Barrington,ILB,active,green-bay-packers,417250,2013
14870,405000,2333,Lane Taylor,G,active,green-bay-packers,407333,2013
14871,405000,1666,Andy Mulumba,OLB,active,green-bay-packers,406666,2013
14872,405000,0,Chris Banjo,SS,active,green-bay-packers,405000,2013
14873,405000,0,Jake Stoneburner,TE,active,green-bay-packers,405000,2013
14874,405000,0,Brandon Bostick,TE,active,green-bay-packers,405000,2013
14875,480000,0,Greg Van Roten,G,active,green-bay-packers,480000,2013
14876,715000,0,Matt Flynn,QB,active,green-bay-packers,715000,2013
14877,555000,0,Scott Tolzien,QB,active,green-bay-packers,555000,2013
14878,405000,0,Myles White,WR,active,green-bay-packers,405000,2013
14879,715000,0,Kahlil Bell,RB,active,green-bay-packers,715000,2013
14880,405000,0,Victor Aiyewa,OLB,active,green-bay-packers,405000,2013
14881,405000,0,Jumal Rolle,CB,active,green-bay-packers,405000,2013
14882,4450000,4300000,Jermichael Finley,TE,injured_reserve,green-bay-packers,8750000,2013
14883,630000,50000,Rob Francois,ILB,injured_reserve,green-bay-packers,680000,2013
14884,715000,0,Johnny Jolly,DE,injured_reserve,green-bay-packers,715000,2013
14885,405000,101367,Johnathan Franklin,RB,injured_reserve,green-bay-packers,506367,2013
14886,840000,0,Seneca Wallace,QB,injured_reserve,green-bay-packers,840000,2013
14887,288000,14212,Kevin Dorsey,WR,injured_reserve,green-bay-packers,302212,2013
14888,288000,0,Sederrick Cunningham,WR,injured_reserve,green-bay-packers,288000,2013
14889,405000,0,James Nixon,CB,injured_reserve,green-bay-packers,405000,2013
14890,18000,0,Reggie Dunn,WR,practice_squad,green-bay-packers,18000,2013
14891,825000,0,Jeff Saturday,C,dead_cap,green-bay-packers,825000,2013
14892,800000,0,Desmond Bishop,OLB,dead_cap,green-bay-packers,800000,2013
14893,442205,0,Jerron McMillian,S,dead_cap,green-bay-packers,442205,2013
14894,137471,0,Michael Hill,RB,dead_cap,green-bay-packers,137471,2013
14895,128750,0,Alexander Green,RB,dead_cap,green-bay-packers,128750,2013
14896,107294,0,Scott Tolzien,QB,dead_cap,green-bay-packers,107294,2013
14897,84706,0,Jeremy Ross,WR,dead_cap,green-bay-packers,84706,2013
14898,66000,0,Bryan Collins,G,dead_cap,green-bay-packers,66000,2013
14899,66000,0,Jumal Rolle,CB,dead_cap,green-bay-packers,66000,2013
14900,51576,0,D.J. Smith,ILB,dead_cap,green-bay-packers,51576,2013
14901,49500,0,D.J. Williams,TE,dead_cap,green-bay-packers,49500,2013
14902,45455,0,Charles Johnson,WR,dead_cap,green-bay-packers,45455,2013
14903,42870,0,Terrell Manning,ILB,dead_cap,green-bay-packers,42870,2013
14904,37666,0,Jake Stoneburner,TE,dead_cap,green-bay-packers,37666,2013
14905,37500,0,Myles White,WR,dead_cap,green-bay-packers,37500,2013
14906,36000,0,Victor Aiyewa,OLB,dead_cap,green-bay-packers,36000,2013
14907,0,34422,Andrew Datko,LT,dead_cap,green-bay-packers,34422,2013
14908,34422,0,B.J. Coleman,QB,dead_cap,green-bay-packers,34422,2013
14909,30000,0,James Nixon,CB,dead_cap,green-bay-packers,30000,2013
14910,0,22950,Lawrence Guy,DE,dead_cap,green-bay-packers,22950,2013
14911,5667,0,Tommie Draheim,G,dead_cap,green-bay-packers,5667,2013
14912,3334,0,Dale Moss,WR,dead_cap,green-bay-packers,3334,2013
14913,3334,0,Marc Tyler,RB,dead_cap,green-bay-packers,3334,2013
14914,3000,0,Jaymes Brooks,G,dead_cap,green-bay-packers,3000,2013
14915,2833,0,Vic So'oto,OLB,dead_cap,green-bay-packers,2833,2013
14916,2667,0,Duane Bennett,RB,dead_cap,green-bay-packers,2667,2013
14917,1667,0,Matt Brown,QB,dead_cap,green-bay-packers,1667,2013
14918,1667,0,Eric Lair,TE,dead_cap,green-bay-packers,1667,2013
14919,1667,0,Mike McCabe,T,dead_cap,green-bay-packers,1667,2013
14920,1666,0,Gilbert Pena,DT,dead_cap,green-bay-packers,1666,2013
14921,1333,0,Patrick Lewis,C,dead_cap,green-bay-packers,1333,2013
14922,1166,0,Dezman Moses,OLB,dead_cap,green-bay-packers,1166,2013
14923,1000,0,Nic Cooper,RB,dead_cap,green-bay-packers,1000,2013
14924,667,0,Dion Turner,CB,dead_cap,green-bay-packers,667,2013
14925,333,0,Shaky Smithson,WR,dead_cap,green-bay-packers,333,2013
14926,900000,16650000,Aaron Rodgers,QB,active,green-bay-packers,17550000,2014
14927,1000000,10006250,Clay Matthews,OLB,active,green-bay-packers,11006250,2014
14928,6900000,2600000,Tramon Williams,CB,active,green-bay-packers,9500000,2014
14929,4500000,1900000,Josh Sitton,G,active,green-bay-packers,6400000,2014
14930,2000000,3925000,Jordy Nelson,WR,active,green-bay-packers,5925000,2014
14931,1500000,4062500,Sam Shields,CB,active,green-bay-packers,5562500,2014
14932,3500000,1600000,T.J. Lang,G,active,green-bay-packers,5100000,2014
14933,2450000,2650000,A.J. Hawk,OLB,active,green-bay-packers,5100000,2014
14934,1150000,3693750,Morgan Burnett,SS,active,green-bay-packers,4843750,2014
14935,3100000,900000,B.J. Raji,DT,active,green-bay-packers,4000000,2014
14936,2500000,1425000,Brad Jones,ILB,active,green-bay-packers,3925000,2014
14937,2565500,2251000,Bryan Bulaga,RT,active,green-bay-packers,4816500,2014
14938,2000000,1750000,Michael Neal,OLB,active,green-bay-packers,3750000,2014
14939,1000000,2500000,Julius Peppers,DE,active,green-bay-packers,3500000,2014
14940,2650000,750000,Mason Crosby,K,active,green-bay-packers,3400000,2014
14941,1071750,973500,Nick Perry,OLB,active,green-bay-packers,2045250,2014
14942,1600000,433333,Jarrett Bush,CB,active,green-bay-packers,2033333,2014
14943,755754,998016,Datone Jones,DE,active,green-bay-packers,1753770,2014
14944,420000,1096091,HaHa Clinton-Dix,FS,active,green-bay-packers,1516091,2014
14945,1431000,0,Jamari Lattimore,ILB,active,green-bay-packers,1431000,2014
14946,750000,634375,James Starks,RB,active,green-bay-packers,1384375,2014
14947,800000,450000,Andrew Quarless,TE,active,green-bay-packers,1250000,2014
14948,900000,340000,Tim Masthay,P,active,green-bay-packers,1240000,2014
14949,730000,348750,Matt Flynn,QB,active,green-bay-packers,1078750,2014
14950,855000,196875,John Kuhn,FB,active,green-bay-packers,1051875,2014
14951,812648,208531,Randall Cobb,WR,active,green-bay-packers,1021179,2014
14952,730000,255000,Letroy Guion,DE,active,green-bay-packers,985000,2014
14953,690901,211802,Casey Hayward,CB,active,green-bay-packers,902703,2014
14954,730000,106250,Brett Goode,LS,active,green-bay-packers,836250,2014
14955,559201,211802,Eddie Lacy,RB,active,green-bay-packers,771003,2014
14956,645000,75145,Davon House,CB,active,green-bay-packers,720145,2014
14957,420000,295164,Davante Adams,WR,active,green-bay-packers,715164,2014
14958,570000,75146,Mike Daniels,DT,active,green-bay-packers,645146,2014
14959,645000,0,DuJuan Harris,RB,active,green-bay-packers,645000,2014
14960,645000,0,Scott Tolzien,QB,active,green-bay-packers,645000,2014
14961,495000,113850,David Bakhtiari,LT,active,green-bay-packers,608850,2014
14962,495000,103977,J.C. Tretter,C,active,green-bay-packers,598977,2014
14963,570000,1667,Sean Richardson,SS,active,green-bay-packers,571667,2014
14964,570000,833,Don Barclay,RT,active,green-bay-packers,570833,2014
14965,570000,0,Jarrett Boykin,WR,active,green-bay-packers,570000,2014
14966,420000,126504,Richard Rodgers,TE,active,green-bay-packers,546504,2014
14967,495000,44527,Micah Hyde,SS,active,green-bay-packers,539527,2014
14968,495000,36140,Josh Boyd,DT,active,green-bay-packers,531140,2014
14969,420000,107325,Carl Bradford,OLB,active,green-bay-packers,527325,2014
14970,495000,12250,Sam Barrington,ILB,active,green-bay-packers,507250,2014
14971,495000,2333,Lane Taylor,G,active,green-bay-packers,497333,2014
14972,495000,0,Brandon Bostick,TE,active,green-bay-packers,495000,2014
14973,420000,46250,Corey Linsley,C,active,green-bay-packers,466250,2014
14974,420000,25788,Demetri Goodson,CB,active,green-bay-packers,445788,2014
14975,303000,140813,Khyri Thornton,DT,active,green-bay-packers,443813,2014
14976,420000,12848,Jeff Janis,WR,active,green-bay-packers,432848,2014
14977,420000,1666,Jayrone Elliott,OLB,active,green-bay-packers,421666,2014
14978,420000,1166,Mike Pennel,DE,active,green-bay-packers,421166,2014
14979,420000,0,Garth Gerhart,C,active,green-bay-packers,420000,2014
14980,318000,24724,Nate Palmer,ILB,active,green-bay-packers,342724,2014
14981,338824,1666,Andy Mulumba,OLB,active,green-bay-packers,340490,2014
14982,303000,36140,Jared Abbrederis,WR,active,green-bay-packers,339140,2014
14983,420000,0,Justin Perillo,TE,active,green-bay-packers,420000,2014
14984,420000,0,Bruce Gaston,DT,active,green-bay-packers,420000,2014
14985,495000,0,Chris Banjo,SS,active,green-bay-packers,495000,2014
14986,303000,0,Aaron Adams,G,injured_reserve,green-bay-packers,303000,2014
14987,420000,0,Luther Robinson,DT,injured_reserve,green-bay-packers,420000,2014
14988,420000,0,Kevin Dorsey,WR,injured_reserve,green-bay-packers,420000,2014
14989,107100,0,Adrian Hubbard,OLB,practice_squad,green-bay-packers,107100,2014
14990,107100,0,Jeremy Vujnovich,LT,practice_squad,green-bay-packers,107100,2014
14991,107100,0,Myles White,WR,practice_squad,green-bay-packers,107100,2014
14992,88200,0,Josh Walker,G,practice_squad,green-bay-packers,88200,2014
14993,75600,0,Devonta Glover-Wright,CB,practice_squad,green-bay-packers,75600,2014
14994,50400,0,Rajion Neal,RB,practice_squad,green-bay-packers,50400,2014
14995,50400,0,Joe Thomas,ILB,practice_squad,green-bay-packers,50400,2014
14996,44100,0,Alex Gillett,WR,practice_squad,green-bay-packers,44100,2014
14997,12600,0,Jean Fanor,FS,practice_squad,green-bay-packers,12600,2014
14998,675145,825364,Derek Sherrod,RT,dead_cap,green-bay-packers,1500509,2014
14999,1400000,0,B.J. Raji,DT,dead_cap,green-bay-packers,1400000,2014
15000,800000,0,Desmond Bishop,OLB,dead_cap,green-bay-packers,800000,2014
15001,0,327855,Jerel Worthy,DT,dead_cap,green-bay-packers,327855,2014
15002,189706,14794,Ryan Taylor,TE,dead_cap,green-bay-packers,204500,2014
15003,150292,0,Jerron McMillian,S,dead_cap,green-bay-packers,150292,2014
15004,142588,0,Colt Lyerla,TE,dead_cap,green-bay-packers,142588,2014
15005,128750,0,Alexander Green,RB,dead_cap,green-bay-packers,128750,2014
15006,0,101367,Johnathan Franklin,RB,dead_cap,green-bay-packers,101367,2014
15007,88200,0,Chris Banjo,SS,dead_cap,green-bay-packers,88200,2014
15008,85882,0,Jamon Meredith,RT,dead_cap,green-bay-packers,85882,2014
15009,85740,0,Terrell Manning,ILB,dead_cap,green-bay-packers,85740,2014
15010,63000,666,Justin Perillo,TE,dead_cap,green-bay-packers,63666,2014
15011,63000,0,Michael Hill,RB,dead_cap,green-bay-packers,63000,2014
15012,49500,0,D.J. Williams,TE,dead_cap,green-bay-packers,49500,2014
15013,46365,0,Charles Johnson,WR,dead_cap,green-bay-packers,46365,2014
15014,31500,14212,Kevin Dorsey,WR,dead_cap,green-bay-packers,45712,2014
15015,31500,0,Justin Renfrow,DT,dead_cap,green-bay-packers,31500,2014
15016,25200,0,Joe Kruger,DE,dead_cap,green-bay-packers,25200,2014
15017,25200,0,Luther Robinson,DT,dead_cap,green-bay-packers,25200,2014
15018,25200,0,Jumal Rolle,CB,dead_cap,green-bay-packers,25200,2014
15019,18900,0,Josh Allen,C,dead_cap,green-bay-packers,18900,2014
15020,18900,0,Ike Ariguzo,TE,dead_cap,green-bay-packers,18900,2014
15021,12600,1166,Jordan McCray,G,dead_cap,green-bay-packers,13766,2014
15022,6300,0,Rishaw  Johnson,G,dead_cap,green-bay-packers,6300,2014
15023,3334,0,Matt Brown,QB,dead_cap,green-bay-packers,3334,2014
15024,3334,0,Gilbert Pena,DT,dead_cap,green-bay-packers,3334,2014
15025,3334,0,Jake Stoneburner,TE,dead_cap,green-bay-packers,3334,2014
15026,3000,0,Myles White,WR,dead_cap,green-bay-packers,3000,2014
15027,2667,0,Patrick Lewis,C,dead_cap,green-bay-packers,2667,2014
15028,0,1666,Jake Doughty,ILB,dead_cap,green-bay-packers,1666,2014
15029,0,1666,John Fullington,G,dead_cap,green-bay-packers,1666,2014
15030,0,1666,Adrian Hubbard,OLB,dead_cap,green-bay-packers,1666,2014
15031,0,1666,Joe Thomas,ILB,dead_cap,green-bay-packers,1666,2014
15032,0,1333,Carlos Gray,DE,dead_cap,green-bay-packers,1333,2014
15033,1168,0,Dezman Moses,OLB,dead_cap,green-bay-packers,1168,2014
15034,0,1166,Chase Rettig,QB,dead_cap,green-bay-packers,1166,2014
15035,0,1000,LaDarius Perkins,RB,dead_cap,green-bay-packers,1000,2014
15036,0,666,Tanner Miller,S,dead_cap,green-bay-packers,666,2014
15037,0,666,Rajion Neal,RB,dead_cap,green-bay-packers,666,2014
15038,0,666,Ryan White,CB,dead_cap,green-bay-packers,666,2014
15039,1000000,17250000,Aaron Rodgers,QB,active,green-bay-packers,18250000,2015
15040,7600000,5100000,Clay Matthews,OLB,active,green-bay-packers,12700000,2015
15041,8500000,3500000,Julius Peppers,DE,active,green-bay-packers,12000000,2015
15042,2500000,6562500,Sam Shields,CB,active,green-bay-packers,9062500,2015
15043,5100000,1900000,Josh Sitton,G,active,green-bay-packers,7000000,2015
15044,4200000,1600000,T.J. Lang,G,active,green-bay-packers,5800000,2015
15045,1200000,4150000,Randall Cobb,WR,active,green-bay-packers,5350000,2015
15046,2900000,2231250,Morgan Burnett,SS,active,green-bay-packers,5131250,2015
15047,1300000,3300000,Jordy Nelson,WR,active,green-bay-packers,4600000,2015
15048,1500000,2750000,Michael Neal,OLB,active,green-bay-packers,4250000,2015
15049,1542000,2480996,Mike Daniels,DT,active,green-bay-packers,4022996,2015
15050,1250000,2318750,Bryan Bulaga,RT,active,green-bay-packers,3568750,2015
15051,2800000,750000,Mason Crosby,K,active,green-bay-packers,3550000,2015
15052,1235294,1250000,Letroy Guion,DE,active,green-bay-packers,2485294,2015
15053,1412625,973500,Nick Perry,OLB,active,green-bay-packers,2386125,2015
15054,1041420,998016,Datone Jones,DE,active,green-bay-packers,2039436,2015
15055,799023,1096091,HaHa Clinton-Dix,FS,active,green-bay-packers,1895114,2015
15056,1175000,662500,James Starks,RB,active,green-bay-packers,1837500,2015
15057,1150000,600000,B.J. Raji,DT,active,green-bay-packers,1750000,2015
15058,1542000,0,Don Barclay,RT,active,green-bay-packers,1542000,2015
15059,435000,1004224,Damarious Randall,FS,active,green-bay-packers,1439224,2015
15060,1000000,340000,Tim Masthay,P,active,green-bay-packers,1340000,2015
15061,990000,210000,Scott Tolzien,QB,active,green-bay-packers,1200000,2015
15062,841352,211802,Casey Hayward,CB,active,green-bay-packers,1053154,2015
15063,713401,211802,Eddie Lacy,RB,active,green-bay-packers,925203,2015
15064,598791,295164,Davante Adams,WR,active,green-bay-packers,893955,2015
15065,585000,113850,David Bakhtiari,LT,active,green-bay-packers,698850,2015
15066,585000,103977,J.C. Tretter,C,active,green-bay-packers,688977,2015
15067,435000,245466,Quinten Rollins,CB,active,green-bay-packers,680466,2015
15068,512500,136504,Richard Rodgers,TE,active,green-bay-packers,649004,2015
15069,870000,50000,John Kuhn,FB,active,green-bay-packers,920000,2015
15070,585000,44527,Micah Hyde,SS,active,green-bay-packers,629527,2015
15071,585000,24724,Nate Palmer,ILB,active,green-bay-packers,609724,2015
15072,585000,2334,Lane Taylor,G,active,green-bay-packers,587334,2015
15073,585000,1667,Andy Mulumba,OLB,active,green-bay-packers,586667,2015
15074,870000,0,James Jones,WR,active,green-bay-packers,870000,2015
15075,585000,0,Chris Banjo,SS,active,green-bay-packers,585000,2015
15076,510000,46250,Corey Linsley,C,active,green-bay-packers,556250,2015
15077,435000,114169,Jake Ryan,ILB,active,green-bay-packers,549169,2015
15078,510000,25788,Demetri Goodson,CB,active,green-bay-packers,535788,2015
15079,510000,12848,Jeff Janis,WR,active,green-bay-packers,522848,2015
15080,510000,1666,Jayrone Elliott,OLB,active,green-bay-packers,511666,2015
15081,510000,1166,Mike Pennel,DE,active,green-bay-packers,511166,2015
15082,435000,55908,Brett Hundley,QB,active,green-bay-packers,490908,2015
15083,435000,26599,Aaron Ripkowski,FB,active,green-bay-packers,461599,2015
15084,435000,22621,Kennard Backman,TE,active,green-bay-packers,457621,2015
15085,435000,1666,LaDarius Gunter,CB,active,green-bay-packers,436666,2015
15086,435000,0,Josh Walker,G,active,green-bay-packers,435000,2015
15087,375882,36140,Josh Boyd,DT,active,green-bay-packers,412022,2015
15088,383823,0,Joe Thomas,ILB,active,green-bay-packers,383823,2015
15089,361941,12250,Sam Barrington,ILB,active,green-bay-packers,374191,2015
15090,360000,0,Justin Perillo,TE,active,green-bay-packers,360000,2015
15091,358235,0,Jared Abbrederis,WR,active,green-bay-packers,358235,2015
15092,127941,0,Josh Crockett,RB,active,green-bay-packers,127941,2015
15093,51176,0,Rick Lovato,LS,active,green-bay-packers,51176,2015
15094,1000000,1550000,Sean Richardson,SS,injured_reserve,green-bay-packers,2550000,2015
15095,1300000,450000,Andrew Quarless,TE,injured_reserve,green-bay-packers,1750000,2015
15096,870000,106250,Brett Goode,LS,injured_reserve,green-bay-packers,976250,2015
15097,421235,151636,Ty Montgomery,RB,injured_reserve,green-bay-packers,572871,2015
15098,26400,0,Ross Scheuerman,RB,practice_squad,green-bay-packers,26400,2015
15099,0,1600000,A.J. Hawk,OLB,dead_cap,green-bay-packers,1600000,2015
15100,0,1000000,Brad Jones,ILB,dead_cap,green-bay-packers,1000000,2015
15101,0,327855,Jerel Worthy,DT,dead_cap,green-bay-packers,327855,2015
15102,318000,1666,Jermauria Rasco,DT,dead_cap,green-bay-packers,319666,2015
15103,307058,1166,Alonzo Harris,RB,dead_cap,green-bay-packers,308224,2015
15104,112200,107325,Carl Bradford,OLB,dead_cap,green-bay-packers,219525,2015
15105,0,202734,Johnathan Franklin,RB,dead_cap,green-bay-packers,202734,2015
15106,188152,1666,Matt Rotheram,G,dead_cap,green-bay-packers,189818,2015
15107,0,150813,Khyri Thornton,DT,dead_cap,green-bay-packers,150813,2015
15108,112200,22621,Christian Ringo,DT,dead_cap,green-bay-packers,134821,2015
15109,112200,0,Robertson Daniel,CB,dead_cap,green-bay-packers,112200,2015
15110,112200,0,Jeremy Vujnovich,LT,dead_cap,green-bay-packers,112200,2015
15111,112200,0,Ed Williams,WR,dead_cap,green-bay-packers,112200,2015
15112,103200,0,Bruce Gaston,DT,dead_cap,green-bay-packers,103200,2015
15113,79200,1666,Josh Crockett,RB,dead_cap,green-bay-packers,80866,2015
15114,79200,1666,Mitchell Henry,TE,dead_cap,green-bay-packers,80866,2015
15115,19800,36140,Jared Abbrederis,WR,dead_cap,green-bay-packers,55940,2015
15116,52800,0,Kyle Sebetic,CB,dead_cap,green-bay-packers,52800,2015
15117,46200,0,B.J. McBryde,DE,dead_cap,green-bay-packers,46200,2015
15118,33000,1334,Justin Perillo,TE,dead_cap,green-bay-packers,34334,2015
15119,0,28424,Kevin Dorsey,WR,dead_cap,green-bay-packers,28424,2015
15120,26400,0,Jamel Johnson,WR,dead_cap,green-bay-packers,26400,2015
15121,19800,1666,James Vaughters,DE,dead_cap,green-bay-packers,21466,2015
15122,18705,1333,Javess Blue,WR,dead_cap,green-bay-packers,20038,2015
15123,19800,0,Blake Annen,TE,dead_cap,green-bay-packers,19800,2015
15124,18705,1000,Larry Pinkard,WR,dead_cap,green-bay-packers,19705,2015
15125,13200,0,Justin Hamilton,DT,dead_cap,green-bay-packers,13200,2015
15126,6600,0,Eric Crume,DT,dead_cap,green-bay-packers,6600,2015
15127,0,3334,Jake Doughty,ILB,dead_cap,green-bay-packers,3334,2015
15128,0,3334,John Fullington,G,dead_cap,green-bay-packers,3334,2015
15129,0,3334,Adrian Hubbard,OLB,dead_cap,green-bay-packers,3334,2015
15130,0,3334,Joe Thomas,ILB,dead_cap,green-bay-packers,3334,2015
15131,0,2667,Carlos Gray,DE,dead_cap,green-bay-packers,2667,2015
15132,0,2334,Jordan McCray,G,dead_cap,green-bay-packers,2334,2015
15133,0,2334,Chase Rettig,QB,dead_cap,green-bay-packers,2334,2015
15134,0,2000,LaDarius Perkins,RB,dead_cap,green-bay-packers,2000,2015
15135,0,1666,Ricky Collins,WR,dead_cap,green-bay-packers,1666,2015
15136,0,1666,Adrian Coxson,WR,dead_cap,green-bay-packers,1666,2015
15137,0,1666,Tavarus Dantzler,OLB,dead_cap,green-bay-packers,1666,2015
15138,0,1666,Jimmie Hunt,WR,dead_cap,green-bay-packers,1666,2015
15139,0,1334,Tanner Miller,S,dead_cap,green-bay-packers,1334,2015
15140,0,1334,Rajion Neal,RB,dead_cap,green-bay-packers,1334,2015
15141,0,1334,Ryan White,CB,dead_cap,green-bay-packers,1334,2015
15142,0,1333,Marcus Reed,G,dead_cap,green-bay-packers,1333,2015
15143,0,1166,Bernard Blake,CB,dead_cap,green-bay-packers,1166,2015
15144,0,666,Fabbians Ebbele,T,dead_cap,green-bay-packers,666,2015
15145,11500000,7750000,Aaron Rodgers,QB,active,green-bay-packers,19250000,2016
15146,8650000,5100000,Clay Matthews,OLB,active,green-bay-packers,13750000,2016
15147,7000000,3500000,Julius Peppers,DE,active,green-bay-packers,10500000,2016
15148,1500000,7650000,Randall Cobb,WR,active,green-bay-packers,9150000,2016
15149,5500000,2800000,Jordy Nelson,WR,active,green-bay-packers,8300000,2016
15150,800000,6600000,Mike Daniels,DT,active,green-bay-packers,7400000,2016
15151,4600000,1581250,T.J. Lang,G,active,green-bay-packers,6181250,2016
15152,3800000,2156250,Morgan Burnett,SS,active,green-bay-packers,5956250,2016
15153,950000,4512500,Bryan Bulaga,RT,active,green-bay-packers,5462500,2016
15154,757117,4313850,David Bakhtiari,LT,active,green-bay-packers,5070967,2016
15155,2300000,2575000,Nick Perry,OLB,active,green-bay-packers,4875000,2016
15156,2000000,1516666,Letroy Guion,DE,active,green-bay-packers,3516666,2016
15157,1425000,1325000,Jared Cook,TE,active,green-bay-packers,2750000,2016
15158,1000000,1455280,Datone Jones,DE,active,green-bay-packers,2455280,2016
15159,900000,1500000,Mason Crosby,K,active,green-bay-packers,2400000,2016
15160,1178046,1096091,HaHa Clinton-Dix,FS,active,green-bay-packers,2274137,2016
15161,1100000,1150000,James Starks,RB,active,green-bay-packers,2250000,2016
15162,794806,1004224,Damarious Randall,FS,active,green-bay-packers,1799030,2016
15163,1671000,44527,Micah Hyde,SS,active,green-bay-packers,1715527,2016
15164,450000,1252117,Kenny Clark,DE,active,green-bay-packers,1702117,2016
15165,1100000,350000,Lane Taylor,G,active,green-bay-packers,1450000,2016
15166,777582,295164,Davante Adams,WR,active,green-bay-packers,1072746,2016
15167,450000,459871,Jason Spriggs,T,active,green-bay-packers,909871,2016
15168,605117,245466,Quinten Rollins,CB,active,green-bay-packers,850583,2016
15169,602500,136504,Richard Rodgers,TE,active,green-bay-packers,739004,2016
15170,675000,25000,Don Barclay,RT,active,green-bay-packers,700000,2016
15171,529750,163636,Ty Montgomery,RB,active,green-bay-packers,693386,2016
15172,600000,46250,Corey Linsley,C,active,green-bay-packers,646250,2016
15173,525000,114169,Jake Ryan,ILB,active,green-bay-packers,639169,2016
15174,450000,173512,Kyler Fackrell,OLB,active,green-bay-packers,623512,2016
15175,600000,12848,Jeff Janis,WR,active,green-bay-packers,612848,2016
15176,600000,1668,Jayrone Elliott,OLB,active,green-bay-packers,601668,2016
15177,885000,0,Brett Goode,LS,active,green-bay-packers,885000,2016
15178,525000,55908,Brett Hundley,QB,active,green-bay-packers,580908,2016
15179,525000,26599,Aaron Ripkowski,FB,active,green-bay-packers,551599,2016
15180,450000,95848,Dean Lowry,DE,active,green-bay-packers,545848,2016
15181,450000,95848,Blake Martinez,ILB,active,green-bay-packers,545848,2016
15182,525000,1666,LaDarius Gunter,CB,active,green-bay-packers,526666,2016
15183,525000,0,Jake Schum,P,active,green-bay-packers,525000,2016
15184,525000,0,Joe Thomas,ILB,active,green-bay-packers,525000,2016
15185,450000,56794,Trevor Davis,WR,active,green-bay-packers,506794,2016
15186,450000,31535,Kyle Murphy,T,active,green-bay-packers,481535,2016
15187,450000,1666,Josh Hawkins,CB,active,green-bay-packers,451666,2016
15188,450000,666,Kentrell Brice,S,active,green-bay-packers,450666,2016
15189,450000,0,Marwin Evans,S,active,green-bay-packers,450000,2016
15190,450000,0,Christian Ringo,DT,active,green-bay-packers,450000,2016
15191,277941,0,Christine Michael,RB,active,green-bay-packers,277941,2016
15192,264700,0,Geronimo Allison,WR,active,green-bay-packers,264700,2016
15193,211760,0,Joe Kerridge,FB,active,green-bay-packers,211760,2016
15194,105882,0,Jordan Tripp,ILB,active,green-bay-packers,105882,2016
15195,79410,0,Joe Callahan,QB,active,green-bay-packers,79410,2016
15196,8000000,4000000,Sam Shields,CB,injured_reserve,green-bay-packers,12000000,2016
15197,867602,211802,Eddie Lacy,RB,injured_reserve,green-bay-packers,1079404,2016
15198,675000,103977,J.C. Tretter,C,injured_reserve,green-bay-packers,778977,2016
15199,458823,25788,Demetri Goodson,CB,injured_reserve,green-bay-packers,484611,2016
15200,348000,0,Josh Crockett,RB,injured_reserve,green-bay-packers,348000,2016
15201,291170,0,Don Jackson,RB,injured_reserve,green-bay-packers,291170,2016
15202,132350,0,Makinton Dorleant,CB,injured_reserve,green-bay-packers,132350,2016
15203,210176,214650,Carl Bradford,OLB,dead_cap,green-bay-packers,424826,2016
15204,384380,0,Brian Price,DT,dead_cap,green-bay-packers,384380,2016
15205,352940,0,Justin Perillo,TE,dead_cap,green-bay-packers,352940,2016
15206,0,340000,Tim Masthay,P,dead_cap,green-bay-packers,340000,2016
15207,317647,0,Chris Banjo,SS,dead_cap,green-bay-packers,317647,2016
15208,0,300000,Josh Sitton,G,dead_cap,green-bay-packers,300000,2016
15209,216176,72280,Jared Abbrederis,WR,dead_cap,green-bay-packers,288456,2016
15210,0,281626,Khyri Thornton,DT,dead_cap,green-bay-packers,281626,2016
15211,176292,2000,Tyler Kuder,DT,dead_cap,green-bay-packers,178292,2016
15212,156440,0,Jermaine Whitehead,FS,dead_cap,green-bay-packers,156440,2016
15213,146150,0,Joe Callahan,QB,dead_cap,green-bay-packers,146150,2016
15214,0,125000,Lerentee McCray,OLB,dead_cap,green-bay-packers,125000,2016
15215,117300,0,Reggie Gilbert,DE,dead_cap,green-bay-packers,117300,2016
15216,117300,0,Lucas Patrick,G,dead_cap,green-bay-packers,117300,2016
15217,117300,0,Herb Waters,WR,dead_cap,green-bay-packers,117300,2016
15218,110400,0,Devon Cajuste,WR,dead_cap,green-bay-packers,110400,2016
15219,81882,0,Josh Walker,G,dead_cap,green-bay-packers,81882,2016
15220,79411,0,Knile Davis,RB,dead_cap,green-bay-packers,79411,2016
15221,75900,1666,Don Jackson,RB,dead_cap,green-bay-packers,77566,2016
15222,69000,0,Jacob Flores,C,dead_cap,green-bay-packers,69000,2016
15223,0,67863,Christian Ringo,DT,dead_cap,green-bay-packers,67863,2016
15224,62100,0,Blake Muir,T,dead_cap,green-bay-packers,62100,2016
15225,55200,0,Beau Sandland,TE,dead_cap,green-bay-packers,55200,2016
15226,48300,0,Geronimo Allison,WR,dead_cap,green-bay-packers,48300,2016
15227,41400,0,Derrick Mathews,ILB,dead_cap,green-bay-packers,41400,2016
15228,0,36140,Josh Boyd,DT,dead_cap,green-bay-packers,36140,2016
15229,34500,0,Joe Kerridge,FB,dead_cap,green-bay-packers,34500,2016
15230,34500,0,Dez Stewart,WR,dead_cap,green-bay-packers,34500,2016
15231,26470,0,Jhurrell Pressley,RB,dead_cap,green-bay-packers,26470,2016
15232,26470,0,Kyle Steuck,T,dead_cap,green-bay-packers,26470,2016
15233,0,24724,Nate Palmer,ILB,dead_cap,green-bay-packers,24724,2016
15234,0,22622,Kennard Backman,TE,dead_cap,green-bay-packers,22622,2016
15235,18000,666,Devonte Robinson,WR,dead_cap,green-bay-packers,18666,2016
15236,13800,0,Max McCaffrey,WR,dead_cap,green-bay-packers,13800,2016
15237,0,12250,Sam Barrington,ILB,dead_cap,green-bay-packers,12250,2016
15238,6900,0,Beniquez Brown,OLB,dead_cap,green-bay-packers,6900,2016
15239,6900,0,Brandon Burks,RB,dead_cap,green-bay-packers,6900,2016
15240,6900,0,Robertson Daniel,CB,dead_cap,green-bay-packers,6900,2016
15241,6900,0,Antwan Goodley,WR,dead_cap,green-bay-packers,6900,2016
15242,0,3334,Ricky Collins,WR,dead_cap,green-bay-packers,3334,2016
15243,0,3334,Adrian Coxson,WR,dead_cap,green-bay-packers,3334,2016
15244,0,3334,Josh Crockett,RB,dead_cap,green-bay-packers,3334,2016
15245,0,3334,Tavarus Dantzler,OLB,dead_cap,green-bay-packers,3334,2016
15246,0,3334,Mitchell Henry,TE,dead_cap,green-bay-packers,3334,2016
15247,0,3334,Jimmie Hunt,WR,dead_cap,green-bay-packers,3334,2016
15248,0,3334,Jermauria Rasco,DT,dead_cap,green-bay-packers,3334,2016
15249,0,3334,Matt Rotheram,G,dead_cap,green-bay-packers,3334,2016
15250,0,3334,James Vaughters,DE,dead_cap,green-bay-packers,3334,2016
15251,0,2667,Javess Blue,WR,dead_cap,green-bay-packers,2667,2016
15252,0,2667,Marcus Reed,G,dead_cap,green-bay-packers,2667,2016
15253,0,2334,Bernard Blake,CB,dead_cap,green-bay-packers,2334,2016
15254,0,2334,Alonzo Harris,RB,dead_cap,green-bay-packers,2334,2016
15255,0,2000,Larry Pinkard,WR,dead_cap,green-bay-packers,2000,2016
15256,0,1334,Fabbians Ebbele,T,dead_cap,green-bay-packers,1334,2016
15257,0,833,Manoa Pikula,ILB,dead_cap,green-bay-packers,833,2016
15258,0,500,Dennis Parks,WR,dead_cap,green-bay-packers,500,2016
15259,0,333,Josh James,T,dead_cap,green-bay-packers,333,2016
15260,10100000,4975000,Clay Matthews,OLB,active,green-bay-packers,15075000,2017
15261,8600000,4056250,Randall Cobb,WR,active,green-bay-packers,12656250,2017
15262,8250000,3300000,Jordy Nelson,WR,active,green-bay-packers,11550000,2017
15263,2100000,8300000,Mike Daniels,DT,active,green-bay-packers,10400000,2017
15264,4750000,2231250,Morgan Burnett,SS,active,green-bay-packers,6981250,2017
15265,775000,5396000,David Bakhtiari,LT,active,green-bay-packers,6171000,2017
15266,956373,3900754,Davante Adams,WR,active,green-bay-packers,4857127,2017
15267,2250000,2450000,Lane Taylor,G,active,green-bay-packers,4700000,2017
15268,1797000,2052700,Corey Linsley,C,active,green-bay-packers,3849700,2017
15269,1000000,2600000,Mason Crosby,K,active,green-bay-packers,3600000,2017
15270,1000000,2500000,Ahmad Brooks,OLB,active,green-bay-packers,3500000,2017
15271,1500000,1300000,Davon House,CB,active,green-bay-packers,2800000,2017
15272,778534,1874625,HaHa Clinton-Dix,FS,active,green-bay-packers,2653159,2017
15273,1150000,1275000,Jahri Evans,G,active,green-bay-packers,2425000,2017
15274,1154612,1004224,Damarious Randall,FS,active,green-bay-packers,2158836,2017
15275,875529,1252117,Kenny Clark,DE,active,green-bay-packers,2127646,2017
15276,1787000,136504,Richard Rodgers,TE,active,green-bay-packers,1923504,2017
15277,800000,975000,Lance Kendricks,TE,active,green-bay-packers,1775000,2017
15278,775001,0,Quinton Dial,DT,active,green-bay-packers,775001,2017
15279,465000,304711,Josh Jones,S,active,green-bay-packers,769711,2017
15280,560000,188512,Kyler Fackrell,OLB,active,green-bay-packers,748512,2017
15281,615000,114169,Jake Ryan,ILB,active,green-bay-packers,729169,2017
15282,690000,12848,Jeff Janis,WR,active,green-bay-packers,702848,2017
15283,615000,55908,Brett Hundley,QB,active,green-bay-packers,670908,2017
15284,465000,201194,Montravius Adams,DT,active,green-bay-packers,666194,2017
15285,615000,26599,Aaron Ripkowski,FB,active,green-bay-packers,641599,2017
15286,540000,95848,Dean Lowry,DE,active,green-bay-packers,635848,2017
15287,540000,95848,Blake Martinez,ILB,active,green-bay-packers,635848,2017
15288,615000,0,Joe Thomas,ILB,active,green-bay-packers,615000,2017
15289,465000,141498,Jamaal Williams,RB,active,green-bay-packers,606498,2017
15290,540000,56794,Trevor Davis,WR,active,green-bay-packers,596794,2017
15291,409937,173435,Vince Biegel,OLB,active,green-bay-packers,583372,2017
15292,540000,1666,Josh Hawkins,CB,active,green-bay-packers,541666,2017
15293,540000,0,Marwin Evans,S,active,green-bay-packers,540000,2017
15294,465000,50484,Aaron Jones,RB,active,green-bay-packers,515484,2017
15295,508235,0,Geronimo Allison,WR,active,green-bay-packers,508235,2017
15296,506471,0,Ulrick John,LT,active,green-bay-packers,506471,2017
15297,465000,18759,Devante Mays,RB,active,green-bay-packers,483759,2017
15298,465000,1666,Lenzy Pipkins,CB,active,green-bay-packers,466666,2017
15299,465000,1666,Justin Vogel,P,active,green-bay-packers,466666,2017
15300,465000,0,Justin McCray,G,active,green-bay-packers,465000,2017
15301,465000,0,Chris Odom,DE,active,green-bay-packers,465000,2017
15302,465000,0,Lucas Patrick,G,active,green-bay-packers,465000,2017
15303,437647,0,Adam Pankey,T,active,green-bay-packers,437647,2017
15304,370588,0,Brett Goode,LS,active,green-bay-packers,370588,2017
15305,300883,0,Jermaine Whitehead,FS,active,green-bay-packers,300883,2017
15306,246177,0,Donatello Brown,CB,active,green-bay-packers,246177,2017
15307,136765,0,Michael Clark,WR,active,green-bay-packers,136765,2017
15308,63530,0,Joe Callahan,QB,active,green-bay-packers,63530,2017
15309,54706,0,Jerod Evans,QB,active,green-bay-packers,54706,2017
15310,54706,0,Reggie Gilbert,DE,active,green-bay-packers,54706,2017
15311,31765,0,Joe Kerridge,FB,active,green-bay-packers,31765,2017
15312,27353,0,Emanuel Byrd,TE,active,green-bay-packers,27353,2017
15313,12550000,7750000,Aaron Rodgers,QB,injured_reserve,green-bay-packers,20300000,2017
15314,5400000,2450000,Bryan Bulaga,RT,injured_reserve,green-bay-packers,7850000,2017
15315,1300000,4625000,Nick Perry,OLB,injured_reserve,green-bay-packers,5925000,2017
15316,437469,822433,Kevin King,CB,injured_reserve,green-bay-packers,1259902,2017
15317,677468,459871,Jason Spriggs,T,injured_reserve,green-bay-packers,1137339,2017
15318,775233,245466,Quinten Rollins,CB,injured_reserve,green-bay-packers,1020699,2017
15319,625000,163636,Ty Montgomery,RB,injured_reserve,green-bay-packers,788636,2017
15320,615000,6450,Jake Schum,P,injured_reserve,green-bay-packers,621450,2017
15321,446296,666,Kentrell Brice,S,injured_reserve,green-bay-packers,446962,2017
15322,394235,31535,Kyle Murphy,T,injured_reserve,green-bay-packers,425770,2017
15323,348000,0,David Talley,OLB,injured_reserve,green-bay-packers,348000,2017
15324,348000,0,Herb Waters,WR,injured_reserve,green-bay-packers,348000,2017
15325,320995,0,Taybor Pepper,LS,injured_reserve,green-bay-packers,320995,2017
15326,0,25788,Demetri Goodson,CB,injured_reserve,green-bay-packers,25788,2017
15327,0,3125000,Sam Shields,CB,dead_cap,green-bay-packers,3125000,2017
15328,423529,2687500,Martellus Bennett,TE,dead_cap,green-bay-packers,3111029,2017
15329,441176,525000,Ricky Jean Francois,DT,dead_cap,green-bay-packers,966176,2017
15330,0,750000,James Starks,RB,dead_cap,green-bay-packers,750000,2017
15331,900000,0,Brett Goode,LS,dead_cap,green-bay-packers,900000,2017
15332,319118,250000,Don Barclay,RT,dead_cap,green-bay-packers,569118,2017
15333,0,400000,Jayrone Elliott,OLB,dead_cap,green-bay-packers,400000,2017
15334,0,366666,Letroy Guion,DE,dead_cap,green-bay-packers,366666,2017
15335,317372,1168,Mike Pennel,DE,dead_cap,green-bay-packers,318540,2017
15336,297318,0,Joe Callahan,QB,dead_cap,green-bay-packers,297318,2017
15337,180424,0,Joe Kerridge,FB,dead_cap,green-bay-packers,180424,2017
15338,122400,55975,DeAngelo Yancey,WR,dead_cap,green-bay-packers,178375,2017
15339,122400,32865,Kofi Amichia,C,dead_cap,green-bay-packers,155265,2017
15340,122400,1666,Izaah Lunsford,DT,dead_cap,green-bay-packers,124066,2017
15341,108000,0,Reggie Gilbert,DE,dead_cap,green-bay-packers,108000,2017
15342,86400,1666,Michael Clark,WR,dead_cap,green-bay-packers,88066,2017
15343,64800,0,Jerod Evans,QB,dead_cap,green-bay-packers,64800,2017
15344,64800,0,Derrick Mathews,ILB,dead_cap,green-bay-packers,64800,2017
15345,57600,666,Donatello Brown,CB,dead_cap,green-bay-packers,58266,2017
15346,57600,0,Emanuel Byrd,TE,dead_cap,green-bay-packers,57600,2017
15347,54706,0,Derek Hart,LS,dead_cap,green-bay-packers,54706,2017
15348,50400,0,Darrell Greene,G,dead_cap,green-bay-packers,50400,2017
15349,50400,0,Max McCaffrey,WR,dead_cap,green-bay-packers,50400,2017
15350,0,45244,Kennard Backman,TE,dead_cap,green-bay-packers,45244,2017
15351,43200,0,Jermaine Whitehead,FS,dead_cap,green-bay-packers,43200,2017
15352,36176,1668,LaDarius Gunter,CB,dead_cap,green-bay-packers,37844,2017
15353,36000,0,Raysean Pringle,CB,dead_cap,green-bay-packers,36000,2017
15354,36000,0,Ahmad Thomas,S,dead_cap,green-bay-packers,36000,2017
15355,0,25000,Christine Michael,RB,dead_cap,green-bay-packers,25000,2017
15356,21600,0,Colby Pearson,WR,dead_cap,green-bay-packers,21600,2017
15357,0,16659,Malachi Dupre,WR,dead_cap,green-bay-packers,16659,2017
15358,7200,1666,Adam Pankey,T,dead_cap,green-bay-packers,8866,2017
15359,7200,0,Francis Kallon,DE,dead_cap,green-bay-packers,7200,2017
15360,7200,0,Jake Kumerow,WR,dead_cap,green-bay-packers,7200,2017
15361,7200,0,Zach Triner,LS,dead_cap,green-bay-packers,7200,2017
15362,0,4000,Tyler Kuder,DT,dead_cap,green-bay-packers,4000,2017
15363,0,3334,Don Jackson,RB,dead_cap,green-bay-packers,3334,2017
15364,0,1667,Manoa Pikula,ILB,dead_cap,green-bay-packers,1667,2017
15365,0,1666,Johnathan Calvin,DE,dead_cap,green-bay-packers,1666,2017
15366,0,1666,Thomas Evans,T,dead_cap,green-bay-packers,1666,2017
15367,0,1666,Geoff Gray,T,dead_cap,green-bay-packers,1666,2017
15368,0,1666,Cody Heiman,ILB,dead_cap,green-bay-packers,1666,2017
15369,0,1666,Taysom Hill,QB,dead_cap,green-bay-packers,1666,2017
15370,0,1666,Aaron Peck,WR,dead_cap,green-bay-packers,1666,2017
15371,0,1334,Devonte Robinson,WR,dead_cap,green-bay-packers,1334,2017
15372,0,1166,David Rivers III,CB,dead_cap,green-bay-packers,1166,2017
15373,0,833,Montay Crockett,WR,dead_cap,green-bay-packers,833,2017
15374,0,667,Josh James,T,dead_cap,green-bay-packers,667,2017
15375,1100000,19800000,Aaron Rodgers,QB,active,green-bay-packers,20900000,2018
15376,8600000,3931250,Randall Cobb,WR,active,green-bay-packers,12531250,2018
15377,10400000,1000000,Clay Matthews,OLB,active,green-bay-packers,11400000,2018
15378,1000000,10075000,David Bakhtiari,LT,active,green-bay-packers,11075000,2018
15379,1000000,9568750,Davante Adams,WR,active,green-bay-packers,10568750,2018
15380,5850000,2418750,Bryan Bulaga,RT,active,green-bay-packers,8268750,2018
15381,1450000,4466666,Jimmy Graham,TE,active,green-bay-packers,5916666,2018
15382,3150000,2100000,Mason Crosby,K,active,green-bay-packers,5250000,2018
15383,1000000,3850000,Corey Linsley,C,active,green-bay-packers,4850000,2018
15384,1100000,3218750,Lane Taylor,G,active,green-bay-packers,4318750,2018
15385,1500000,2125000,Tramon Williams,CB,active,green-bay-packers,3625000,2018
15386,1250000,975000,Lance Kendricks,TE,active,green-bay-packers,2225000,2018
15387,480000,1711041,Jaire Alexander,CB,active,green-bay-packers,2191041,2018
15388,1050000,1050000,Marcedes Lewis,TE,active,green-bay-packers,2100000,2018
15389,904936,459871,Jason Spriggs,T,active,green-bay-packers,1364807,2018
15390,480000,657473,Josh Jackson,CB,active,green-bay-packers,1137473,2018
15391,657428,304711,Josh Jones,S,active,green-bay-packers,962139,2018
15392,648000,188512,Kyler Fackrell,OLB,active,green-bay-packers,836512,2018
15393,581000,201194,Montravius Adams,DE,active,green-bay-packers,782194,2018
15394,630000,95848,Dean Lowry,DE,active,green-bay-packers,725848,2018
15395,630000,95848,Blake Martinez,ILB,active,green-bay-packers,725848,2018
15396,555000,141498,Jamaal Williams,RB,active,green-bay-packers,696498,2018
15397,689928,0,DeShone Kizer,QB,active,green-bay-packers,689928,2018
15398,480000,205189,Oren Burks,ILB,active,green-bay-packers,685189,2018
15399,630000,668,Kentrell Brice,SS,active,green-bay-packers,630668,2018
15400,630000,0,Antonio Morrison,ILB,active,green-bay-packers,630000,2018
15401,650588,90000,Bashaud Breeland,CB,active,green-bay-packers,740588,2018
15402,480000,113089,J'Mon Moore,WR,active,green-bay-packers,593089,2018
15403,555000,0,Justin McCray,G,active,green-bay-packers,555000,2018
15404,555000,0,Lucas Patrick,G,active,green-bay-packers,555000,2018
15405,480000,54388,JK Scott,P,active,green-bay-packers,534388,2018
15406,480000,54388,Marquez Valdes-Scantling,WR,active,green-bay-packers,534388,2018
15407,480000,29602,Equanimeous St. Brown,WR,active,green-bay-packers,509602,2018
15408,480000,19335,Hunter Bradley,LS,active,green-bay-packers,499335,2018
15409,480000,2000,Tim Boyle,QB,active,green-bay-packers,482000,2018
15410,480000,0,James Crawford,LB,active,green-bay-packers,480000,2018
15411,480000,0,Reggie Gilbert,DE,active,green-bay-packers,480000,2018
15412,480000,0,Robert Tonyan Jr.,WR,active,green-bay-packers,480000,2018
15413,451760,1000,Alex Light,G,active,green-bay-packers,452760,2018
15414,397399,0,Jake Kumerow,WR,active,green-bay-packers,397399,2018
15415,395294,0,Tony Brown,CB,active,green-bay-packers,395294,2018
15416,367059,0,Tyler Lancaster,DT,active,green-bay-packers,367059,2018
15417,232353,0,Eddie Pleasant,FS,active,green-bay-packers,232353,2018
15418,185295,0,Dan Vitale,FB,active,green-bay-packers,185295,2018
15419,169410,0,James Looney,DT,active,green-bay-packers,169410,2018
15420,130588,0,Adam Pankey,T,active,green-bay-packers,130588,2018
15421,112940,0,Fadol Brown,DE,active,green-bay-packers,112940,2018
15422,112940,0,Kendall Donnerson,OLB,active,green-bay-packers,112940,2018
15423,112940,0,Natrell Jamerson,S,active,green-bay-packers,112940,2018
15424,84705,0,Nico Siragusa,G,active,green-bay-packers,84705,2018
15425,82941,0,Kapri Bibbs,RB,active,green-bay-packers,82941,2018
15426,56470,0,Lavon Coleman,RB,active,green-bay-packers,56470,2018
15427,56470,0,Allen Lazard,WR,active,green-bay-packers,56470,2018
15428,1900000,8737500,Nick Perry,OLB,injured_reserve,green-bay-packers,10637500,2018
15429,6600000,3112500,Mike Daniels,DE,injured_reserve,green-bay-packers,9712500,2018
15430,1600000,2912500,Muhammad Wilkerson,DE,injured_reserve,green-bay-packers,4512500,2018
15431,1301059,1252117,Kenny Clark,DT,injured_reserve,green-bay-packers,2553176,2018
15432,1907000,114169,Jake Ryan,ILB,injured_reserve,green-bay-packers,2021169,2018
15433,850000,850000,Byron Bell,G,injured_reserve,green-bay-packers,1700000,2018
15434,786858,822433,Kevin King,CB,injured_reserve,green-bay-packers,1609291,2018
15435,915000,90000,Davon House,CB,injured_reserve,green-bay-packers,1005000,2018
15436,630000,56794,Trevor Davis,WR,injured_reserve,green-bay-packers,686794,2018
15437,630000,0,Geronimo Allison,WR,injured_reserve,green-bay-packers,630000,2018
15438,474822,44547,Aaron Jones,RB,injured_reserve,green-bay-packers,519369,2018
15439,452471,1166,Raven Greene,S,injured_reserve,green-bay-packers,453637,2018
15440,331765,0,Ibraheim Campbell,SS,injured_reserve,green-bay-packers,331765,2018
15441,226583,0,Tra Carson,RB,injured_reserve,green-bay-packers,226583,2018
15442,212117,0,Will Redmond,CB,injured_reserve,green-bay-packers,212117,2018
15443,0,4200000,Martellus Bennett,TE,dead_cap,green-bay-packers,4200000,2018
15444,2821294,0,HaHa Clinton-Dix,FS,dead_cap,green-bay-packers,2821294,2018
15445,0,2300000,Jordy Nelson,WR,dead_cap,green-bay-packers,2300000,2018
15446,0,1004225,Damarious Randall,FS,dead_cap,green-bay-packers,1004225,2018
15447,790000,0,Korey Toomer,ILB,dead_cap,green-bay-packers,790000,2018
15448,592944,31535,Kyle Murphy,T,dead_cap,green-bay-packers,624479,2018
15449,337176,163637,Ty Montgomery,RB,dead_cap,green-bay-packers,500813,2018
15450,55609,245466,Quinten Rollins,CB,dead_cap,green-bay-packers,301075,2018
15451,293823,0,Jermaine Whitehead,FS,dead_cap,green-bay-packers,293823,2018
15452,15200,167925,DeAngelo Yancey,WR,dead_cap,green-bay-packers,183125,2018
15453,0,173435,Vince Biegel,OLB,dead_cap,green-bay-packers,173435,2018
15454,0,166667,Letroy Guion,DE,dead_cap,green-bay-packers,166667,2018
15455,163235,0,Darius Jackson,RB,dead_cap,green-bay-packers,163235,2018
15456,98800,17738,Kendall Donnerson,OLB,dead_cap,green-bay-packers,116538,2018
15457,106400,0,Anthony Coyle,G,dead_cap,green-bay-packers,106400,2018
15458,106400,0,Deon Simon,DT,dead_cap,green-bay-packers,106400,2018
15459,83600,22357,James Looney,DT,dead_cap,green-bay-packers,105957,2018
15460,98800,3334,Adam Pankey,T,dead_cap,green-bay-packers,102134,2018
15461,0,98598,Kofi Amichia,C,dead_cap,green-bay-packers,98598,2018
15462,60800,0,Joe Kerridge,FB,dead_cap,green-bay-packers,60800,2018
15463,60800,0,Will Redmond,CB,dead_cap,green-bay-packers,60800,2018
15464,60800,0,Brady Sheldon,OLB,dead_cap,green-bay-packers,60800,2018
15465,0,55908,Brett Hundley,QB,dead_cap,green-bay-packers,55908,2018
15466,53200,0,Lavon Coleman,RB,dead_cap,green-bay-packers,53200,2018
15467,0,49977,Malachi Dupre,WR,dead_cap,green-bay-packers,49977,2018
15468,45600,0,Keon Hatcher,WR,dead_cap,green-bay-packers,45600,2018
15469,45600,0,Teo Redding,WR,dead_cap,green-bay-packers,45600,2018
15470,22235,18759,Devante Mays,RB,dead_cap,green-bay-packers,40994,2018
15471,38000,0,Joel Bouganon,RB,dead_cap,green-bay-packers,38000,2018
15472,38000,0,Gerhard de Beer,T,dead_cap,green-bay-packers,38000,2018
15473,38000,0,Malcolm Johnson,FB,dead_cap,green-bay-packers,38000,2018
15474,37059,0,Drew Kaser,P,dead_cap,green-bay-packers,37059,2018
15475,30400,0,Tyler Lancaster,DT,dead_cap,green-bay-packers,30400,2018
15476,30400,0,Greer Martini,LB,dead_cap,green-bay-packers,30400,2018
15477,30400,0,Tray Matthews,S,dead_cap,green-bay-packers,30400,2018
15478,30400,0,Jason Thompson,S,dead_cap,green-bay-packers,30400,2018
15479,28235,0,Deante Burton,WR,dead_cap,green-bay-packers,28235,2018
15480,0,26599,Aaron Ripkowski,FB,dead_cap,green-bay-packers,26599,2018
15481,22800,0,Tony Brown,CB,dead_cap,green-bay-packers,22800,2018
15482,22800,0,Tra Carson,RB,dead_cap,green-bay-packers,22800,2018
15483,22800,0,Austin Davis,C,dead_cap,green-bay-packers,22800,2018
15484,15200,0,Eric Cotton,DE,dead_cap,green-bay-packers,15200,2018
15485,15200,0,D.J. Killings,CB,dead_cap,green-bay-packers,15200,2018
15486,15200,0,Dan Vitale,FB,dead_cap,green-bay-packers,15200,2018
15487,15200,0,Ethan Wolf,TE,dead_cap,green-bay-packers,15200,2018
15488,7600,0,Evan Baylis,TE,dead_cap,green-bay-packers,7600,2018
15489,7600,0,Marwin Evans,S,dead_cap,green-bay-packers,7600,2018
15490,0,3334,Johnathan Calvin,DE,dead_cap,green-bay-packers,3334,2018
15491,0,3334,Michael Clark,WR,dead_cap,green-bay-packers,3334,2018
15492,0,3334,Thomas Evans,T,dead_cap,green-bay-packers,3334,2018
15493,0,3334,Geoff Gray,T,dead_cap,green-bay-packers,3334,2018
15494,0,3334,Cody Heiman,ILB,dead_cap,green-bay-packers,3334,2018
15495,0,3334,Taysom Hill,QB,dead_cap,green-bay-packers,3334,2018
15496,0,3334,Izaah Lunsford,DT,dead_cap,green-bay-packers,3334,2018
15497,0,3334,Aaron Peck,WR,dead_cap,green-bay-packers,3334,2018
15498,0,3334,Justin Vogel,P,dead_cap,green-bay-packers,3334,2018
15499,0,2334,David Rivers III,CB,dead_cap,green-bay-packers,2334,2018
15500,0,1668,Josh Hawkins,CB,dead_cap,green-bay-packers,1668,2018
15501,0,1667,Montay Crockett,WR,dead_cap,green-bay-packers,1667,2018
15502,0,1666,Lenzy Pipkins,CB,dead_cap,green-bay-packers,1666,2018
15503,0,1334,Donatello Brown,CB,dead_cap,green-bay-packers,1334,2018
15504,1100000,28572000,Aaron Rodgers,QB,active,green-bay-packers,29672000,2019
15505,8500000,5700000,David Bakhtiari,LT,active,green-bay-packers,14200000,2019
15506,3450000,9216666,Jimmy Graham,TE,active,green-bay-packers,12666666,2019
15507,2750000,7975000,Davante Adams,WR,active,green-bay-packers,10725000,2019
15508,5800000,2550000,Bryan Bulaga,RT,active,green-bay-packers,8350000,2019
15509,4300000,3850000,Corey Linsley,C,active,green-bay-packers,8150000,2019
15510,1000000,6250000,Za'Darius Smith,OLB,active,green-bay-packers,7250000,2019
15511,3250000,3125000,Tramon Williams,CB,active,green-bay-packers,6375000,2019
15512,850000,5150000,Preston Smith,OLB,active,green-bay-packers,6000000,2019
15513,1250000,4650000,Adrian Amos,FS,active,green-bay-packers,5900000,2019
15514,3200000,1650000,Mason Crosby,K,active,green-bay-packers,4850000,2019
15515,1350000,2900000,Billy Turner,G,active,green-bay-packers,4250000,2019
15516,2050000,1595849,Dean Lowry,DE,active,green-bay-packers,3645849,2019
15517,1726588,1252119,Kenny Clark,DT,active,green-bay-packers,2978707,2019
15518,495000,2391784,Rashan Gary,OLB,active,green-bay-packers,2886784,2019
15519,1450000,1350000,Geronimo Allison,WR,active,green-bay-packers,2800000,2019
15520,1027761,1711041,Jaire Alexander,CB,active,green-bay-packers,2738802,2019
15521,495000,1780943,Darnell Savage,S,active,green-bay-packers,2275943,2019
15522,2010000,188512,Kyler Fackrell,OLB,active,green-bay-packers,2198512,2019
15523,2025000,95849,Blake Martinez,ILB,active,green-bay-packers,2120849,2019
15524,1050000,1050000,Marcedes Lewis,TE,active,green-bay-packers,2100000,2019
15525,1108717,822433,Kevin King,CB,active,green-bay-packers,1931150,2019
15526,764368,657473,Josh Jackson,CB,active,green-bay-packers,1421841,2019
15527,495000,735389,Elgton Jenkins,G,active,green-bay-packers,1230389,2019
15528,671000,201194,Montravius Adams,DE,active,green-bay-packers,872194,2019
15529,606500,230189,Oren Burks,OLB,active,green-bay-packers,836689,2019
15530,645000,141498,Jamaal Williams,RB,active,green-bay-packers,786498,2019
15531,645000,116666,Lucas Patrick,G,active,green-bay-packers,761666,2019
15532,720000,0,B.J. Goodson,ILB,active,green-bay-packers,720000,2019
15533,720000,0,Dan Vitale,FB,active,green-bay-packers,720000,2019
15534,645000,50487,Aaron Jones,RB,active,green-bay-packers,695487,2019
15535,645000,0,Ibraheim Campbell,SS,active,green-bay-packers,645000,2019
15536,645000,0,Lucas Patrick,G,active,green-bay-packers,645000,2019
15537,378000,251632,Jace Sternberger,TE,active,green-bay-packers,629632,2019
15538,570000,54388,JK Scott,P,active,green-bay-packers,624388,2019
15539,570000,54388,Marquez Valdes-Scantling,WR,active,green-bay-packers,624388,2019
15540,441176,156250,Jared Veldheer,RT,active,green-bay-packers,597426,2019
15541,570000,19335,Hunter Bradley,LS,active,green-bay-packers,589335,2019
15542,495000,78316,Kingsley Keke,DT,active,green-bay-packers,573316,2019
15543,570000,2000,Tim Boyle,QB,active,green-bay-packers,572000,2019
15544,570000,1000,Alex Light,T,active,green-bay-packers,571000,2019
15545,570000,0,Jake Kumerow,WR,active,green-bay-packers,570000,2019
15546,570000,0,Tyler Lancaster,DE,active,green-bay-packers,570000,2019
15547,570000,0,Will Redmond,FS,active,green-bay-packers,570000,2019
15548,570000,0,Chandon Sullivan,CB,active,green-bay-packers,570000,2019
15549,570000,0,Robert Tonyan Jr.,TE,active,green-bay-packers,570000,2019
15550,495000,43737,Ka'dar Hollman,CB,active,green-bay-packers,538737,2019
15551,495000,41514,Dexter Williams,RB,active,green-bay-packers,536514,2019
15552,520882,0,Ryan Grant,WR,active,green-bay-packers,520882,2019
15553,495000,24476,Ty Summers,LB,active,green-bay-packers,519476,2019
15554,495000,0,Allen Lazard,WR,active,green-bay-packers,495000,2019
15555,169412,0,Tyler Ervin,RB,active,green-bay-packers,169412,2019
15556,58236,0,John Leglue,G,active,green-bay-packers,58236,2019
15557,2600000,2562500,Lane Taylor,G,injured_reserve,green-bay-packers,5162500,2019
15558,1132404,459873,Jason Spriggs,T,injured_reserve,green-bay-packers,1592277,2019
15559,453707,81082,Cole Madison,C,injured_reserve,green-bay-packers,534789,2019
15560,393000,59602,Equanimeous St. Brown,WR,injured_reserve,green-bay-packers,452602,2019
15561,413823,1166,Raven Greene,S,injured_reserve,green-bay-packers,414989,2019
15562,408000,0,Malcolm Johnson,FB,injured_reserve,green-bay-packers,408000,2019
15563,378000,2333,Curtis Bolton,LB,injured_reserve,green-bay-packers,380333,2019
15564,145588,0,Yosh Nijman,T,injured_reserve,green-bay-packers,145588,2019
15565,0,11100000,Nick Perry,OLB,dead_cap,green-bay-packers,11100000,2019
15566,0,2800000,Mike Daniels,DE,dead_cap,green-bay-packers,2800000,2019
15567,536464,0,Tony Brown,CB,dead_cap,green-bay-packers,536464,2019
15568,455294,0,Adam Pankey,T,dead_cap,green-bay-packers,455294,2019
15569,0,346870,Vince Biegel,OLB,dead_cap,green-bay-packers,346870,2019
15570,304944,0,Darrius Shepherd,WR,dead_cap,green-bay-packers,304944,2019
15571,0,304712,Josh Jones,S,dead_cap,green-bay-packers,304712,2019
15572,284235,0,Tremon Smith,RB,dead_cap,green-bay-packers,284235,2019
15573,266941,0,Tim Williams,OLB,dead_cap,green-bay-packers,266941,2019
15574,249588,0,Evan Baylis,TE,dead_cap,green-bay-packers,249588,2019
15575,136000,67072,James Looney,DT,dead_cap,green-bay-packers,203072,2019
15576,167647,0,Fadol Brown,DE,dead_cap,green-bay-packers,167647,2019
15577,84706,56794,Trevor Davis,WR,dead_cap,green-bay-packers,141500,2019
15578,136000,2333,Randy Ramsey,OLB,dead_cap,green-bay-packers,138333,2019
15579,136000,2333,Manny Wilkins,QB,dead_cap,green-bay-packers,138333,2019
15580,136000,833,Kabion Ento,WR,dead_cap,green-bay-packers,136833,2019
15581,136000,0,Malik Taylor,WR,dead_cap,green-bay-packers,136000,2019
15582,0,113090,J'Mon Moore,WR,dead_cap,green-bay-packers,113090,2019
15583,96000,0,Yosh Nijman,T,dead_cap,green-bay-packers,96000,2019
15584,90235,0,Tra Carson,RB,dead_cap,green-bay-packers,90235,2019
15585,88000,0,Damarea Crockett,RB,dead_cap,green-bay-packers,88000,2019
15586,64000,0,Benjamin Braden,T,dead_cap,green-bay-packers,64000,2019
15587,0,60000,Corey Grant,RB,dead_cap,green-bay-packers,60000,2019
15588,0,53217,Kendall Donnerson,OLB,dead_cap,green-bay-packers,53217,2019
15589,48000,0,Keon Hatcher,WR,dead_cap,green-bay-packers,48000,2019
15590,40000,0,Cody Conway,T,dead_cap,green-bay-packers,40000,2019
15591,32000,0,Brady Sheldon,OLB,dead_cap,green-bay-packers,32000,2019
15592,0,31535,Kyle Murphy,T,dead_cap,green-bay-packers,31535,2019
15593,0,18759,Devante Mays,RB,dead_cap,green-bay-packers,18759,2019
15594,8000,0,Ethan Wolf,TE,dead_cap,green-bay-packers,8000,2019
15595,0,2800,Javien Hamilton,CB,dead_cap,green-bay-packers,2800,2019
15596,0,2333,Davis Koppenhaver,TE,dead_cap,green-bay-packers,2333,2019
15597,0,1668,Lenzy Pipkins,CB,dead_cap,green-bay-packers,1668,2019
15598,0,833,Nydair Rouse,CB,dead_cap,green-bay-packers,833,2019
15599,0,666,Larry Williams,G,dead_cap,green-bay-packers,666,2019
15600,1550000,20092000,Aaron Rodgers,QB,active,green-bay-packers,21642000,2020
15601,2000000,15250000,Za'Darius Smith,OLB,active,green-bay-packers,17250000,2020
15602,12000000,4475000,Davante Adams,WR,active,green-bay-packers,16475000,2020
15603,10500000,4200000,David Bakhtiari,LT,active,green-bay-packers,14700000,2020
15604,4350000,9150000,Preston Smith,OLB,active,green-bay-packers,13500000,2020
15605,7450000,4216668,Jimmy Graham,TE,active,green-bay-packers,11666668,2020
15606,7650000,2850000,Corey Linsley,C,active,green-bay-packers,10500000,2020
15607,1750000,7650000,Adrian Amos,FS,active,green-bay-packers,9400000,2020
15608,7690000,0,Kenny Clark,DT,active,green-bay-packers,7690000,2020
15609,1700000,5900000,Billy Turner,G,active,green-bay-packers,7600000,2020
15610,3800000,2312500,Lane Taylor,G,active,green-bay-packers,6112500,2020
15611,1000000,4200000,Dean Lowry,DE,active,green-bay-packers,5200000,2020
15612,1216696,2391784,Rashan Gary,OLB,active,green-bay-packers,3608480,2020
15613,1575522,1711041,Jaire Alexander,CB,active,green-bay-packers,3286563,2020
15614,1063986,1780943,Darnell Savage,S,active,green-bay-packers,2844929,2020
15615,1430575,822435,Kevin King,CB,active,green-bay-packers,2253010,2020
15616,1048736,657473,Josh Jackson,CB,active,green-bay-packers,1706209,2020
15617,802597,735389,Elgton Jenkins,G,active,green-bay-packers,1537986,2020
15618,875000,401041,Lucas Patrick,G,active,green-bay-packers,1276041,2020
15619,755000,201194,Montravius Adams,DE,active,green-bay-packers,956194,2020
15620,651452,281632,Jace Sternberger,TE,active,green-bay-packers,933084,2020
15621,697500,230189,Oren Burks,OLB,active,green-bay-packers,927689,2020
15622,735000,141498,Jamaal Williams,RB,active,green-bay-packers,876498,2020
15623,735000,50487,Aaron Jones,RB,active,green-bay-packers,785487,2020
15624,660000,81082,Cole Madison,C,active,green-bay-packers,741082,2020
15625,660000,54388,JK Scott,P,active,green-bay-packers,714388,2020
15626,660000,54388,Marquez Valdes-Scantling,WR,active,green-bay-packers,714388,2020
15627,660000,29602,Equanimeous St. Brown,WR,active,green-bay-packers,689602,2020
15628,660000,19335,Hunter Bradley,LS,active,green-bay-packers,679335,2020
15629,585000,78316,Kingsley Keke,DT,active,green-bay-packers,663316,2020
15630,660000,2000,Tim Boyle,QB,active,green-bay-packers,662000,2020
15631,660000,1168,Raven Greene,S,active,green-bay-packers,661168,2020
15632,660000,1000,Alex Light,T,active,green-bay-packers,661000,2020
15633,585000,43737,Ka'dar Hollman,CB,active,green-bay-packers,628737,2020
15634,585000,41514,Dexter Williams,RB,active,green-bay-packers,626514,2020
15635,585000,24476,Ty Summers,LB,active,green-bay-packers,609476,2020
15636,585000,2333,Greg Roberts,DE,active,green-bay-packers,587333,2020
15637,585000,0,Yosh Nijman,T,active,green-bay-packers,585000,2020
15638,510000,2333,Reggie Begelton,WR,active,green-bay-packers,512333,2020
15639,510000,2333,Curtis Bolton,LB,active,green-bay-packers,512333,2020
15640,510000,0,DaShaun Amos,CB,active,green-bay-packers,510000,2020
15641,510000,0,John Leglue,G,active,green-bay-packers,510000,2020
15642,510000,0,Elijah Wellman,FB,active,green-bay-packers,510000,2020
15643,0,0,Evan Baylis,TE,active,green-bay-packers,0,2020
15644,0,0,Cody Conway,T,active,green-bay-packers,0,2020
15645,0,0,Damarea Crockett,RB,active,green-bay-packers,0,2020
15646,0,0,Kabion Ento,WR,active,green-bay-packers,0,2020
15647,0,0,James Looney,DT,active,green-bay-packers,0,2020
15648,0,0,Randy Ramsey,OLB,active,green-bay-packers,0,2020
15649,0,0,Darrius Shepherd,WR,active,green-bay-packers,0,2020
15650,0,0,Malik Taylor,WR,active,green-bay-packers,0,2020
15651,0,0,Manny Wilkins,QB,active,green-bay-packers,0,2020
15652,0,0,Tim Williams,OLB,active,green-bay-packers,0,2020
15653,0,304712,Josh Jones,S,dead_cap,green-bay-packers,304712,2020
15654,0,226180,J'Mon Moore,WR,dead_cap,green-bay-packers,226180,2020
15655,0,4667,Davis Koppenhaver,TE,dead_cap,green-bay-packers,4667,2020
15656,0,4667,Randy Ramsey,OLB,dead_cap,green-bay-packers,4667,2020
15657,0,4667,Manny Wilkins,QB,dead_cap,green-bay-packers,4667,2020
15658,0,2800,Javien Hamilton,CB,dead_cap,green-bay-packers,2800,2020
15659,0,2800,Javien Hamilton,CB,dead_cap,green-bay-packers,2800,2020
15660,0,1667,Kabion Ento,WR,dead_cap,green-bay-packers,1667,2020
15661,0,1667,Nydair Rouse,CB,dead_cap,green-bay-packers,1667,2020
15662,0,1334,Larry Williams,G,dead_cap,green-bay-packers,1334,2020
15663,1500000,2750000,Ahman Green,RB,active,houston-texans,4250000,2007
15664,950000,3300000,Matt Schaub,QB,active,houston-texans,4250000,2007
15665,1000000,3930712,Andre Johnson,WR,active,houston-texans,4930712,2007
15666,975000,4800000,Mario Williams,DE,active,houston-texans,5775000,2007
15667,285000,1345000,Amobi Okoye,DT,active,houston-texans,1630000,2007
15668,435000,2381000,Travis Johnson,OLB,active,houston-texans,2816000,2007
15669,1100000,500000,Sage Rosenfels,QB,active,houston-texans,1600000,2007
15670,1000000,500000,Kevin Walter,WR,active,houston-texans,1500000,2007
15671,800000,500000,Ron Dayne,RB,active,houston-texans,1300000,2007
15672,940000,356250,DeMeco Ryans,ILB,active,houston-texans,1296250,2007
15673,650000,400000,Vonta Leach,FB,active,houston-texans,1050000,2007
15674,435000,190000,Shaun Cody,DT,active,houston-texans,625000,2007
15675,850000,0,Charlie Anderson,LB,active,houston-texans,850000,2007
15676,850000,0,Von Hutchins,CB,active,houston-texans,850000,2007
15677,360000,152500,Charles Spencer,T,active,houston-texans,512500,2007
15678,360000,152000,Eric Winston,RT,active,houston-texans,512000,2007
15679,510000,0,Dexter Wynn,CB,active,houston-texans,510000,2007
15680,285000,194277,Jacoby Jones,WR,active,houston-texans,479277,2007
15681,435000,25100,Ceandris Brown,CB,active,houston-texans,460100,2007
15682,360000,92500,Owen Daniels,TE,active,houston-texans,452500,2007
15683,435000,0,Drew Hodgdon,C,active,houston-texans,435000,2007
15684,285000,105062,Fred Bennett,CB,active,houston-texans,390062,2007
15685,360000,0,David Anderson,WR,active,houston-texans,360000,2007
15686,360000,0,Rashad Butler,LT,active,houston-texans,360000,2007
15687,285000,45531,Brandon Harrison,CB,active,houston-texans,330531,2007
15688,285000,25150,Kasey Studdard,G,active,houston-texans,310150,2007
15689,285000,14228,Zac Diles,ILB,active,houston-texans,299228,2007
15690,285000,0,Brandon Frye,T,active,houston-texans,285000,2007
15691,67058,0,Mike Brisiel,G,active,houston-texans,67058,2007
15692,42352,0,Tim Bulman,DT,active,houston-texans,42352,2007
15693,510000,2386000,Dunta Robinson,CB,injured_reserve,houston-texans,2896000,2007
15694,435000,112000,Jerome Mathis,WR,injured_reserve,houston-texans,547000,2007
15695,0,4146666,David Carr,QB,dead_cap,houston-texans,4146666,2007
15696,3750000,0,Eric Moulds,WR,dead_cap,houston-texans,3750000,2007
15697,366667,510000,Jason Babin,DE,dead_cap,houston-texans,876667,2007
15698,189000,0,Vernand Morency,RB,dead_cap,houston-texans,189000,2007
15699,70500,0,Tim Bulman,DT,dead_cap,houston-texans,70500,2007
15700,53466,0,Brandon Frye,T,dead_cap,houston-texans,53466,2007
15701,41966,0,Drew Hodgdon,C,dead_cap,houston-texans,41966,2007
15702,24000,0,Wali Lundy,RB,dead_cap,houston-texans,24000,2007
15703,16466,0,David Anderson,WR,dead_cap,houston-texans,16466,2007
15704,8000,0,Onrea Jones,WR,dead_cap,houston-texans,8000,2007
15705,2825000,6864045,Andre Johnson,WR,active,houston-texans,9689045,2008
15706,4950000,800000,Matt Schaub,QB,active,houston-texans,5750000,2008
15707,2350000,4800000,Mario Williams,DE,active,houston-texans,7150000,2008
15708,1800000,2850000,Ahman Green,RB,active,houston-texans,4650000,2008
15709,2370000,2386000,Dunta Robinson,CB,active,houston-texans,4756000,2008
15710,1000000,800000,Jacques Reeves,CB,active,houston-texans,1800000,2008
15711,295000,2190000,Duane Brown,LT,active,houston-texans,2485000,2008
15712,370000,2032327,Mike Brisiel,G,active,houston-texans,2402327,2008
15713,370000,3335000,Amobi Okoye,DT,active,houston-texans,3705000,2008
15714,707500,2381000,Travis Johnson,OLB,active,houston-texans,3088500,2008
15715,1350000,500000,Sage Rosenfels,QB,active,houston-texans,1850000,2008
15716,1300000,500000,Kevin Walter,WR,active,houston-texans,1800000,2008
15717,530000,1152000,Eric Winston,RT,active,houston-texans,1682000,2008
15718,850000,750000,Chris Myers,C,active,houston-texans,1600000,2008
15719,445000,831250,DeMeco Ryans,ILB,active,houston-texans,1276250,2008
15720,520000,190000,Shaun Cody,DT,active,houston-texans,710000,2008
15721,370000,194277,Jacoby Jones,WR,active,houston-texans,564277,2008
15722,445000,92500,Owen Daniels,TE,active,houston-texans,537500,2008
15723,295000,187500,Antwaun Molden,CB,active,houston-texans,482500,2008
15724,370000,105062,Fred Bennett,CB,active,houston-texans,475062,2008
15725,295000,166096,Steve Slaton,RB,active,houston-texans,461096,2008
15726,445000,0,David Anderson,WR,active,houston-texans,445000,2008
15727,445000,0,Rashad Butler,LT,active,houston-texans,445000,2008
15728,445000,0,Joel Dreessen,TE,active,houston-texans,445000,2008
15729,445000,0,Stanley McClover,DE,active,houston-texans,445000,2008
15730,445000,0,Ryan Moats,RB,active,houston-texans,445000,2008
15731,445000,0,David Pittman,CB,active,houston-texans,445000,2008
15732,295000,113125,Xavier Adibi,LB,active,houston-texans,408125,2008
15733,370000,25150,Kasey Studdard,G,active,houston-texans,395150,2008
15734,370000,0,Tim Bulman,DT,active,houston-texans,370000,2008
15735,295000,45531,Brandon Harrison,CB,active,houston-texans,340531,2008
15736,295000,44500,Frank Okam,DT,active,houston-texans,339500,2008
15737,295000,0,Jesse Nading,DE,active,houston-texans,295000,2008
15738,230000,0,Harry Williams,WR,active,houston-texans,230000,2008
15739,185000,14228,Zac Diles,ILB,active,houston-texans,199228,2008
15740,1417000,0,Ceandris Brown,CB,injured_reserve,houston-texans,1417000,2008
15741,733334,1020000,Jason Babin,DE,dead_cap,houston-texans,1753334,2008
15742,189000,0,Vernand Morency,RB,dead_cap,houston-texans,189000,2008
15743,152500,0,Charles Spencer,T,dead_cap,houston-texans,152500,2008
15744,106932,0,Brandon Frye,T,dead_cap,houston-texans,106932,2008
15745,48000,0,Wali Lundy,RB,dead_cap,houston-texans,48000,2008
15746,13750,0,Alex Brink,QB,dead_cap,houston-texans,13750,2008
15747,8000,0,Onrea Jones,WR,dead_cap,houston-texans,8000,2008
15748,6950000,5750000,Matt Schaub,QB,active,houston-texans,12700000,2009
15749,9957000,0,Dunta Robinson,CB,active,houston-texans,9957000,2009
15750,5325000,5214045,Andre Johnson,WR,active,houston-texans,10539045,2009
15751,3000000,2500000,Antonio Smith,DE,active,houston-texans,5500000,2009
15752,2875000,4800000,Mario Williams,DE,active,houston-texans,7675000,2009
15753,2000000,3152000,Eric Winston,RT,active,houston-texans,5152000,2009
15754,2500000,800000,Jacques Reeves,CB,active,houston-texans,3300000,2009
15755,2000000,750000,Chris Myers,C,active,houston-texans,2750000,2009
15756,1750000,800000,Dan Orlovsky,QB,active,houston-texans,2550000,2009
15757,630000,3335000,Amobi Okoye,DT,active,houston-texans,3965000,2009
15758,1500000,500000,Kevin Walter,WR,active,houston-texans,2000000,2009
15759,1200000,750000,Vonta Leach,FB,active,houston-texans,1950000,2009
15760,1390000,356250,DeMeco Ryans,ILB,active,houston-texans,1746250,2009
15761,800000,0,Shaun Cody,DT,active,houston-texans,800000,2009
15762,1000000,650000,Vonta Leach,FB,active,houston-texans,1650000,2009
15763,310000,1206000,Brian Cushing,ILB,active,houston-texans,1516000,2009
15764,385000,1915000,Duane Brown,LT,active,houston-texans,2300000,2009
15765,900000,333333,David Anderson,WR,active,houston-texans,1233333,2009
15766,1010000,0,Rashad Butler,LT,active,houston-texans,1010000,2009
15767,600000,315000,Joel Dreessen,TE,active,houston-texans,915000,2009
15768,620000,250000,Wade Smith,G,active,houston-texans,870000,2009
15769,310000,352500,Connor Barwin,OLB,active,houston-texans,662500,2009
15770,460000,194277,Jacoby Jones,WR,active,houston-texans,654277,2009
15771,385000,187500,Antwaun Molden,CB,active,houston-texans,572500,2009
15772,460000,105062,Fred Bennett,CB,active,houston-texans,565062,2009
15773,385000,166096,Steve Slaton,RB,active,houston-texans,551096,2009
15774,535000,0,Ryan Moats,RB,active,houston-texans,535000,2009
15775,535000,0,Bernard Pollard,S,active,houston-texans,535000,2009
15776,310000,201062,Antoine Caldwell,G,active,houston-texans,511062,2009
15777,385000,113125,Xavier Adibi,LB,active,houston-texans,498125,2009
15778,460000,25150,Kasey Studdard,G,active,houston-texans,485150,2009
15779,460000,14228,Zac Diles,ILB,active,houston-texans,474228,2009
15780,620000,0,Rex Grossman,QB,active,houston-texans,620000,2009
15781,460000,0,Tim Bulman,DT,active,houston-texans,460000,2009
15782,310000,122562,Glover Quin,FS,active,houston-texans,432562,2009
15783,385000,44500,Frank Okam,DT,active,houston-texans,429500,2009
15784,385000,0,Buster Davis,LB,active,houston-texans,385000,2009
15785,385000,0,Jesse Nading,DE,active,houston-texans,385000,2009
15786,310000,46250,James Casey,FB,active,houston-texans,356250,2009
15787,310000,25437,Brice McCain,CB,active,houston-texans,335437,2009
15788,310000,25000,Arian Foster,RB,active,houston-texans,335000,2009
15789,310000,14565,Troy Nolan,S,active,houston-texans,324565,2009
15790,2792000,0,Owen Daniels,TE,injured_reserve,houston-texans,2792000,2009
15791,460000,0,Mike Brisiel,G,injured_reserve,houston-texans,460000,2009
15792,88400,0,Andrew Crummey,G,practice_squad,houston-texans,88400,2009
15793,0,2500000,Ahman Green,RB,dead_cap,houston-texans,2500000,2009
15794,0,1190500,Travis Johnson,OLB,dead_cap,houston-texans,1190500,2009
15795,500000,0,Sage Rosenfels,QB,dead_cap,houston-texans,500000,2009
15796,152500,0,Charles Spencer,T,dead_cap,houston-texans,152500,2009
15797,45531,0,Brandon Harrison,CB,dead_cap,houston-texans,45531,2009
15798,41250,0,Alex Brink,QB,dead_cap,houston-texans,41250,2009
15799,9600000,4800000,Mario Williams,DE,active,houston-texans,14400000,2010
15800,7182500,3694668,Andre Johnson,WR,active,houston-texans,10877168,2010
15801,7000000,1250000,DeMeco Ryans,ILB,active,houston-texans,8250000,2010
15802,4500000,5800000,Matt Schaub,QB,active,houston-texans,10300000,2010
15803,3900000,2500000,Antonio Smith,DE,active,houston-texans,6400000,2010
15804,4500000,1000000,Eric Winston,RT,active,houston-texans,5500000,2010
15805,302059,5919000,Brian Cushing,ILB,active,houston-texans,6221059,2010
15806,3000000,1000000,Kevin Walter,WR,active,houston-texans,4000000,2010
15807,3000000,800000,Jacques Reeves,CB,active,houston-texans,3800000,2010
15808,3168000,0,Owen Daniels,TE,active,houston-texans,3168000,2010
15809,2400000,750000,Chris Myers,C,active,houston-texans,3150000,2010
15810,1000000,2000000,Wade Smith,G,active,houston-texans,3000000,2010
15811,2521000,0,Bernard Pollard,S,active,houston-texans,2521000,2010
15812,765000,3335000,Amobi Okoye,DT,active,houston-texans,4100000,2010
15813,1450000,925000,Vonta Leach,FB,active,houston-texans,2375000,2010
15814,850000,800000,Dan Orlovsky,QB,active,houston-texans,1650000,2010
15815,1440000,0,Neil Rackers,K,active,houston-texans,1440000,2010
15816,1000000,0,Shaun Cody,DT,active,houston-texans,1000000,2010
15817,1759000,0,Mark Anderson,DE,active,houston-texans,1759000,2010
15818,1170000,333333,David Anderson,WR,active,houston-texans,1503333,2010
15819,485205,1915000,Duane Brown,LT,active,houston-texans,2400205,2010
15820,395000,1035000,Kareem Jackson,CB,active,houston-texans,1430000,2010
15821,1270000,50000,Jason Allen,CB,active,houston-texans,1320000,2010
15822,1176000,0,Rashad Butler,LT,active,houston-texans,1176000,2010
15823,380000,779250,Ben Tate,RB,active,houston-texans,1159250,2010
15824,1101000,14228,Zac Diles,ILB,active,houston-texans,1115228,2010
15825,760000,315000,Joel Dreessen,TE,active,houston-texans,1075000,2010
15826,800000,0,Adewale Ogunleye,DE,active,houston-texans,800000,2010
15827,555000,194277,Jacoby Jones,WR,active,houston-texans,749277,2010
15828,390000,352500,Connor Barwin,OLB,active,houston-texans,742500,2010
15829,470000,187500,Antwaun Molden,CB,active,houston-texans,657500,2010
15830,470000,166096,Steve Slaton,RB,active,houston-texans,636096,2010
15831,630000,0,Matt Leinart,QB,active,houston-texans,630000,2010
15832,630000,0,Derrick Ward,RB,active,houston-texans,630000,2010
15833,405000,201062,Antoine Caldwell,G,active,houston-texans,606062,2010
15834,550000,25150,Kasey Studdard,G,active,houston-texans,575150,2010
15835,545000,0,Mike Brisiel,G,active,houston-texans,545000,2010
15836,395000,122562,Glover Quin,FS,active,houston-texans,517562,2010
15837,320000,197125,Earl Mitchell,DT,active,houston-texans,517125,2010
15838,470000,44500,Frank Okam,DT,active,houston-texans,514500,2010
15839,320000,133735,Darryl Sharpton,ILB,active,houston-texans,453735,2010
15840,405000,46250,James Casey,FB,active,houston-texans,451250,2010
15841,320000,120025,Garrett Graham,TE,active,houston-texans,440025,2010
15842,395000,25437,Brice McCain,CB,active,houston-texans,420437,2010
15843,395000,25000,Arian Foster,RB,active,houston-texans,420000,2010
15844,395000,24000,Trindon Holliday,KR,active,houston-texans,419000,2010
15845,395000,0,Tim Jamison,DE,active,houston-texans,395000,2010
15846,395000,0,Jesse Nading,DE,active,houston-texans,395000,2010
15847,320000,48000,Sherrick McManis,CB,active,houston-texans,368000,2010
15848,320000,14565,Troy Nolan,S,active,houston-texans,334565,2010
15849,320000,13403,Dorin Dickerson,TE,active,houston-texans,333403,2010
15850,320000,0,Jon Weeks,LS,active,houston-texans,320000,2010
15851,255000,0,Darnell Bing,S,active,houston-texans,255000,2010
15852,88400,0,Shelley Smith,G,active,houston-texans,88400,2010
15853,1010000,0,Tim Bulman,DT,injured_reserve,houston-texans,1010000,2010
15854,88400,0,Chris McCoy,OLB,practice_squad,houston-texans,88400,2010
15855,88400,0,Shelley Smith,G,practice_squad,houston-texans,88400,2010
15856,88400,0,Cody Wallace,C,practice_squad,houston-texans,88400,2010
15857,0,1339000,Travis Johnson,OLB,dead_cap,houston-texans,1339000,2010
15858,352941,0,Cato June,LB,dead_cap,houston-texans,352941,2010
15859,105062,0,Fred Bennett,CB,dead_cap,houston-texans,105062,2010
15860,95258,0,Shane Boyd,QB,dead_cap,houston-texans,95258,2010
15861,50000,0,Arian Foster,RB,dead_cap,houston-texans,50000,2010
15862,45531,0,Brandon Harrison,CB,dead_cap,houston-texans,45531,2010
15863,0,26017,Shelley Smith,G,dead_cap,houston-texans,26017,2010
15864,6250,0,Steve Maneri,TE,dead_cap,houston-texans,6250,2010
15865,13800000,4800000,Mario Williams,DE,active,houston-texans,18600000,2011
15866,5700000,5800000,Matt Schaub,QB,active,houston-texans,11500000,2011
15867,5500000,2500000,Johnathan Joseph,CB,active,houston-texans,8000000,2011
15868,1300000,5194668,Andre Johnson,WR,active,houston-texans,6494668,2011
15869,4500000,1000000,Eric Winston,RT,active,houston-texans,5500000,2011
15870,1600000,3500000,Antonio Smith,DE,active,houston-texans,5100000,2011
15871,3000000,1687500,Owen Daniels,TE,active,houston-texans,4687500,2011
15872,3000000,1000000,Kevin Walter,WR,active,houston-texans,4000000,2011
15873,2750000,750000,Chris Myers,C,active,houston-texans,3500000,2011
15874,2000000,1500000,Danieal Manning,S,active,houston-texans,3500000,2011
15875,800000,2250000,DeMeco Ryans,ILB,active,houston-texans,3050000,2011
15876,450000,3420000,Kareem Jackson,CB,active,houston-texans,3870000,2011
15877,2000000,750000,Shaun Cody,DT,active,houston-texans,2750000,2011
15878,2000000,500000,Jacoby Jones,WR,active,houston-texans,2500000,2011
15879,1750000,750000,Wade Smith,G,active,houston-texans,2500000,2011
15880,774000,3000000,Brian Cushing,ILB,active,houston-texans,3774000,2011
15881,2150000,0,Neil Rackers,K,active,houston-texans,2150000,2011
15882,375000,1668182,J.J. Watt,DE,active,houston-texans,2043182,2011
15883,1835000,0,Mike Brisiel,G,active,houston-texans,1835000,2011
15884,800000,1915000,Duane Brown,LT,active,houston-texans,2715000,2011
15885,875000,875000,Derrick Ward,RB,active,houston-texans,1750000,2011
15886,1017280,625000,Rashad Butler,LT,active,houston-texans,1642280,2011
15887,910000,315000,Joel Dreessen,TE,active,houston-texans,1225000,2011
15888,980000,50000,Jason Allen,CB,active,houston-texans,1030000,2011
15889,375000,661867,Brooks Reed,DE,active,houston-texans,1036867,2011
15890,480000,352500,Connor Barwin,OLB,active,houston-texans,832500,2011
15891,525000,201062,Antoine Caldwell,G,active,houston-texans,726062,2011
15892,405000,269250,Ben Tate,RB,active,houston-texans,674250,2011
15893,525000,122562,Glover Quin,FS,active,houston-texans,647562,2011
15894,450000,197125,Earl Mitchell,DT,active,houston-texans,647125,2011
15895,642353,0,Derrick Mason,WR,active,houston-texans,642353,2011
15896,600000,0,Tim Bulman,DT,active,houston-texans,600000,2011
15897,375000,224878,Brandon Harris,CB,active,houston-texans,599878,2011
15898,450000,133735,Darryl Sharpton,ILB,active,houston-texans,583735,2011
15899,525000,46250,James Casey,FB,active,houston-texans,571250,2011
15900,450000,120025,Garrett Graham,TE,active,houston-texans,570025,2011
15901,555000,0,Quintin Demps,SS,active,houston-texans,555000,2011
15902,525000,25437,Brice McCain,CB,active,houston-texans,550437,2011
15903,685000,50000,Kasey Studdard,G,active,houston-texans,735000,2011
15904,525000,0,Arian Foster,RB,active,houston-texans,525000,2011
15905,525000,0,Tim Jamison,DE,active,houston-texans,525000,2011
15906,525000,0,Jesse Nading,DE,active,houston-texans,525000,2011
15907,450000,48000,Sherrick McManis,CB,active,houston-texans,498000,2011
15908,480000,14565,Troy Nolan,S,active,houston-texans,494565,2011
15909,450000,0,Steve Maneri,TE,active,houston-texans,450000,2011
15910,450000,0,Jon Weeks,LS,active,houston-texans,450000,2011
15911,375000,46250,T.J. Yates,QB,active,houston-texans,421250,2011
15912,375000,15064,Derek Newton,RT,active,houston-texans,390064,2011
15913,375000,1667,Lestar Jean,WR,active,houston-texans,376667,2011
15914,375000,667,Bryan Braman,OLB,active,houston-texans,375667,2011
15915,375000,0,Mister Alexander,LB,active,houston-texans,375000,2011
15916,375000,0,Brett Hartmann,P,active,houston-texans,375000,2011
15917,375000,0,Shiloh Keo,SS,active,houston-texans,375000,2011
15918,375000,0,Jeff Maehl,WR,active,houston-texans,375000,2011
15919,258000,99272,Rashad Carmichael,CB,active,houston-texans,357272,2011
15920,273000,0,Shelley Smith,G,active,houston-texans,273000,2011
15921,267647,0,Jake Delhomme,QB,active,houston-texans,267647,2011
15922,1750000,1000000,Matt Leinart,QB,injured_reserve,houston-texans,2750000,2011
15923,96900,0,Cody Wallace,C,practice_squad,houston-texans,96900,2011
15924,0,3335000,Amobi Okoye,DT,dead_cap,houston-texans,3335000,2011
15925,1600000,0,Jacques Reeves,CB,dead_cap,houston-texans,1600000,2011
15926,333333,0,David Anderson,WR,dead_cap,houston-texans,333333,2011
15927,226250,0,Xavier Adibi,LB,dead_cap,houston-texans,226250,2011
15928,187500,0,Antwaun Molden,CB,dead_cap,houston-texans,187500,2011
15929,0,78052,Shelley Smith,G,dead_cap,houston-texans,78052,2011
15930,0,48000,Shiloh Keo,SS,dead_cap,houston-texans,48000,2011
15931,44500,0,Frank Okam,DT,dead_cap,houston-texans,44500,2011
15932,0,24000,Trindon Holliday,KR,dead_cap,houston-texans,24000,2011
15933,0,13403,Dorin Dickerson,TE,dead_cap,houston-texans,13403,2011
15934,0,11475,Cheta Ozougwu,DE,dead_cap,houston-texans,11475,2011
15935,6250,0,Steve Maneri,TE,dead_cap,houston-texans,6250,2011
15936,4400000,9250000,Matt Schaub,QB,active,houston-texans,13650000,2012
15937,5500000,3500000,Antonio Smith,DE,active,houston-texans,9000000,2012
15938,5000000,3000000,Arian Foster,RB,active,houston-texans,8000000,2012
15939,1000000,6694668,Andre Johnson,WR,active,houston-texans,7694668,2012
15940,2250000,5000000,Johnathan Joseph,CB,active,houston-texans,7250000,2012
15941,3500000,2750000,Owen Daniels,TE,active,houston-texans,6250000,2012
15942,3500000,1500000,Danieal Manning,S,active,houston-texans,5000000,2012
15943,1081500,4401500,Duane Brown,LT,active,houston-texans,5483000,2012
15944,2500000,2000000,Chris Myers,C,active,houston-texans,4500000,2012
15945,2000000,750000,Shaun Cody,DT,active,houston-texans,2750000,2012
15946,2000000,1000000,Kevin Walter,WR,active,houston-texans,3000000,2012
15947,2000000,750000,Wade Smith,G,active,houston-texans,2750000,2012
15948,1153000,3000000,Brian Cushing,ILB,active,houston-texans,4153000,2012
15949,885795,1668182,J.J. Watt,DE,active,houston-texans,2553977,2012
15950,700000,2315000,Kareem Jackson,CB,active,houston-texans,3015000,2012
15951,1308000,122562,Glover Quin,FS,active,houston-texans,1430562,2012
15952,390000,998016,Whitney Mercilus,OLB,active,houston-texans,1388016,2012
15953,1308000,25437,Brice McCain,CB,active,houston-texans,1333437,2012
15954,589000,661867,Brooks Reed,DE,active,houston-texans,1250867,2012
15955,565000,352500,Connor Barwin,OLB,active,houston-texans,917500,2012
15956,825000,65000,Donnie Jones,P,active,houston-texans,890000,2012
15957,615000,201062,Antoine Caldwell,G,active,houston-texans,816062,2012
15958,490000,269250,Ben Tate,RB,active,houston-texans,759250,2012
15959,524969,224878,Brandon Harris,CB,active,houston-texans,749847,2012
15960,540000,197125,Earl Mitchell,DT,active,houston-texans,737125,2012
15961,700000,0,Alan Ball,CB,active,houston-texans,700000,2012
15962,700000,0,Quintin Demps,SS,active,houston-texans,700000,2012
15963,700000,0,Tim Dobbins,ILB,active,houston-texans,700000,2012
15964,700000,0,Justin Forsett,RB,active,houston-texans,700000,2012
15965,700000,0,Ryan Harris,LT,active,houston-texans,700000,2012
15966,615000,46250,James Casey,FB,active,houston-texans,661250,2012
15967,540000,120025,Garrett Graham,TE,active,houston-texans,660025,2012
15968,925000,65000,Shayne Graham,K,active,houston-texans,990000,2012
15969,615000,0,Jesse Nading,DE,active,houston-texans,615000,2012
15970,540000,63750,Jon Weeks,LS,active,houston-texans,603750,2012
15971,390000,171023,DeVier Posey,WR,active,houston-texans,561023,2012
15972,390000,154359,Brandon Brooks,G,active,houston-texans,544359,2012
15973,825000,65000,Bradie James,LB,active,houston-texans,890000,2012
15974,825000,0,Barrett Ruud,LB,active,houston-texans,825000,2012
15975,540000,0,Andrew Gardner,G,active,houston-texans,540000,2012
15976,465000,46250,T.J. Yates,QB,active,houston-texans,511250,2012
15977,390000,120362,Ben Jones,C,active,houston-texans,510362,2012
15978,390000,103140,Keshawn Martin,WR,active,houston-texans,493140,2012
15979,390000,99272,Rashad Carmichael,CB,active,houston-texans,489272,2012
15980,390000,97875,Jared Crick,DE,active,houston-texans,487875,2012
15981,465000,15064,Derek Newton,RT,active,houston-texans,480064,2012
15982,465000,667,Bryan Braman,OLB,active,houston-texans,465667,2012
15983,465000,0,Mister Alexander,LB,active,houston-texans,465000,2012
15984,465000,0,Tyler Clutts,FB,active,houston-texans,465000,2012
15985,465000,0,Shiloh Keo,SS,active,houston-texans,465000,2012
15986,390000,44527,Randy Bullock,K,active,houston-texans,434527,2012
15987,390000,1667,Lestar Jean,WR,active,houston-texans,391667,2012
15988,390000,0,Cameron Collins,ILB,active,houston-texans,390000,2012
15989,390000,0,Nate Menkin,G,active,houston-texans,390000,2012
15990,540000,0,Troy Nolan,S,active,houston-texans,540000,2012
15991,268125,0,Cody White,C,active,houston-texans,268125,2012
15992,465000,0,Terrell McClain,DE,active,houston-texans,465000,2012
15993,390000,0,Johnathan Grimes,RB,active,houston-texans,390000,2012
15994,175000,0,John Beck,QB,active,houston-texans,175000,2012
15995,825000,0,Stanford Routt,CB,active,houston-texans,825000,2012
15996,390000,0,Eddie Pleasant,FS,active,houston-texans,390000,2012
15997,1300000,625000,Rashad Butler,LT,injured_reserve,houston-texans,1925000,2012
15998,825000,0,Keyaron Fox,ILB,injured_reserve,houston-texans,825000,2012
15999,640000,110000,Tim Jamison,DE,injured_reserve,houston-texans,750000,2012
16000,390000,0,Ra'Shon Harris,DT,injured_reserve,houston-texans,390000,2012
16001,390000,0,David Hunter,DE,injured_reserve,houston-texans,390000,2012
16002,96900,0,Case Keenum,QB,practice_squad,houston-texans,96900,2012
16003,88400,0,Logan Brock,TE,practice_squad,houston-texans,88400,2012
16004,9000000,0,DeMeco Ryans,ILB,dead_cap,houston-texans,9000000,2012
16005,2000000,0,Eric Winston,RT,dead_cap,houston-texans,2000000,2012
16006,0,3335000,Amobi Okoye,DT,dead_cap,houston-texans,3335000,2012
16007,1000000,0,Jacoby Jones,WR,dead_cap,houston-texans,1000000,2012
16008,1000000,0,Matt Leinart,QB,dead_cap,houston-texans,1000000,2012
16009,800000,0,Dan Orlovsky,QB,dead_cap,houston-texans,800000,2012
16010,250000,0,Lawrence Vickers,FB,dead_cap,houston-texans,250000,2012
16011,168750,48000,Trindon Holliday,KR,dead_cap,houston-texans,216750,2012
16012,166096,0,Steve Slaton,RB,dead_cap,houston-texans,166096,2012
16013,0,144000,Shiloh Keo,SS,dead_cap,houston-texans,144000,2012
16014,124565,0,Troy Nolan,S,dead_cap,houston-texans,124565,2012
16015,65000,0,Moran Norris,RB,dead_cap,houston-texans,65000,2012
16016,0,34425,Cheta Ozougwu,DE,dead_cap,houston-texans,34425,2012
16017,0,26806,Dorin Dickerson,TE,dead_cap,houston-texans,26806,2012
16018,25412,0,Phillip Supernaw,TE,dead_cap,houston-texans,25412,2012
16019,0,24358,Nick Mondek,LT,dead_cap,houston-texans,24358,2012
16020,24000,0,Sherrick McManis,CB,dead_cap,houston-texans,24000,2012
16021,4000,0,Case Keenum,QB,dead_cap,houston-texans,4000,2012
16022,1666,0,Desmond Morrow,CB,dead_cap,houston-texans,1666,2012
16023,834,0,Mister Alexander,LB,dead_cap,houston-texans,834,2012
16024,5000000,7011251,Andre Johnson,WR,active,houston-texans,12011251,2013
16025,7500000,5000000,Johnathan Joseph,CB,active,houston-texans,12500000,2013
16026,7250000,3500000,Matt Schaub,QB,active,houston-texans,10750000,2013
16027,5647059,3500000,Antonio Smith,DE,active,houston-texans,9147059,2013
16028,5250000,3000000,Arian Foster,RB,active,houston-texans,8250000,2013
16029,4000000,2750000,Owen Daniels,TE,active,houston-texans,6750000,2013
16030,3500000,2000000,Chris Myers,C,active,houston-texans,5500000,2013
16031,2500000,2500000,Duane Brown,LT,active,houston-texans,5000000,2013
16032,1143000,4597500,Brian Cushing,ILB,active,houston-texans,5740500,2013
16033,3000000,750000,Wade Smith,G,active,houston-texans,3750000,2013
16034,1396590,1668182,J.J. Watt,DE,active,houston-texans,3064772,2013
16035,995000,2315000,Kareem Jackson,CB,active,houston-texans,3310000,2013
16036,737004,998016,Whitney Mercilus,OLB,active,houston-texans,1735020,2013
16037,405000,981673,DeAndre Hopkins,WR,active,houston-texans,1386673,2013
16038,900000,450000,Brice McCain,CB,active,houston-texans,1350000,2013
16039,1000000,333333,Shane Lechler,P,active,houston-texans,1333333,2013
16040,802000,661867,Brooks Reed,DE,active,houston-texans,1463867,2013
16041,715000,285000,Joe Mays,ILB,active,houston-texans,1000000,2013
16042,840000,160000,Greg Jones,FB,active,houston-texans,1000000,2013
16043,674938,224878,Brandon Harris,CB,active,houston-texans,899816,2013
16044,630000,269250,Ben Tate,RB,active,houston-texans,899250,2013
16045,630000,197125,Earl Mitchell,DT,active,houston-texans,827125,2013
16046,715000,110000,Tim Jamison,DE,active,houston-texans,825000,2013
16047,630000,133735,Darryl Sharpton,ILB,active,houston-texans,763735,2013
16048,630000,120025,Garrett Graham,TE,active,houston-texans,750025,2013
16049,630000,63750,Jon Weeks,LS,active,houston-texans,693750,2013
16050,510000,171023,DeVier Posey,WR,active,houston-texans,681023,2013
16051,500000,154359,Brandon Brooks,G,active,houston-texans,654359,2013
16052,650000,0,Andrew Gardner,G,active,houston-texans,650000,2013
16053,405000,229782,D.J. Swearinger,FS,active,houston-texans,634782,2013
16054,715000,65000,Ryan Harris,LT,active,houston-texans,780000,2013
16055,555000,46250,T.J. Yates,QB,active,houston-texans,601250,2013
16056,480000,120362,Ben Jones,C,active,houston-texans,600362,2013
16057,480000,103140,Keshawn Martin,WR,active,houston-texans,583140,2013
16058,480000,97875,Jared Crick,DE,active,houston-texans,577875,2013
16059,555000,15064,Derek Newton,RT,active,houston-texans,570064,2013
16060,555000,1667,Lestar Jean,WR,active,houston-texans,556667,2013
16061,555000,667,Bryan Braman,OLB,active,houston-texans,555667,2013
16062,555000,0,Shiloh Keo,SS,active,houston-texans,555000,2013
16063,555000,0,Terrell McClain,DE,active,houston-texans,555000,2013
16064,480000,0,Cody White,C,active,houston-texans,480000,2013
16065,405000,44527,Randy Bullock,K,active,houston-texans,449527,2013
16066,405000,19670,Ryan Griffin,TE,active,houston-texans,424670,2013
16067,405000,1666,A.J. Bouye,CB,active,houston-texans,406666,2013
16068,405000,833,Justin Tuggle,ILB,active,houston-texans,405833,2013
16069,405000,0,Case Keenum,QB,active,houston-texans,405000,2013
16070,405000,0,Eddie Pleasant,FS,active,houston-texans,405000,2013
16071,462647,0,Elbert Mack,CB,active,houston-texans,462647,2013
16072,630000,0,Deji Karim,RB,active,houston-texans,630000,2013
16073,405000,28363,David Quessenberry,LT,active,houston-texans,433363,2013
16074,480000,0,Mike Mohamed,ILB,active,houston-texans,480000,2013
16075,555000,0,Jeff Tarpinian,OLB,active,houston-texans,555000,2013
16076,480000,0,Josh Victorian,CB,active,houston-texans,480000,2013
16077,405000,0,Dennis Johnson,RB,active,houston-texans,405000,2013
16078,480000,0,Ricky Sapp,OLB,active,houston-texans,480000,2013
16079,405000,0,Jawanza Starling,S,active,houston-texans,405000,2013
16080,405000,0,Alex Kupper,G,active,houston-texans,405000,2013
16081,480000,0,Brad Smelley,TE,active,houston-texans,480000,2013
16082,480000,0,Johnathan Grimes,RB,active,houston-texans,480000,2013
16083,405000,0,Ray Graham,RB,active,houston-texans,405000,2013
16084,405000,0,Toben Opurum,DE,active,houston-texans,405000,2013
16085,405000,0,Chad Spann,RB,active,houston-texans,405000,2013
16086,405000,0,Phillip Supernaw,TE,active,houston-texans,405000,2013
16087,4000000,1500000,Danieal Manning,S,injured_reserve,houston-texans,5500000,2013
16088,288000,135725,Brennan Williams,RT,injured_reserve,houston-texans,423725,2013
16089,288000,101903,Trevardo Williams,DE,injured_reserve,houston-texans,389903,2013
16090,288000,24250,Alan Bonner,WR,injured_reserve,houston-texans,312250,2013
16091,288000,1000,Alec Lemon,WR,injured_reserve,houston-texans,289000,2013
16092,405000,833,Evan Frierson,ILB,injured_reserve,houston-texans,405833,2013
16093,60000,0,Nathan Overbay,TE,practice_squad,houston-texans,60000,2013
16094,12000,0,Zach Boren,RB,practice_squad,houston-texans,12000,2013
16095,12000,0,Rashad Carmichael,CB,practice_squad,houston-texans,12000,2013
16096,1000000,1770833,Ed Reed,S,dead_cap,houston-texans,2770833,2013
16097,2000000,0,Kevin Walter,WR,dead_cap,houston-texans,2000000,2013
16098,620000,0,Tim Dobbins,ILB,dead_cap,houston-texans,620000,2013
16099,293269,0,Sam Montgomery,DE,dead_cap,houston-texans,293269,2013
16100,169431,0,Cierre Wood,RB,dead_cap,houston-texans,169431,2013
16101,166765,333,Willie Jefferson,OLB,dead_cap,houston-texans,167098,2013
16102,119804,0,Ray Graham,RB,dead_cap,houston-texans,119804,2013
16103,99272,0,Rashad Carmichael,CB,dead_cap,houston-texans,99272,2013
16104,0,73074,Nick Mondek,LT,dead_cap,houston-texans,73074,2013
16105,72000,0,Alex Kupper,G,dead_cap,houston-texans,72000,2013
16106,65294,0,Tavares Gooden,ILB,dead_cap,houston-texans,65294,2013
16107,65294,0,Justin Rogers,LB,dead_cap,houston-texans,65294,2013
16108,65294,0,D.J. Smith,ILB,dead_cap,houston-texans,65294,2013
16109,56824,0,Phillip Supernaw,TE,dead_cap,houston-texans,56824,2013
16110,48000,0,Sherrick McManis,CB,dead_cap,houston-texans,48000,2013
16111,24000,0,Mike Mohamed,ILB,dead_cap,houston-texans,24000,2013
16112,23128,0,Chris Jones,DT,dead_cap,houston-texans,23128,2013
16113,18000,0,Edwin Baker,RB,dead_cap,houston-texans,18000,2013
16114,18000,0,Josh Victorian,CB,dead_cap,houston-texans,18000,2013
16115,12000,0,Chad Spann,RB,dead_cap,houston-texans,12000,2013
16116,8000,0,Case Keenum,QB,dead_cap,houston-texans,8000,2013
16117,6000,0,Brad Smelley,TE,dead_cap,houston-texans,6000,2013
16118,3334,0,Desmond Morrow,CB,dead_cap,houston-texans,3334,2013
16119,2000,0,Uzoma Nwachukwu,WR,dead_cap,houston-texans,2000,2013
16120,1833,0,Earl Okine,DE,dead_cap,houston-texans,1833,2013
16121,1668,0,Mister Alexander,LB,dead_cap,houston-texans,1668,2013
16122,1667,0,Ja'Gared Davis,ILB,dead_cap,houston-texans,1667,2013
16123,1666,0,Johnny  Adams,CB,dead_cap,houston-texans,1666,2013
16124,1333,0,Jawanza Starling,S,dead_cap,houston-texans,1333,2013
16125,1167,0,Travis Howard,CB,dead_cap,houston-texans,1167,2013
16126,1000,0,Bryan Collins,G,dead_cap,houston-texans,1000,2013
16127,833,0,Dennis Johnson,RB,dead_cap,houston-texans,833,2013
16128,666,0,Zach Boren,RB,dead_cap,houston-texans,666,2013
16129,333,0,Andy Cruse,WR,dead_cap,houston-texans,333,2013
16130,333,0,Michael Smith,WR,dead_cap,houston-texans,333,2013
16131,10000000,5844583,Andre Johnson,WR,active,houston-texans,15844583,2014
16132,7500000,5000000,Johnathan Joseph,CB,active,houston-texans,12500000,2014
16133,6000000,2500000,Duane Brown,LT,active,houston-texans,8500000,2014
16134,5750000,2550000,Arian Foster,RB,active,houston-texans,8300000,2014
16135,5000000,2000000,Chris Myers,C,active,houston-texans,7000000,2014
16136,2000000,4935000,Brian Cushing,ILB,active,houston-texans,6935000,2014
16137,907385,3668182,J.J. Watt,DE,active,houston-texans,4575567,2014
16138,3090000,2315000,Kareem Jackson,CB,active,houston-texans,5405000,2014
16139,420000,3629636,Jadeveon Clowney,OLB,active,houston-texans,4049636,2014
16140,1750000,1625000,Ryan Fitzpatrick,QB,active,houston-texans,3375000,2014
16141,1000000,2203125,Garrett Graham,TE,active,houston-texans,3203125,2014
16142,1750000,333333,Shane Lechler,P,active,houston-texans,2083333,2014
16143,1084008,998016,Whitney Mercilus,OLB,active,houston-texans,2082024,2014
16144,751668,981673,DeAndre Hopkins,WR,active,houston-texans,1733341,2014
16145,1016148,661867,Brooks Reed,DE,active,houston-texans,1678015,2014
16146,1431000,15064,Derek Newton,RT,active,houston-texans,1446064,2014
16147,900000,180000,Tyson Clabo,RT,active,houston-texans,1080000,2014
16148,420000,589382,Xavier Su'a-Filo,G,active,houston-texans,1009382,2014
16149,630000,171023,DeVier Posey,WR,active,houston-texans,801023,2014
16150,730000,63750,Jon Weeks,LS,active,houston-texans,793750,2014
16151,563695,229782,D.J. Swearinger,FS,active,houston-texans,793477,2014
16152,776976,0,Ryan Mallett,QB,active,houston-texans,776976,2014
16153,590000,154359,Brandon Brooks,G,active,houston-texans,744359,2014
16154,725000,0,Akeem Dent,ILB,active,houston-texans,725000,2014
16155,570000,120362,Ben Jones,C,active,houston-texans,690362,2014
16156,570000,103140,Keshawn Martin,WR,active,houston-texans,673140,2014
16157,570000,97875,Jared Crick,DE,active,houston-texans,667875,2014
16158,645000,0,Jerrell Powe,DT,active,houston-texans,645000,2014
16159,645000,0,Jeff Tarpinian,OLB,active,houston-texans,645000,2014
16160,730000,65000,Kendrick Lewis,FS,active,houston-texans,795000,2014
16161,570000,44527,Randy Bullock,K,active,houston-texans,614527,2014
16162,420000,175826,C.J. Fiedorowicz,TE,active,houston-texans,595826,2014
16163,855000,0,Danieal Manning,S,active,houston-texans,855000,2014
16164,570000,0,Damaris Johnson,WR,active,houston-texans,570000,2014
16165,570000,0,Mike Mohamed,ILB,active,houston-texans,570000,2014
16166,495000,19670,Ryan Griffin,TE,active,houston-texans,514670,2014
16167,495000,1666,A.J. Bouye,CB,active,houston-texans,496666,2014
16168,495000,833,Justin Tuggle,ILB,active,houston-texans,495833,2014
16169,420000,75146,Tom Savage,QB,active,houston-texans,495146,2014
16170,495000,0,Johnathan Grimes,RB,active,houston-texans,495000,2014
16171,495000,0,Darryl Morris,CB,active,houston-texans,495000,2014
16172,495000,0,Eddie Pleasant,FS,active,houston-texans,495000,2014
16173,955000,0,Ryan Pickett,DT,active,houston-texans,955000,2014
16174,323647,143813,Louis Nix,DT,active,houston-texans,467460,2014
16175,420000,32205,Jeoffrey Pagan,DE,active,houston-texans,452205,2014
16176,420000,29483,Alfred Blue,RB,active,houston-texans,449483,2014
16177,420000,28363,David Quessenberry,LT,active,houston-texans,448363,2014
16178,420000,19670,Jay Prosch,FB,active,houston-texans,439670,2014
16179,420000,17281,Andre Hal,FS,active,houston-texans,437281,2014
16180,420000,0,Jeff Adams,G,active,houston-texans,420000,2014
16181,495000,0,Josh Aubrey,SS,active,houston-texans,495000,2014
16182,495000,0,John Simon,OLB,active,houston-texans,495000,2014
16183,420000,0,Jumal Rolle,CB,active,houston-texans,420000,2014
16184,303000,11474,Lonnie Ballentine,FS,active,houston-texans,314474,2014
16185,303000,2666,Bryan Witzmann,G,active,houston-texans,305666,2014
16186,645000,0,Thaddeus Lewis,QB,active,houston-texans,645000,2014
16187,420000,0,Max Bullough,ILB,active,houston-texans,420000,2014
16188,420000,0,Anthony Denham,TE,active,houston-texans,420000,2014
16189,420000,0,Jason Ankrah,DE,active,houston-texans,420000,2014
16190,420000,0,Keith Browner,DE,active,houston-texans,420000,2014
16191,495000,0,Case Keenum,QB,active,houston-texans,495000,2014
16192,645000,210000,Will Yeatman,LT,injured_reserve,houston-texans,855000,2014
16193,730000,110000,Tim Jamison,DE,injured_reserve,houston-texans,840000,2014
16194,570000,0,Cody White,C,injured_reserve,houston-texans,570000,2014
16195,303000,24250,Alan Bonner,WR,injured_reserve,houston-texans,327250,2014
16196,107100,0,Matt Feiler,RT,practice_squad,houston-texans,107100,2014
16197,107100,0,James Ferentz,C,practice_squad,houston-texans,107100,2014
16198,107100,0,Alex Kupper,G,practice_squad,houston-texans,107100,2014
16199,81900,0,Charles James,CB,practice_squad,houston-texans,81900,2014
16200,81900,0,Travis Labhart,WR,practice_squad,houston-texans,81900,2014
16201,56700,0,Ben Malena,RB,practice_squad,houston-texans,56700,2014
16202,31500,0,Terrance Parks,SS,practice_squad,houston-texans,31500,2014
16203,25200,0,Jace Davis,WR,practice_squad,houston-texans,25200,2014
16204,18900,0,Kourtnei Brown,OLB,practice_squad,houston-texans,18900,2014
16205,12600,0,Uzoma Nwachukwu,WR,practice_squad,houston-texans,12600,2014
16206,12600,0,Ricky Stanzi,QB,practice_squad,houston-texans,12600,2014
16207,10500000,0,Matt Schaub,QB,dead_cap,houston-texans,10500000,2014
16208,0,2666667,Ed Reed,S,dead_cap,houston-texans,2666667,2014
16209,0,2750000,Owen Daniels,TE,dead_cap,houston-texans,2750000,2014
16210,1500000,0,Danieal Manning,S,dead_cap,houston-texans,1500000,2014
16211,900000,0,Brice McCain,CB,dead_cap,houston-texans,900000,2014
16212,730000,65000,Elbert Mack,CB,dead_cap,houston-texans,795000,2014
16213,570000,0,Ronnie Brown,RB,dead_cap,houston-texans,570000,2014
16214,379512,0,Sam Montgomery,DE,dead_cap,houston-texans,379512,2014
16215,0,350000,Chris Clemons,FS,dead_cap,houston-texans,350000,2014
16216,301765,0,Ricky Sapp,OLB,dead_cap,houston-texans,301765,2014
16217,0,224878,Brandon Harris,CB,dead_cap,houston-texans,224878,2014
16218,151765,0,Shiloh Keo,SS,dead_cap,houston-texans,151765,2014
16219,0,135725,Brennan Williams,RT,dead_cap,houston-texans,135725,2014
16220,106112,500,Jason Ankrah,DE,dead_cap,houston-texans,106612,2014
16221,0,101903,Trevardo Williams,DE,dead_cap,houston-texans,101903,2014
16222,99272,0,Rashad Carmichael,CB,dead_cap,houston-texans,99272,2014
16223,88200,0,Keith Browner,DE,dead_cap,houston-texans,88200,2014
16224,81900,1000,Anthony Denham,TE,dead_cap,houston-texans,82900,2014
16225,69384,0,Chris Jones,DT,dead_cap,houston-texans,69384,2014
16226,67059,0,Zac Diles,ILB,dead_cap,houston-texans,67059,2014
16227,63000,1000,Max Bullough,ILB,dead_cap,houston-texans,64000,2014
16228,0,46250,T.J. Yates,QB,dead_cap,houston-texans,46250,2014
16229,31500,0,Toben Opurum,DE,dead_cap,houston-texans,31500,2014
16230,29200,0,Uzoma Nwachukwu,WR,dead_cap,houston-texans,29200,2014
16231,25200,0,Kendall James,CB,dead_cap,houston-texans,25200,2014
16232,12600,7000,Chris Martin,RT,dead_cap,houston-texans,19600,2014
16233,18900,666,Marcus Williams,CB,dead_cap,houston-texans,19566,2014
16234,12600,1000,Travis Labhart,WR,dead_cap,houston-texans,13600,2014
16235,12600,0,Josh Aubrey,SS,dead_cap,houston-texans,12600,2014
16236,6300,1000,Chris Boswell,K,dead_cap,houston-texans,7300,2014
16237,5334,0,Cierre Wood,RB,dead_cap,houston-texans,5334,2014
16238,3667,0,Earl Okine,DE,dead_cap,houston-texans,3667,2014
16239,3334,0,Johnny  Adams,CB,dead_cap,houston-texans,3334,2014
16240,3334,0,Ja'Gared Davis,ILB,dead_cap,houston-texans,3334,2014
16241,2667,0,Jawanza Starling,S,dead_cap,houston-texans,2667,2014
16242,2334,0,Travis Howard,CB,dead_cap,houston-texans,2334,2014
16243,2000,0,Bryan Collins,G,dead_cap,houston-texans,2000,2014
16244,1667,0,Evan Frierson,ILB,dead_cap,houston-texans,1667,2014
16245,1667,0,Dennis Johnson,RB,dead_cap,houston-texans,1667,2014
16246,0,1666,Matt Feiler,RT,dead_cap,houston-texans,1666,2014
16247,0,1666,Sullivan Grosz,DT,dead_cap,houston-texans,1666,2014
16248,0,1500,Nathan Slaughter,WR,dead_cap,houston-texans,1500,2014
16249,1334,0,Zach Boren,RB,dead_cap,houston-texans,1334,2014
16250,0,1333,Anthony McClung,WR,dead_cap,houston-texans,1333,2014
16251,0,1000,Tyrone Ezell,DT,dead_cap,houston-texans,1000,2014
16252,0,1000,Alec Lemon,WR,dead_cap,houston-texans,1000,2014
16253,0,1000,Chris Young,ILB,dead_cap,houston-texans,1000,2014
16254,0,667,Willie Jefferson,OLB,dead_cap,houston-texans,667,2014
16255,667,0,Andy Cruse,WR,dead_cap,houston-texans,667,2014
16256,667,0,Ray Graham,RB,dead_cap,houston-texans,667,2014
16257,667,0,Michael Smith,WR,dead_cap,houston-texans,667,2014
16258,0,666,Terrance Lloyd,OLB,dead_cap,houston-texans,666,2014
16259,0,666,Chris McAlister,DE,dead_cap,houston-texans,666,2014
16260,0,500,Austin Brown,DT,dead_cap,houston-texans,500,2014
16261,0,333,Chris Coyle,TE,dead_cap,houston-texans,333,2014
16262,9969000,4000000,J.J. Watt,DE,active,houston-texans,13969000,2015
16263,7000000,6000000,Johnathan Joseph,CB,active,houston-texans,13000000,2015
16264,4000000,5091250,Brian Cushing,ILB,active,houston-texans,9091250,2015
16265,1000000,6453125,Kareem Jackson,CB,active,houston-texans,7453125,2015
16266,1000000,4218750,Brian Hoyer,QB,active,houston-texans,5218750,2015
16267,510000,4552045,Jadeveon Clowney,OLB,active,houston-texans,5062045,2015
16268,1500000,3000000,Derek Newton,RT,active,houston-texans,4500000,2015
16269,3000000,921875,Garrett Graham,TE,active,houston-texans,3921875,2015
16270,1000000,2500000,Vince Wilfork,DT,active,houston-texans,3500000,2015
16271,1000000,2000000,Rahim Moore,FS,active,houston-texans,3000000,2015
16272,931012,2048018,Whitney Mercilus,OLB,active,houston-texans,2979030,2015
16273,1000000,1453125,Cecil Shorts,WR,active,houston-texans,2453125,2015
16274,1750000,333334,Shane Lechler,P,active,houston-texans,2083334,2015
16275,1098337,981673,DeAndre Hopkins,WR,active,houston-texans,2080010,2015
16276,435000,1392166,Kevin Johnson,CB,active,houston-texans,1827166,2015
16277,1100000,609375,Akeem Dent,ILB,active,houston-texans,1709375,2015
16278,1542000,154359,Brandon Brooks,G,active,houston-texans,1696359,2015
16279,1542000,120362,Ben Jones,C,active,houston-texans,1662362,2015
16280,1542000,97875,Jared Crick,DE,active,houston-texans,1639875,2015
16281,1400000,0,Chris Clark,LT,active,houston-texans,1400000,2015
16282,672345,589382,Xavier Su'a-Filo,G,active,houston-texans,1261727,2015
16283,435000,536840,Benardrick McKinney,ILB,active,houston-texans,971840,2015
16284,825000,113750,Jon Weeks,LS,active,houston-texans,938750,2015
16285,660000,87500,Chris Polk,RB,active,houston-texans,747500,2015
16286,555000,175826,C.J. Fiedorowicz,TE,active,houston-texans,730826,2015
16287,435000,192995,Jaelen Strong,WR,active,houston-texans,627995,2015
16288,970000,30000,Nate Washington,WR,active,houston-texans,1000000,2015
16289,585000,1668,A.J. Bouye,CB,active,houston-texans,586668,2015
16290,585000,834,Justin Tuggle,ILB,active,houston-texans,585834,2015
16291,870000,0,Quintin Demps,SS,active,houston-texans,870000,2015
16292,585000,0,Johnathan Grimes,RB,active,houston-texans,585000,2015
16293,585000,0,Darryl Morris,CB,active,houston-texans,585000,2015
16294,585000,0,Eddie Pleasant,FS,active,houston-texans,585000,2015
16295,585000,0,John Simon,OLB,active,houston-texans,585000,2015
16296,550588,0,Oday Aboushi,G,active,houston-texans,550588,2015
16297,510000,32205,Jeoffrey Pagan,DE,active,houston-texans,542205,2015
16298,510000,29483,Alfred Blue,RB,active,houston-texans,539483,2015
16299,510000,19670,Jay Prosch,FB,active,houston-texans,529670,2015
16300,510000,17281,Andre Hal,FS,active,houston-texans,527281,2015
16301,716470,0,Nick Novak,K,active,houston-texans,716470,2015
16302,435000,41563,Keith Mumphery,WR,active,houston-texans,476563,2015
16303,435000,25075,Reshard Cliett,OLB,active,houston-texans,460075,2015
16304,435000,22621,Christian Covington,DE,active,houston-texans,457621,2015
16305,435000,666,Kendall Lamm,RT,active,houston-texans,435666,2015
16306,420000,0,Max Bullough,ILB,active,houston-texans,420000,2015
16307,333000,75146,Tom Savage,QB,active,houston-texans,408146,2015
16308,361941,19670,Ryan Griffin,TE,active,houston-texans,381611,2015
16309,360000,0,Brandon Dunn,DE,active,houston-texans,360000,2015
16310,358235,0,Brian Peters,ILB,active,houston-texans,358235,2015
16311,353823,0,Jeff Adams,G,active,houston-texans,353823,2015
16312,338647,833,Carlos Thompson,OLB,active,houston-texans,339480,2015
16313,333000,0,Anthony Denham,TE,active,houston-texans,333000,2015
16314,318000,1666,Chad Slade,G,active,houston-texans,319666,2015
16315,271764,0,Brandon Weeden,QB,active,houston-texans,271764,2015
16316,255882,1666,Kurtis Drummond,SS,active,houston-texans,257548,2015
16317,179117,0,Akeem Hunt,RB,active,houston-texans,179117,2015
16318,60000,0,B.J. Daniels,WR,active,houston-texans,60000,2015
16319,25588,0,Corey Moore,SS,active,houston-texans,25588,2015
16320,7000000,2500000,Duane Brown,LT,injured_reserve,houston-texans,9500000,2015
16321,6000000,2706250,Arian Foster,RB,injured_reserve,houston-texans,8706250,2015
16322,373058,2000,Greg Mancz,C,injured_reserve,houston-texans,375058,2015
16323,359294,11474,Lonnie Ballentine,FS,injured_reserve,houston-texans,370768,2015
16324,438235,0,T.J. Yates,QB,injured_reserve,houston-texans,438235,2015
16325,330000,0,Charles James,CB,injured_reserve,houston-texans,330000,2015
16326,0,7719583,Andre Johnson,WR,dead_cap,houston-texans,7719583,2015
16327,2500000,437500,Ryan Mallett,QB,dead_cap,houston-texans,2937500,2015
16328,0,2000000,Chris Myers,C,dead_cap,houston-texans,2000000,2015
16329,0,625000,Ryan Fitzpatrick,QB,dead_cap,houston-texans,625000,2015
16330,0,459564,D.J. Swearinger,FS,dead_cap,houston-texans,459564,2015
16331,324000,0,James Rouse,DE,dead_cap,houston-texans,324000,2015
16332,300000,0,Jumal Rolle,CB,dead_cap,houston-texans,300000,2015
16333,271764,0,Mike Mohamed,ILB,dead_cap,houston-texans,271764,2015
16334,0,271450,Brennan Williams,RT,dead_cap,houston-texans,271450,2015
16335,204705,0,Kourtnei Brown,OLB,dead_cap,houston-texans,204705,2015
16336,0,203806,Trevardo Williams,DE,dead_cap,houston-texans,203806,2015
16337,188152,1000,Chandler Worthy,WR,dead_cap,houston-texans,189152,2015
16338,0,171023,DeVier Posey,WR,dead_cap,houston-texans,171023,2015
16339,116470,44527,Randy Bullock,K,dead_cap,houston-texans,160997,2015
16340,0,143813,Louis Nix,DT,dead_cap,houston-texans,143813,2015
16341,38823,103140,Keshawn Martin,WR,dead_cap,houston-texans,141963,2015
16342,112200,16344,Kenny Hilliard,RB,dead_cap,houston-texans,128544,2015
16343,112200,1000,Dan Pettinato,DT,dead_cap,houston-texans,113200,2015
16344,112200,0,Karim Barton,G,dead_cap,houston-texans,112200,2015
16345,112200,0,Eric Tomlinson,TE,dead_cap,houston-texans,112200,2015
16346,105600,0,Corey Moore,SS,dead_cap,houston-texans,105600,2015
16347,0,100000,Tyson Clabo,RT,dead_cap,houston-texans,100000,2015
16348,0,100000,Chris Clemons,FS,dead_cap,houston-texans,100000,2015
16349,100000,0,Damaris Johnson,WR,dead_cap,houston-texans,100000,2015
16350,79200,0,Josh Lenz,WR,dead_cap,houston-texans,79200,2015
16351,68471,0,Will Yeatman,LT,dead_cap,houston-texans,68471,2015
16352,66000,0,Zac Dysert,QB,dead_cap,houston-texans,66000,2015
16353,33000,24250,Alan Bonner,WR,dead_cap,houston-texans,57250,2015
16354,0,50000,Jeff Tarpinian,OLB,dead_cap,houston-texans,50000,2015
16355,46294,3333,Lynden Trail,OLB,dead_cap,houston-texans,49627,2015
16356,46200,1666,Kurtis Drummond,SS,dead_cap,houston-texans,47866,2015
16357,46200,0,Steven Means,DE,dead_cap,houston-texans,46200,2015
16358,39494,2500,Tony Washington,OLB,dead_cap,houston-texans,41994,2015
16359,0,40000,Stevie Brown,SS,dead_cap,houston-texans,40000,2015
16360,39600,0,Dalton Freeman,C,dead_cap,houston-texans,39600,2015
16361,39600,0,Gerald Rivers,DE,dead_cap,houston-texans,39600,2015
16362,33000,0,Daryl Richardson,RB,dead_cap,houston-texans,33000,2015
16363,26400,0,J.J. Worton,WR,dead_cap,houston-texans,26400,2015
16364,19800,2000,Max Bullough,ILB,dead_cap,houston-texans,21800,2015
16365,18705,1666,Mike McFarland,TE,dead_cap,houston-texans,20371,2015
16366,19800,0,Edawn Coughman,LT,dead_cap,houston-texans,19800,2015
16367,13200,0,Jordan Dewalt-Ondijo,DE,dead_cap,houston-texans,13200,2015
16368,13200,0,Akeem Hunt,RB,dead_cap,houston-texans,13200,2015
16369,0,7000,Jake Cotton,G,dead_cap,houston-texans,7000,2015
16370,6600,0,Robert Nelson,CB,dead_cap,houston-texans,6600,2015
16371,6600,0,Joseph Treadwell,T,dead_cap,houston-texans,6600,2015
16372,0,3334,Matt Feiler,RT,dead_cap,houston-texans,3334,2015
16373,0,3334,Sullivan Grosz,DT,dead_cap,houston-texans,3334,2015
16374,0,2667,Anthony McClung,WR,dead_cap,houston-texans,2667,2015
16375,0,2666,Bryan Witzmann,G,dead_cap,houston-texans,2666,2015
16376,0,2000,Chris Boswell,K,dead_cap,houston-texans,2000,2015
16377,0,2000,Anthony Denham,TE,dead_cap,houston-texans,2000,2015
16378,0,2000,Tyrone Ezell,DT,dead_cap,houston-texans,2000,2015
16379,0,2000,Travis Labhart,WR,dead_cap,houston-texans,2000,2015
16380,0,2000,Chris Young,ILB,dead_cap,houston-texans,2000,2015
16381,0,1666,Brandon Ivory,DT,dead_cap,houston-texans,1666,2015
16382,0,1334,Terrance Lloyd,OLB,dead_cap,houston-texans,1334,2015
16383,0,1334,Chris McAlister,DE,dead_cap,houston-texans,1334,2015
16384,0,1334,Marcus Williams,CB,dead_cap,houston-texans,1334,2015
16385,0,1000,Jason Ankrah,DE,dead_cap,houston-texans,1000,2015
16386,0,1000,Austin Brown,DT,dead_cap,houston-texans,1000,2015
16387,0,1000,Will Johnson,T,dead_cap,houston-texans,1000,2015
16388,0,1000,Alec Lemon,WR,dead_cap,houston-texans,1000,2015
16389,0,1000,Cameron McLeod,DT,dead_cap,houston-texans,1000,2015
16390,0,667,Chris Coyle,TE,dead_cap,houston-texans,667,2015
16391,0,666,Khari Lee,TE,dead_cap,houston-texans,666,2015
16392,4000000,8000000,Brock Osweiler,QB,active,houston-texans,12000000,2016
16393,7000000,2500000,Duane Brown,LT,active,houston-texans,9500000,2016
16394,5000000,5247500,Brian Cushing,ILB,active,houston-texans,10247500,2016
16395,6000000,2437500,Kareem Jackson,CB,active,houston-texans,8437500,2016
16396,6500000,500000,Johnathan Joseph,CB,active,houston-texans,7000000,2016
16397,2000000,4250000,Jeff Allen,G,active,houston-texans,6250000,2016
16398,600000,5474454,Jadeveon Clowney,OLB,active,houston-texans,6074454,2016
16399,4500000,1284375,Whitney Mercilus,OLB,active,houston-texans,5784375,2016
16400,4000000,1500000,Vince Wilfork,DT,active,houston-texans,5500000,2016
16401,1000000,4500000,Lamar Miller,RB,active,houston-texans,5500000,2016
16402,1500000,1250000,Chris Clark,LT,active,houston-texans,2750000,2016
16403,2000000,625000,Akeem Dent,ILB,active,houston-texans,2625000,2016
16404,1125000,1375000,Tony Bergstrom,C,active,houston-texans,2500000,2016
16405,1000000,1426678,DeAndre Hopkins,WR,active,houston-texans,2426678,2016
16406,450000,1398057,Will Fuller,WR,active,houston-texans,1848057,2016
16407,1300000,500000,Shane Lechler,P,active,houston-texans,1800000,2016
16408,800000,937500,Brandon Weeden,QB,active,houston-texans,1737500,2016
16409,1671000,0,A.J. Bouye,CB,active,houston-texans,1671000,2016
16410,1671000,0,John Simon,OLB,active,houston-texans,1671000,2016
16411,924691,589382,Xavier Su'a-Filo,G,active,houston-texans,1514073,2016
16412,1000000,470000,Quintin Demps,SS,active,houston-texans,1470000,2016
16413,677961,536840,Benardrick McKinney,ILB,active,houston-texans,1214801,2016
16414,725000,311000,Eddie Pleasant,FS,active,houston-texans,1036000,2016
16415,700000,200000,Johnathan Grimes,RB,active,houston-texans,900000,2016
16416,825000,50000,Jon Weeks,LS,active,houston-texans,875000,2016
16417,685000,175826,C.J. Fiedorowicz,TE,active,houston-texans,860826,2016
16418,811176,0,Antonio Smith,DE,active,houston-texans,811176,2016
16419,675000,19670,Ryan Griffin,TE,active,houston-texans,694670,2016
16420,885000,80000,Nick Novak,K,active,houston-texans,965000,2016
16421,600000,75146,Tom Savage,QB,active,houston-texans,675146,2016
16422,675000,0,Oday Aboushi,G,active,houston-texans,675000,2016
16423,600000,29483,Alfred Blue,RB,active,houston-texans,629483,2016
16424,600000,19670,Jay Prosch,FB,active,houston-texans,619670,2016
16425,600000,17281,Andre Hal,FS,active,houston-texans,617281,2016
16426,600000,0,Max Bullough,ILB,active,houston-texans,600000,2016
16427,450000,136892,Tyler Ervin,RB,active,houston-texans,586892,2016
16428,525000,41563,Keith Mumphery,WR,active,houston-texans,566563,2016
16429,525000,22622,Christian Covington,DE,active,houston-texans,547622,2016
16430,525000,2000,Greg Mancz,C,active,houston-texans,527000,2016
16431,525000,666,Kendall Lamm,RT,active,houston-texans,525666,2016
16432,525000,0,Brian Peters,ILB,active,houston-texans,525000,2016
16433,450000,53845,D.J. Reader,DT,active,houston-texans,503845,2016
16434,450000,3666,Joel Heath,DE,active,houston-texans,453666,2016
16435,450000,1666,Stephen Anderson,TE,active,houston-texans,451666,2016
16436,450000,0,Corey Moore,SS,active,houston-texans,450000,2016
16437,436764,0,Don Jones,FS,active,houston-texans,436764,2016
16438,423529,0,Robert Nelson,CB,active,houston-texans,423529,2016
16439,374288,1666,Brennan Scarlett,OLB,active,houston-texans,375954,2016
16440,247058,0,Josh Walker,G,active,houston-texans,247058,2016
16441,247056,0,Akeem Hunt,RB,active,houston-texans,247056,2016
16442,158820,0,Ufomba Kamalu,DE,active,houston-texans,158820,2016
16443,123528,0,Denzel Rice,CB,active,houston-texans,123528,2016
16444,79410,0,Wendell Williams,WR,active,houston-texans,79410,2016
16445,10500000,4000000,J.J. Watt,DE,injured_reserve,houston-texans,14500000,2016
16446,4750000,750000,Derek Newton,RT,injured_reserve,houston-texans,5500000,2016
16447,891791,1392166,Kevin Johnson,CB,injured_reserve,houston-texans,2283957,2016
16448,450000,418177,Nick Martin,C,injured_reserve,houston-texans,868177,2016
16449,570000,192995,Jaelen Strong,WR,injured_reserve,houston-texans,762995,2016
16450,675000,0,Devon Still,DT,injured_reserve,houston-texans,675000,2016
16451,450000,177275,Braxton Miller,WR,injured_reserve,houston-texans,627275,2016
16452,525000,11474,Lonnie Ballentine,FS,injured_reserve,houston-texans,536474,2016
16453,525000,1666,Kurtis Drummond,SS,injured_reserve,houston-texans,526666,2016
16454,450000,0,Ka'imi Fairbairn,K,injured_reserve,houston-texans,450000,2016
16455,450000,0,Gerald Rivers,DE,injured_reserve,houston-texans,450000,2016
16456,450000,0,Tony Washington,OLB,injured_reserve,houston-texans,450000,2016
16457,374288,58734,K.J. Dillon,S,injured_reserve,houston-texans,433022,2016
16458,0,28363,David Quessenberry,LT,non_fb_injury,houston-texans,28363,2016
16459,89700,0,Dan Pettinato,DT,practice_squad,houston-texans,89700,2016
16460,0,2300000,Arian Foster,RB,dead_cap,houston-texans,2300000,2016
16461,0,2000000,Rahim Moore,FS,dead_cap,houston-texans,2000000,2016
16462,0,750000,Garrett Graham,TE,dead_cap,houston-texans,750000,2016
16463,0,700000,Cecil Shorts,WR,dead_cap,houston-texans,700000,2016
16464,458822,0,Charles James,CB,dead_cap,houston-texans,458822,2016
16465,0,287626,Louis Nix,DT,dead_cap,houston-texans,287626,2016
16466,280764,0,Brandon Dunn,DE,dead_cap,houston-texans,280764,2016
16467,202400,0,Brennan Williams,RT,dead_cap,houston-texans,202400,2016
16468,176294,666,Richard Leonard,CB,dead_cap,houston-texans,176960,2016
16469,141176,32205,Jeoffrey Pagan,DE,dead_cap,houston-texans,173381,2016
16470,117300,3333,Shakeel Rashad,ILB,dead_cap,houston-texans,120633,2016
16471,117300,1666,Chad Slade,G,dead_cap,houston-texans,118966,2016
16472,117300,0,Eric Lee,DE,dead_cap,houston-texans,117300,2016
16473,116964,0,Jeff Adams,G,dead_cap,houston-texans,116964,2016
16474,48300,49034,Kenny Hilliard,RB,dead_cap,houston-texans,97334,2016
16475,0,80000,Antonio Allen,CB,dead_cap,houston-texans,80000,2016
16476,75900,1666,Ufomba Kamalu,DE,dead_cap,houston-texans,77566,2016
16477,62100,0,Quenton Bundrage,WR,dead_cap,houston-texans,62100,2016
16478,62100,0,Akeem Hunt,RB,dead_cap,houston-texans,62100,2016
16479,55200,0,Rashaun Allen,TE,dead_cap,houston-texans,55200,2016
16480,55200,0,Eric Tomlinson,TE,dead_cap,houston-texans,55200,2016
16481,48300,0,Joseph Cheek,T,dead_cap,houston-texans,48300,2016
16482,48300,0,Denzel Rice,CB,dead_cap,houston-texans,48300,2016
16483,34500,1666,Wendell Williams,WR,dead_cap,houston-texans,36166,2016
16484,34500,0,Robert Nelson,CB,dead_cap,houston-texans,34500,2016
16485,26470,0,Al-Hajj Shabazz,CB,dead_cap,houston-texans,26470,2016
16486,26470,0,Soma Vainuku,FB,dead_cap,houston-texans,26470,2016
16487,0,24250,Alan Bonner,WR,dead_cap,houston-texans,24250,2016
16488,20700,333,Tevin Jones,WR,dead_cap,houston-texans,21033,2016
16489,20700,0,Laurence Gibson,T,dead_cap,houston-texans,20700,2016
16490,20470,0,Dalton Freeman,C,dead_cap,houston-texans,20470,2016
16491,13800,0,Josh Walker,G,dead_cap,houston-texans,13800,2016
16492,0,6667,Lynden Trail,OLB,dead_cap,houston-texans,6667,2016
16493,0,5000,Tony Washington,OLB,dead_cap,houston-texans,5000,2016
16494,0,3334,Kurtis Drummond,SS,dead_cap,houston-texans,3334,2016
16495,0,3334,Brandon Ivory,DT,dead_cap,houston-texans,3334,2016
16496,0,3334,Mike McFarland,TE,dead_cap,houston-texans,3334,2016
16497,0,2667,Bryan Witzmann,G,dead_cap,houston-texans,2667,2016
16498,0,2000,Will Johnson,T,dead_cap,houston-texans,2000,2016
16499,0,2000,Cameron McLeod,DT,dead_cap,houston-texans,2000,2016
16500,0,2000,Dan Pettinato,DT,dead_cap,houston-texans,2000,2016
16501,0,2000,Chandler Worthy,WR,dead_cap,houston-texans,2000,2016
16502,0,1666,Ra'Zahn Howard,DT,dead_cap,houston-texans,1666,2016
16503,0,1500,Duke Thomas,S,dead_cap,houston-texans,1500,2016
16504,0,1334,Khari Lee,TE,dead_cap,houston-texans,1334,2016
16505,0,1166,Cleveland Wallace,CB,dead_cap,houston-texans,1166,2016
16506,0,833,Carlos Thompson,OLB,dead_cap,houston-texans,833,2016
16507,0,500,Richard Mullaney,WR,dead_cap,houston-texans,500,2016
16508,8000000,10000000,DeAndre Hopkins,WR,active,houston-texans,18000000,2017
16509,6500000,2468750,Kareem Jackson,CB,active,houston-texans,8968750,2017
16510,690000,6396863,Jadeveon Clowney,OLB,active,houston-texans,7086863,2017
16511,6500000,406250,Johnathan Joseph,CB,active,houston-texans,6906250,2017
16512,5500000,1000000,Lamar Miller,RB,active,houston-texans,6500000,2017
16513,4750000,1687500,Jeff Allen,G,active,houston-texans,6437500,2017
16514,2264706,5013125,Brian Cushing,ILB,active,houston-texans,7277831,2017
16515,1797000,3767281,Andre Hal,FS,active,houston-texans,5564281,2017
16516,1200000,1612500,Marcus Gilchrist,SS,active,houston-texans,2812500,2017
16517,1348583,1392166,Kevin Johnson,CB,active,houston-texans,2740749,2017
16518,1000000,1312500,Breno Giacomini,RT,active,houston-texans,2312500,2017
16519,912014,1398057,Will Fuller,WR,active,houston-texans,2310071,2017
16520,1500000,500000,Shane Lechler,P,active,houston-texans,2000000,2017
16521,1938348,0,Marcus Williams,CB,active,houston-texans,1938348,2017
16522,1177036,589382,Xavier Su'a-Filo,G,active,houston-texans,1766418,2017
16523,690000,1019670,Jay Prosch,FB,active,houston-texans,1709670,2017
16524,920921,536840,Benardrick McKinney,ILB,active,houston-texans,1457761,2017
16525,1078000,31500,Eddie Pleasant,FS,active,houston-texans,1109500,2017
16526,900000,50000,Jon Weeks,LS,active,houston-texans,950000,2017
16527,465000,348044,Zach Cunningham,ILB,active,houston-texans,813044,2017
16528,557500,177275,Braxton Miller,WR,active,houston-texans,734775,2017
16529,690000,29483,Alfred Blue,RB,active,houston-texans,719483,2017
16530,690000,0,Brandon Dunn,DE,active,houston-texans,690000,2017
16531,615000,2000,Greg Mancz,C,active,houston-texans,617000,2017
16532,775000,0,Jordan Todman,RB,active,houston-texans,775000,2017
16533,615000,0,Brian Peters,ILB,active,houston-texans,615000,2017
16534,465000,146605,Julie'n Davenport,T,active,houston-texans,611605,2017
16535,465000,104912,Carlos Watkins,DT,active,houston-texans,569912,2017
16536,540000,3666,Joel Heath,DE,active,houston-texans,543666,2017
16537,540000,1666,Stephen Anderson,TE,active,houston-texans,541666,2017
16538,540000,0,Ufomba Kamalu,DE,active,houston-texans,540000,2017
16539,465000,62337,Treston Decoud,S,active,houston-texans,527337,2017
16540,465000,17304,Kyle Fuller,C,active,houston-texans,482304,2017
16541,465000,4000,Dylan Cole,ILB,active,houston-texans,469000,2017
16542,465000,2500,Ka'imi Fairbairn,K,active,houston-texans,467500,2017
16543,410294,0,T.J. Yates,QB,active,houston-texans,410294,2017
16544,382942,0,Chris Thompson,WR,active,houston-texans,382942,2017
16545,381176,0,Kurtis Drummond,SS,active,houston-texans,381176,2017
16546,455880,0,Jelani Jenkins,OLB,active,houston-texans,455880,2017
16547,325588,0,Angelo Blackson,DE,active,houston-texans,325588,2017
16548,325588,0,Kendall Lamm,RT,active,houston-texans,325588,2017
16549,273529,0,Andre Ellington,RB,active,houston-texans,273529,2017
16550,190590,0,Cobi Hamilton,WR,active,houston-texans,190590,2017
16551,136765,0,LaTroy Lewis,ILB,active,houston-texans,136765,2017
16552,136765,0,Gimel President,OLB,active,houston-texans,136765,2017
16553,136765,0,Chad Slade,G,active,houston-texans,136765,2017
16554,109412,0,DeAndrew White,WR,active,houston-texans,109412,2017
16555,108529,0,Taylor Heinicke,QB,active,houston-texans,108529,2017
16556,72353,0,Ibraheim Campbell,SS,active,houston-texans,72353,2017
16557,54706,0,Jarrod Clements,DT,active,houston-texans,54706,2017
16558,54706,0,Ryan Malleck,TE,active,houston-texans,54706,2017
16559,54706,0,David Quessenberry,LT,active,houston-texans,54706,2017
16560,52941,0,Josh Johnson,QB,active,houston-texans,52941,2017
16561,10500000,4000000,J.J. Watt,DE,injured_reserve,houston-texans,14500000,2017
16562,3097000,3300826,C.J. Fiedorowicz,TE,injured_reserve,houston-texans,6397826,2017
16563,4500000,1518750,Whitney Mercilus,OLB,injured_reserve,houston-texans,6018750,2017
16564,875000,2625000,Ryan Griffin,TE,injured_reserve,houston-texans,3500000,2017
16565,2750000,500000,Chris Clark,LT,injured_reserve,houston-texans,3250000,2017
16566,403054,2053960,Deshaun Watson,QB,injured_reserve,houston-texans,2457014,2017
16567,667044,418177,Nick Martin,C,injured_reserve,houston-texans,1085221,2017
16568,690000,75146,Tom Savage,QB,injured_reserve,houston-texans,765146,2017
16569,615000,0,Bruce Ellington,WR,injured_reserve,houston-texans,615000,2017
16570,423703,189871,D'Onta Foreman,RB,injured_reserve,houston-texans,613574,2017
16571,540000,53845,D.J. Reader,DT,injured_reserve,houston-texans,593845,2017
16572,540000,1666,Brennan Scarlett,OLB,injured_reserve,houston-texans,541666,2017
16573,404636,136892,Tyler Ervin,RB,injured_reserve,houston-texans,541528,2017
16574,540000,0,Corey Moore,SS,injured_reserve,houston-texans,540000,2017
16575,489526,22622,Christian Covington,DE,injured_reserve,houston-texans,512148,2017
16576,470294,0,Ben Heeney,ILB,injured_reserve,houston-texans,470294,2017
16577,348000,2666,Matt Godin,DE,injured_reserve,houston-texans,350666,2017
16578,348000,666,Deante' Gray,WR,injured_reserve,houston-texans,348666,2017
16579,144706,0,MyCole Pruitt,TE,injured_reserve,houston-texans,144706,2017
16580,0,9000000,Brock Osweiler,QB,dead_cap,houston-texans,9000000,2017
16581,552941,0,Duane Brown,LT,dead_cap,houston-texans,552941,2017
16582,0,375000,Tony Bergstrom,C,dead_cap,houston-texans,375000,2017
16583,284116,0,Marcus Burley,CB,dead_cap,houston-texans,284116,2017
16584,264706,0,Kendall Langford,DE,dead_cap,houston-texans,264706,2017
16585,253232,668,Kendall Lamm,RT,dead_cap,houston-texans,253900,2017
16586,370588,0,Lamarr Houston,OLB,dead_cap,houston-texans,370588,2017
16587,0,250000,Nick Novak,K,dead_cap,houston-texans,250000,2017
16588,40294,192995,Jaelen Strong,WR,dead_cap,houston-texans,233289,2017
16589,158365,0,Jarrod Clements,DT,dead_cap,houston-texans,158365,2017
16590,151906,1668,Kurtis Drummond,SS,dead_cap,houston-texans,153574,2017
16591,136765,0,Johnthan Banks,CB,dead_cap,houston-texans,136765,2017
16592,136765,0,Jah Reid,RT,dead_cap,houston-texans,136765,2017
16593,132459,0,Dorian Johnson,G,dead_cap,houston-texans,132459,2017
16594,122400,1666,Dee Virgin,CB,dead_cap,houston-texans,124066,2017
16595,122400,0,Bryce Jones,CB,dead_cap,houston-texans,122400,2017
16596,108000,0,David Quessenberry,LT,dead_cap,houston-texans,108000,2017
16597,105882,0,Josh Johnson,QB,dead_cap,houston-texans,105882,2017
16598,100800,0,Kennan Gilchrist,OLB,dead_cap,houston-texans,100800,2017
16599,86400,1667,Chad Slade,G,dead_cap,houston-texans,88067,2017
16600,86400,1000,Gimel President,OLB,dead_cap,houston-texans,87400,2017
16601,86400,0,LaTroy Lewis,ILB,dead_cap,houston-texans,86400,2017
16602,79200,0,MyCole Pruitt,TE,dead_cap,houston-texans,79200,2017
16603,64800,0,Cobi Hamilton,WR,dead_cap,houston-texans,64800,2017
16604,0,58734,K.J. Dillon,S,dead_cap,houston-texans,58734,2017
16605,54706,0,Andy Jones,WR,dead_cap,houston-texans,54706,2017
16606,45588,0,Matt McGloin,QB,dead_cap,houston-texans,45588,2017
16607,43200,0,Troymaine Pope,RB,dead_cap,houston-texans,43200,2017
16608,0,41563,Keith Mumphery,WR,dead_cap,houston-texans,41563,2017
16609,38800,1000,Dare Ogunbowale,RB,dead_cap,houston-texans,39800,2017
16610,45588,0,Marcus Cromartie,CB,dead_cap,houston-texans,45588,2017
16611,34553,333,Evan Baylis,TE,dead_cap,houston-texans,34886,2017
16612,0,32205,Jeoffrey Pagan,DE,dead_cap,houston-texans,32205,2017
16613,28800,0,Josh Thornton,CB,dead_cap,houston-texans,28800,2017
16614,21600,0,Ryan Malleck,TE,dead_cap,houston-texans,21600,2017
16615,21600,0,Chris Thompson,WR,dead_cap,houston-texans,21600,2017
16616,16400,1333,Riley McCarron,WR,dead_cap,houston-texans,17733,2017
16617,16500,1166,Eli Ankou,DT,dead_cap,houston-texans,17666,2017
16618,14400,1333,Zach Conque,TE,dead_cap,houston-texans,15733,2017
16619,14400,0,Marcus Hardison,DT,dead_cap,houston-texans,14400,2017
16620,14400,0,Taylor Heinicke,QB,dead_cap,houston-texans,14400,2017
16621,14400,0,Jake Rodgers,T,dead_cap,houston-texans,14400,2017
16622,0,11474,Lonnie Ballentine,FS,dead_cap,houston-texans,11474,2017
16623,0,10000,Dimitiric Camiel,T,dead_cap,houston-texans,10000,2017
16624,7200,0,Erik Austell,T,dead_cap,houston-texans,7200,2017
16625,7200,0,Ibraheim Campbell,SS,dead_cap,houston-texans,7200,2017
16626,7200,0,Devin Lucien,WR,dead_cap,houston-texans,7200,2017
16627,7200,0,Jevoni Robinson,TE,dead_cap,houston-texans,7200,2017
16628,7200,0,DeAndrew White,WR,dead_cap,houston-texans,7200,2017
16629,0,6667,Shakeel Rashad,ILB,dead_cap,houston-texans,6667,2017
16630,6000,666,Justin Hardee,CB,dead_cap,houston-texans,6666,2017
16631,0,4332,Malik Smith,CB,dead_cap,houston-texans,4332,2017
16632,0,3334,Ra'Zahn Howard,DT,dead_cap,houston-texans,3334,2017
16633,0,3334,Ufomba Kamalu,DE,dead_cap,houston-texans,3334,2017
16634,0,3334,Wendell Williams,WR,dead_cap,houston-texans,3334,2017
16635,0,3000,Duke Thomas,S,dead_cap,houston-texans,3000,2017
16636,0,2334,Cleveland Wallace,CB,dead_cap,houston-texans,2334,2017
16637,0,1833,Daniel Ross,DE,dead_cap,houston-texans,1833,2017
16638,0,1666,T.J. Daniel,DE,dead_cap,houston-texans,1666,2017
16639,0,1666,Shaq Hill,WR,dead_cap,houston-texans,1666,2017
16640,0,1666,Avery Williams,OLB,dead_cap,houston-texans,1666,2017
16641,0,1334,Richard Leonard,CB,dead_cap,houston-texans,1334,2017
16642,0,1000,Richard Mullaney,WR,dead_cap,houston-texans,1000,2017
16643,0,834,Carlos Thompson,OLB,dead_cap,houston-texans,834,2017
16644,0,667,Tevin Jones,WR,dead_cap,houston-texans,667,2017
16645,0,500,Rickey Hatley,DT,dead_cap,houston-texans,500,2017
16646,11000000,4000000,J.J. Watt,DE,active,houston-texans,15000000,2018
16647,12500000,1500000,DeAndre Hopkins,WR,active,houston-texans,14000000,2018
16648,12306000,1005000,Jadeveon Clowney,OLB,active,houston-texans,13311000,2018
16649,6500000,2500000,Kareem Jackson,SS,active,houston-texans,9000000,2018
16650,1163880,6536841,Benardrick McKinney,ILB,active,houston-texans,7700721,2018
16651,2500000,5156250,Aaron Colvin,CB,active,houston-texans,7656250,2018
16652,2000000,5000000,Tyrann Mathieu,FS,active,houston-texans,7000000,2018
16653,1500000,5406250,Zach Fulton,G,active,houston-texans,6906250,2018
16654,5000000,1703125,Lamar Miller,RB,active,houston-texans,6703125,2018
16655,4750000,1550000,Whitney Mercilus,OLB,active,houston-texans,6300000,2018
16656,2400000,3087500,Johnathan Joseph,CB,active,houston-texans,5487500,2018
16657,1250000,2750000,Senio Kelemete,G,active,houston-texans,4000000,2018
16658,1907000,2000000,Greg Mancz,C,active,houston-texans,3907000,2018
16659,3250000,250000,Andre Hal,FS,active,houston-texans,3500000,2018
16660,1094740,2053960,Deshaun Watson,QB,active,houston-texans,3148700,2018
16661,1250000,1750000,Johnson Bademosi,CB,active,houston-texans,3000000,2018
16662,2250000,437500,Ryan Griffin,TE,active,houston-texans,2687500,2018
16663,884088,418177,Nick Martin,C,active,houston-texans,1302265,2018
16664,850000,390000,Angelo Blackson,DE,active,houston-texans,1240000,2018
16665,668261,348044,Zach Cunningham,ILB,active,houston-texans,1016305,2018
16666,915000,50000,Jon Weeks,LS,active,houston-texans,965000,2018
16667,790000,0,Brandon Dunn,DE,active,houston-texans,790000,2018
16668,588500,189871,D'Onta Foreman,RB,active,houston-texans,778371,2018
16669,480000,259914,Justin Reid,S,active,houston-texans,739914,2018
16670,705000,22622,Christian Covington,DE,active,houston-texans,727622,2018
16671,790000,90000,Alfred Blue,RB,active,houston-texans,880000,2018
16672,790000,90000,Brandon Weeden,QB,active,houston-texans,880000,2018
16673,480000,225317,Martinas Rankin,C,active,houston-texans,705317,2018
16674,705000,0,Kendall Lamm,RT,active,houston-texans,705000,2018
16675,555000,146605,Julie'n Davenport,LT,active,houston-texans,701605,2018
16676,630000,53845,D.J. Reader,DT,active,houston-texans,683845,2018
16677,480000,190380,Jordan Akins,TE,active,houston-texans,670380,2018
16678,480000,182256,Keke Coutee,WR,active,houston-texans,662256,2018
16679,555000,104912,Carlos Watkins,DT,active,houston-texans,659912,2018
16680,630000,3668,Joel Heath,DE,active,houston-texans,633668,2018
16681,915000,0,Joe Webb,QB,active,houston-texans,915000,2018
16682,861176,0,Shareece Wright,CB,active,houston-texans,861176,2018
16683,555000,2500,Ka'imi Fairbairn,K,active,houston-texans,557500,2018
16684,480000,46314,Duke Ejofor,OLB,active,houston-texans,526314,2018
16685,480000,29602,Peter Kalambayi,DE,active,houston-texans,509602,2018
16686,480000,29602,Jordan Thomas,TE,active,houston-texans,509602,2018
16687,480000,3333,Vyncint Smith,WR,active,houston-texans,483333,2018
16688,480000,666,Trevor Daniel,P,active,houston-texans,480666,2018
16689,480000,0,Buddy Howell,RB,active,houston-texans,480000,2018
16690,480000,0,A.J. Moore,S,active,houston-texans,480000,2018
16691,461294,4000,Dylan Cole,ILB,active,houston-texans,465294,2018
16692,391765,0,Michael Tyson,CB,active,houston-texans,391765,2018
16693,254115,0,Deante Burton,WR,active,houston-texans,254115,2018
16694,225880,0,Deandre Carter,WR,active,houston-texans,225880,2018
16695,112940,0,Roderick Johnson,T,active,houston-texans,112940,2018
16696,41471,0,Josh Keyes,ILB,active,houston-texans,41471,2018
16697,37059,0,Tyrell Adams,OLB,active,houston-texans,37059,2018
16698,28235,0,Steven Mitchell,WR,active,houston-texans,28235,2018
16699,4500000,0,Demaryius Thomas,WR,injured_reserve,houston-texans,4500000,2018
16700,1805375,1392166,Kevin Johnson,CB,injured_reserve,houston-texans,3197541,2018
16701,1374028,1398057,Will Fuller,WR,injured_reserve,houston-texans,2772085,2018
16702,1700000,893750,Seantrel Henderson,RT,injured_reserve,houston-texans,2593750,2018
16703,790000,288125,Kayvon Webster,CB,injured_reserve,houston-texans,1078125,2018
16704,705000,195000,Brian Peters,ILB,injured_reserve,houston-texans,900000,2018
16705,630000,1668,Brennan Scarlett,OLB,injured_reserve,houston-texans,631668,2018
16706,363000,25194,Jermaine Kelly,CB,injured_reserve,houston-texans,388194,2018
16707,129200,0,Jester Weah,WR,injured_reserve,houston-texans,129200,2018
16708,959143,1250000,Jeff Allen,G,dead_cap,houston-texans,2209143,2018
16709,2200000,0,C.J. Fiedorowicz,TE,dead_cap,houston-texans,2200000,2018
16710,0,1700000,Derek Newton,RT,dead_cap,houston-texans,1700000,2018
16711,0,2117644,Brian Cushing,ILB,dead_cap,houston-texans,2117644,2018
16712,1000000,0,Jay Prosch,FB,dead_cap,houston-texans,1000000,2018
16713,730000,260000,Bruce Ellington,WR,dead_cap,houston-texans,990000,2018
16714,705000,0,Ben Heeney,ILB,dead_cap,houston-texans,705000,2018
16715,622059,25000,Sammie Coates,WR,dead_cap,houston-texans,647059,2018
16716,0,600000,Shane Lechler,P,dead_cap,houston-texans,600000,2018
16717,333531,136892,Tyler Ervin,RB,dead_cap,houston-texans,470423,2018
16718,406964,0,David Sharpe,T,dead_cap,houston-texans,406964,2018
16719,367055,0,Natrell Jamerson,S,dead_cap,houston-texans,367055,2018
16720,248824,35000,Josh Keyes,ILB,dead_cap,houston-texans,283824,2018
16721,226764,0,Tyrell Adams,OLB,dead_cap,houston-texans,226764,2018
16722,0,192995,Jaelen Strong,WR,dead_cap,houston-texans,192995,2018
16723,192177,0,Jevoni Robinson,TE,dead_cap,houston-texans,192177,2018
16724,183788,0,Daeshon Hall,DE,dead_cap,houston-texans,183788,2018
16725,0,177276,Braxton Miller,WR,dead_cap,houston-texans,177276,2018
16726,160705,0,Roderick Johnson,T,dead_cap,houston-texans,160705,2018
16727,129200,2500,Davin Bellamy,LB,dead_cap,houston-texans,131700,2018
16728,129200,2000,Jester Weah,WR,dead_cap,houston-texans,131200,2018
16729,129200,0,Chad Slade,G,dead_cap,houston-texans,129200,2018
16730,106400,17304,Kyle Fuller,C,dead_cap,houston-texans,123704,2018
16731,0,117468,K.J. Dillon,S,dead_cap,houston-texans,117468,2018
16732,113600,2666,Andre Chachere,CB,dead_cap,houston-texans,116266,2018
16733,114000,0,Isaac Whitney,WR,dead_cap,houston-texans,114000,2018
16734,91200,0,Jerell Adams,TE,dead_cap,houston-texans,91200,2018
16735,0,90000,Joe Webb,QB,dead_cap,houston-texans,90000,2018
16736,0,62337,Treston Decoud,S,dead_cap,houston-texans,62337,2018
16737,60800,0,Steven Mitchell,WR,dead_cap,houston-texans,60800,2018
16738,60800,0,Malachi Dupre,WR,dead_cap,houston-texans,60800,2018
16739,60800,0,Josh Ferguson,RB,dead_cap,houston-texans,60800,2018
16740,45600,0,David Steinmetz,G,dead_cap,houston-texans,45600,2018
16741,0,41565,Keith Mumphery,WR,dead_cap,houston-texans,41565,2018
16742,38000,0,Matt Lengel,TE,dead_cap,houston-texans,38000,2018
16743,38000,0,Michael Tyson,CB,dead_cap,houston-texans,38000,2018
16744,30400,0,Cyril Grayson,WR,dead_cap,houston-texans,30400,2018
16745,25000,5000,Anthony Coyle,G,dead_cap,houston-texans,30000,2018
16746,22800,0,Breon Borders,CB,dead_cap,houston-texans,22800,2018
16747,22800,0,Amba Etta-Tawo,WR,dead_cap,houston-texans,22800,2018
16748,22800,0,Maurquice Shakir,G,dead_cap,houston-texans,22800,2018
16749,15000,2000,Terry Swanson,RB,dead_cap,houston-texans,17000,2018
16750,15200,0,Kennan Gilchrist,OLB,dead_cap,houston-texans,15200,2018
16751,10000,4000,Jaryd Jones-Smith,T,dead_cap,houston-texans,14000,2018
16752,0,8668,Malik Smith,CB,dead_cap,houston-texans,8668,2018
16753,7600,0,Michael Hunter,CB,dead_cap,houston-texans,7600,2018
16754,7600,0,Robert Jackson,CB,dead_cap,houston-texans,7600,2018
16755,7600,0,Darius Kilgo,DT,dead_cap,houston-texans,7600,2018
16756,7600,0,Chris Landrum,OLB,dead_cap,houston-texans,7600,2018
16757,7600,0,MyCole Pruitt,TE,dead_cap,houston-texans,7600,2018
16758,0,5334,Matt Godin,DE,dead_cap,houston-texans,5334,2018
16759,0,3667,Daniel Ross,DE,dead_cap,houston-texans,3667,2018
16760,0,3334,T.J. Daniel,DE,dead_cap,houston-texans,3334,2018
16761,0,3334,Shaq Hill,WR,dead_cap,houston-texans,3334,2018
16762,0,3334,Dee Virgin,CB,dead_cap,houston-texans,3334,2018
16763,0,3334,Avery Williams,OLB,dead_cap,houston-texans,3334,2018
16764,0,3000,Lavon Coleman,RB,dead_cap,houston-texans,3000,2018
16765,0,2667,Zach Conque,TE,dead_cap,houston-texans,2667,2018
16766,0,2667,Riley McCarron,WR,dead_cap,houston-texans,2667,2018
16767,0,2334,Eli Ankou,DT,dead_cap,houston-texans,2334,2018
16768,0,2000,Dare Ogunbowale,RB,dead_cap,houston-texans,2000,2018
16769,0,2000,Gimel President,OLB,dead_cap,houston-texans,2000,2018
16770,0,1668,Stephen Anderson,TE,dead_cap,houston-texans,1668,2018
16771,0,1666,Mason Gentry,DE,dead_cap,houston-texans,1666,2018
16772,0,1334,Deante' Gray,WR,dead_cap,houston-texans,1334,2018
16773,0,1334,Justin Hardee,CB,dead_cap,houston-texans,1334,2018
16774,0,1000,Rickey Hatley,DT,dead_cap,houston-texans,1000,2018
16775,0,667,Evan Baylis,TE,dead_cap,houston-texans,667,2018
16776,0,166,Kingsley Opara,DT,dead_cap,houston-texans,166,2018
16777,13000000,2000000,J.J. Watt,DE,active,houston-texans,15000000,2019
16778,12500000,1500000,DeAndre Hopkins,WR,active,houston-texans,14000000,2019
16779,5000000,4812500,Bradley Roby,CB,active,houston-texans,9812500,2019
16780,5750000,3050000,Whitney Mercilus,OLB,active,houston-texans,8800000,2019
16781,7975000,0,Kenny Stills,WR,active,houston-texans,7975000,2019
16782,6101132,1668177,Nick Martin,C,active,houston-texans,7769309,2019
16783,6000000,1406250,Benardrick McKinney,ILB,active,houston-texans,7406250,2019
16784,6500000,500000,Zach Fulton,G,active,houston-texans,7000000,2019
16785,4000000,1937500,Johnathan Joseph,CB,active,houston-texans,5937500,2019
16786,3400000,800000,Barkevious Mingo,OLB,active,houston-texans,4200000,2019
16787,2000000,1968750,Angelo Blackson,DE,active,houston-texans,3968750,2019
16788,862231,2916209,Deshaun Watson,QB,active,houston-texans,3778440,2019
16789,2025000,1707285,Brennan Scarlett,OLB,active,houston-texans,3732285,2019
16790,1836043,1398057,Will Fuller,WR,active,houston-texans,3234100,2019
16791,3095000,0,Ka'imi Fairbairn,K,active,houston-texans,3095000,2019
16792,1500000,1500000,A.J. McCarron,QB,active,houston-texans,3000000,2019
16793,1800000,400000,Duke Johnson,RB,active,houston-texans,2200000,2019
16794,2148770,0,Laremy Tunsil,LT,active,houston-texans,2148770,2019
16795,2025000,53845,D.J. Reader,DT,active,houston-texans,2078845,2019
16796,2025000,0,Brandon Dunn,DT,active,houston-texans,2025000,2019
16797,1400000,500000,Carlos Hyde,RB,active,houston-texans,1900000,2019
16798,1500000,140625,Greg Mancz,C,active,houston-texans,1640625,2019
16799,900000,600000,Darren Fells,TE,active,houston-texans,1500000,2019
16800,871522,348044,Zach Cunningham,ILB,active,houston-texans,1219566,2019
16801,805000,300000,Jahleel Addae,SS,active,houston-texans,1105000,2019
16802,981366,0,Vernon Hargreaves,CB,active,houston-texans,981366,2019
16803,930000,50000,Jon Weeks,LS,active,houston-texans,980000,2019
16804,495000,451300,Lonnie Johnson,CB,active,houston-texans,946300,2019
16805,664979,259914,Justin Reid,FS,active,houston-texans,924893,2019
16806,495000,426470,Max Scharping,G,active,houston-texans,921470,2019
16807,569118,312500,Bryan Anger,P,active,houston-texans,881618,2019
16808,833285,0,Gareon Conley,CB,active,houston-texans,833285,2019
16809,600000,190380,Jordan Akins,TE,active,houston-texans,790380,2019
16810,570000,182256,Keke Coutee,WR,active,houston-texans,752256,2019
16811,645000,104912,Carlos Watkins,DE,active,houston-texans,749912,2019
16812,930000,90000,Taiwan Jones,RB,active,houston-texans,1020000,2019
16813,570000,29602,Peter Kalambayi,OLB,active,houston-texans,599602,2019
16814,592941,0,Tyrell Adams,OLB,active,houston-texans,592941,2019
16815,570000,0,Deandre Carter,WR,active,houston-texans,570000,2019
16816,570000,0,Keion Crossen,CB,active,houston-texans,570000,2019
16817,570000,0,Buddy Howell,RB,active,houston-texans,570000,2019
16818,570000,0,Roderick Johnson,T,active,houston-texans,570000,2019
16819,570000,0,Jake Martin,OLB,active,houston-texans,570000,2019
16820,570000,0,A.J. Moore,S,active,houston-texans,570000,2019
16821,495000,73820,Charles Omenihu,DE,active,houston-texans,568820,2019
16822,787647,60000,Mike Adams,FS,active,houston-texans,847647,2019
16823,495000,25790,Cullen Gillaspia,FB,active,houston-texans,520790,2019
16824,455471,29602,Jordan Thomas,TE,active,houston-texans,485073,2019
16825,601765,0,Chris Clark,LT,active,houston-texans,601765,2019
16826,335290,0,Cornell Armstrong,CB,active,houston-texans,335290,2019
16827,189706,0,Eddie Vanderdoes,DT,active,houston-texans,189706,2019
16828,145588,0,Steven Mitchell,WR,active,houston-texans,145588,2019
16829,29118,0,Elijah Nkansah,T,active,houston-texans,29118,2019
16830,2500000,4937500,Tashaun Gipson,SS,injured_reserve,houston-texans,7437500,2019
16831,5500000,1000000,Lamar Miller,RB,injured_reserve,houston-texans,6500000,2019
16832,2750000,843750,Senio Kelemete,G,injured_reserve,houston-texans,3593750,2019
16833,495000,1727827,Tytus Howard,G,injured_reserve,houston-texans,2222827,2019
16834,930000,90000,Joe Webb,QB,injured_reserve,houston-texans,1020000,2019
16835,645000,4000,Dylan Cole,ILB,injured_reserve,houston-texans,649000,2019
16836,378000,223051,Kahale Warring,TE,injured_reserve,houston-texans,601051,2019
16837,757647,0,Phillip Gaines,CB,injured_reserve,houston-texans,757647,2019
16838,393000,46314,Duke Ejofor,DE,injured_reserve,houston-texans,439314,2019
16839,408000,0,Chris Landrum,OLB,injured_reserve,houston-texans,408000,2019
16840,393000,0,Isaac Whitney,WR,injured_reserve,houston-texans,393000,2019
16841,378000,166,Ira Lewis,DT,injured_reserve,houston-texans,378166,2019
16842,378000,0,David Steinmetz,G,injured_reserve,houston-texans,378000,2019
16843,7500000,1015625,Aaron Colvin,CB,dead_cap,houston-texans,8515625,2019
16844,0,7000000,Jadeveon Clowney,OLB,dead_cap,houston-texans,7000000,2019
16845,1500000,1156250,Seantrel Henderson,RT,dead_cap,houston-texans,2656250,2019
16846,0,2250000,Matt Kalil,LT,dead_cap,houston-texans,2250000,2019
16847,0,1250000,Jeff Allen,G,dead_cap,houston-texans,1250000,2019
16848,930000,0,Logan Paulsen,TE,dead_cap,houston-texans,930000,2019
16849,0,500000,Johnson Bademosi,CB,dead_cap,houston-texans,500000,2019
16850,485886,0,Alex McGough,QB,dead_cap,houston-texans,485886,2019
16851,354118,0,Joel Heath,DT,dead_cap,houston-texans,354118,2019
16852,203824,41142,Xavier Crawford,CB,dead_cap,houston-texans,244966,2019
16853,239765,0,Jerell Adams,TE,dead_cap,houston-texans,239765,2019
16854,0,225317,Martinas Rankin,C,dead_cap,houston-texans,225317,2019
16855,196471,0,Steven Mitchell,WR,dead_cap,houston-texans,196471,2019
16856,0,189871,D'Onta Foreman,RB,dead_cap,houston-texans,189871,2019
16857,181000,1666,Karan Higdon,RB,dead_cap,houston-texans,182666,2019
16858,0,177278,Braxton Miller,WR,dead_cap,houston-texans,177278,2019
16859,0,146605,Julie'n Davenport,LT,dead_cap,houston-texans,146605,2019
16860,0,136892,Tyler Ervin,RB,dead_cap,houston-texans,136892,2019
16861,136000,0,Rick Leonard,T,dead_cap,houston-texans,136000,2019
16862,129529,0,Jonathan Owens,S,dead_cap,houston-texans,129529,2019
16863,0,124674,Treston Decoud,S,dead_cap,houston-texans,124674,2019
16864,120000,0,Xavier Woodson-Luster,ILB,dead_cap,houston-texans,120000,2019
16865,116471,0,Dan Skipper,T,dead_cap,houston-texans,116471,2019
16866,112000,0,Chad Hansen,WR,dead_cap,houston-texans,112000,2019
16867,96000,0,Elijah Nkansah,T,dead_cap,houston-texans,96000,2019
16868,88000,0,Kyle Murphy,T,dead_cap,houston-texans,88000,2019
16869,84706,0,Briean Boddy-Calhoun,S,dead_cap,houston-texans,84706,2019
16870,72000,0,Anthony Chesley,CB,dead_cap,houston-texans,72000,2019
16871,65000,3333,Chris Johnson,S,dead_cap,houston-texans,68333,2019
16872,67058,666,Trevor Daniel,P,dead_cap,houston-texans,67724,2019
16873,56000,0,Albert Huggins,DT,dead_cap,houston-texans,56000,2019
16874,48000,0,Cornell Armstrong,CB,dead_cap,houston-texans,48000,2019
16875,30000,13333,Walter Palmore,DT,dead_cap,houston-texans,43333,2019
16876,40000,3333,Johnnie Dixon,WR,dead_cap,houston-texans,43333,2019
16877,35000,3333,Damarea Crockett,RB,dead_cap,houston-texans,38333,2019
16878,35000,2666,Malcolm Pridgeon,T,dead_cap,houston-texans,37666,2019
16879,37000,333,Austin Exford,S,dead_cap,houston-texans,37333,2019
16880,0,34608,Kyle Fuller,C,dead_cap,houston-texans,34608,2019
16881,30000,2333,Jamal Davis,OLB,dead_cap,houston-texans,32333,2019
16882,32000,0,Nate Hall,LB,dead_cap,houston-texans,32000,2019
16883,32000,0,Shalom Luani,S,dead_cap,houston-texans,32000,2019
16884,32000,0,Wyatt Ray,DE,dead_cap,houston-texans,32000,2019
16885,32000,0,Eddie Vanderdoes,DT,dead_cap,houston-texans,32000,2019
16886,30000,1666,Tyron Johnson,WR,dead_cap,houston-texans,31666,2019
16887,24000,3333,Vyncint Smith,WR,dead_cap,houston-texans,27333,2019
16888,0,25194,Jermaine Kelly,CB,dead_cap,houston-texans,25194,2019
16889,24000,0,Tyrell Adams,OLB,dead_cap,houston-texans,24000,2019
16890,20000,1666,Derrick Baity,CB,dead_cap,houston-texans,21666,2019
16891,0,20000,Bryan Anger,P,dead_cap,houston-texans,20000,2019
16892,15000,3333,Drew Lewis,DT,dead_cap,houston-texans,18333,2019
16893,10000,1666,Jesse Aniebonam,OLB,dead_cap,houston-texans,11666,2019
16894,0,10000,Anthony Coyle,G,dead_cap,houston-texans,10000,2019
16895,8000,500,Javier Edwards,DT,dead_cap,houston-texans,8500,2019
16896,0,8000,Jaryd Jones-Smith,T,dead_cap,houston-texans,8000,2019
16897,8000,0,Keenen Brown,TE,dead_cap,houston-texans,8000,2019
16898,8000,0,Christian Dilauro,G,dead_cap,houston-texans,8000,2019
16899,8000,0,Marcus Henry,C,dead_cap,houston-texans,8000,2019
16900,5000,2666,D.J. Coker,C,dead_cap,houston-texans,7666,2019
16901,0,6000,Lavon Coleman,RB,dead_cap,houston-texans,6000,2019
16902,0,5334,Andre Chachere,CB,dead_cap,houston-texans,5334,2019
16903,0,5000,Davin Bellamy,LB,dead_cap,houston-texans,5000,2019
16904,0,4000,Terry Swanson,RB,dead_cap,houston-texans,4000,2019
16905,0,4000,Jester Weah,WR,dead_cap,houston-texans,4000,2019
16906,0,3334,Mason Gentry,DE,dead_cap,houston-texans,3334,2019
16907,0,1000,Dexter Wright,S,dead_cap,houston-texans,1000,2019
16908,0,334,Kingsley Opara,DT,dead_cap,houston-texans,334,2019
16909,0,333,Johnny Dwight,DE,dead_cap,houston-texans,333,2019
16910,15500000,0,J.J. Watt,DE,active,houston-texans,15500000,2020
16911,12500000,1500000,DeAndre Hopkins,WR,active,houston-texans,14000000,2020
16912,10500000,1500000,Whitney Mercilus,OLB,active,houston-texans,12000000,2020
16913,10350000,0,Laremy Tunsil,LT,active,houston-texans,10350000,2020
16914,10162000,0,Will Fuller,WR,active,houston-texans,10162000,2020
16915,9954000,0,Vernon Hargreaves,CB,active,houston-texans,9954000,2020
16916,7250000,1500000,Nick Martin,C,active,houston-texans,8750000,2020
16917,6500000,937500,Tashaun Gipson,SS,active,houston-texans,7437500,2020
16918,6000000,1406250,Benardrick McKinney,ILB,active,houston-texans,7406250,2020
16919,6975000,25000,Kenny Stills,WR,active,houston-texans,7000000,2020
16920,6500000,500000,Zach Fulton,G,active,houston-texans,7000000,2020
16921,1177123,3231084,Deshaun Watson,QB,active,houston-texans,4408207,2020
16922,3600000,500000,Duke Johnson,RB,active,houston-texans,4100000,2020
16923,3500000,468750,Angelo Blackson,DE,active,houston-texans,3968750,2020
16924,2750000,843750,Senio Kelemete,G,active,houston-texans,3593750,2020
16925,1050707,1727827,Tytus Howard,G,active,houston-texans,2778534,2020
16926,1250000,1062500,Bryan Anger,P,active,houston-texans,2312500,2020
16927,2000000,140625,Greg Mancz,C,active,houston-texans,2140625,2020
16928,1125000,878125,Brennan Scarlett,OLB,active,houston-texans,2003125,2020
16929,1892376,0,Gareon Conley,CB,active,houston-texans,1892376,2020
16930,1074783,348046,Zach Cunningham,ILB,active,houston-texans,1422829,2020
16931,731575,451300,Lonnie Johnson,CB,active,houston-texans,1182875,2020
16932,725368,426470,Max Scharping,G,active,houston-texans,1151838,2020
16933,849957,259914,Justin Reid,FS,active,houston-texans,1109871,2020
16934,700000,190380,Jordan Akins,TE,active,houston-texans,890380,2020
16935,658252,223051,Kahale Warring,TE,active,houston-texans,881303,2020
16936,660000,182256,Keke Coutee,WR,active,houston-texans,842256,2020
16937,735000,104912,Carlos Watkins,DE,active,houston-texans,839912,2020
16938,735000,0,Chris Landrum,OLB,active,houston-texans,735000,2020
16939,735000,0,Shalom Luani,S,active,houston-texans,735000,2020
16940,735000,0,Eddie Vanderdoes,DT,active,houston-texans,735000,2020
16941,660000,29602,Peter Kalambayi,OLB,active,houston-texans,689602,2020
16942,660000,29602,Jordan Thomas,TE,active,houston-texans,689602,2020
16943,660000,0,Cornell Armstrong,CB,active,houston-texans,660000,2020
16944,660000,0,Keion Crossen,CB,active,houston-texans,660000,2020
16945,660000,0,Buddy Howell,RB,active,houston-texans,660000,2020
16946,660000,0,Jake Martin,OLB,active,houston-texans,660000,2020
16947,660000,0,A.J. Moore,S,active,houston-texans,660000,2020
16948,660000,0,Kyle Murphy,T,active,houston-texans,660000,2020
16949,660000,0,Isaac Whitney,WR,active,houston-texans,660000,2020
16950,585000,73820,Charles Omenihu,DE,active,houston-texans,658820,2020
16951,585000,46314,Duke Ejofor,DE,active,houston-texans,631314,2020
16952,585000,25790,Cullen Gillaspia,FB,active,houston-texans,610790,2020
16953,585000,166,Ira Lewis,DT,active,houston-texans,585166,2020
16954,585000,0,Chad Hansen,WR,active,houston-texans,585000,2020
16955,585000,0,Alex McGough,QB,active,houston-texans,585000,2020
16956,585000,0,Steven Mitchell,WR,active,houston-texans,585000,2020
16957,585000,0,Elijah Nkansah,T,active,houston-texans,585000,2020
16958,510000,0,Davin Bellamy,LB,active,houston-texans,510000,2020
16959,510000,0,Anthony Chesley,CB,active,houston-texans,510000,2020
16960,510000,0,Nate Hall,LB,active,houston-texans,510000,2020
16961,510000,0,Karan Higdon,RB,active,houston-texans,510000,2020
16962,510000,0,Rick Leonard,T,active,houston-texans,510000,2020
16963,510000,0,Jonathan Owens,S,active,houston-texans,510000,2020
16964,510000,0,David Steinmetz,G,active,houston-texans,510000,2020
16965,0,2000000,Aaron Colvin,CB,dead_cap,houston-texans,2000000,2020
16966,0,450634,Martinas Rankin,C,dead_cap,houston-texans,450634,2020
16967,0,189871,D'Onta Foreman,RB,dead_cap,houston-texans,189871,2020
16968,0,146605,Julie'n Davenport,LT,dead_cap,houston-texans,146605,2020
16969,0,123426,Xavier Crawford,CB,dead_cap,houston-texans,123426,2020
16970,0,50388,Jermaine Kelly,CB,dead_cap,houston-texans,50388,2020
16971,0,26667,Walter Palmore,DT,dead_cap,houston-texans,26667,2020
16972,0,6667,Damarea Crockett,RB,dead_cap,houston-texans,6667,2020
16973,0,6667,Johnnie Dixon,WR,dead_cap,houston-texans,6667,2020
16974,0,6667,Chris Johnson,S,dead_cap,houston-texans,6667,2020
16975,0,6667,Drew Lewis,DT,dead_cap,houston-texans,6667,2020
16976,0,5334,D.J. Coker,C,dead_cap,houston-texans,5334,2020
16977,0,5334,Malcolm Pridgeon,T,dead_cap,houston-texans,5334,2020
16978,0,4667,Jamal Davis,OLB,dead_cap,houston-texans,4667,2020
16979,0,3334,Jesse Aniebonam,OLB,dead_cap,houston-texans,3334,2020
16980,0,3334,Derrick Baity,CB,dead_cap,houston-texans,3334,2020
16981,0,3334,Karan Higdon,RB,dead_cap,houston-texans,3334,2020
16982,0,3334,Tyron Johnson,WR,dead_cap,houston-texans,3334,2020
16983,0,3334,Vyncint Smith,WR,dead_cap,houston-texans,3334,2020
16984,0,1000,Javier Edwards,DT,dead_cap,houston-texans,1000,2020
16985,0,667,Trevor Daniel,P,dead_cap,houston-texans,667,2020
16986,0,667,Johnny Dwight,DE,dead_cap,houston-texans,667,2020
16987,0,667,Austin Exford,S,dead_cap,houston-texans,667,2020
16988,7600000,7800000,Marvin Harrison,WR,active,indianapolis-colts,15400000,2007
16989,1000000,12683332,Peyton Manning,QB,active,indianapolis-colts,13683332,2007
16990,750000,8928571,Dwight Freeney,OLB,active,indianapolis-colts,9678571,2007
16991,3000000,2463333,Reggie Wayne,WR,active,indianapolis-colts,5463333,2007
16992,2400000,833333,Jeff Saturday,C,active,indianapolis-colts,3233333,2007
16993,1430000,2560000,Robert Mathis,OLB,active,indianapolis-colts,3990000,2007
16994,1670000,668750,Gary Brackett,LB,active,indianapolis-colts,2338750,2007
16995,1370000,700000,Adam Vinatieri,K,active,indianapolis-colts,2070000,2007
16996,360000,2517500,Joseph Addai,RB,active,indianapolis-colts,2877500,2007
16997,285000,1265000,Anthony Gonzalez,WR,active,indianapolis-colts,1550000,2007
16998,1350000,125000,Jim Sorgi,QB,active,indianapolis-colts,1475000,2007
16999,497500,1480000,Marlin Jackson,CB,active,indianapolis-colts,1977500,2007
17000,1300000,0,Ryan Lilja,C,active,indianapolis-colts,1300000,2007
17001,595000,542857,Dallas Clark,TE,active,indianapolis-colts,1137857,2007
17002,720000,0,Justin Snow,TE,active,indianapolis-colts,720000,2007
17003,510000,271667,Bob Sanders,S,active,indianapolis-colts,781667,2007
17004,435000,281250,Kelvin Hayden,CB,active,indianapolis-colts,716250,2007
17005,285000,0,Tony Ugoh,T,active,indianapolis-colts,285000,2007
17006,435000,99633,Dylan Gandy,G,active,indianapolis-colts,534633,2007
17007,435000,93710,Matt Giordano,S,active,indianapolis-colts,528710,2007
17008,360000,141333,Freddy Keiaho,LB,active,indianapolis-colts,501333,2007
17009,435000,32050,Tyjuan Hagler,LB,active,indianapolis-colts,467050,2007
17010,435000,15300,Bryan Fletcher,TE,active,indianapolis-colts,450300,2007
17011,595000,40000,Dan Klecko,FB,active,indianapolis-colts,635000,2007
17012,285000,152500,Dante Hughes,CB,active,indianapolis-colts,437500,2007
17013,435000,0,Ben Utecht,TE,active,indianapolis-colts,435000,2007
17014,285000,145500,Quinn PItcock,DT,active,indianapolis-colts,430500,2007
17015,385000,0,Reggie Hodges,P,active,indianapolis-colts,385000,2007
17016,285000,97000,Brannon Condren,S,active,indianapolis-colts,382000,2007
17017,360000,20575,Charlie Johnson,G,active,indianapolis-colts,380575,2007
17018,360000,20500,Tim Jennings,CB,active,indianapolis-colts,380500,2007
17019,285000,92500,Clint Session,LB,active,indianapolis-colts,377500,2007
17020,360000,17250,Antoine Bethea,SS,active,indianapolis-colts,377250,2007
17021,360000,14250,T.J. Rushing,CB,active,indianapolis-colts,374250,2007
17022,360000,0,Luke Lawton,RB,active,indianapolis-colts,360000,2007
17023,285000,36687,Roy Hall,WR,active,indianapolis-colts,321687,2007
17024,285000,10375,Keyunta Dawson,DE,active,indianapolis-colts,295375,2007
17025,285000,1667,Melvin Bullitt,S,active,indianapolis-colts,286667,2007
17026,285000,1333,Kenton Keith,RB,active,indianapolis-colts,286333,2007
17027,285000,0,Michael Toudouze,T,active,indianapolis-colts,285000,2007
17028,900000,283333,Rob Morris,ILB,injured_reserve,indianapolis-colts,1183333,2007
17029,595000,25000,Aaron Moorehead,WR,injured_reserve,indianapolis-colts,620000,2007
17030,79900,0,DeCori Birmingham,RB,practice_squad,indianapolis-colts,79900,2007
17031,79900,0,Onrea Jones,WR,practice_squad,indianapolis-colts,79900,2007
17032,79900,0,Pat Ross,C,practice_squad,indianapolis-colts,79900,2007
17033,0,5600000,Corey Simon,DT,dead_cap,indianapolis-colts,5600000,2007
17034,3000000,0,Brandon Stokley,WR,dead_cap,indianapolis-colts,3000000,2007
17035,99334,0,Michael Toudouze,T,dead_cap,indianapolis-colts,99334,2007
17036,42588,0,Jonathan Welsh,DE,dead_cap,indianapolis-colts,42588,2007
17037,25000,0,John Navarre,QB,dead_cap,indianapolis-colts,25000,2007
17038,0,1666,Gijon Robinson,TE,dead_cap,indianapolis-colts,1666,2007
17039,11500000,12683332,Peyton Manning,QB,active,indianapolis-colts,24183332,2008
17040,9000000,7800000,Marvin Harrison,WR,active,indianapolis-colts,16800000,2008
17041,605000,1475000,Bob Sanders,S,active,indianapolis-colts,2080000,2008
17042,2250000,4560000,Robert Mathis,OLB,active,indianapolis-colts,6810000,2008
17043,750000,8928571,Dwight Freeney,OLB,active,indianapolis-colts,9678571,2008
17044,3500000,2743333,Reggie Wayne,WR,active,indianapolis-colts,6243333,2008
17045,3000000,833333,Jeff Saturday,C,active,indianapolis-colts,3833333,2008
17046,605000,2421190,Dallas Clark,TE,active,indianapolis-colts,3026190,2008
17047,2055000,668750,Gary Brackett,LB,active,indianapolis-colts,2723750,2008
17048,1650000,700000,Adam Vinatieri,K,active,indianapolis-colts,2350000,2008
17049,625000,900000,Ryan Lilja,C,active,indianapolis-colts,1525000,2008
17050,1417000,0,Tyjuan Hagler,LB,active,indianapolis-colts,1417000,2008
17051,603000,1817500,Joseph Addai,RB,active,indianapolis-colts,2420500,2008
17052,370000,1692500,Anthony Gonzalez,WR,active,indianapolis-colts,2062500,2008
17053,375000,0,Tony Ugoh,T,active,indianapolis-colts,375000,2008
17054,927000,0,Matt Giordano,S,active,indianapolis-colts,927000,2008
17055,730000,0,Justin Snow,TE,active,indianapolis-colts,730000,2008
17056,520000,281250,Kelvin Hayden,CB,active,indianapolis-colts,801250,2008
17057,605000,155000,Jim Sorgi,QB,active,indianapolis-colts,760000,2008
17058,605000,25000,John Navarre,QB,active,indianapolis-colts,630000,2008
17059,445000,141333,Freddy Keiaho,LB,active,indianapolis-colts,586333,2008
17060,370000,152500,Dante Hughes,CB,active,indianapolis-colts,522500,2008
17061,295000,212500,Mike Pollak,G,active,indianapolis-colts,507500,2008
17062,445000,20575,Charlie Johnson,G,active,indianapolis-colts,465575,2008
17063,445000,20500,Tim Jennings,CB,active,indianapolis-colts,465500,2008
17064,370000,92500,Clint Session,LB,active,indianapolis-colts,462500,2008
17065,445000,17250,Antoine Bethea,SS,active,indianapolis-colts,462250,2008
17066,445000,14250,T.J. Rushing,CB,active,indianapolis-colts,459250,2008
17067,295000,161000,Philip Wheeler,OLB,active,indianapolis-colts,456000,2008
17068,445000,0,LaJuan Ramsey,DT,active,indianapolis-colts,445000,2008
17069,605000,40000,Dominic Rhodes,RB,active,indianapolis-colts,645000,2008
17070,370000,36687,Roy Hall,WR,active,indianapolis-colts,406687,2008
17071,295000,105393,Jacob Tamme,TE,active,indianapolis-colts,400393,2008
17072,370000,10375,Keyunta Dawson,DE,active,indianapolis-colts,380375,2008
17073,370000,1667,Melvin Bullitt,S,active,indianapolis-colts,371667,2008
17074,295000,41625,Marcus Howard,DE,active,indianapolis-colts,336625,2008
17075,295000,18935,Steve Justice,C,active,indianapolis-colts,313935,2008
17076,295000,18767,Mike Hart,RB,active,indianapolis-colts,313767,2008
17077,295000,17900,Pierre Garcon,WR,active,indianapolis-colts,312900,2008
17078,295000,11183,Jamey Richard,G,active,indianapolis-colts,306183,2008
17079,295000,0,Gijon Robinson,TE,active,indianapolis-colts,295000,2008
17080,138823,0,Antonio Johnson,DT,active,indianapolis-colts,138823,2008
17081,685000,1480000,Marlin Jackson,CB,injured_reserve,indianapolis-colts,2165000,2008
17082,295000,21690,Tom Santi,TE,injured_reserve,indianapolis-colts,316690,2008
17083,88400,0,Lance Ball,RB,practice_squad,indianapolis-colts,88400,2008
17084,88400,0,Christian Gaddis,C,practice_squad,indianapolis-colts,88400,2008
17085,0,11200000,Corey Simon,DT,dead_cap,indianapolis-colts,11200000,2008
17086,0,366667,Rob Morris,ILB,dead_cap,indianapolis-colts,366667,2008
17087,145500,0,Quinn PItcock,DT,dead_cap,indianapolis-colts,145500,2008
17088,97000,0,Brannon Condren,S,dead_cap,indianapolis-colts,97000,2008
17089,25000,0,John Navarre,QB,dead_cap,indianapolis-colts,25000,2008
17090,0,3334,Gijon Robinson,TE,dead_cap,indianapolis-colts,3334,2008
17091,0,1333,Kenton Keith,RB,dead_cap,indianapolis-colts,1333,2008
17092,14000000,12683332,Peyton Manning,QB,active,indianapolis-colts,26683332,2009
17093,8600000,4950000,Kelvin Hayden,CB,active,indianapolis-colts,13550000,2009
17094,6220000,7500000,Dwight Freeney,OLB,active,indianapolis-colts,13720000,2009
17095,3300000,5706190,Dallas Clark,TE,active,indianapolis-colts,9006190,2009
17096,2300000,4400000,Robert Mathis,OLB,active,indianapolis-colts,6700000,2009
17097,4220000,2323333,Reggie Wayne,WR,active,indianapolis-colts,6543333,2009
17098,620000,2017500,Bob Sanders,S,active,indianapolis-colts,2637500,2009
17099,1500000,2483333,Jeff Saturday,C,active,indianapolis-colts,3983333,2009
17100,1755000,1834750,Winston Justice,LT,active,indianapolis-colts,3589750,2009
17101,2415000,668750,Gary Brackett,LB,active,indianapolis-colts,3083750,2009
17102,1490000,1205000,Adam Vinatieri,K,active,indianapolis-colts,2695000,2009
17103,620000,900000,Ryan Lilja,C,active,indianapolis-colts,1520000,2009
17104,713000,1817500,Joseph Addai,RB,active,indianapolis-colts,2530500,2009
17105,310000,860000,Donald Brown,RB,active,indianapolis-colts,1170000,2009
17106,530000,0,Tony Ugoh,T,active,indianapolis-colts,530000,2009
17107,745000,0,Justin Snow,TE,active,indianapolis-colts,745000,2009
17108,385000,212500,Mike Pollak,G,active,indianapolis-colts,597500,2009
17109,535000,50000,Freddy Keiaho,LB,active,indianapolis-colts,585000,2009
17110,310000,258000,Fili Moala,DE,active,indianapolis-colts,568000,2009
17111,535000,20575,Charlie Johnson,G,active,indianapolis-colts,555575,2009
17112,535000,20500,Tim Jennings,CB,active,indianapolis-colts,555500,2009
17113,460000,92500,Clint Session,LB,active,indianapolis-colts,552500,2009
17114,535000,17250,Antoine Bethea,SS,active,indianapolis-colts,552250,2009
17115,385000,161000,Philip Wheeler,OLB,active,indianapolis-colts,546000,2009
17116,535000,0,T.J. Rushing,CB,active,indianapolis-colts,535000,2009
17117,385000,105393,Jacob Tamme,TE,active,indianapolis-colts,490393,2009
17118,310000,169625,Jerraud Powers,CB,active,indianapolis-colts,479625,2009
17119,460000,10375,Keyunta Dawson,DE,active,indianapolis-colts,470375,2009
17120,460000,1667,Melvin Bullitt,S,active,indianapolis-colts,461667,2009
17121,460000,0,Roy Hall,WR,active,indianapolis-colts,460000,2009
17122,310000,109388,Austin Collie,WR,active,indianapolis-colts,419388,2009
17123,310000,99812,Terrance Taylor,DT,active,indianapolis-colts,409812,2009
17124,385000,17900,Pierre Garcon,WR,active,indianapolis-colts,402900,2009
17125,385000,11183,Jamey Richard,G,active,indianapolis-colts,396183,2009
17126,385000,0,Mike Hart,RB,active,indianapolis-colts,385000,2009
17127,385000,0,Antonio Johnson,DT,active,indianapolis-colts,385000,2009
17128,385000,0,Gijon Robinson,TE,active,indianapolis-colts,385000,2009
17129,385000,0,Michael Toudouze,T,active,indianapolis-colts,385000,2009
17130,310000,22750,Curtis Painter,QB,active,indianapolis-colts,332750,2009
17131,310000,14570,Pat McAfee,P,active,indianapolis-colts,324570,2009
17132,320000,0,Jaimie Thomas,T,active,indianapolis-colts,320000,2009
17133,310000,666,Ramon Humber,OLB,active,indianapolis-colts,310666,2009
17134,310000,333,Jacob Lacey,CB,active,indianapolis-colts,310333,2009
17135,310000,0,John Gill,DT,active,indianapolis-colts,310000,2009
17136,182353,0,Cody Glenn,LB,active,indianapolis-colts,182353,2009
17137,310000,0,Kyle DeVan,G,active,indianapolis-colts,310000,2009
17138,1872500,1480000,Marlin Jackson,CB,injured_reserve,indianapolis-colts,3352500,2009
17139,460000,1737500,Anthony Gonzalez,WR,injured_reserve,indianapolis-colts,2197500,2009
17140,900000,405000,Jim Sorgi,QB,injured_reserve,indianapolis-colts,1305000,2009
17141,620000,50000,Tyjuan Hagler,LB,injured_reserve,indianapolis-colts,670000,2009
17142,385000,0,Tom Santi,TE,injured_reserve,indianapolis-colts,385000,2009
17143,88400,0,Colin Cloherty,TE,practice_squad,indianapolis-colts,88400,2009
17144,0,11800000,Marvin Harrison,WR,dead_cap,indianapolis-colts,11800000,2009
17145,194000,0,Brannon Condren,S,dead_cap,indianapolis-colts,194000,2009
17146,152500,0,Dante Hughes,CB,dead_cap,indianapolis-colts,152500,2009
17147,145500,0,Quinn PItcock,DT,dead_cap,indianapolis-colts,145500,2009
17148,21690,0,Tom Santi,TE,dead_cap,indianapolis-colts,21690,2009
17149,18935,0,Steve Justice,C,dead_cap,indianapolis-colts,18935,2009
17150,0,1334,Kenton Keith,RB,dead_cap,indianapolis-colts,1334,2009
17151,15800000,6933332,Peyton Manning,QB,active,indianapolis-colts,22733332,2010
17152,8825000,7500000,Dwight Freeney,OLB,active,indianapolis-colts,16325000,2010
17153,8600000,5200000,Kelvin Hayden,CB,active,indianapolis-colts,13800000,2010
17154,630000,7650000,Antoine Bethea,SS,active,indianapolis-colts,8280000,2010
17155,5470000,2323333,Reggie Wayne,WR,active,indianapolis-colts,7793333,2010
17156,2310000,3560000,Robert Mathis,OLB,active,indianapolis-colts,5870000,2010
17157,1950000,2483333,Jeff Saturday,C,active,indianapolis-colts,4433333,2010
17158,2275000,1875833,Bob Sanders,S,active,indianapolis-colts,4150833,2010
17159,2000000,1205000,Adam Vinatieri,K,active,indianapolis-colts,3205000,2010
17160,800000,2400000,Gary Brackett,LB,active,indianapolis-colts,3200000,2010
17161,2164000,1817500,Joseph Addai,RB,active,indianapolis-colts,3981500,2010
17162,1759000,0,Charlie Johnson,G,active,indianapolis-colts,1759000,2010
17163,1684000,0,Antonio Johnson,DT,active,indianapolis-colts,1684000,2010
17164,1684000,0,Daniel Muir,DT,active,indianapolis-colts,1684000,2010
17165,395000,1830000,Donald Brown,RB,active,indianapolis-colts,2225000,2010
17166,320000,905000,Jerry Hughes,DE,active,indianapolis-colts,1225000,2010
17167,1101000,92500,Clint Session,LB,active,indianapolis-colts,1193500,2010
17168,1101000,10375,Keyunta Dawson,DE,active,indianapolis-colts,1111375,2010
17169,860000,0,Justin Snow,TE,active,indianapolis-colts,860000,2010
17170,470000,212500,Mike Pollak,G,active,indianapolis-colts,682500,2010
17171,395000,258000,Fili Moala,DE,active,indianapolis-colts,653000,2010
17172,470000,161000,Philip Wheeler,OLB,active,indianapolis-colts,631000,2010
17173,470000,105393,Jacob Tamme,TE,active,indianapolis-colts,575393,2010
17174,395000,169625,Jerraud Powers,CB,active,indianapolis-colts,564625,2010
17175,310000,252500,Patrick Angerer,ILB,active,indianapolis-colts,562500,2010
17176,395000,109388,Austin Collie,WR,active,indianapolis-colts,504388,2010
17177,320000,168868,Kevin Thomas,CB,active,indianapolis-colts,488868,2010
17178,470000,17900,Pierre Garcon,WR,active,indianapolis-colts,487900,2010
17179,470000,11183,Jamey Richard,G,active,indianapolis-colts,481183,2010
17180,470000,0,Mike Hart,RB,active,indianapolis-colts,470000,2010
17181,470000,0,Kenneth Moore,WR,active,indianapolis-colts,470000,2010
17182,470000,0,Mike Richardson,CB,active,indianapolis-colts,470000,2010
17183,470000,0,Gijon Robinson,TE,active,indianapolis-colts,470000,2010
17184,320000,108750,Jacques McClendon,C,active,indianapolis-colts,428750,2010
17185,395000,22750,Curtis Painter,QB,active,indianapolis-colts,417750,2010
17186,405000,0,Jaimie Thomas,T,active,indianapolis-colts,405000,2010
17187,395000,333,Jacob Lacey,CB,active,indianapolis-colts,395333,2010
17188,395000,0,Tom Brandstater,QB,active,indianapolis-colts,395000,2010
17189,395000,0,Cody Glenn,LB,active,indianapolis-colts,395000,2010
17190,371764,14500,Pat McAfee,P,active,indianapolis-colts,386264,2010
17191,320000,40700,Brody Eldridge,TE,active,indianapolis-colts,360700,2010
17192,320000,11628,Ricardo Mathews,DT,active,indianapolis-colts,331628,2010
17193,320000,11309,Kavell Conner,ILB,active,indianapolis-colts,331309,2010
17194,320000,6666,Jeff Linkenbach,RT,active,indianapolis-colts,326666,2010
17195,320000,0,David Caldwell,S,active,indianapolis-colts,320000,2010
17196,320000,0,John Gill,DT,active,indianapolis-colts,320000,2010
17197,320000,0,Chris Gronkowski,RB,active,indianapolis-colts,320000,2010
17198,320000,0,Javarris James,RB,active,indianapolis-colts,320000,2010
17199,320000,0,Brandon King,CB,active,indianapolis-colts,320000,2010
17200,320000,0,Blair White,WR,active,indianapolis-colts,320000,2010
17201,755000,0,Dominic Rhodes,RB,active,indianapolis-colts,755000,2010
17202,209117,666,Ramon Humber,OLB,active,indianapolis-colts,209783,2010
17203,320000,0,Devin Moore,RB,active,indianapolis-colts,320000,2010
17204,395000,0,Kyle DeVan,G,active,indianapolis-colts,395000,2010
17205,320000,0,Joe Reitz,G,active,indianapolis-colts,320000,2010
17206,4000000,5463333,Dallas Clark,TE,injured_reserve,indianapolis-colts,9463333,2010
17207,550000,1737500,Anthony Gonzalez,WR,injured_reserve,indianapolis-colts,2287500,2010
17208,470000,0,Tom Santi,TE,injured_reserve,indianapolis-colts,470000,2010
17209,88400,0,John Destin,CB,practice_squad,indianapolis-colts,88400,2010
17210,88400,0,Terrence Johnson,CB,practice_squad,indianapolis-colts,88400,2010
17211,88400,0,Joe Reitz,G,practice_squad,indianapolis-colts,88400,2010
17212,2700000,0,Ryan Lilja,C,dead_cap,indianapolis-colts,2700000,2010
17213,152500,0,Dante Hughes,CB,dead_cap,indianapolis-colts,152500,2010
17214,0,125000,Jim Sorgi,QB,dead_cap,indianapolis-colts,125000,2010
17215,0,106666,Joe Reitz,G,dead_cap,indianapolis-colts,106666,2010
17216,99812,0,Terrance Taylor,DT,dead_cap,indianapolis-colts,99812,2010
17217,73374,0,Roy Hall,WR,dead_cap,indianapolis-colts,73374,2010
17218,43380,0,Tom Santi,TE,dead_cap,indianapolis-colts,43380,2010
17219,37870,0,Steve Justice,C,dead_cap,indianapolis-colts,37870,2010
17220,18767,0,Mike Hart,RB,dead_cap,indianapolis-colts,18767,2010
17221,0,12000,Blair White,WR,dead_cap,indianapolis-colts,12000,2010
17222,0,10391,Ray Fisher,CB,dead_cap,indianapolis-colts,10391,2010
17223,11420000,7500000,Dwight Freeney,OLB,active,indianapolis-colts,18920000,2011
17224,3400000,18200000,Peyton Manning,QB,active,indianapolis-colts,21600000,2011
17225,5950000,2323333,Reggie Wayne,WR,active,indianapolis-colts,8273333,2011
17226,4200000,5163333,Dallas Clark,TE,active,indianapolis-colts,9363333,2011
17227,4745000,1000000,Antoine Bethea,SS,active,indianapolis-colts,5745000,2011
17228,2400000,2483333,Jeff Saturday,C,active,indianapolis-colts,4883333,2011
17229,2000000,2400000,Gary Brackett,LB,active,indianapolis-colts,4400000,2011
17230,2410000,1940000,Robert Mathis,OLB,active,indianapolis-colts,4350000,2011
17231,2450000,1860000,Joseph Addai,RB,active,indianapolis-colts,4310000,2011
17232,635000,3435000,Donald Brown,RB,active,indianapolis-colts,4070000,2011
17233,1700000,1335000,Melvin Bullitt,S,active,indianapolis-colts,3035000,2011
17234,1400000,1200000,Adam Vinatieri,K,active,indianapolis-colts,2600000,2011
17235,1100000,1737500,Anthony Gonzalez,WR,active,indianapolis-colts,2837500,2011
17236,1250000,750000,Antonio Johnson,DT,active,indianapolis-colts,2000000,2011
17237,450000,1832500,Jerry Hughes,DE,active,indianapolis-colts,2282500,2011
17238,375000,1079745,Anthony Castonzo,LT,active,indianapolis-colts,1454745,2011
17239,1200000,161000,Philip Wheeler,OLB,active,indianapolis-colts,1361000,2011
17240,1200000,17900,Pierre Garcon,WR,active,indianapolis-colts,1217900,2011
17241,750000,350000,Jamaal Anderson,DE,active,indianapolis-colts,1100000,2011
17242,910000,0,Justin Snow,TE,active,indianapolis-colts,910000,2011
17243,810000,190000,Tyler Brayton,DT,active,indianapolis-colts,1000000,2011
17244,525000,258000,Fili Moala,DE,active,indianapolis-colts,783000,2011
17245,375000,360545,Benjamin Ijalana,RT,active,indianapolis-colts,735545,2011
17246,600000,105393,Jacob Tamme,TE,active,indianapolis-colts,705393,2011
17247,450000,252500,Patrick Angerer,ILB,active,indianapolis-colts,702500,2011
17248,525000,169625,Jerraud Powers,CB,active,indianapolis-colts,694625,2011
17249,525000,109388,Austin Collie,WR,active,indianapolis-colts,634388,2011
17250,555000,11183,Jamey Richard,G,active,indianapolis-colts,566183,2011
17251,525000,22750,Curtis Painter,QB,active,indianapolis-colts,547750,2011
17252,375000,168868,Kevin Thomas,CB,active,indianapolis-colts,543868,2011
17253,515000,14500,Pat McAfee,P,active,indianapolis-colts,529500,2011
17254,685000,0,Dan Orlovsky,QB,active,indianapolis-colts,685000,2011
17255,525000,0,Quan Cosby,WR,active,indianapolis-colts,525000,2011
17256,375000,137278,Drake Nevis,DE,active,indianapolis-colts,512278,2011
17257,450000,40700,Brody Eldridge,TE,active,indianapolis-colts,490700,2011
17258,490000,0,Jaimie Thomas,T,active,indianapolis-colts,490000,2011
17259,375000,106301,Delone Carter,RB,active,indianapolis-colts,481301,2011
17260,480000,333,Jacob Lacey,CB,active,indianapolis-colts,480333,2011
17261,480000,0,Kyle DeVan,G,active,indianapolis-colts,480000,2011
17262,480000,0,John Gill,DT,active,indianapolis-colts,480000,2011
17263,480000,0,Michael Toudouze,T,active,indianapolis-colts,480000,2011
17264,450000,11309,Kavell Conner,ILB,active,indianapolis-colts,461309,2011
17265,450000,6666,Jeff Linkenbach,RT,active,indianapolis-colts,456666,2011
17266,450000,0,Brandon King,CB,active,indianapolis-colts,450000,2011
17267,405000,0,David Caldwell,S,active,indianapolis-colts,405000,2011
17268,405000,0,Chris Gronkowski,RB,active,indianapolis-colts,405000,2011
17269,375000,25418,Chris Rucker,CB,active,indianapolis-colts,400418,2011
17270,375000,2667,Joe Lefeged,S,active,indianapolis-colts,377667,2011
17271,375000,0,Mario Addison,DE,active,indianapolis-colts,375000,2011
17272,375000,0,A.J. Edds,OLB,active,indianapolis-colts,375000,2011
17273,375000,0,Jermale Hines,S,active,indianapolis-colts,375000,2011
17274,375000,0,Mike Holmes,CB,active,indianapolis-colts,375000,2011
17275,375000,0,Scott Lutrus,ILB,active,indianapolis-colts,375000,2011
17276,375000,0,Ryan Mahaffey,RB,active,indianapolis-colts,375000,2011
17277,375000,0,Mike Newton,CB,active,indianapolis-colts,375000,2011
17278,375000,0,Joe Reitz,G,active,indianapolis-colts,375000,2011
17279,375000,0,Andre Smith,TE,active,indianapolis-colts,375000,2011
17280,337500,0,Ricardo Mathews,DT,active,indianapolis-colts,337500,2011
17281,1500000,1250000,Kerry Collins,QB,injured_reserve,indianapolis-colts,2750000,2011
17282,450000,0,Blair White,WR,injured_reserve,indianapolis-colts,450000,2011
17283,375000,0,Terrence Johnson,CB,injured_reserve,indianapolis-colts,375000,2011
17284,96900,0,Ricardo Mathews,DT,practice_squad,indianapolis-colts,96900,2011
17285,212500,0,Mike Pollak,G,dead_cap,indianapolis-colts,212500,2011
17286,199624,0,Terrance Taylor,DT,dead_cap,indianapolis-colts,199624,2011
17287,0,108750,Jacques McClendon,C,dead_cap,indianapolis-colts,108750,2011
17288,0,100000,Tommie Harris,DT,dead_cap,indianapolis-colts,100000,2011
17289,0,31173,Ray Fisher,CB,dead_cap,indianapolis-colts,31173,2011
17290,0,30000,Jermale Hines,S,dead_cap,indianapolis-colts,30000,2011
17291,11628,0,Ricardo Mathews,DT,dead_cap,indianapolis-colts,11628,2011
17292,666,0,Ramon Humber,OLB,dead_cap,indianapolis-colts,666,2011
17293,14035000,7500000,Dwight Freeney,OLB,active,indianapolis-colts,21535000,2012
17294,5025000,1200000,Antoine Bethea,SS,active,indianapolis-colts,6225000,2012
17295,2000000,3750000,Robert Mathis,OLB,active,indianapolis-colts,5750000,2012
17296,390000,3629636,Andrew Luck,QB,active,indianapolis-colts,4019636,2012
17297,2000000,1200000,Adam Vinatieri,K,active,indianapolis-colts,3200000,2012
17298,1000000,2166666,Reggie Wayne,WR,active,indianapolis-colts,3166666,2012
17299,1250000,750000,Antonio Johnson,DT,active,indianapolis-colts,2000000,2012
17300,865000,1830000,Donald Brown,RB,active,indianapolis-colts,2695000,2012
17301,700000,1066667,Samson Satele,C,active,indianapolis-colts,1766667,2012
17302,738686,1079745,Anthony Castonzo,LT,active,indianapolis-colts,1818431,2012
17303,825000,891667,Cory Redding,DE,active,indianapolis-colts,1716667,2012
17304,635000,1832500,Jerry Hughes,DE,active,indianapolis-colts,2467500,2012
17305,1500000,0,Winston Justice,LT,active,indianapolis-colts,1500000,2012
17306,1308000,14500,Pat McAfee,P,active,indianapolis-colts,1322500,2012
17307,700000,391667,Tom Zbikowski,S,active,indianapolis-colts,1091667,2012
17308,540000,592500,Patrick Angerer,ILB,active,indianapolis-colts,1132500,2012
17309,700000,425000,Mike McGlynn,G,active,indianapolis-colts,1125000,2012
17310,390000,581209,Coby Fleener,TE,active,indianapolis-colts,971209,2012
17311,957500,0,Vontae Davis,CB,active,indianapolis-colts,957500,2012
17312,558886,360545,Benjamin Ijalana,RT,active,indianapolis-colts,919431,2012
17313,770000,25000,Darius Butler,FS,active,indianapolis-colts,795000,2012
17314,615000,169625,Jerraud Powers,CB,active,indianapolis-colts,784625,2012
17315,540000,133735,Darryl Sharpton,ILB,active,indianapolis-colts,673735,2012
17316,615000,50000,Donnie Avery,WR,active,indianapolis-colts,665000,2012
17317,615000,12438,Moise Fokou,ILB,active,indianapolis-colts,627438,2012
17318,485000,137278,Drake Nevis,DE,active,indianapolis-colts,622278,2012
17319,615000,0,Jamaal Westerman,LB,active,indianapolis-colts,615000,2012
17320,465000,106301,Delone Carter,RB,active,indianapolis-colts,571301,2012
17321,390000,175826,Dwayne Allen,TE,active,indianapolis-colts,565826,2012
17322,540000,11309,Kavell Conner,ILB,active,indianapolis-colts,551309,2012
17323,540000,6668,Jeff Linkenbach,RT,active,indianapolis-colts,546668,2012
17324,700000,0,Tony Hills,LT,active,indianapolis-colts,700000,2012
17325,540000,0,Deji Karim,RB,active,indianapolis-colts,540000,2012
17326,540000,0,Ricardo Mathews,DT,active,indianapolis-colts,540000,2012
17327,540000,0,Joe Reitz,G,active,indianapolis-colts,540000,2012
17328,540000,0,Cassius Vaughn,CB,active,indianapolis-colts,540000,2012
17329,390000,131850,T.Y. Hilton,WR,active,indianapolis-colts,521850,2012
17330,490000,0,Sergio Brown,FS,active,indianapolis-colts,490000,2012
17331,465000,2667,Joe Lefeged,S,active,indianapolis-colts,467667,2012
17332,465000,0,A.J. Edds,OLB,active,indianapolis-colts,465000,2012
17333,465000,0,Weslye Saunders,WR,active,indianapolis-colts,465000,2012
17334,465000,0,Martin Tevaseu,DT,active,indianapolis-colts,465000,2012
17335,390000,36140,Vick Ballard,RB,active,indianapolis-colts,426140,2012
17336,825000,0,Mewelde Moore,RB,active,indianapolis-colts,825000,2012
17337,390000,18513,LaVon Brazill,WR,active,indianapolis-colts,408513,2012
17338,390000,0,Justin Anderson,RT,active,indianapolis-colts,390000,2012
17339,390000,0,Mario Harvey,FB,active,indianapolis-colts,390000,2012
17340,390000,0,Justin Hickman,ILB,active,indianapolis-colts,390000,2012
17341,390000,0,Jake Kirkpatrick,G,active,indianapolis-colts,390000,2012
17342,390000,0,Matt Overton,LS,active,indianapolis-colts,390000,2012
17343,390000,0,Nathan Palmer,WR,active,indianapolis-colts,390000,2012
17344,390000,0,Brandon Peguese,LB,active,indianapolis-colts,390000,2012
17345,390000,0,A.Q. Shipley,C,active,indianapolis-colts,390000,2012
17346,390000,0,Bradley Sowell,LT,active,indianapolis-colts,390000,2012
17347,390000,0,Trevor Vittatoe,QB,active,indianapolis-colts,390000,2012
17348,390000,0,Teddy Williams,CB,active,indianapolis-colts,390000,2012
17349,375000,6666,Jerrell Freeman,ILB,active,indianapolis-colts,381666,2012
17350,273000,500,Griff Whalen,WR,active,indianapolis-colts,273500,2012
17351,390000,0,Lawrence Guy,DE,active,indianapolis-colts,390000,2012
17352,540000,0,Kellen Heard,DE,active,indianapolis-colts,540000,2012
17353,390000,0,Delano Howell,S,active,indianapolis-colts,390000,2012
17354,1308000,109388,Austin Collie,WR,injured_reserve,indianapolis-colts,1417388,2012
17355,615000,258000,Fili Moala,DE,injured_reserve,indianapolis-colts,873000,2012
17356,700000,150000,Brandon McKinney,DT,injured_reserve,indianapolis-colts,850000,2012
17357,540000,0,Seth Olsen,G,injured_reserve,indianapolis-colts,540000,2012
17358,390000,53878,Josh Chapman,DT,injured_reserve,indianapolis-colts,443878,2012
17359,390000,0,Robert Hughes,RB,injured_reserve,indianapolis-colts,390000,2012
17360,288000,0,Scott Lutrus,ILB,injured_reserve,indianapolis-colts,288000,2012
17361,0,10400000,Peyton Manning,QB,dead_cap,indianapolis-colts,10400000,2012
17362,0,10226666,Dallas Clark,TE,dead_cap,indianapolis-colts,10226666,2012
17363,5400000,0,Kelvin Hayden,CB,dead_cap,indianapolis-colts,5400000,2012
17364,0,3720000,Joseph Addai,RB,dead_cap,indianapolis-colts,3720000,2012
17365,2670000,0,Melvin Bullitt,S,dead_cap,indianapolis-colts,2670000,2012
17366,2400000,0,Gary Brackett,LB,dead_cap,indianapolis-colts,2400000,2012
17367,0,1250000,Kerry Collins,QB,dead_cap,indianapolis-colts,1250000,2012
17368,0,217500,Jacques McClendon,C,dead_cap,indianapolis-colts,217500,2012
17369,192187,0,Justin King,CB,dead_cap,indianapolis-colts,192187,2012
17370,168868,0,Kevin Thomas,CB,dead_cap,indianapolis-colts,168868,2012
17371,146250,11474,Chandler Harnish,QB,dead_cap,indianapolis-colts,157724,2012
17372,150000,0,Justin Snow,TE,dead_cap,indianapolis-colts,150000,2012
17373,121875,0,Dominique Jones,TE,dead_cap,indianapolis-colts,121875,2012
17374,116250,0,Kris Adams,WR,dead_cap,indianapolis-colts,116250,2012
17375,116250,0,Mario Addison,DE,dead_cap,indianapolis-colts,116250,2012
17376,34884,0,Ricardo Mathews,DT,dead_cap,indianapolis-colts,34884,2012
17377,0,25418,Chris Rucker,CB,dead_cap,indianapolis-colts,25418,2012
17378,22750,0,Curtis Painter,QB,dead_cap,indianapolis-colts,22750,2012
17379,20909,0,Tim Fugger,OLB,dead_cap,indianapolis-colts,20909,2012
17380,0,17250,Justin Anderson,RT,dead_cap,indianapolis-colts,17250,2012
17381,4667,0,Mike McNeill,TE,dead_cap,indianapolis-colts,4667,2012
17382,4000000,6750000,Robert Mathis,OLB,active,indianapolis-colts,10750000,2013
17383,5500000,2900000,Gosder Cherilus,RT,active,indianapolis-colts,8400000,2013
17384,5000000,3166666,Reggie Wayne,WR,active,indianapolis-colts,8166666,2013
17385,4550000,1200000,Antoine Bethea,SS,active,indianapolis-colts,5750000,2013
17386,4000000,1750000,LaRon Landry,S,active,indianapolis-colts,5750000,2013
17387,1394909,3629636,Andrew Luck,QB,active,indianapolis-colts,5024545,2013
17388,1000000,3625000,Ricky Jean Francois,DT,active,indianapolis-colts,4625000,2013
17389,3500000,891667,Cory Redding,DE,active,indianapolis-colts,4391667,2013
17390,4000000,333333,Greg Toler,CB,active,indianapolis-colts,4333333,2013
17391,2700000,1066667,Samson Satele,C,active,indianapolis-colts,3766667,2013
17392,2000000,1500000,Matt Hasselbeck,QB,active,indianapolis-colts,3500000,2013
17393,2000000,1400000,Adam Vinatieri,K,active,indianapolis-colts,3400000,2013
17394,2823529,250000,Erik Walden,OLB,active,indianapolis-colts,3073529,2013
17395,2977000,0,Pat McAfee,P,active,indianapolis-colts,2977000,2013
17396,1705000,1830000,Donald Brown,RB,active,indianapolis-colts,3535000,2013
17397,1500000,1075000,Mike McGlynn,G,active,indianapolis-colts,2575000,2013
17398,1000000,1500000,Darrius Heyward-Bey,WR,active,indianapolis-colts,2500000,2013
17399,1102372,1079745,Anthony Castonzo,LT,active,indianapolis-colts,2182117,2013
17400,1861250,0,Vontae Davis,CB,active,indianapolis-colts,1861250,2013
17401,1000000,500000,Darius Butler,FS,active,indianapolis-colts,1500000,2013
17402,405000,1030708,Bjoern Werner,OLB,active,indianapolis-colts,1435708,2013
17403,1323000,0,Jeff Linkenbach,RT,active,indianapolis-colts,1323000,2013
17404,1323000,0,Cassius Vaughn,CB,active,indianapolis-colts,1323000,2013
17405,1321354,0,Trent Richardson,RB,active,indianapolis-colts,1321354,2013
17406,850000,400000,Fili Moala,DE,active,indianapolis-colts,1250000,2013
17407,630000,592500,Patrick Angerer,ILB,active,indianapolis-colts,1222500,2013
17408,632802,581209,Coby Fleener,TE,active,indianapolis-colts,1214011,2013
17409,940000,65000,Aubrayo Franklin,DT,active,indianapolis-colts,1005000,2013
17410,527000,175826,Dwayne Allen,TE,active,indianapolis-colts,702826,2013
17411,614243,30000,Kelvin Sheppard,ILB,active,indianapolis-colts,644243,2013
17412,630000,11309,Kavell Conner,ILB,active,indianapolis-colts,641309,2013
17413,630000,0,Sergio Brown,FS,active,indianapolis-colts,630000,2013
17414,630000,0,Ricardo Mathews,DT,active,indianapolis-colts,630000,2013
17415,485000,131850,T.Y. Hilton,WR,active,indianapolis-colts,616850,2013
17416,555000,0,Josh Gordy,CB,active,indianapolis-colts,555000,2013
17417,555000,0,Joe Reitz,G,active,indianapolis-colts,555000,2013
17418,405000,136345,Hugh Thornton,G,active,indianapolis-colts,541345,2013
17419,405000,105027,Khaled Holmes,C,active,indianapolis-colts,510027,2013
17420,715000,0,Andy Studebaker,OLB,active,indianapolis-colts,715000,2013
17421,480000,6666,Jerrell Freeman,ILB,active,indianapolis-colts,486666,2013
17422,480000,0,Stanley Havili,FB,active,indianapolis-colts,480000,2013
17423,480000,0,Matt Overton,LS,active,indianapolis-colts,480000,2013
17424,405000,53878,Josh Chapman,DT,active,indianapolis-colts,458878,2013
17425,405000,50493,Montori Hughes,DT,active,indianapolis-colts,455493,2013
17426,405000,0,Jack Doyle,TE,active,indianapolis-colts,405000,2013
17427,405000,0,Cam Johnson,OLB,active,indianapolis-colts,405000,2013
17428,405000,0,Josh Lenz,WR,active,indianapolis-colts,405000,2013
17429,367059,18513,LaVon Brazill,WR,active,indianapolis-colts,385572,2013
17430,338823,0,Dan Herron,RB,active,indianapolis-colts,338823,2013
17431,303000,0,Justin Anderson,RT,active,indianapolis-colts,303000,2013
17432,555000,0,Weslye Saunders,WR,active,indianapolis-colts,555000,2013
17433,715000,0,Corey Lynch,S,active,indianapolis-colts,715000,2013
17434,405000,0,Da'Rick Rogers,WR,active,indianapolis-colts,405000,2013
17435,715000,0,Tashard Choice,RB,active,indianapolis-colts,715000,2013
17436,405000,0,Josh McNary,OLB,active,indianapolis-colts,405000,2013
17437,405000,0,Daniel Adongo,OLB,active,indianapolis-colts,405000,2013
17438,405000,0,Xavier Nixon,LT,active,indianapolis-colts,405000,2013
17439,480000,0,Jeris Pendleton,DT,active,indianapolis-colts,480000,2013
17440,405000,0,Sheldon Price,CB,active,indianapolis-colts,405000,2013
17441,2500000,250000,Donald Thomas,G,injured_reserve,indianapolis-colts,2750000,2013
17442,1100000,818750,Ahmad Bradshaw,RB,injured_reserve,indianapolis-colts,1918750,2013
17443,715000,65000,Lawrence Sidbury,OLB,injured_reserve,indianapolis-colts,780000,2013
17444,555000,0,Scott Lutrus,ILB,injured_reserve,indianapolis-colts,555000,2013
17445,480000,36140,Vick Ballard,RB,injured_reserve,indianapolis-colts,516140,2013
17446,480000,0,Mario Harvey,FB,injured_reserve,indianapolis-colts,480000,2013
17447,480000,0,Delano Howell,S,injured_reserve,indianapolis-colts,480000,2013
17448,303000,0,Justin Hickman,ILB,injured_reserve,indianapolis-colts,303000,2013
17449,480000,0,Chris Rainey,RB,injured_reserve,indianapolis-colts,480000,2013
17450,208767,0,Griff Whalen,WR,practice_squad,indianapolis-colts,208767,2013
17451,163235,0,Joe Lefeged,S,practice_squad,indianapolis-colts,163235,2013
17452,143118,0,Xavier Nixon,LT,practice_squad,indianapolis-colts,143118,2013
17453,96000,0,Sheldon Price,CB,practice_squad,indianapolis-colts,96000,2013
17454,77824,0,Da'Rick Rogers,WR,practice_squad,indianapolis-colts,77824,2013
17455,72000,0,Josh McNary,OLB,practice_squad,indianapolis-colts,72000,2013
17456,18000,0,Jeris Pendleton,DT,practice_squad,indianapolis-colts,18000,2013
17457,12000,0,Danny Coale,WR,practice_squad,indianapolis-colts,12000,2013
17458,12000,0,Miguel Maysonet,RB,practice_squad,indianapolis-colts,12000,2013
17459,4800000,0,Gary Brackett,LB,dead_cap,indianapolis-colts,4800000,2013
17460,2112500,0,Jerry Hughes,DE,dead_cap,indianapolis-colts,2112500,2013
17461,783334,0,Tom Zbikowski,S,dead_cap,indianapolis-colts,783334,2013
17462,444706,0,David Reed,WR,dead_cap,indianapolis-colts,444706,2013
17463,360545,0,Benjamin Ijalana,RT,dead_cap,indianapolis-colts,360545,2013
17464,261177,0,Jalil Brown,CB,dead_cap,indianapolis-colts,261177,2013
17465,252000,0,Larry Asante,SS,dead_cap,indianapolis-colts,252000,2013
17466,238235,0,Jacob Byrne,TE,dead_cap,indianapolis-colts,238235,2013
17467,197647,0,Dominique Jones,TE,dead_cap,indianapolis-colts,197647,2013
17468,168868,0,Kevin Thomas,CB,dead_cap,indianapolis-colts,168868,2013
17469,150000,0,Brandon McKinney,DT,dead_cap,indianapolis-colts,150000,2013
17470,139696,0,Dax Swanson,SS,dead_cap,indianapolis-colts,139696,2013
17471,137278,0,Drake Nevis,DE,dead_cap,indianapolis-colts,137278,2013
17472,106301,0,Delone Carter,RB,dead_cap,indianapolis-colts,106301,2013
17473,101298,0,Justice Cunningham,TE,dead_cap,indianapolis-colts,101298,2013
17474,78235,0,Kerwynn Williams,RB,dead_cap,indianapolis-colts,78235,2013
17475,72000,0,Daniel Adongo,OLB,dead_cap,indianapolis-colts,72000,2013
17476,66000,0,Thomas Austin,C,dead_cap,indianapolis-colts,66000,2013
17477,56470,0,Lawrence Guy,DE,dead_cap,indianapolis-colts,56470,2013
17478,52235,0,Robert Hughes,RB,dead_cap,indianapolis-colts,52235,2013
17479,0,50836,Chris Rucker,CB,dead_cap,indianapolis-colts,50836,2013
17480,47046,0,Tim Fugger,OLB,dead_cap,indianapolis-colts,47046,2013
17481,2500,34422,Chandler Harnish,QB,dead_cap,indianapolis-colts,36922,2013
17482,35548,0,Dan Moore,FB,dead_cap,indianapolis-colts,35548,2013
17483,28235,0,Shaun Draughn,RB,dead_cap,indianapolis-colts,28235,2013
17484,25085,0,John Boyett,S,dead_cap,indianapolis-colts,25085,2013
17485,17824,0,Quinton Spears,OLB,dead_cap,indianapolis-colts,17824,2013
17486,6666,0,Emmett Cleary,RT,dead_cap,indianapolis-colts,6666,2013
17487,6000,0,Darin Drakeford,ILB,dead_cap,indianapolis-colts,6000,2013
17488,3333,0,Sheldon Price,CB,dead_cap,indianapolis-colts,3333,2013
17489,3000,0,Nigel Malone,CB,dead_cap,indianapolis-colts,3000,2013
17490,2668,0,Joe Lefeged,S,dead_cap,indianapolis-colts,2668,2013
17491,2500,0,Lanear Sampson,WR,dead_cap,indianapolis-colts,2500,2013
17492,2333,0,Brandon McManus,K,dead_cap,indianapolis-colts,2333,2013
17493,666,0,Denodus O'Bryant,RB,dead_cap,indianapolis-colts,666,2013
17494,0,500,Griff Whalen,WR,dead_cap,indianapolis-colts,500,2013
17495,5000000,1250000,Vontae Davis,CB,active,indianapolis-colts,6250000,2014
17496,4000000,2166668,Reggie Wayne,WR,active,indianapolis-colts,6166668,2014
17497,2399818,3629636,Andrew Luck,QB,active,indianapolis-colts,6029454,2014
17498,4500000,1100000,Arthur Jones,DT,active,indianapolis-colts,5600000,2014
17499,4500000,625000,Ricky Jean Francois,DT,active,indianapolis-colts,5125000,2014
17500,4500000,333333,Greg Toler,CB,active,indianapolis-colts,4833333,2014
17501,4500000,250000,D'Qwell Jackson,ILB,active,indianapolis-colts,4750000,2014
17502,3000000,1750000,LaRon Landry,S,active,indianapolis-colts,4750000,2014
17503,3500000,891667,Cory Redding,DE,active,indianapolis-colts,4391667,2014
17504,4000000,250000,Erik Walden,OLB,active,indianapolis-colts,4250000,2014
17505,1600000,2375000,Hakeem Nicks,WR,active,indianapolis-colts,3975000,2014
17506,1000000,2900000,Gosder Cherilus,RT,active,indianapolis-colts,3900000,2014
17507,1750000,2000000,Matt Hasselbeck,QB,active,indianapolis-colts,3750000,2014
17508,2500000,500000,Darius Butler,FS,active,indianapolis-colts,3000000,2014
17509,2750000,200000,Pat McAfee,P,active,indianapolis-colts,2950000,2014
17510,1466058,1079745,Anthony Castonzo,LT,active,indianapolis-colts,2545803,2014
17511,2252708,0,Trent Richardson,RB,active,indianapolis-colts,2252708,2014
17512,2000000,250000,Adam Vinatieri,K,active,indianapolis-colts,2250000,2014
17513,763927,1030708,Bjoern Werner,OLB,active,indianapolis-colts,1794635,2014
17514,875604,581209,Coby Fleener,TE,active,indianapolis-colts,1456813,2014
17515,1431000,0,Josh Gordy,CB,active,indianapolis-colts,1431000,2014
17516,1431000,0,Joe Reitz,G,active,indianapolis-colts,1431000,2014
17517,1100000,300000,Sergio Brown,FS,active,indianapolis-colts,1400000,2014
17518,730000,162500,Lance Louis,G,active,indianapolis-colts,892500,2014
17519,660000,175826,Dwayne Allen,TE,active,indianapolis-colts,835826,2014
17520,730000,0,Andy Studebaker,OLB,active,indianapolis-colts,730000,2014
17521,575000,131850,T.Y. Hilton,WR,active,indianapolis-colts,706850,2014
17522,420000,229782,Jack Mewhort,G,active,indianapolis-colts,649782,2014
17523,505000,136345,Hugh Thornton,G,active,indianapolis-colts,641345,2014
17524,955000,65000,Mike Adams,SS,active,indianapolis-colts,1020000,2014
17525,730000,65000,Colt Anderson,SS,active,indianapolis-colts,795000,2014
17526,495000,105027,Khaled Holmes,C,active,indianapolis-colts,600027,2014
17527,570000,6667,Jerrell Freeman,ILB,active,indianapolis-colts,576667,2014
17528,570000,0,Dan Herron,RB,active,indianapolis-colts,570000,2014
17529,570000,0,Matt Overton,LS,active,indianapolis-colts,570000,2014
17530,570000,0,A.Q. Shipley,C,active,indianapolis-colts,570000,2014
17531,420000,135880,Donte Moncrief,WR,active,indianapolis-colts,555880,2014
17532,495000,53878,Josh Chapman,DT,active,indianapolis-colts,548878,2014
17533,495000,50493,Montori Hughes,DT,active,indianapolis-colts,545493,2014
17534,495000,0,Jack Doyle,TE,active,indianapolis-colts,495000,2014
17535,495000,0,Cam Johnson,OLB,active,indianapolis-colts,495000,2014
17536,495000,0,Griff Whalen,WR,active,indianapolis-colts,495000,2014
17537,420000,44527,Jonathan Newsome,OLB,active,indianapolis-colts,464527,2014
17538,441176,0,Shaun Phillips,DE,active,indianapolis-colts,441176,2014
17539,420000,2500,Jonotthan Harrison,C,active,indianapolis-colts,422500,2014
17540,420000,2000,Zach Kerr,DE,active,indianapolis-colts,422000,2014
17541,420000,0,Henoc Muamba,ILB,active,indianapolis-colts,420000,2014
17542,411706,0,Xavier Nixon,LT,active,indianapolis-colts,411706,2014
17543,420000,0,Andrew Jackson,ILB,active,indianapolis-colts,420000,2014
17544,420000,0,Dewey McDonald,OLB,active,indianapolis-colts,420000,2014
17545,318000,0,Jeris Pendleton,DT,active,indianapolis-colts,318000,2014
17546,303000,14462,Ulrick John,LT,active,indianapolis-colts,317462,2014
17547,301764,0,Joshua Cribbs,WR,active,indianapolis-colts,301764,2014
17548,645000,0,Jalil Brown,CB,active,indianapolis-colts,645000,2014
17549,420000,0,Zurlon Tipton,RB,active,indianapolis-colts,420000,2014
17550,420000,0,Sheldon Price,CB,active,indianapolis-colts,420000,2014
17551,3500000,250000,Donald Thomas,G,injured_reserve,indianapolis-colts,3750000,2014
17552,1000000,600000,Fili Moala,DE,injured_reserve,indianapolis-colts,1600000,2014
17553,570000,0,Delano Howell,S,injured_reserve,indianapolis-colts,570000,2014
17554,495000,36140,Vick Ballard,RB,injured_reserve,indianapolis-colts,531140,2014
17555,855000,0,Ahmad Bradshaw,RB,injured_reserve,indianapolis-colts,855000,2014
17556,333000,0,Aaron Morgan,DE,injured_reserve,indianapolis-colts,333000,2014
17557,318000,0,Daniel Adongo,OLB,injured_reserve,indianapolis-colts,318000,2014
17558,420000,0,Matt Hall,RT,injured_reserve,indianapolis-colts,420000,2014
17559,303000,0,Shawn Loiseau,LB,injured_reserve,indianapolis-colts,303000,2014
17560,2294117,5750000,Robert Mathis,OLB,non_fb_injury,indianapolis-colts,8044117,2014
17561,107100,0,Ryan Lankford,WR,practice_squad,indianapolis-colts,107100,2014
17562,107100,0,Josh Lenz,WR,practice_squad,indianapolis-colts,107100,2014
17563,107100,0,Erik Swoope,TE,practice_squad,indianapolis-colts,107100,2014
17564,56700,0,Carlos Fields,OLB,practice_squad,indianapolis-colts,56700,2014
17565,31500,0,Jeff Demps,RB,practice_squad,indianapolis-colts,31500,2014
17566,31500,0,Kelcy Quarles,DT,practice_squad,indianapolis-colts,31500,2014
17567,12600,0,Tyler Hoover,DE,practice_squad,indianapolis-colts,12600,2014
17568,6300,0,Gannon Conway,DE,practice_squad,indianapolis-colts,6300,2014
17569,1066668,0,Samson Satele,C,dead_cap,indianapolis-colts,1066668,2014
17570,825000,0,Jamon Meredith,RT,dead_cap,indianapolis-colts,825000,2014
17571,380912,500,Griff Whalen,WR,dead_cap,indianapolis-colts,381412,2014
17572,360545,0,Benjamin Ijalana,RT,dead_cap,indianapolis-colts,360545,2014
17573,301765,0,Stanley Havili,FB,dead_cap,indianapolis-colts,301765,2014
17574,300588,0,Victor Butler,OLB,dead_cap,indianapolis-colts,300588,2014
17575,296471,1666,Louchiez Purifoy,CB,dead_cap,indianapolis-colts,298137,2014
17576,247059,0,Kelcy Quarles,DT,dead_cap,indianapolis-colts,247059,2014
17577,189706,0,Jalil Brown,CB,dead_cap,indianapolis-colts,189706,2014
17578,167647,0,Mario Harvey,FB,dead_cap,indianapolis-colts,167647,2014
17579,151765,0,Chris Carter,ILB,dead_cap,indianapolis-colts,151765,2014
17580,137278,0,Drake Nevis,DE,dead_cap,indianapolis-colts,137278,2014
17581,116471,0,Da'Rick Rogers,WR,dead_cap,indianapolis-colts,116471,2014
17582,106112,3333,Zurlon Tipton,RB,dead_cap,indianapolis-colts,109445,2014
17583,107100,0,Nnamdi Onukwelu,DT,dead_cap,indianapolis-colts,107100,2014
17584,106301,0,Delone Carter,RB,dead_cap,indianapolis-colts,106301,2014
17585,101167,0,Sheldon Price,CB,dead_cap,indianapolis-colts,101167,2014
17586,94500,0,David Arkin,G,dead_cap,indianapolis-colts,94500,2014
17587,93647,0,Deji Karim,RB,dead_cap,indianapolis-colts,93647,2014
17588,75880,0,Weslye Saunders,WR,dead_cap,indianapolis-colts,75880,2014
17589,75255,0,John Boyett,S,dead_cap,indianapolis-colts,75255,2014
17590,43606,24250,Andrew Jackson,ILB,dead_cap,indianapolis-colts,67856,2014
17591,56700,0,Trevardo Williams,DE,dead_cap,indianapolis-colts,56700,2014
17592,49412,0,Andrew McDonald,RT,dead_cap,indianapolis-colts,49412,2014
17593,43100,0,Nnadmi Obukwelu,DT,dead_cap,indianapolis-colts,43100,2014
17594,37800,0,Dominique Davis,DE,dead_cap,indianapolis-colts,37800,2014
17595,37764,0,Kerwynn Williams,RB,dead_cap,indianapolis-colts,37764,2014
17596,34422,0,Justice Cunningham,TE,dead_cap,indianapolis-colts,34422,2014
17597,33529,0,Dion Lewis,RB,dead_cap,indianapolis-colts,33529,2014
17598,0,30000,Kelvin Sheppard,ILB,dead_cap,indianapolis-colts,30000,2014
17599,25200,2833,Dewey McDonald,OLB,dead_cap,indianapolis-colts,28033,2014
17600,25200,0,Chandler Jones,WR,dead_cap,indianapolis-colts,25200,2014
17601,0,18513,LaVon Brazill,WR,dead_cap,indianapolis-colts,18513,2014
17602,12600,3333,Josh Walker,G,dead_cap,indianapolis-colts,15933,2014
17603,12600,2000,Eric Thomas,WR,dead_cap,indianapolis-colts,14600,2014
17604,13333,0,Emmett Cleary,RT,dead_cap,indianapolis-colts,13333,2014
17605,12600,0,Reid Fragel,RT,dead_cap,indianapolis-colts,12600,2014
17606,12600,0,Konrad Reuland,TE,dead_cap,indianapolis-colts,12600,2014
17607,8334,0,Dax Swanson,SS,dead_cap,indianapolis-colts,8334,2014
17608,6300,0,Jeff Demps,RB,dead_cap,indianapolis-colts,6300,2014
17609,6300,0,Michael Hill,RB,dead_cap,indianapolis-colts,6300,2014
17610,6300,0,Jeff Mathews,QB,dead_cap,indianapolis-colts,6300,2014
17611,6300,0,Robert Ruggiero,OLB,dead_cap,indianapolis-colts,6300,2014
17612,5000,0,Chandler Harnish,QB,dead_cap,indianapolis-colts,5000,2014
17613,5000,0,Lanear Sampson,WR,dead_cap,indianapolis-colts,5000,2014
17614,4667,0,Brandon McManus,K,dead_cap,indianapolis-colts,4667,2014
17615,3334,0,Dan Moore,FB,dead_cap,indianapolis-colts,3334,2014
17616,0,2666,Tyler Hoover,DE,dead_cap,indianapolis-colts,2666,2014
17617,0,2000,Eric Pike,RT,dead_cap,indianapolis-colts,2000,2014
17618,0,1666,Erik Swoope,TE,dead_cap,indianapolis-colts,1666,2014
17619,0,1666,Tony Washington,WR,dead_cap,indianapolis-colts,1666,2014
17620,1334,0,Denodus O'Bryant,RB,dead_cap,indianapolis-colts,1334,2014
17621,0,1000,Seth Lobato,QB,dead_cap,indianapolis-colts,1000,2014
17622,0,1000,Keon Lyn,CB,dead_cap,indianapolis-colts,1000,2014
17623,0,1000,Darius Polk,CB,dead_cap,indianapolis-colts,1000,2014
17624,0,333,Kameron Jackson,CB,dead_cap,indianapolis-colts,333,2014
17625,4000000,7250000,Vontae Davis,CB,active,indianapolis-colts,11250000,2015
17626,3500000,4000000,Andre Johnson,WR,active,indianapolis-colts,7500000,2015
17627,4000000,3470586,Robert Mathis,OLB,active,indianapolis-colts,7470586,2015
17628,6000000,1100000,Arthur Jones,DT,active,indianapolis-colts,7100000,2015
17629,3404727,3629636,Andrew Luck,QB,active,indianapolis-colts,7034363,2015
17630,2000000,4953125,Trent Cole,OLB,active,indianapolis-colts,6953125,2015
17631,4000000,2800000,Anthony Castonzo,LT,active,indianapolis-colts,6800000,2015
17632,5500000,333334,Greg Toler,CB,active,indianapolis-colts,5833334,2015
17633,870000,4880000,D'Qwell Jackson,ILB,active,indianapolis-colts,5750000,2015
17634,1000000,3500000,Frank Gore,RB,active,indianapolis-colts,4500000,2015
17635,4000000,250000,Erik Walden,OLB,active,indianapolis-colts,4250000,2015
17636,2500000,1750000,Kendall Langford,DE,active,indianapolis-colts,4250000,2015
17637,2750000,450000,Pat McAfee,P,active,indianapolis-colts,3200000,2015
17638,1000000,2131850,T.Y. Hilton,WR,active,indianapolis-colts,3131850,2015
17639,1000000,2100000,Mike Adams,SS,active,indianapolis-colts,3100000,2015
17640,1500000,1562500,Joe Reitz,G,active,indianapolis-colts,3062500,2015
17641,2000000,1000000,Matt Hasselbeck,QB,active,indianapolis-colts,3000000,2015
17642,2000000,750000,Adam Vinatieri,K,active,indianapolis-colts,2750000,2015
17643,1500000,1000000,Darius Butler,FS,active,indianapolis-colts,2500000,2015
17644,2356000,0,Jerrell Freeman,ILB,active,indianapolis-colts,2356000,2015
17645,1122854,1030708,Bjoern Werner,OLB,active,indianapolis-colts,2153562,2015
17646,1118406,581209,Coby Fleener,TE,active,indianapolis-colts,1699615,2015
17647,435000,1044166,Phillip Dorsett,WR,active,indianapolis-colts,1479166,2015
17648,660000,640000,Matt Overton,LS,active,indianapolis-colts,1300000,2015
17649,745000,221250,Lance Louis,G,active,indianapolis-colts,966250,2015
17650,582446,229782,Jack Mewhort,G,active,indianapolis-colts,812228,2015
17651,585000,105027,Khaled Holmes,C,active,indianapolis-colts,690027,2015
17652,870000,80000,Dwight Lowery,FS,active,indianapolis-colts,950000,2015
17653,745000,80000,Colt Anderson,SS,active,indianapolis-colts,825000,2015
17654,525000,135880,Donte Moncrief,WR,active,indianapolis-colts,660880,2015
17655,660000,0,Winston Guy,FS,active,indianapolis-colts,660000,2015
17656,643000,0,Sio Moore,OLB,active,indianapolis-colts,643000,2015
17657,585000,0,Jack Doyle,TE,active,indianapolis-colts,585000,2015
17658,435000,133482,Clayton Geathers,FS,active,indianapolis-colts,568482,2015
17659,510000,44527,Jonathan Newsome,OLB,active,indianapolis-colts,554527,2015
17660,510000,2500,Jonotthan Harrison,C,active,indianapolis-colts,512500,2015
17661,510000,2000,Zach Kerr,DE,active,indianapolis-colts,512000,2015
17662,435000,55002,David Parry,DT,active,indianapolis-colts,490002,2015
17663,435000,13196,Denzell Good,RT,active,indianapolis-colts,448196,2015
17664,435000,0,T.Y. McGill,DT,active,indianapolis-colts,435000,2015
17665,318000,2666,Junior Sylvestre,ILB,active,indianapolis-colts,320666,2015
17666,318000,0,Tevin Mitchel,CB,active,indianapolis-colts,318000,2015
17667,255882,0,Quan Bray,WR,active,indianapolis-colts,255882,2015
17668,232941,0,Dan Herron,RB,active,indianapolis-colts,232941,2015
17669,175294,0,Jalil Brown,CB,active,indianapolis-colts,175294,2015
17670,131470,0,Andy Studebaker,OLB,active,indianapolis-colts,131470,2015
17671,90000,0,Akeem Davis,SS,active,indianapolis-colts,90000,2015
17672,76764,0,Devonta Glover-Wright,CB,active,indianapolis-colts,76764,2015
17673,51176,0,Stephen Morris,QB,active,indianapolis-colts,51176,2015
17674,51176,0,Earl Okine,DE,active,indianapolis-colts,51176,2015
17675,51176,0,Kelcy Quarles,DT,active,indianapolis-colts,51176,2015
17676,51176,0,Trey Williams,RB,active,indianapolis-colts,51176,2015
17677,43823,0,Josh Freeman,QB,active,indianapolis-colts,43823,2015
17678,38823,0,Ryan Lindley,QB,active,indianapolis-colts,38823,2015
17679,25588,0,Amarlo Herrera,ILB,active,indianapolis-colts,25588,2015
17680,25588,0,Erik Swoope,TE,active,indianapolis-colts,25588,2015
17681,1542000,175826,Dwayne Allen,TE,injured_reserve,indianapolis-colts,1717826,2015
17682,1542000,0,Billy Winn,DE,injured_reserve,indianapolis-colts,1542000,2015
17683,750000,500000,Nate Irving,ILB,injured_reserve,indianapolis-colts,1250000,2015
17684,941176,0,Charlie Whitehurst,QB,injured_reserve,indianapolis-colts,941176,2015
17685,595000,136345,Hugh Thornton,G,injured_reserve,indianapolis-colts,731345,2015
17686,379941,202211,D'Joun Smith,CB,injured_reserve,indianapolis-colts,582152,2015
17687,571058,0,Josh McNary,OLB,injured_reserve,indianapolis-colts,571058,2015
17688,379941,153419,Henry Anderson,DE,injured_reserve,indianapolis-colts,533360,2015
17689,562941,0,Ahmad Bradshaw,RB,injured_reserve,indianapolis-colts,562941,2015
17690,352411,2000,Tyler Varga,RB,injured_reserve,indianapolis-colts,354411,2015
17691,333000,666,Joshua Mitchell,CB,injured_reserve,indianapolis-colts,333666,2015
17692,0,3294117,LaRon Landry,S,dead_cap,indianapolis-colts,3294117,2015
17693,0,3800000,Gosder Cherilus,RT,dead_cap,indianapolis-colts,3800000,2015
17694,1000000,875000,Todd Herremans,G,dead_cap,indianapolis-colts,1875000,2015
17695,0,1250000,Ricky Jean Francois,DT,dead_cap,indianapolis-colts,1250000,2015
17696,745000,0,Jalil Brown,CB,dead_cap,indianapolis-colts,745000,2015
17697,585000,0,Griff Whalen,WR,dead_cap,indianapolis-colts,585000,2015
17698,482058,0,Joshua Thomas,CB,dead_cap,indianapolis-colts,482058,2015
17699,343200,6667,Zurlon Tipton,RB,dead_cap,indianapolis-colts,349867,2015
17700,263294,27041,Josh Robinson,RB,dead_cap,indianapolis-colts,290335,2015
17701,0,250000,Donald Thomas,G,dead_cap,indianapolis-colts,250000,2015
17702,209400,0,Daniel Adongo,OLB,dead_cap,indianapolis-colts,209400,2015
17703,150176,26164,Amarlo Herrera,ILB,dead_cap,indianapolis-colts,176340,2015
17704,149364,0,Earl Okine,DE,dead_cap,indianapolis-colts,149364,2015
17705,137200,0,Duron Carter,WR,dead_cap,indianapolis-colts,137200,2015
17706,131812,0,Ben Heenan,G,dead_cap,indianapolis-colts,131812,2015
17707,116470,0,Shaun Prater,CB,dead_cap,indianapolis-colts,116470,2015
17708,77647,36140,Vick Ballard,RB,dead_cap,indianapolis-colts,113787,2015
17709,109588,0,Sheldon Price,CB,dead_cap,indianapolis-colts,109588,2015
17710,105600,3334,Erik Swoope,TE,dead_cap,indianapolis-colts,108934,2015
17711,96565,0,Eric Patterson,CB,dead_cap,indianapolis-colts,96565,2015
17712,75363,0,Tony Carter,CB,dead_cap,indianapolis-colts,75363,2015
17713,69600,5667,Dewey McDonald,OLB,dead_cap,indianapolis-colts,75267,2015
17714,0,72750,Andrew Jackson,ILB,dead_cap,indianapolis-colts,72750,2015
17715,87646,0,Josh Johnson,QB,dead_cap,indianapolis-colts,87646,2015
17716,66000,0,Devonta Glover-Wright,CB,dead_cap,indianapolis-colts,66000,2015
17717,46200,14462,Ulrick John,LT,dead_cap,indianapolis-colts,60662,2015
17718,59400,0,Alex Tanney,QB,dead_cap,indianapolis-colts,59400,2015
17719,0,53878,Josh Chapman,DT,dead_cap,indianapolis-colts,53878,2015
17720,52800,0,Dezmen Southward,CB,dead_cap,indianapolis-colts,52800,2015
17721,0,50493,Montori Hughes,DT,dead_cap,indianapolis-colts,50493,2015
17722,46200,1666,Quan Bray,WR,dead_cap,indianapolis-colts,47866,2015
17723,33000,0,Pierce Burton,RT,dead_cap,indianapolis-colts,33000,2015
17724,26400,0,Josh Martin,OLB,dead_cap,indianapolis-colts,26400,2015
17725,19800,0,Matt Blanchard,QB,dead_cap,indianapolis-colts,19800,2015
17726,19800,0,LaDarius Perkins,RB,dead_cap,indianapolis-colts,19800,2015
17727,19800,0,Edwin Jackson,ILB,dead_cap,indianapolis-colts,19800,2015
17728,19800,0,Sean McGrath,TE,dead_cap,indianapolis-colts,19800,2015
17729,19800,0,Kitt O'Brien,G,dead_cap,indianapolis-colts,19800,2015
17730,0,18513,LaVon Brazill,WR,dead_cap,indianapolis-colts,18513,2015
17731,13200,0,Joshua Stangby,WR,dead_cap,indianapolis-colts,13200,2015
17732,13200,0,Joe Vellano,DT,dead_cap,indianapolis-colts,13200,2015
17733,13200,0,David Arkin,G,dead_cap,indianapolis-colts,13200,2015
17734,0,6667,Josh Walker,G,dead_cap,indianapolis-colts,6667,2015
17735,6600,0,Sean Baker,FS,dead_cap,indianapolis-colts,6600,2015
17736,6600,0,Brandon Dixon,CB,dead_cap,indianapolis-colts,6600,2015
17737,6600,0,Josh McNary,OLB,dead_cap,indianapolis-colts,6600,2015
17738,6600,0,Robert Myers,G,dead_cap,indianapolis-colts,6600,2015
17739,6600,0,Jeris Pendleton,DT,dead_cap,indianapolis-colts,6600,2015
17740,6600,0,Brian Vogler,TE,dead_cap,indianapolis-colts,6600,2015
17741,6600,0,John Wetzel,RT,dead_cap,indianapolis-colts,6600,2015
17742,0,5334,Tyler Hoover,DE,dead_cap,indianapolis-colts,5334,2015
17743,0,4000,Eric Thomas,WR,dead_cap,indianapolis-colts,4000,2015
17744,0,3334,Louchiez Purifoy,CB,dead_cap,indianapolis-colts,3334,2015
17745,0,3334,Tony Washington,WR,dead_cap,indianapolis-colts,3334,2015
17746,0,3333,Bryan Bennett,QB,dead_cap,indianapolis-colts,3333,2015
17747,0,3333,Zack Hodges,OLB,dead_cap,indianapolis-colts,3333,2015
17748,0,3000,Terrell Hartsfield,OLB,dead_cap,indianapolis-colts,3000,2015
17749,0,2666,Donald Celiscar,CB,dead_cap,indianapolis-colts,2666,2015
17750,0,2500,David Fluellen,RB,dead_cap,indianapolis-colts,2500,2015
17751,0,2000,Seth Lobato,QB,dead_cap,indianapolis-colts,2000,2015
17752,0,2000,Keon Lyn,CB,dead_cap,indianapolis-colts,2000,2015
17753,0,2000,Darius Polk,CB,dead_cap,indianapolis-colts,2000,2015
17754,0,1166,Brandon Vitabile,C,dead_cap,indianapolis-colts,1166,2015
17755,0,1000,Robert Smith,S,dead_cap,indianapolis-colts,1000,2015
17756,0,833,Jean Sifrin,TE,dead_cap,indianapolis-colts,833,2015
17757,0,667,Kameron Jackson,CB,dead_cap,indianapolis-colts,667,2015
17758,0,666,Cody Galea,OLB,dead_cap,indianapolis-colts,666,2015
17759,0,666,Ezell Ruffin,WR,dead_cap,indianapolis-colts,666,2015
17760,0,666,Al-Hajj Shabazz,CB,dead_cap,indianapolis-colts,666,2015
17761,0,666,Justin Sinz,TE,dead_cap,indianapolis-colts,666,2015
17762,12000000,6400000,Andrew Luck,QB,active,indianapolis-colts,18400000,2016
17763,3000000,8000000,T.Y. Hilton,WR,active,indianapolis-colts,11000000,2016
17764,2500000,7300000,Anthony Castonzo,LT,active,indianapolis-colts,9800000,2016
17765,2500000,6406250,Dwayne Allen,TE,active,indianapolis-colts,8906250,2016
17766,7125000,1250000,Vontae Davis,CB,active,indianapolis-colts,8375000,2016
17767,2000000,3093750,Trent Cole,OLB,active,indianapolis-colts,5093750,2016
17768,3500000,1500000,Robert Mathis,OLB,active,indianapolis-colts,5000000,2016
17769,4000000,250000,Erik Walden,OLB,active,indianapolis-colts,4250000,2016
17770,1000000,3000000,Frank Gore,RB,active,indianapolis-colts,4000000,2016
17771,3250000,0,Adam Vinatieri,K,active,indianapolis-colts,3250000,2016
17772,2750000,500000,Joe Reitz,G,active,indianapolis-colts,3250000,2016
17773,1500000,1500000,Darius Butler,FS,active,indianapolis-colts,3000000,2016
17774,2500000,200000,Pat McAfee,P,active,indianapolis-colts,2700000,2016
17775,1550000,1050000,Akeem Ayers,OLB,active,indianapolis-colts,2600000,2016
17776,1300000,909375,Mike Adams,SS,active,indianapolis-colts,2209375,2016
17777,450000,1450178,Ryan Kelly,C,active,indianapolis-colts,1900178,2016
17778,804792,1044166,Phillip Dorsett,WR,active,indianapolis-colts,1848958,2016
17779,1671000,0,Jack Doyle,TE,active,indianapolis-colts,1671000,2016
17780,1250000,250000,Scott Tolzien,QB,active,indianapolis-colts,1500000,2016
17781,800000,0,Matt Overton,LS,active,indianapolis-colts,800000,2016
17782,450000,307679,T.J. Green,S,active,indianapolis-colts,757679,2016
17783,615000,135880,Donte Moncrief,WR,active,indianapolis-colts,750880,2016
17784,539500,153419,Henry Anderson,DE,active,indianapolis-colts,692919,2016
17785,675000,0,Josh McNary,OLB,active,indianapolis-colts,675000,2016
17786,675000,0,Rashaan Melvin,CB,active,indianapolis-colts,675000,2016
17787,450000,183433,Le'Raven Clark,RT,active,indianapolis-colts,633433,2016
17788,600000,2500,Jonotthan Harrison,C,active,indianapolis-colts,602500,2016
17789,600000,2000,Zach Kerr,DE,active,indianapolis-colts,602000,2016
17790,760000,0,Jordan Todman,RB,active,indianapolis-colts,760000,2016
17791,760000,0,Robert Turbin,RB,active,indianapolis-colts,760000,2016
17792,450000,140055,Hassan Ridgeway,DE,active,indianapolis-colts,590055,2016
17793,525000,55002,David Parry,DT,active,indianapolis-colts,580002,2016
17794,450000,129976,Antonio Morrison,ILB,active,indianapolis-colts,579976,2016
17795,525000,13196,Denzell Good,RT,active,indianapolis-colts,538196,2016
17796,536470,0,Chris Carter,ILB,active,indianapolis-colts,536470,2016
17797,525000,0,T.Y. McGill,DT,active,indianapolis-colts,525000,2016
17798,450000,60602,Joe Haeg,G,active,indianapolis-colts,510602,2016
17799,450000,15497,Austin Blythe,C,active,indianapolis-colts,465497,2016
17800,450000,3333,Josh Ferguson,RB,active,indianapolis-colts,453333,2016
17801,450000,0,Matthias Farley,SS,active,indianapolis-colts,450000,2016
17802,450000,0,Edwin Jackson,ILB,active,indianapolis-colts,450000,2016
17803,450000,0,Chester Rogers,WR,active,indianapolis-colts,450000,2016
17804,450000,0,Erik Swoope,TE,active,indianapolis-colts,450000,2016
17805,238236,0,Darryl Morris,CB,active,indianapolis-colts,238236,2016
17806,185290,0,Deon King,OLB,active,indianapolis-colts,185290,2016
17807,185290,0,Chris Milton,CB,active,indianapolis-colts,185290,2016
17808,119117,0,Duke Williams,FS,active,indianapolis-colts,119117,2016
17809,105882,0,Charles James,CB,active,indianapolis-colts,105882,2016
17810,105882,0,Devin Street,WR,active,indianapolis-colts,105882,2016
17811,105880,0,Luke Rhodes,ILB,active,indianapolis-colts,105880,2016
17812,92646,0,Deiontrez Mount,OLB,active,indianapolis-colts,92646,2016
17813,92646,0,Jeremy Vujnovich,LT,active,indianapolis-colts,92646,2016
17814,61764,0,Kristjan Sokoli,G,active,indianapolis-colts,61764,2016
17815,3000000,1250000,Kendall Langford,DE,injured_reserve,indianapolis-colts,4250000,2016
17816,1500000,2500000,Patrick Robinson,CB,injured_reserve,indianapolis-colts,4000000,2016
17817,1911764,1100000,Arthur Jones,DT,injured_reserve,indianapolis-colts,3011764,2016
17818,1671000,136345,Hugh Thornton,G,injured_reserve,indianapolis-colts,1807345,2016
17819,744891,229782,Jack Mewhort,G,injured_reserve,indianapolis-colts,974673,2016
17820,525000,133482,Clayton Geathers,FS,injured_reserve,indianapolis-colts,658482,2016
17821,450000,1833,Andrew Williamson,S,injured_reserve,indianapolis-colts,451833,2016
17822,450000,1333,Isiah Cage,T,injured_reserve,indianapolis-colts,451333,2016
17823,450000,0,Curt Maggitt,S,injured_reserve,indianapolis-colts,450000,2016
17824,410462,0,Quan Bray,WR,injured_reserve,indianapolis-colts,410462,2016
17825,238230,0,Frankie Williams,CB,non_fb_injury,indianapolis-colts,238230,2016
17826,117300,0,Mike Miller,TE,practice_squad,indianapolis-colts,117300,2016
17827,0,7600000,Gosder Cherilus,RT,dead_cap,indianapolis-colts,7600000,2016
17828,2000000,1000000,Antonio Cromartie,CB,dead_cap,indianapolis-colts,3000000,2016
17829,0,2500000,Andre Johnson,WR,dead_cap,indianapolis-colts,2500000,2016
17830,0,1030709,Bjoern Werner,OLB,dead_cap,indianapolis-colts,1030709,2016
17831,760000,0,Winston Guy,FS,dead_cap,indianapolis-colts,760000,2016
17832,387294,25000,Sio Moore,OLB,dead_cap,indianapolis-colts,412294,2016
17833,331447,0,Lavar Edwards,DE,dead_cap,indianapolis-colts,331447,2016
17834,303052,0,Devin Street,WR,dead_cap,indianapolis-colts,303052,2016
17835,285382,0,Stephen Morris,QB,dead_cap,indianapolis-colts,285382,2016
17836,0,250000,Nate Irving,ILB,dead_cap,indianapolis-colts,250000,2016
17837,0,250000,Donald Thomas,G,dead_cap,indianapolis-colts,250000,2016
17838,238236,0,Darryl Morris,CB,dead_cap,indianapolis-colts,238236,2016
17839,34705,202211,D'Joun Smith,CB,dead_cap,indianapolis-colts,236916,2016
17840,149540,0,Tevaun Smith,WR,dead_cap,indianapolis-colts,149540,2016
17841,135740,0,Jeremy Vujnovich,LT,dead_cap,indianapolis-colts,135740,2016
17842,0,105027,Khaled Holmes,C,dead_cap,indianapolis-colts,105027,2016
17843,96600,0,Adam Redmond,G,dead_cap,indianapolis-colts,96600,2016
17844,95470,0,Marcus Leak,WR,dead_cap,indianapolis-colts,95470,2016
17845,89411,0,Chase Coffman,TE,dead_cap,indianapolis-colts,89411,2016
17846,0,89054,Jonathan Newsome,OLB,dead_cap,indianapolis-colts,89054,2016
17847,82800,0,Deiontrez Mount,OLB,dead_cap,indianapolis-colts,82800,2016
17848,82800,0,Kristjan Sokoli,G,dead_cap,indianapolis-colts,82800,2016
17849,0,81124,Josh Robinson,RB,dead_cap,indianapolis-colts,81124,2016
17850,0,78492,Amarlo Herrera,ILB,dead_cap,indianapolis-colts,78492,2016
17851,74770,0,Frankie Williams,CB,dead_cap,indianapolis-colts,74770,2016
17852,54070,18127,Trevor Bates,ILB,dead_cap,indianapolis-colts,72197,2016
17853,69000,0,Chris Milton,CB,dead_cap,indianapolis-colts,69000,2016
17854,62100,0,Tevin Mitchel,CB,dead_cap,indianapolis-colts,62100,2016
17855,62100,0,Luke Rhodes,ILB,dead_cap,indianapolis-colts,62100,2016
17856,62100,0,Kelcy Quarles,DT,dead_cap,indianapolis-colts,62100,2016
17857,0,50493,Montori Hughes,DT,dead_cap,indianapolis-colts,50493,2016
17858,34500,0,Lee Hightower,S,dead_cap,indianapolis-colts,34500,2016
17859,0,28924,Ulrick John,LT,dead_cap,indianapolis-colts,28924,2016
17860,27600,0,Stefan McClure,S,dead_cap,indianapolis-colts,27600,2016
17861,26470,0,Mike McFarland,TE,dead_cap,indianapolis-colts,26470,2016
17862,20700,0,Sterling Bailey,DE,dead_cap,indianapolis-colts,20700,2016
17863,20700,0,Pierce Burton,RT,dead_cap,indianapolis-colts,20700,2016
17864,20700,0,Kitt O'Brien,G,dead_cap,indianapolis-colts,20700,2016
17865,20000,0,Josh Woodrum,QB,dead_cap,indianapolis-colts,20000,2016
17866,6900,0,Devonta Glover-Wright,CB,dead_cap,indianapolis-colts,6900,2016
17867,0,6667,Bryan Bennett,QB,dead_cap,indianapolis-colts,6667,2016
17868,0,6667,Zack Hodges,OLB,dead_cap,indianapolis-colts,6667,2016
17869,0,5334,Donald Celiscar,CB,dead_cap,indianapolis-colts,5334,2016
17870,0,5000,Ron Thompson,DE,dead_cap,indianapolis-colts,5000,2016
17871,0,3334,Quan Bray,WR,dead_cap,indianapolis-colts,3334,2016
17872,0,2666,Junior Sylvestre,ILB,dead_cap,indianapolis-colts,2666,2016
17873,0,2334,Brandon Vitabile,C,dead_cap,indianapolis-colts,2334,2016
17874,0,2000,Robert Smith,S,dead_cap,indianapolis-colts,2000,2016
17875,0,2000,Tyler Varga,RB,dead_cap,indianapolis-colts,2000,2016
17876,0,1667,Jean Sifrin,TE,dead_cap,indianapolis-colts,1667,2016
17877,0,1666,Daniel Davie,CB,dead_cap,indianapolis-colts,1666,2016
17878,0,1334,Cody Galea,OLB,dead_cap,indianapolis-colts,1334,2016
17879,0,1334,Joshua Mitchell,CB,dead_cap,indianapolis-colts,1334,2016
17880,0,1334,Ezell Ruffin,WR,dead_cap,indianapolis-colts,1334,2016
17881,0,1334,Al-Hajj Shabazz,CB,dead_cap,indianapolis-colts,1334,2016
17882,0,1334,Justin Sinz,TE,dead_cap,indianapolis-colts,1334,2016
17883,1000000,11800000,Anthony Castonzo,LT,active,indianapolis-colts,12800000,2017
17884,3000000,7500000,Johnathan Hankins,DT,active,indianapolis-colts,10500000,2017
17885,8000000,2000000,T.Y. Hilton,WR,active,indianapolis-colts,10000000,2017
17886,2500000,7468750,Jabaal Sheard,OLB,active,indianapolis-colts,9968750,2017
17887,1000000,7000000,Jack Doyle,TE,active,indianapolis-colts,8000000,2017
17888,3500000,0,Frank Gore,RB,active,indianapolis-colts,3500000,2017
17889,1000000,1875000,Darius Butler,FS,active,indianapolis-colts,2875000,2017
17890,2750000,0,Adam Vinatieri,K,active,indianapolis-colts,2750000,2017
17891,1000000,1600000,Kamar Aiken,WR,active,indianapolis-colts,2600000,2017
17892,1100000,968750,Margus Hunt,DT,active,indianapolis-colts,2068750,2017
17893,1750000,250000,Scott Tolzien,QB,active,indianapolis-colts,2000000,2017
17894,1500000,500000,Barkevious Mingo,OLB,active,indianapolis-colts,2000000,2017
17895,1250000,750000,Al Woods,DT,active,indianapolis-colts,2000000,2017
17896,1797000,135880,Donte Moncrief,WR,active,indianapolis-colts,1932880,2017
17897,465000,583414,Quincy Wilson,CB,active,indianapolis-colts,1048414,2017
17898,639420,307679,T.J. Green,S,active,indianapolis-colts,947099,2017
17899,615000,133482,Clayton Geathers,FS,active,indianapolis-colts,748482,2017
17900,563000,183433,Le'Raven Clark,RT,active,indianapolis-colts,746433,2017
17901,540000,140055,Hassan Ridgeway,DE,active,indianapolis-colts,680055,2017
17902,465000,208964,Tarell Basham,OLB,active,indianapolis-colts,673964,2017
17903,540000,129976,Antonio Morrison,ILB,active,indianapolis-colts,669976,2017
17904,615000,13196,Denzelle Good,RT,active,indianapolis-colts,628196,2017
17905,615000,0,Jeremiah George,ILB,active,indianapolis-colts,615000,2017
17906,540000,60602,Joe Haeg,G,active,indianapolis-colts,600602,2017
17907,580038,0,Jacoby Brissett,QB,active,indianapolis-colts,580038,2017
17908,465000,104912,Marlon Mack,RB,active,indianapolis-colts,569912,2017
17909,465000,104912,Grover Stewart,DT,active,indianapolis-colts,569912,2017
17910,540000,0,Matthias Farley,SS,active,indianapolis-colts,540000,2017
17911,540000,0,Chris Milton,CB,active,indianapolis-colts,540000,2017
17912,540000,0,Luke Rhodes,ILB,active,indianapolis-colts,540000,2017
17913,540000,0,Chester Rogers,WR,active,indianapolis-colts,540000,2017
17914,540000,0,Jeremy Vujnovich,LT,active,indianapolis-colts,540000,2017
17915,465000,66946,Nate Hairston,CB,active,indianapolis-colts,531946,2017
17916,465000,66353,Anthony Walker Jr.,ILB,active,indianapolis-colts,531353,2017
17917,592647,0,Michael Person,G,active,indianapolis-colts,592647,2017
17918,465000,4000,Rigoberto Sanchez,P,active,indianapolis-colts,469000,2017
17919,465000,3333,Darrell Daniels,TE,active,indianapolis-colts,468333,2017
17920,465000,0,Kenny Moore,CB,active,indianapolis-colts,465000,2017
17921,349415,0,Josh Ferguson,RB,active,indianapolis-colts,349415,2017
17922,325588,0,Tyreek Burwell,T,active,indianapolis-colts,325588,2017
17923,285882,0,D.J. White,CB,active,indianapolis-colts,285882,2017
17924,254120,0,Joey Mbu,DT,active,indianapolis-colts,254120,2017
17925,191471,0,Jermaine Grace,OLB,active,indianapolis-colts,191471,2017
17926,164118,0,Jason Vander Laan,TE,active,indianapolis-colts,164118,2017
17927,158825,0,Ross Travis,TE,active,indianapolis-colts,158825,2017
17928,158824,0,Anthony Fabiano,T,active,indianapolis-colts,158824,2017
17929,144706,0,Anthony Johnson,DE,active,indianapolis-colts,144706,2017
17930,144706,0,Matt Jones,RB,active,indianapolis-colts,144706,2017
17931,136765,0,K.J. Brent,WR,active,indianapolis-colts,136765,2017
17932,81176,0,Caraun Reid,DE,active,indianapolis-colts,81176,2017
17933,68333,0,Mark Glowinski,G,active,indianapolis-colts,68333,2017
17934,63530,0,Ronald Martin,SS,active,indianapolis-colts,63530,2017
17935,27353,0,Brad Kaaya,QB,active,indianapolis-colts,27353,2017
17936,7000000,12400000,Andrew Luck,QB,injured_reserve,indianapolis-colts,19400000,2017
17937,1500000,4500000,John Simon,OLB,injured_reserve,indianapolis-colts,6000000,2017
17938,925045,1450178,Ryan Kelly,C,injured_reserve,indianapolis-colts,2375223,2017
17939,396171,1825892,Malik Hooker,S,injured_reserve,indianapolis-colts,2222063,2017
17940,800000,581250,Robert Turbin,RB,injured_reserve,indianapolis-colts,1381250,2017
17941,907337,229782,Jack Mewhort,G,injured_reserve,indianapolis-colts,1137119,2017
17942,629500,153419,Henry Anderson,DE,injured_reserve,indianapolis-colts,782919,2017
17943,775000,0,Rashaan Melvin,CB,injured_reserve,indianapolis-colts,775000,2017
17944,690000,31250,Pierre Desir,CB,injured_reserve,indianapolis-colts,721250,2017
17945,690000,0,Jon Bostic,ILB,injured_reserve,indianapolis-colts,690000,2017
17946,775000,0,Brandon Williams,TE,injured_reserve,indianapolis-colts,775000,2017
17947,540000,0,Erik Swoope,TE,injured_reserve,indianapolis-colts,540000,2017
17948,378000,0,Christine Michael,RB,injured_reserve,indianapolis-colts,378000,2017
17949,378000,0,George Winn,RB,injured_reserve,indianapolis-colts,378000,2017
17950,375529,1000,Deyshawn Bond,G,injured_reserve,indianapolis-colts,376529,2017
17951,363000,0,Edwin Jackson,ILB,injured_reserve,indianapolis-colts,363000,2017
17952,300346,0,Krishawn Hogan,WR,injured_reserve,indianapolis-colts,300346,2017
17953,9000000,1250000,Vontae Davis,CB,dead_cap,indianapolis-colts,10250000,2017
17954,0,3000000,Dwayne Allen,TE,dead_cap,indianapolis-colts,3000000,2017
17955,0,2200000,Arthur Jones,DT,dead_cap,indianapolis-colts,2200000,2017
17956,0,2000000,Patrick Robinson,CB,dead_cap,indianapolis-colts,2000000,2017
17957,500000,750000,Jeff Locke,P,dead_cap,indianapolis-colts,1250000,2017
17958,0,1044166,Phillip Dorsett,WR,dead_cap,indianapolis-colts,1044166,2017
17959,136765,750000,Sean Spence,ILB,dead_cap,indianapolis-colts,886765,2017
17960,775000,0,Chris Culliver,CB,dead_cap,indianapolis-colts,775000,2017
17961,578824,0,Quan Bray,WR,dead_cap,indianapolis-colts,578824,2017
17962,0,500000,Akeem Ayers,OLB,dead_cap,indianapolis-colts,500000,2017
17963,0,404422,D'Joun Smith,CB,dead_cap,indianapolis-colts,404422,2017
17964,0,400000,Pat McAfee,P,dead_cap,indianapolis-colts,400000,2017
17965,368965,0,Matt Jones,RB,dead_cap,indianapolis-colts,368965,2017
17966,0,300000,Brian Schwenke,C,dead_cap,indianapolis-colts,300000,2017
17967,0,250000,Nate Irving,ILB,dead_cap,indianapolis-colts,250000,2017
17968,0,250000,D'Qwell Jackson,ILB,dead_cap,indianapolis-colts,250000,2017
17969,0,250000,Kendall Langford,DE,dead_cap,indianapolis-colts,250000,2017
17970,233790,0,Matt Hazel,WR,dead_cap,indianapolis-colts,233790,2017
17971,218824,0,Kyle Kalis,T,dead_cap,indianapolis-colts,218824,2017
17972,200118,0,Isaiah Williams,T,dead_cap,indianapolis-colts,200118,2017
17973,185717,0,Darnell Sankey,ILB,dead_cap,indianapolis-colts,185717,2017
17974,182352,0,Darryl Morris,CB,dead_cap,indianapolis-colts,182352,2017
17975,181694,0,Joshua Perry,ILB,dead_cap,indianapolis-colts,181694,2017
17976,0,134584,Zach Banner,T,dead_cap,indianapolis-colts,134584,2017
17977,122400,3333,Phillip Walker,QB,dead_cap,indianapolis-colts,125733,2017
17978,121130,0,Ian Silberman,G,dead_cap,indianapolis-colts,121130,2017
17979,109412,0,Adam Redmond,G,dead_cap,indianapolis-colts,109412,2017
17980,103659,0,Henry Krieger-Coble,TE,dead_cap,indianapolis-colts,103659,2017
17981,93600,0,Mo Alie-Cox,TE,dead_cap,indianapolis-colts,93600,2017
17982,82059,0,Tevin Mitchel,CB,dead_cap,indianapolis-colts,82059,2017
17983,0,80000,Brandon Williams,TE,dead_cap,indianapolis-colts,80000,2017
17984,72353,0,Dillon Day,C,dead_cap,indianapolis-colts,72353,2017
17985,64800,0,Joey Mbu,DT,dead_cap,indianapolis-colts,64800,2017
17986,64800,0,Ronald Martin,SS,dead_cap,indianapolis-colts,64800,2017
17987,57600,0,Denzel Rice,CB,dead_cap,indianapolis-colts,57600,2017
17988,0,55002,David Parry,DT,dead_cap,indianapolis-colts,55002,2017
17989,0,54382,Trevor Bates,ILB,dead_cap,indianapolis-colts,54382,2017
17990,50400,0,Dres Anderson,WR,dead_cap,indianapolis-colts,50400,2017
17991,0,46492,Austin Blythe,C,dead_cap,indianapolis-colts,46492,2017
17992,43200,0,Tyreek Burwell,T,dead_cap,indianapolis-colts,43200,2017
17993,43200,0,Channing Stribling,CB,dead_cap,indianapolis-colts,43200,2017
17994,36000,0,K.J. Brent,WR,dead_cap,indianapolis-colts,36000,2017
17995,28800,0,Anthony Johnson,DE,dead_cap,indianapolis-colts,28800,2017
17996,28800,0,Andreas Knappe,T,dead_cap,indianapolis-colts,28800,2017
17997,21600,0,Cyril Grayson,WR,dead_cap,indianapolis-colts,21600,2017
17998,21600,0,Krishawn Hogan,WR,dead_cap,indianapolis-colts,21600,2017
17999,21600,0,Kolby Listenbee,WR,dead_cap,indianapolis-colts,21600,2017
18000,21600,0,Devin Lucien,WR,dead_cap,indianapolis-colts,21600,2017
18001,21600,0,Jason Vander Laan,TE,dead_cap,indianapolis-colts,21600,2017
18002,21600,0,Andrew Wylie,T,dead_cap,indianapolis-colts,21600,2017
18003,21600,0,Johnathan Calvin,DE,dead_cap,indianapolis-colts,21600,2017
18004,21600,0,Jeremy Liggins,DT,dead_cap,indianapolis-colts,21600,2017
18005,21353,0,Tyvis Powell,S,dead_cap,indianapolis-colts,21353,2017
18006,14400,0,Vontarrius Dora,OLB,dead_cap,indianapolis-colts,14400,2017
18007,14400,0,Arthur Miley,DE,dead_cap,indianapolis-colts,14400,2017
18008,14400,0,Marcus Murphy,RB,dead_cap,indianapolis-colts,14400,2017
18009,14400,0,Fred Brown,WR,dead_cap,indianapolis-colts,14400,2017
18010,0,10000,Ron Thompson,DE,dead_cap,indianapolis-colts,10000,2017
18011,7200,1833,Andrew Williamson,S,dead_cap,indianapolis-colts,9033,2017
18012,7200,1666,Garrett Sickels,OLB,dead_cap,indianapolis-colts,8866,2017
18013,7200,0,Marcus Lucas,TE,dead_cap,indianapolis-colts,7200,2017
18014,7200,0,Kevonn Mabon,WR,dead_cap,indianapolis-colts,7200,2017
18015,7200,0,Taurean Nixon,CB,dead_cap,indianapolis-colts,7200,2017
18016,7200,0,Troymaine Pope,RB,dead_cap,indianapolis-colts,7200,2017
18017,0,3334,Daniel Davie,CB,dead_cap,indianapolis-colts,3334,2017
18018,0,3333,Josh Ferguson,RB,dead_cap,indianapolis-colts,3333,2017
18019,0,2668,Junior Sylvestre,ILB,dead_cap,indianapolis-colts,2668,2017
18020,0,2667,Isiah Cage,T,dead_cap,indianapolis-colts,2667,2017
18021,0,2000,Jhaustin Thomas,DT,dead_cap,indianapolis-colts,2000,2017
18022,0,2000,Tyler Varga,RB,dead_cap,indianapolis-colts,2000,2017
18023,0,1666,Bug Howard,WR,dead_cap,indianapolis-colts,1666,2017
18024,0,1000,Dalton Crossan,RB,dead_cap,indianapolis-colts,1000,2017
18025,0,1000,Jojo Natson,WR,dead_cap,indianapolis-colts,1000,2017
18026,12000000,12400000,Andrew Luck,QB,active,indianapolis-colts,24400000,2018
18027,11000000,2000000,T.Y. Hilton,WR,active,indianapolis-colts,13000000,2018
18028,6000000,4800000,Anthony Castonzo,LT,active,indianapolis-colts,10800000,2018
18029,7000000,500000,Jabaal Sheard,DE,active,indianapolis-colts,7500000,2018
18030,3000000,3875000,Denico Autry,DT,active,indianapolis-colts,6875000,2018
18031,1250000,5500000,Eric Ebron,TE,active,indianapolis-colts,6750000,2018
18032,1000000,4000000,Ryan Grant,WR,active,indianapolis-colts,5000000,2018
18033,480000,3863437,Quenton Nelson,G,active,indianapolis-colts,4343437,2018
18034,2625000,1000000,Adam Vinatieri,K,active,indianapolis-colts,3625000,2018
18035,1037723,1825892,Malik Hooker,FS,active,indianapolis-colts,2863615,2018
18036,1400089,1450178,Ryan Kelly,C,active,indianapolis-colts,2850267,2018
18037,1500000,968750,Margus Hunt,DE,active,indianapolis-colts,2468750,2018
18038,1000000,750000,Pierre Desir,CB,active,indianapolis-colts,1750000,2018
18039,480000,837782,Darius Leonard,OLB,active,indianapolis-colts,1317782,2018
18040,727103,583414,Quincy Wilson,CB,active,indianapolis-colts,1310517,2018
18041,480000,827943,Braden Smith,G,active,indianapolis-colts,1307943,2018
18042,1219000,0,Mark Glowinski,G,active,indianapolis-colts,1219000,2018
18043,790000,150000,Ryan Hewitt,FB,active,indianapolis-colts,940000,2018
18044,480000,468800,Kemoko Turay,DE,active,indianapolis-colts,948800,2018
18045,705000,133482,Clayton Geathers,SS,active,indianapolis-colts,838482,2018
18046,653000,183433,Le'Raven Clark,LT,active,indianapolis-colts,836433,2018
18047,480000,313828,Tyquan Lewis,DE,active,indianapolis-colts,793828,2018
18048,630000,140055,Hassan Ridgeway,DT,active,indianapolis-colts,770055,2018
18049,735076,25000,Jacoby Brissett,QB,active,indianapolis-colts,760076,2018
18050,630000,60602,Joe Haeg,RT,active,indianapolis-colts,690602,2018
18051,480000,181136,Nyheim Hines,RB,active,indianapolis-colts,661136,2018
18052,555000,104912,Marlon Mack,RB,active,indianapolis-colts,659912,2018
18053,555000,104912,Grover Stewart,DT,active,indianapolis-colts,659912,2018
18054,790000,0,Najee Goode,OLB,active,indianapolis-colts,790000,2018
18055,630000,0,Chris Milton,CB,active,indianapolis-colts,630000,2018
18056,630000,0,Corey Moore,SS,active,indianapolis-colts,630000,2018
18057,630000,0,Luke Rhodes,ILB,active,indianapolis-colts,630000,2018
18058,630000,0,Chester Rogers,WR,active,indianapolis-colts,630000,2018
18059,555000,66946,Nate Hairston,CB,active,indianapolis-colts,621946,2018
18060,555000,66353,Anthony Walker Jr.,ILB,active,indianapolis-colts,621353,2018
18061,555000,4000,Rigoberto Sanchez,P,active,indianapolis-colts,559000,2018
18062,555000,0,Kenny Moore,CB,active,indianapolis-colts,555000,2018
18063,480000,60310,Jordan Wilkins,RB,active,indianapolis-colts,540310,2018
18064,480000,25395,Matthew Adams,OLB,active,indianapolis-colts,505395,2018
18065,480000,21764,Zaire Franklin,OLB,active,indianapolis-colts,501764,2018
18066,480000,4333,George Odum,S,active,indianapolis-colts,484333,2018
18067,480000,0,Zach Pascal,WR,active,indianapolis-colts,480000,2018
18068,444706,0,Evan Boehm,G,active,indianapolis-colts,444706,2018
18069,511176,0,Dontrelle Inman,WR,active,indianapolis-colts,511176,2018
18070,391765,0,Al-Quadin Muhammad,DE,active,indianapolis-colts,391765,2018
18071,338820,0,Mo Alie-Cox,TE,active,indianapolis-colts,338820,2018
18072,222354,0,Josh Andrews,C,active,indianapolis-colts,222354,2018
18073,222354,0,Jonathan Williams,RB,active,indianapolis-colts,222354,2018
18074,112940,0,Daurice Fountain,WR,active,indianapolis-colts,112940,2018
18075,92941,0,J.J. Wilcox,FS,active,indianapolis-colts,92941,2018
18076,84705,0,Ahmad Thomas,S,active,indianapolis-colts,84705,2018
18077,480000,0,Rolan Milligan,S,active,indianapolis-colts,480000,2018
18078,3900000,1437500,Jack Doyle,TE,injured_reserve,indianapolis-colts,5337500,2018
18079,1500000,1000000,Al Woods,DT,injured_reserve,indianapolis-colts,2500000,2018
18080,1000000,984375,Matt Slauson,G,injured_reserve,indianapolis-colts,1984375,2018
18081,630000,0,Matthias Farley,SS,injured_reserve,indianapolis-colts,630000,2018
18082,630000,0,Ross Travis,TE,injured_reserve,indianapolis-colts,630000,2018
18083,555000,0,Brad Kaaya,QB,injured_reserve,indianapolis-colts,555000,2018
18084,453530,0,Jihad Ward,DE,injured_reserve,indianapolis-colts,453530,2018
18085,645882,0,Mike Mitchell,FS,injured_reserve,indianapolis-colts,645882,2018
18086,440470,0,Marcus Johnson,WR,injured_reserve,indianapolis-colts,440470,2018
18087,790000,0,J'Marcus Webb,RT,injured_reserve,indianapolis-colts,790000,2018
18088,393000,0,Ronald Martin,SS,injured_reserve,indianapolis-colts,393000,2018
18089,393000,0,James Wright,WR,injured_reserve,indianapolis-colts,393000,2018
18090,348000,41408,Deon Cain,WR,injured_reserve,indianapolis-colts,389408,2018
18091,384176,0,Carroll Phillips,OLB,injured_reserve,indianapolis-colts,384176,2018
18092,212118,0,Skai Moore,LB,injured_reserve,indianapolis-colts,212118,2018
18093,0,1300000,Austin Howard,RT,dead_cap,indianapolis-colts,1300000,2018
18094,0,1044166,Phillip Dorsett,WR,dead_cap,indianapolis-colts,1044166,2018
18095,1000000,37500,Robert Turbin,RB,dead_cap,indianapolis-colts,1037500,2018
18096,762800,0,Rakeem Nunez-Roches,DE,dead_cap,indianapolis-colts,762800,2018
18097,705000,0,Anthony Johnson,DE,dead_cap,indianapolis-colts,705000,2018
18098,705000,0,Chris McCain,OLB,dead_cap,indianapolis-colts,705000,2018
18099,790000,0,Christine Michael,RB,dead_cap,indianapolis-colts,790000,2018
18100,570200,0,Erik Swoope,TE,dead_cap,indianapolis-colts,570200,2018
18101,544379,13196,Denzelle Good,RT,dead_cap,indianapolis-colts,557575,2018
18102,146267,307679,T.J. Green,S,dead_cap,indianapolis-colts,453946,2018
18103,0,403754,Zach Banner,T,dead_cap,indianapolis-colts,403754,2018
18104,138824,208964,Tarell Basham,OLB,dead_cap,indianapolis-colts,347788,2018
18105,0,300000,Jack Mewhort,G,dead_cap,indianapolis-colts,300000,2018
18106,261176,0,Arthur Maulet,CB,dead_cap,indianapolis-colts,261176,2018
18107,0,250000,Kendall Langford,DE,dead_cap,indianapolis-colts,250000,2018
18108,207353,0,Tyreek Burwell,T,dead_cap,indianapolis-colts,207353,2018
18109,189412,6666,Skai Moore,LB,dead_cap,indianapolis-colts,196078,2018
18110,98800,69299,Daurice Fountain,WR,dead_cap,indianapolis-colts,168099,2018
18111,162870,3333,Steve Ishmael,WR,dead_cap,indianapolis-colts,166203,2018
18112,163235,0,Al-Quadin Muhammad,DE,dead_cap,indianapolis-colts,163235,2018
18113,0,153419,Henry Anderson,DE,dead_cap,indianapolis-colts,153419,2018
18114,151200,0,Tion Green,RB,dead_cap,indianapolis-colts,151200,2018
18115,147941,0,Lenzy Pipkins,CB,dead_cap,indianapolis-colts,147941,2018
18116,145200,0,Jared Machorro,T,dead_cap,indianapolis-colts,145200,2018
18117,0,129977,Antonio Morrison,ILB,dead_cap,indianapolis-colts,129977,2018
18118,122691,0,D.J. Killings,CB,dead_cap,indianapolis-colts,122691,2018
18119,114000,6667,Phillip Walker,QB,dead_cap,indianapolis-colts,120667,2018
18120,106765,833,Robert Jackson,CB,dead_cap,indianapolis-colts,107598,2018
18121,106760,0,Johnathan Calvin,DE,dead_cap,indianapolis-colts,106760,2018
18122,106400,0,Ahmad Thomas,S,dead_cap,indianapolis-colts,106400,2018
18123,89035,0,Rolan Milligan,S,dead_cap,indianapolis-colts,89035,2018
18124,87071,0,Jalen Collins,CB,dead_cap,indianapolis-colts,87071,2018
18125,83600,0,Krishawn Hogan,WR,dead_cap,indianapolis-colts,83600,2018
18126,69354,0,Robenson Therezie,FS,dead_cap,indianapolis-colts,69354,2018
18127,68400,0,Antonio Garcia,T,dead_cap,indianapolis-colts,68400,2018
18128,64056,3333,Chris Cooper,S,dead_cap,indianapolis-colts,67389,2018
18129,58635,0,Mo Alie-Cox,TE,dead_cap,indianapolis-colts,58635,2018
18130,55447,0,Jeremy McNichols,RB,dead_cap,indianapolis-colts,55447,2018
18131,0,55002,David Parry,DT,dead_cap,indianapolis-colts,55002,2018
18132,53200,0,Jonathan Williams,RB,dead_cap,indianapolis-colts,53200,2018
18133,53200,0,Rees Odhiambo,T,dead_cap,indianapolis-colts,53200,2018
18134,46235,3334,Josh Ferguson,RB,dead_cap,indianapolis-colts,49569,2018
18135,41471,0,Jeremiah George,ILB,dead_cap,indianapolis-colts,41471,2018
18136,41471,0,Clive Walford,TE,dead_cap,indianapolis-colts,41471,2018
18137,38000,0,Je'Ron Hamm,TE,dead_cap,indianapolis-colts,38000,2018
18138,38000,0,Sean Harlow,G,dead_cap,indianapolis-colts,38000,2018
18139,38000,0,De'Ondre Wesley,G,dead_cap,indianapolis-colts,38000,2018
18140,37059,0,Matt Hazel,WR,dead_cap,indianapolis-colts,37059,2018
18141,30400,0,Billy Brown,TE,dead_cap,indianapolis-colts,30400,2018
18142,23118,0,Tyrell Adams,OLB,dead_cap,indianapolis-colts,23118,2018
18143,22800,0,Zack Golditch,G,dead_cap,indianapolis-colts,22800,2018
18144,22800,0,Carroll Phillips,OLB,dead_cap,indianapolis-colts,22800,2018
18145,22800,0,DeShawn Williams,DT,dead_cap,indianapolis-colts,22800,2018
18146,22800,0,Anthony Winbush,LB,dead_cap,indianapolis-colts,22800,2018
18147,15200,0,Will Holden,T,dead_cap,indianapolis-colts,15200,2018
18148,15200,0,Tarvarus McFadden,CB,dead_cap,indianapolis-colts,15200,2018
18149,15200,0,Tegray Scales,LB,dead_cap,indianapolis-colts,15200,2018
18150,0,9000,D.J. White,CB,dead_cap,indianapolis-colts,9000,2018
18151,7600,0,Jamil Douglas,C,dead_cap,indianapolis-colts,7600,2018
18152,7600,0,Tray Matthews,S,dead_cap,indianapolis-colts,7600,2018
18153,7600,0,Jihad Ward,DE,dead_cap,indianapolis-colts,7600,2018
18154,0,5000,Henre' Toliver,CB,dead_cap,indianapolis-colts,5000,2018
18155,0,4000,Tomasi Laulile,DT,dead_cap,indianapolis-colts,4000,2018
18156,0,4000,Jhaustin Thomas,DT,dead_cap,indianapolis-colts,4000,2018
18157,0,3334,Bug Howard,WR,dead_cap,indianapolis-colts,3334,2018
18158,0,3334,Garrett Sickels,OLB,dead_cap,indianapolis-colts,3334,2018
18159,0,3333,Darrell Daniels,TE,dead_cap,indianapolis-colts,3333,2018
18160,0,2666,Lashard Durr,CB,dead_cap,indianapolis-colts,2666,2018
18161,0,2000,Dalton Crossan,RB,dead_cap,indianapolis-colts,2000,2018
18162,0,2000,Jojo Natson,WR,dead_cap,indianapolis-colts,2000,2018
18163,0,1834,Andrew Williamson,S,dead_cap,indianapolis-colts,1834,2018
18164,0,1666,William Ossai,LB,dead_cap,indianapolis-colts,1666,2018
18165,0,1333,Michael Badgley,K,dead_cap,indianapolis-colts,1333,2018
18166,0,1000,Deyshawn Bond,G,dead_cap,indianapolis-colts,1000,2018
18167,13000000,2000000,T.Y. Hilton,WR,active,indianapolis-colts,15000000,2019
18168,1000000,13000000,Justin Houston,DE,active,indianapolis-colts,14000000,2019
18169,6250000,4800000,Anthony Castonzo,LT,active,indianapolis-colts,11050000,2019
18170,2000000,7407500,Jacoby Brissett,QB,active,indianapolis-colts,9407500,2019
18171,1000000,8000000,Pierre Desir,CB,active,indianapolis-colts,9000000,2019
18172,1000000,8000000,Kenny Moore,CB,active,indianapolis-colts,9000000,2019
18173,7500000,406250,Jabaal Sheard,DE,active,indianapolis-colts,7906250,2019
18174,5150000,937500,Jack Doyle,TE,active,indianapolis-colts,6087500,2019
18175,570000,4859297,Quenton Nelson,G,active,indianapolis-colts,5429297,2019
18176,1000000,4100000,Margus Hunt,DT,active,indianapolis-colts,5100000,2019
18177,3500000,1406250,Denico Autry,DT,active,indianapolis-colts,4906250,2019
18178,1610446,1825892,Malik Hooker,FS,active,indianapolis-colts,3436338,2019
18179,1500000,1900000,Mark Glowinski,G,active,indianapolis-colts,3400000,2019
18180,1875134,1450181,Ryan Kelly,C,active,indianapolis-colts,3325315,2019
18181,1250000,1937500,Clayton Geathers,SS,active,indianapolis-colts,3187500,2019
18182,645000,2359000,Rigoberto Sanchez,P,active,indianapolis-colts,3004000,2019
18183,2000000,1000000,Brian Hoyer,QB,active,indianapolis-colts,3000000,2019
18184,2025000,60604,Joe Haeg,G,active,indianapolis-colts,2085604,2019
18185,809446,837782,Darius Leonard,OLB,active,indianapolis-colts,1647228,2019
18186,806986,827943,Braden Smith,RT,active,indianapolis-colts,1634929,2019
18187,989207,583414,Quincy Wilson,CB,active,indianapolis-colts,1572621,2019
18188,720000,850000,Luke Rhodes,LS,active,indianapolis-colts,1570000,2019
18189,495000,944355,Rock Ya-Sin,CB,active,indianapolis-colts,1439355,2019
18190,495000,585819,Ben Banogu,DE,active,indianapolis-colts,1080819,2019
18191,678457,313828,Tyquan Lewis,DT,active,indianapolis-colts,992285,2019
18192,743000,183433,Le'Raven Clark,RT,active,indianapolis-colts,926433,2019
18193,570000,181136,Nyheim Hines,RB,active,indianapolis-colts,751136,2019
18194,645000,104912,Marlon Mack,RB,active,indianapolis-colts,749912,2019
18195,645000,104912,Grover Stewart,DT,active,indianapolis-colts,749912,2019
18196,720000,0,Josh Andrews,G,active,indianapolis-colts,720000,2019
18197,720000,0,Jonathan Williams,RB,active,indianapolis-colts,720000,2019
18198,495000,220779,Bobby Okereke,LB,active,indianapolis-colts,715779,2019
18199,645000,66353,Anthony Walker Jr.,ILB,active,indianapolis-colts,711353,2019
18200,495000,191776,Khari Willis,S,active,indianapolis-colts,686776,2019
18201,645000,0,Al-Quadin Muhammad,DE,active,indianapolis-colts,645000,2019
18202,570000,60310,Jordan Wilkins,RB,active,indianapolis-colts,630310,2019
18203,570000,25395,Matthew Adams,OLB,active,indianapolis-colts,595395,2019
18204,570000,21764,Zaire Franklin,OLB,active,indianapolis-colts,591764,2019
18205,495000,82040,Marvell Tell,CB,active,indianapolis-colts,577040,2019
18206,570000,4333,George Odum,S,active,indianapolis-colts,574333,2019
18207,570000,0,Mo Alie-Cox,TE,active,indianapolis-colts,570000,2019
18208,570000,0,Zach Pascal,WR,active,indianapolis-colts,570000,2019
18209,495000,72349,E.J. Speed,LB,active,indianapolis-colts,567349,2019
18210,493233,0,Trevon Coley,DT,active,indianapolis-colts,493233,2019
18211,407647,0,Ashton Dulin,WR,active,indianapolis-colts,407647,2019
18212,303528,0,Marcus Johnson,WR,active,indianapolis-colts,303528,2019
18213,268235,0,Chad Kelly,QB,active,indianapolis-colts,268235,2019
18214,151765,0,Chad Williams,WR,active,indianapolis-colts,151765,2019
18215,142059,0,Dontrelle Inman,WR,active,indianapolis-colts,142059,2019
18216,116471,0,Chase McLaughlin,K,active,indianapolis-colts,116471,2019
18217,87353,0,Jake Eldrenkamp,G,active,indianapolis-colts,87353,2019
18218,84706,0,Briean Boddy-Calhoun,S,active,indianapolis-colts,84706,2019
18219,33529,0,Skai Moore,LB,active,indianapolis-colts,33529,2019
18220,3000000,7000000,Devin Funchess,WR,injured_reserve,indianapolis-colts,10000000,2019
18221,5250000,1671875,Eric Ebron,TE,injured_reserve,indianapolis-colts,6921875,2019
18222,1875000,2000000,Adam Vinatieri,K,injured_reserve,indianapolis-colts,3875000,2019
18223,3095000,0,Chester Rogers,WR,injured_reserve,indianapolis-colts,3095000,2019
18224,717200,468800,Kemoko Turay,DE,injured_reserve,indianapolis-colts,1186000,2019
18225,495000,373352,Parris Campbell,WR,injured_reserve,indianapolis-colts,868352,2019
18226,465888,0,Rolan Milligan,S,injured_reserve,indianapolis-colts,465888,2019
18227,448000,0,Isaiah Johnson,FS,injured_reserve,indianapolis-colts,448000,2019
18228,378000,18644,Javon Patterson,C,injured_reserve,indianapolis-colts,396644,2019
18229,393000,0,Daurice Fountain,WR,injured_reserve,indianapolis-colts,393000,2019
18230,393000,0,Kai Nacua,S,injured_reserve,indianapolis-colts,393000,2019
18231,378000,6666,Jegs Jegede,DE,injured_reserve,indianapolis-colts,384666,2019
18232,378000,0,Billy Brown,TE,injured_reserve,indianapolis-colts,378000,2019
18233,378000,0,Steve Ishmael,WR,injured_reserve,indianapolis-colts,378000,2019
18234,16000,0,Roderick Young,DT,practice_squad,indianapolis-colts,16000,2019
18235,0,18400000,Andrew Luck,QB,dead_cap,indianapolis-colts,18400000,2019
18236,0,600000,Chris Milton,CB,dead_cap,indianapolis-colts,600000,2019
18237,518853,0,D'Onta Foreman,RB,dead_cap,indianapolis-colts,518853,2019
18238,0,417928,Tarell Basham,OLB,dead_cap,indianapolis-colts,417928,2019
18239,0,307682,T.J. Green,S,dead_cap,indianapolis-colts,307682,2019
18240,142059,150000,Spencer Ware,RB,dead_cap,indianapolis-colts,292059,2019
18241,270062,0,Deon Cain,WR,dead_cap,indianapolis-colts,270062,2019
18242,268236,0,Ryan Lewis,CB,dead_cap,indianapolis-colts,268236,2019
18243,232941,0,Shakial Taylor,CB,dead_cap,indianapolis-colts,232941,2019
18244,200000,19903,Jackson Barton,T,dead_cap,indianapolis-colts,219903,2019
18245,210000,0,Jake Eldrenkamp,G,dead_cap,indianapolis-colts,210000,2019
18246,0,207897,Daurice Fountain,WR,dead_cap,indianapolis-colts,207897,2019
18247,201174,0,Chad Kelly,QB,dead_cap,indianapolis-colts,201174,2019
18248,169412,0,Jihad Ward,DT,dead_cap,indianapolis-colts,169412,2019
18249,151765,0,Ross Travis,TE,dead_cap,indianapolis-colts,151765,2019
18250,112000,39402,Gerri Green,DE,dead_cap,indianapolis-colts,151402,2019
18251,145588,5000,Hale Hentges,TE,dead_cap,indianapolis-colts,150588,2019
18252,128000,13334,Skai Moore,LB,dead_cap,indianapolis-colts,141334,2019
18253,0,140057,Hassan Ridgeway,DE,dead_cap,indianapolis-colts,140057,2019
18254,0,129977,Antonio Morrison,ILB,dead_cap,indianapolis-colts,129977,2019
18255,127059,0,Carl Davis,DT,dead_cap,indianapolis-colts,127059,2019
18256,123108,0,Ahmad Thomas,S,dead_cap,indianapolis-colts,123108,2019
18257,104000,0,Chad Williams,WR,dead_cap,indianapolis-colts,104000,2019
18258,96000,0,Ian Bunting,TE,dead_cap,indianapolis-colts,96000,2019
18259,0,90000,J'Marcus Webb,RT,dead_cap,indianapolis-colts,90000,2019
18260,77941,0,Marcus Johnson,WR,dead_cap,indianapolis-colts,77941,2019
18261,0,66946,Nate Hairston,CB,dead_cap,indianapolis-colts,66946,2019
18262,64000,0,Deante Burton,WR,dead_cap,indianapolis-colts,64000,2019
18263,64000,0,Darius Jackson,RB,dead_cap,indianapolis-colts,64000,2019
18264,56000,0,Cedrick Lang,T,dead_cap,indianapolis-colts,56000,2019
18265,42353,0,Matt Lengel,TE,dead_cap,indianapolis-colts,42353,2019
18266,40000,0,Picasso Nelson,CB,dead_cap,indianapolis-colts,40000,2019
18267,40000,0,Jackson Porter,S,dead_cap,indianapolis-colts,40000,2019
18268,40000,0,Bruce Anderson,RB,dead_cap,indianapolis-colts,40000,2019
18269,32000,0,Jalen Collins,CB,dead_cap,indianapolis-colts,32000,2019
18270,32000,0,Malik Henry,WR,dead_cap,indianapolis-colts,32000,2019
18271,32000,0,Kyle Peko,DT,dead_cap,indianapolis-colts,32000,2019
18272,32000,0,Brian Price,DT,dead_cap,indianapolis-colts,32000,2019
18273,24000,5000,Ashton Dulin,WR,dead_cap,indianapolis-colts,29000,2019
18274,24000,0,Jamal Davis,OLB,dead_cap,indianapolis-colts,24000,2019
18275,16000,0,Tyree St. Louis,T,dead_cap,indianapolis-colts,16000,2019
18276,16000,0,Travis Vornkahl,T,dead_cap,indianapolis-colts,16000,2019
18277,0,10000,Henre' Toliver,CB,dead_cap,indianapolis-colts,10000,2019
18278,0,8000,Tomasi Laulile,DT,dead_cap,indianapolis-colts,8000,2019
18279,8000,0,Rolan Milligan,S,dead_cap,indianapolis-colts,8000,2019
18280,0,6667,Chris Cooper,S,dead_cap,indianapolis-colts,6667,2019
18281,0,6667,Steve Ishmael,WR,dead_cap,indianapolis-colts,6667,2019
18282,0,5334,Lashard Durr,CB,dead_cap,indianapolis-colts,5334,2019
18283,0,5000,Penny Hart,WR,dead_cap,indianapolis-colts,5000,2019
18284,0,5000,Johnny Robinson,DT,dead_cap,indianapolis-colts,5000,2019
18285,0,5000,Jordan Thompson,DT,dead_cap,indianapolis-colts,5000,2019
18286,0,3334,Darrell Daniels,TE,dead_cap,indianapolis-colts,3334,2019
18287,0,3334,William Ossai,LB,dead_cap,indianapolis-colts,3334,2019
18288,0,2667,Michael Badgley,K,dead_cap,indianapolis-colts,2667,2019
18289,0,1667,Robert Jackson,CB,dead_cap,indianapolis-colts,1667,2019
18290,0,1000,Deyshawn Bond,G,dead_cap,indianapolis-colts,1000,2019
18291,6000000,15375000,Jacoby Brissett,QB,active,indianapolis-colts,21375000,2020
18292,14542000,0,T.Y. Hilton,WR,active,indianapolis-colts,14542000,2020
18293,10350000,0,Ryan Kelly,C,active,indianapolis-colts,10350000,2020
18294,8000000,1000000,Justin Houston,DE,active,indianapolis-colts,9000000,2020
18295,1250000,7250000,Jack Doyle,TE,active,indianapolis-colts,8500000,2020
18296,5000000,1900000,Mark Glowinski,G,active,indianapolis-colts,6900000,2020
18297,6500000,350000,Pierre Desir,CB,active,indianapolis-colts,6850000,2020
18298,660000,5855157,Quenton Nelson,G,active,indianapolis-colts,6515157,2020
18299,5750000,171875,Kenny Moore,CB,active,indianapolis-colts,5921875,2020
18300,5300000,406250,Denico Autry,DT,active,indianapolis-colts,5706250,2020
18301,2000000,3000000,Brian Hoyer,QB,active,indianapolis-colts,5000000,2020
18302,2183169,1825894,Malik Hooker,FS,active,indianapolis-colts,4009063,2020
18303,3500000,500000,Margus Hunt,DT,active,indianapolis-colts,4000000,2020
18304,2000000,0,Rigoberto Sanchez,P,active,indianapolis-colts,2000000,2020
18305,1138891,837782,Darius Leonard,OLB,active,indianapolis-colts,1976673,2020
18306,1133972,827943,Braden Smith,RT,active,indianapolis-colts,1961915,2020
18307,1251310,583414,Quincy Wilson,CB,active,indianapolis-colts,1834724,2020
18308,854839,944355,Rock Ya-Sin,CB,active,indianapolis-colts,1799194,2020
18309,954400,468800,Kemoko Turay,DE,active,indianapolis-colts,1423200,2020
18310,765205,585819,Ben Banogu,DE,active,indianapolis-colts,1351024,2020
18311,876914,313828,Tyquan Lewis,DT,active,indianapolis-colts,1190742,2020
18312,712088,373352,Parris Campbell,WR,active,indianapolis-colts,1085440,2020
18313,657500,220779,Bobby Okereke,LB,active,indianapolis-colts,878279,2020
18314,850000,0,Luke Rhodes,LS,active,indianapolis-colts,850000,2020
18315,660000,181136,Nyheim Hines,RB,active,indianapolis-colts,841136,2020
18316,735000,104912,Marlon Mack,RB,active,indianapolis-colts,839912,2020
18317,735000,104912,Grover Stewart,DT,active,indianapolis-colts,839912,2020
18318,735000,66354,Anthony Walker Jr.,ILB,active,indianapolis-colts,801354,2020
18319,585000,191776,Khari Willis,S,active,indianapolis-colts,776776,2020
18320,735000,0,Al-Quadin Muhammad,DE,active,indianapolis-colts,735000,2020
18321,735000,0,Lafayette Pitts,CB,active,indianapolis-colts,735000,2020
18322,735000,0,Chad Williams,WR,active,indianapolis-colts,735000,2020
18323,660000,60310,Jordan Wilkins,RB,active,indianapolis-colts,720310,2020
18324,660000,25395,Matthew Adams,OLB,active,indianapolis-colts,685395,2020
18325,660000,21764,Zaire Franklin,OLB,active,indianapolis-colts,681764,2020
18326,585000,82040,Marvell Tell,CB,active,indianapolis-colts,667040,2020
18327,660000,4334,George Odum,S,active,indianapolis-colts,664334,2020
18328,820000,0,Andrew Donnal,G,active,indianapolis-colts,820000,2020
18329,820000,0,Chaz Green,T,active,indianapolis-colts,820000,2020
18330,820000,0,Xavier Grimble,TE,active,indianapolis-colts,820000,2020
18331,660000,0,Darius Jackson,RB,active,indianapolis-colts,660000,2020
18332,660000,0,Chad Kelly,QB,active,indianapolis-colts,660000,2020
18333,585000,72349,E.J. Speed,LB,active,indianapolis-colts,657349,2020
18334,585000,6666,Jegs Jegede,DE,active,indianapolis-colts,591666,2020
18335,585000,0,Billy Brown,TE,active,indianapolis-colts,585000,2020
18336,585000,0,Ashton Dulin,WR,active,indianapolis-colts,585000,2020
18337,585000,0,Jake Eldrenkamp,G,active,indianapolis-colts,585000,2020
18338,510000,18644,Javon Patterson,C,active,indianapolis-colts,528644,2020
18339,510000,0,Bruce Anderson,RB,active,indianapolis-colts,510000,2020
18340,510000,0,Ian Bunting,TE,active,indianapolis-colts,510000,2020
18341,510000,0,Gerri Green,DE,active,indianapolis-colts,510000,2020
18342,510000,0,Malik Henry,WR,active,indianapolis-colts,510000,2020
18343,510000,0,Steve Ishmael,WR,active,indianapolis-colts,510000,2020
18344,510000,0,Cedrick Lang,T,active,indianapolis-colts,510000,2020
18345,510000,0,Matt Lengel,TE,active,indianapolis-colts,510000,2020
18346,510000,0,Picasso Nelson,CB,active,indianapolis-colts,510000,2020
18347,510000,0,Jackson Porter,S,active,indianapolis-colts,510000,2020
18348,510000,0,Travis Vornkahl,T,active,indianapolis-colts,510000,2020
18349,0,0,Brandon Hitner,T,active,indianapolis-colts,0,2020
18350,0,0,Artavis Scott,WR,active,indianapolis-colts,0,2020
18351,0,6400000,Andrew Luck,QB,dead_cap,indianapolis-colts,6400000,2020
18352,0,118206,Gerri Green,DE,dead_cap,indianapolis-colts,118206,2020
18353,0,66946,Nate Hairston,CB,dead_cap,indianapolis-colts,66946,2020
18354,0,59709,Jackson Barton,T,dead_cap,indianapolis-colts,59709,2020
18355,0,10000,Ashton Dulin,WR,dead_cap,indianapolis-colts,10000,2020
18356,0,10000,Penny Hart,WR,dead_cap,indianapolis-colts,10000,2020
18357,0,10000,Hale Hentges,TE,dead_cap,indianapolis-colts,10000,2020
18358,510000,6562000,Daryl Smith,ILB,active,jacksonville-jaguars,7072000,2007
18359,800000,5800000,Fred Taylor,RB,active,jacksonville-jaguars,6600000,2007
18360,605000,3890000,John Henderson,DT,active,jacksonville-jaguars,4495000,2007
18361,1400000,2800000,Vince Manuwai,G,active,jacksonville-jaguars,4200000,2007
18362,3800000,333333,Mike Peterson,LB,active,jacksonville-jaguars,4133333,2007
18363,2000000,2000000,Brian Williams,CB,active,jacksonville-jaguars,4000000,2007
18364,1550000,1718000,Rashean Mathis,CB,active,jacksonville-jaguars,3268000,2007
18365,2050000,1050000,Brad Meester,C,active,jacksonville-jaguars,3100000,2007
18366,510000,2838333,Reggie Williams,WR,active,jacksonville-jaguars,3348333,2007
18367,700000,1400000,Josh Scobee,K,active,jacksonville-jaguars,2100000,2007
18368,575000,2545000,Matt Jones,WR,active,jacksonville-jaguars,3120000,2007
18369,1095000,360000,Rob Meier,DE,active,jacksonville-jaguars,1455000,2007
18370,1850000,0,Bobby McCray,DE,active,jacksonville-jaguars,1850000,2007
18371,510000,1300000,Tony Pashos,RT,active,jacksonville-jaguars,1810000,2007
18372,1100000,500000,David Garrard,QB,active,jacksonville-jaguars,1600000,2007
18373,360000,1755000,Marcedes Lewis,TE,active,jacksonville-jaguars,2115000,2007
18374,285000,622000,Reggie Nelson,FS,active,jacksonville-jaguars,907000,2007
18375,435000,287000,Khalif Barnes,LT,active,jacksonville-jaguars,722000,2007
18376,720000,0,Joe Zelenka,LS,active,jacksonville-jaguars,720000,2007
18377,460000,252000,Greg Jones,FB,active,jacksonville-jaguars,712000,2007
18378,285000,325500,Justin Durant,OLB,active,jacksonville-jaguars,610500,2007
18379,360000,380000,Maurice Jones-Drew,RB,active,jacksonville-jaguars,740000,2007
18380,435000,150000,Scott Starks,CB,active,jacksonville-jaguars,585000,2007
18381,360000,178750,Clint Ingram,LB,active,jacksonville-jaguars,538750,2007
18382,435000,40833,Gerald Sensabaugh,S,active,jacksonville-jaguars,475833,2007
18383,820000,40000,Sammy Knight,S,active,jacksonville-jaguars,860000,2007
18384,285000,121000,Adam Podlesh,P,active,jacksonville-jaguars,406000,2007
18385,360000,38750,Brent Hawkins,DE,active,jacksonville-jaguars,398750,2007
18386,285000,112500,Brian Smith,DE,active,jacksonville-jaguars,397500,2007
18387,385000,0,Kenneth Pettway,LB,active,jacksonville-jaguars,385000,2007
18388,190000,184628,Mike Sims-Walker,WR,active,jacksonville-jaguars,374628,2007
18389,360000,2500,Tony McDaniel,DT,active,jacksonville-jaguars,362500,2007
18390,360000,500,Montell Owens,FB,active,jacksonville-jaguars,360500,2007
18391,360000,0,Jeremy Mincey,DE,active,jacksonville-jaguars,360000,2007
18392,360000,0,Dee Webb,CB,active,jacksonville-jaguars,360000,2007
18393,360000,0,James Wyche,DE,active,jacksonville-jaguars,360000,2007
18394,285000,43900,Uche Nwaneri,G,active,jacksonville-jaguars,328900,2007
18395,285000,38750,Derek Landri,DT,active,jacksonville-jaguars,323750,2007
18396,285000,12462,John Broussard,WR,active,jacksonville-jaguars,297462,2007
18397,285000,9062,Chad Nkang,LB,active,jacksonville-jaguars,294062,2007
18398,285000,0,Andrew Carnahan,T,active,jacksonville-jaguars,285000,2007
18399,1415000,1083333,Marcus Stroud,DT,injured_reserve,jacksonville-jaguars,2498333,2007
18400,720000,100000,Stockar McDougle,G,injured_reserve,jacksonville-jaguars,820000,2007
18401,0,3089332,Byron Leftwich,QB,dead_cap,jacksonville-jaguars,3089332,2007
18402,0,700000,Mike Williams,T,dead_cap,jacksonville-jaguars,700000,2007
18403,0,125000,Donovan Darius,S,dead_cap,jacksonville-jaguars,125000,2007
18404,101166,0,Alvin Pearman,RB,dead_cap,jacksonville-jaguars,101166,2007
18405,80000,0,Chad Owens,WR,dead_cap,jacksonville-jaguars,80000,2007
18406,43700,0,Josh Gattis,CB,dead_cap,jacksonville-jaguars,43700,2007
18407,22667,0,Pat Thomas,LB,dead_cap,jacksonville-jaguars,22667,2007
18408,11062,0,Dee Webb,CB,dead_cap,jacksonville-jaguars,11062,2007
18409,8950,0,Andrew Carnahan,T,dead_cap,jacksonville-jaguars,8950,2007
18410,3334,0,Dan Connolly,G,dead_cap,jacksonville-jaguars,3334,2007
18411,2975000,6525000,David Garrard,QB,active,jacksonville-jaguars,9500000,2008
18412,1000000,5500000,Drayton Florence,CB,active,jacksonville-jaguars,6500000,2008
18413,4000000,2000000,Brian Williams,CB,active,jacksonville-jaguars,6000000,2008
18414,3000000,1933333,Mike Peterson,LB,active,jacksonville-jaguars,4933333,2008
18415,605000,3925000,Tony Pashos,RT,active,jacksonville-jaguars,4530000,2008
18416,605000,3200000,Cleo Lemon,QB,active,jacksonville-jaguars,3805000,2008
18417,2450000,1718000,Rashean Mathis,CB,active,jacksonville-jaguars,4168000,2008
18418,605000,3092000,Daryl Smith,ILB,active,jacksonville-jaguars,3697000,2008
18419,1000000,360000,Rob Meier,DE,active,jacksonville-jaguars,1360000,2008
18420,2450000,1050000,Brad Meester,C,active,jacksonville-jaguars,3500000,2008
18421,1400000,1490000,John Henderson,DT,active,jacksonville-jaguars,2890000,2008
18422,525000,2339700,Greg Jones,FB,active,jacksonville-jaguars,2864700,2008
18423,810000,2838333,Reggie Williams,WR,active,jacksonville-jaguars,3648333,2008
18424,295000,1795000,Derrick Harvey,DE,active,jacksonville-jaguars,2090000,2008
18425,625000,2545000,Matt Jones,WR,active,jacksonville-jaguars,3170000,2008
18426,582500,1780000,Marcedes Lewis,TE,active,jacksonville-jaguars,2362500,2008
18427,1417000,0,Gerald Sensabaugh,S,active,jacksonville-jaguars,1417000,2008
18428,800000,400000,Josh Scobee,K,active,jacksonville-jaguars,1200000,2008
18429,370000,622000,Reggie Nelson,FS,active,jacksonville-jaguars,992000,2008
18430,910000,0,Troy Williamson,WR,active,jacksonville-jaguars,910000,2008
18431,520000,306428,Khalif Barnes,LT,active,jacksonville-jaguars,826428,2008
18432,730000,0,Joe Zelenka,LS,active,jacksonville-jaguars,730000,2008
18433,370000,325500,Justin Durant,OLB,active,jacksonville-jaguars,695500,2008
18434,445000,380000,Maurice Jones-Drew,RB,active,jacksonville-jaguars,825000,2008
18435,445000,235833,Tony McDaniel,DT,active,jacksonville-jaguars,680833,2008
18436,520000,150000,Scott Starks,CB,active,jacksonville-jaguars,670000,2008
18437,295000,338750,Quentin Groves,OLB,active,jacksonville-jaguars,633750,2008
18438,445000,178750,Clint Ingram,LB,active,jacksonville-jaguars,623750,2008
18439,370000,184628,Mike Sims-Walker,WR,active,jacksonville-jaguars,554628,2008
18440,520000,0,Alvin Pearman,RB,active,jacksonville-jaguars,520000,2008
18441,445000,0,Jeremy Mincey,DE,active,jacksonville-jaguars,445000,2008
18442,445000,0,Montell Owens,FB,active,jacksonville-jaguars,445000,2008
18443,445000,0,Dee Webb,CB,active,jacksonville-jaguars,445000,2008
18444,370000,43900,Uche Nwaneri,G,active,jacksonville-jaguars,413900,2008
18445,370000,38750,Derek Landri,DT,active,jacksonville-jaguars,408750,2008
18446,370000,0,Charles Spencer,T,active,jacksonville-jaguars,370000,2008
18447,370000,0,James Wyche,DE,active,jacksonville-jaguars,370000,2008
18448,295000,43625,Thomas Williams,LB,active,jacksonville-jaguars,338625,2008
18449,315294,9062,Chad Nkang,LB,active,jacksonville-jaguars,324356,2008
18450,295000,14935,Chauncey Washington,RB,active,jacksonville-jaguars,309935,2008
18451,295000,3750,William Robinson,T,active,jacksonville-jaguars,298750,2008
18452,295000,0,Trae Williams,CB,active,jacksonville-jaguars,295000,2008
18453,46250,0,Andrew Carnahan,T,active,jacksonville-jaguars,46250,2008
18454,41926,0,Trae Williams,CB,active,jacksonville-jaguars,41926,2008
18455,4000000,1000000,Fred Taylor,RB,injured_reserve,jacksonville-jaguars,5000000,2008
18456,900000,500000,Jerry Porter,WR,injured_reserve,jacksonville-jaguars,1400000,2008
18457,1900000,1300000,Vince Manuwai,G,injured_reserve,jacksonville-jaguars,3200000,2008
18458,370000,121000,Adam Podlesh,P,injured_reserve,jacksonville-jaguars,491000,2008
18459,88400,0,Stefan Rodgers,T,practice_squad,jacksonville-jaguars,88400,2008
18460,0,6178664,Byron Leftwich,QB,dead_cap,jacksonville-jaguars,6178664,2008
18461,1083333,0,Marcus Stroud,DT,dead_cap,jacksonville-jaguars,1083333,2008
18462,391470,0,Milford Brown,G,dead_cap,jacksonville-jaguars,391470,2008
18463,177941,100000,Jimmy Kennedy,DT,dead_cap,jacksonville-jaguars,277941,2008
18464,131100,0,Josh Gattis,CB,dead_cap,jacksonville-jaguars,131100,2008
18465,0,125000,Donovan Darius,S,dead_cap,jacksonville-jaguars,125000,2008
18466,112500,0,Brian Smith,DE,dead_cap,jacksonville-jaguars,112500,2008
18467,78530,0,Chad Slaughter,T,dead_cap,jacksonville-jaguars,78530,2008
18468,38750,0,Brent Hawkins,DE,dead_cap,jacksonville-jaguars,38750,2008
18469,26850,0,Andrew Carnahan,T,dead_cap,jacksonville-jaguars,26850,2008
18470,22124,0,Dee Webb,CB,dead_cap,jacksonville-jaguars,22124,2008
18471,17352,0,Stefan Rodgers,T,dead_cap,jacksonville-jaguars,17352,2008
18472,15600,0,Travarous Bain,CB,dead_cap,jacksonville-jaguars,15600,2008
18473,12462,0,John Broussard,WR,dead_cap,jacksonville-jaguars,12462,2008
18474,0,1666,Brett Goode,LS,dead_cap,jacksonville-jaguars,1666,2008
18475,5475000,3025000,David Garrard,QB,active,jacksonville-jaguars,8500000,2009
18476,802500,8135000,Derrick Harvey,DE,active,jacksonville-jaguars,8937500,2009
18477,4050000,2380000,Maurice Jones-Drew,RB,active,jacksonville-jaguars,6430000,2009
18478,3450000,1718000,Rashean Mathis,CB,active,jacksonville-jaguars,5168000,2009
18479,2300000,2050000,Tra Thomas,LT,active,jacksonville-jaguars,4350000,2009
18480,2900000,1300000,Vince Manuwai,G,active,jacksonville-jaguars,4200000,2009
18481,2950000,1050000,Torry Holt,WR,active,jacksonville-jaguars,4000000,2009
18482,2480000,1090625,Greg Jones,FB,active,jacksonville-jaguars,3570625,2009
18483,2500000,0,Luke McCown,QB,active,jacksonville-jaguars,2500000,2009
18484,1145000,1112000,Daryl Smith,ILB,active,jacksonville-jaguars,2257000,2009
18485,750000,1500000,Brad Meester,C,active,jacksonville-jaguars,2250000,2009
18486,310000,1795000,Eugene Monroe,LT,active,jacksonville-jaguars,2105000,2009
18487,1675000,400000,Josh Scobee,K,active,jacksonville-jaguars,2075000,2009
18488,950000,1050000,Sean Considine,S,active,jacksonville-jaguars,2000000,2009
18489,535000,1780000,Marcedes Lewis,TE,active,jacksonville-jaguars,2315000,2009
18490,1435000,0,Troy Williamson,WR,active,jacksonville-jaguars,1435000,2009
18491,620000,0,Scott Starks,CB,active,jacksonville-jaguars,620000,2009
18492,1010000,178750,Clint Ingram,LB,active,jacksonville-jaguars,1188750,2009
18493,532500,622000,Reggie Nelson,FS,active,jacksonville-jaguars,1154500,2009
18494,535000,487500,Montell Owens,FB,active,jacksonville-jaguars,1022500,2009
18495,460000,325500,Justin Durant,OLB,active,jacksonville-jaguars,785500,2009
18496,310000,475000,Eben Britton,RT,active,jacksonville-jaguars,785000,2009
18497,385000,338750,Quentin Groves,OLB,active,jacksonville-jaguars,723750,2009
18498,460000,184628,Mike Sims-Walker,WR,active,jacksonville-jaguars,644628,2009
18499,620000,0,Jordan Black,T,active,jacksonville-jaguars,620000,2009
18500,460000,121000,Adam Podlesh,P,active,jacksonville-jaguars,581000,2009
18501,535000,12500,Jeremy Cain,LS,active,jacksonville-jaguars,547500,2009
18502,535000,0,Jeremy Mincey,DE,active,jacksonville-jaguars,535000,2009
18503,535000,0,Anthony Smith,S,active,jacksonville-jaguars,535000,2009
18504,530000,0,Dee Webb,CB,active,jacksonville-jaguars,530000,2009
18505,310000,210964,Terrance Knighton,DT,active,jacksonville-jaguars,520964,2009
18506,310000,208250,Derek Cox,CB,active,jacksonville-jaguars,518250,2009
18507,460000,43900,Uche Nwaneri,G,active,jacksonville-jaguars,503900,2009
18508,620000,0,Adam Seward,LB,active,jacksonville-jaguars,620000,2009
18509,460000,0,Gerald Alexander,S,active,jacksonville-jaguars,460000,2009
18510,460000,0,Montavious Stanley,DT,active,jacksonville-jaguars,460000,2009
18511,310000,126862,Mike Thomas,WR,active,jacksonville-jaguars,436862,2009
18512,431250,0,James Wyche,DE,active,jacksonville-jaguars,431250,2009
18513,385000,43625,Thomas Williams,LB,active,jacksonville-jaguars,428625,2009
18514,385000,0,Leger Douzable,DT,active,jacksonville-jaguars,385000,2009
18515,385000,0,Chris Harrington,DE,active,jacksonville-jaguars,385000,2009
18516,385000,0,Trae Williams,CB,active,jacksonville-jaguars,385000,2009
18517,310000,45250,Alvin Bowen,LB,active,jacksonville-jaguars,355250,2009
18518,310000,27625,Zach Miller,TE,active,jacksonville-jaguars,337625,2009
18519,310000,10662,Courtney Greene,S,active,jacksonville-jaguars,320662,2009
18520,310000,9612,Rashad Jennings,RB,active,jacksonville-jaguars,319612,2009
18521,310000,5000,Russell Allen,OLB,active,jacksonville-jaguars,315000,2009
18522,310000,0,Brock Bolen,RB,active,jacksonville-jaguars,310000,2009
18523,310000,0,Don Carey,SS,active,jacksonville-jaguars,310000,2009
18524,310000,0,Nate Hughes,WR,active,jacksonville-jaguars,310000,2009
18525,310000,0,William Middleton,CB,active,jacksonville-jaguars,310000,2009
18526,310000,0,Zach Potter,TE,active,jacksonville-jaguars,310000,2009
18527,310000,0,Tiquan Underwood,WR,active,jacksonville-jaguars,310000,2009
18528,145882,0,Jeremy Navarre,DT,active,jacksonville-jaguars,145882,2009
18529,125778,0,Trae Williams,CB,active,jacksonville-jaguars,125778,2009
18530,1500000,0,Rob Meier,DE,injured_reserve,jacksonville-jaguars,1500000,2009
18531,215000,48075,Jarett Dillard,WR,injured_reserve,jacksonville-jaguars,263075,2009
18532,88400,0,Jeremy Navarre,DT,practice_squad,jacksonville-jaguars,88400,2009
18533,88400,0,Cecil Newton,C,practice_squad,jacksonville-jaguars,88400,2009
18534,2166666,0,Marcus Stroud,DT,dead_cap,jacksonville-jaguars,2166666,2009
18535,2000000,0,Brian Williams,CB,dead_cap,jacksonville-jaguars,2000000,2009
18536,0,2813334,Reggie Williams,WR,dead_cap,jacksonville-jaguars,2813334,2009
18537,1512500,0,Tony Pashos,RT,dead_cap,jacksonville-jaguars,1512500,2009
18538,0,2520000,Matt Jones,WR,dead_cap,jacksonville-jaguars,2520000,2009
18539,500000,0,Drayton Florence,CB,dead_cap,jacksonville-jaguars,500000,2009
18540,466666,0,Tony McDaniel,DT,dead_cap,jacksonville-jaguars,466666,2009
18541,267572,0,Khalif Barnes,LT,dead_cap,jacksonville-jaguars,267572,2009
18542,225000,0,Brian Smith,DE,dead_cap,jacksonville-jaguars,225000,2009
18543,110000,0,Richard Bartel,QB,dead_cap,jacksonville-jaguars,110000,2009
18544,77500,0,Derek Landri,DT,dead_cap,jacksonville-jaguars,77500,2009
18545,38750,0,Brent Hawkins,DE,dead_cap,jacksonville-jaguars,38750,2009
18546,25000,0,Joe Zelenka,LS,dead_cap,jacksonville-jaguars,25000,2009
18547,24924,0,John Broussard,WR,dead_cap,jacksonville-jaguars,24924,2009
18548,18124,0,Chad Nkang,LB,dead_cap,jacksonville-jaguars,18124,2009
18549,14935,0,Chauncey Washington,RB,dead_cap,jacksonville-jaguars,14935,2009
18550,0,3334,Brett Goode,LS,dead_cap,jacksonville-jaguars,3334,2009
18551,7975000,25000,David Garrard,QB,active,jacksonville-jaguars,8000000,2010
18552,4400000,2000000,Maurice Jones-Drew,RB,active,jacksonville-jaguars,6400000,2010
18553,3950000,778000,Rashean Mathis,CB,active,jacksonville-jaguars,4728000,2010
18554,2900000,1350000,Vince Manuwai,G,active,jacksonville-jaguars,4250000,2010
18555,3150000,800000,Daryl Smith,ILB,active,jacksonville-jaguars,3950000,2010
18556,3000000,600000,Greg Jones,FB,active,jacksonville-jaguars,3600000,2010
18557,1000000,2500000,Aaron Kampman,DE,active,jacksonville-jaguars,3500000,2010
18558,1215000,3220000,Derrick Harvey,DE,active,jacksonville-jaguars,4435000,2010
18559,802500,3309000,Eugene Monroe,LT,active,jacksonville-jaguars,4111500,2010
18560,2524000,0,Kirk Morrison,LB,active,jacksonville-jaguars,2524000,2010
18561,2500000,0,Luke McCown,QB,active,jacksonville-jaguars,2500000,2010
18562,1825000,400000,Josh Scobee,K,active,jacksonville-jaguars,2225000,2010
18563,1077500,1880000,Marcedes Lewis,TE,active,jacksonville-jaguars,2957500,2010
18564,715000,1337500,Montell Owens,FB,active,jacksonville-jaguars,2052500,2010
18565,1450000,600000,Brad Meester,C,active,jacksonville-jaguars,2050000,2010
18566,320000,1615000,Tyson Alualu,DE,active,jacksonville-jaguars,1935000,2010
18567,598000,1138400,Uche Nwaneri,G,active,jacksonville-jaguars,1736400,2010
18568,775000,858333,Kassim Osgood,WR,active,jacksonville-jaguars,1633333,2010
18569,1358823,0,Trent Edwards,QB,active,jacksonville-jaguars,1358823,2010
18570,1101000,184628,Mike Sims-Walker,WR,active,jacksonville-jaguars,1285628,2010
18571,1101000,121000,Adam Podlesh,P,active,jacksonville-jaguars,1222000,2010
18572,1101000,0,David Jones,CB,active,jacksonville-jaguars,1101000,2010
18573,950000,50000,Sean Considine,S,active,jacksonville-jaguars,1000000,2010
18574,550000,325500,Justin Durant,OLB,active,jacksonville-jaguars,875500,2010
18575,395000,475000,Eben Britton,RT,active,jacksonville-jaguars,870000,2010
18576,630000,12500,Jeremy Cain,LS,active,jacksonville-jaguars,642500,2010
18577,630000,0,Freddy Keiaho,LB,active,jacksonville-jaguars,630000,2010
18578,630000,0,C.J. Mosley,DT,active,jacksonville-jaguars,630000,2010
18579,395000,210964,Terrance Knighton,DT,active,jacksonville-jaguars,605964,2010
18580,395000,208250,Derek Cox,CB,active,jacksonville-jaguars,603250,2010
18581,545000,0,Jeremy Mincey,DE,active,jacksonville-jaguars,545000,2010
18582,540000,0,Guy Whimper,G,active,jacksonville-jaguars,540000,2010
18583,395000,126862,Mike Thomas,WR,active,jacksonville-jaguars,521862,2010
18584,470000,45250,Alvin Bowen,LB,active,jacksonville-jaguars,515250,2010
18585,470000,43625,Thomas Williams,LB,active,jacksonville-jaguars,513625,2010
18586,630000,0,Adam Terry,T,active,jacksonville-jaguars,630000,2010
18587,470000,0,Landon Cohen,DT,active,jacksonville-jaguars,470000,2010
18588,470000,0,Leger Douzable,DT,active,jacksonville-jaguars,470000,2010
18589,470000,0,Chris Harrington,DE,active,jacksonville-jaguars,470000,2010
18590,470000,0,Jalen Parmele,RB,active,jacksonville-jaguars,470000,2010
18591,470000,0,Trae Williams,CB,active,jacksonville-jaguars,470000,2010
18592,225000,212500,D'Anthony Smith,DT,active,jacksonville-jaguars,437500,2010
18593,395000,27625,Zach Miller,TE,active,jacksonville-jaguars,422625,2010
18594,395000,9612,Rashad Jennings,RB,active,jacksonville-jaguars,404612,2010
18595,395000,5000,Russell Allen,OLB,active,jacksonville-jaguars,400000,2010
18596,395000,0,Brock Bolen,RB,active,jacksonville-jaguars,395000,2010
18597,395000,0,Courtney Greene,S,active,jacksonville-jaguars,395000,2010
18598,395000,0,William Middleton,CB,active,jacksonville-jaguars,395000,2010
18599,395000,0,Tiquan Underwood,WR,active,jacksonville-jaguars,395000,2010
18600,320000,48200,Larry Hart,LB,active,jacksonville-jaguars,368200,2010
18601,320000,46049,Austen Lane,DE,active,jacksonville-jaguars,366049,2010
18602,320000,27500,Deji Karim,RB,active,jacksonville-jaguars,347500,2010
18603,320000,20000,Scotty McGee,KR,active,jacksonville-jaguars,340000,2010
18604,320000,5000,Daniel Baldridge,RT,active,jacksonville-jaguars,325000,2010
18605,320000,4167,Kyle Bosworth,OLB,active,jacksonville-jaguars,324167,2010
18606,320000,667,Aaron Morgan,DE,active,jacksonville-jaguars,320667,2010
18607,320000,0,Don Carey,SS,active,jacksonville-jaguars,320000,2010
18608,320000,0,Zach Potter,TE,active,jacksonville-jaguars,320000,2010
18609,225000,5833,Kevin Haslam,T,active,jacksonville-jaguars,230833,2010
18610,225000,5000,John Estes,C,active,jacksonville-jaguars,230000,2010
18611,207058,0,Jacob Cutrera,ILB,active,jacksonville-jaguars,207058,2010
18612,240000,48075,Jarett Dillard,WR,injured_reserve,jacksonville-jaguars,288075,2010
18613,88400,0,Jacob Cutrera,ILB,practice_squad,jacksonville-jaguars,88400,2010
18614,88400,0,John Destin,CB,practice_squad,jacksonville-jaguars,88400,2010
18615,3025000,0,Tony Pashos,RT,dead_cap,jacksonville-jaguars,3025000,2010
18616,2000000,0,Brian Williams,CB,dead_cap,jacksonville-jaguars,2000000,2010
18617,0,1290000,John Henderson,DT,dead_cap,jacksonville-jaguars,1290000,2010
18618,133235,0,Patrick Ramsey,QB,dead_cap,jacksonville-jaguars,133235,2010
18619,0,100000,Troy Williamson,WR,dead_cap,jacksonville-jaguars,100000,2010
18620,36544,0,Tiquan Underwood,WR,dead_cap,jacksonville-jaguars,36544,2010
18621,29870,0,Chauncey Washington,RB,dead_cap,jacksonville-jaguars,29870,2010
18622,4050000,1950000,Maurice Jones-Drew,RB,active,jacksonville-jaguars,6000000,2011
18623,4200000,800000,Daryl Smith,ILB,active,jacksonville-jaguars,5000000,2011
18624,2450000,2500000,Aaron Kampman,DE,active,jacksonville-jaguars,4950000,2011
18625,4450000,50000,Rashean Mathis,CB,active,jacksonville-jaguars,4500000,2011
18626,1650000,2200000,Marcedes Lewis,TE,active,jacksonville-jaguars,3850000,2011
18627,3100000,600000,Greg Jones,FB,active,jacksonville-jaguars,3700000,2011
18628,1242500,3309000,Eugene Monroe,LT,active,jacksonville-jaguars,4551500,2011
18629,2500000,500000,Matt Roth,DE,active,jacksonville-jaguars,3000000,2011
18630,1000000,2000000,Paul Posluszny,OLB,active,jacksonville-jaguars,3000000,2011
18631,1950000,700000,Brad Meester,C,active,jacksonville-jaguars,2650000,2011
18632,1300000,1300000,Dawan Landry,S,active,jacksonville-jaguars,2600000,2011
18633,2285000,250000,Jason Spitz,G,active,jacksonville-jaguars,2535000,2011
18634,2000000,400000,Josh Scobee,K,active,jacksonville-jaguars,2400000,2011
18635,802500,2790000,Tyson Alualu,DE,active,jacksonville-jaguars,3592500,2011
18636,1475000,858333,Kassim Osgood,WR,active,jacksonville-jaguars,2333333,2011
18637,375000,1807118,Blaine Gabbert,QB,active,jacksonville-jaguars,2182118,2011
18638,1100000,1050000,Drew Coleman,CB,active,jacksonville-jaguars,2150000,2011
18639,950000,937500,Montell Owens,FB,active,jacksonville-jaguars,1887500,2011
18640,711000,1094500,Uche Nwaneri,G,active,jacksonville-jaguars,1805500,2011
18641,1000000,800000,Luke McCown,QB,active,jacksonville-jaguars,1800000,2011
18642,525000,626862,Mike Thomas,WR,active,jacksonville-jaguars,1151862,2011
18643,685000,350000,C.J. Mosley,DT,active,jacksonville-jaguars,1035000,2011
18644,544600,475000,Eben Britton,RT,active,jacksonville-jaguars,1019600,2011
18645,725000,158333,Jeremy Cain,LS,active,jacksonville-jaguars,883333,2011
18646,645000,100000,David Jones,CB,active,jacksonville-jaguars,745000,2011
18647,525000,210964,Terrance Knighton,DT,active,jacksonville-jaguars,735964,2011
18648,525000,208250,Derek Cox,CB,active,jacksonville-jaguars,733250,2011
18649,685000,0,Jeremy Mincey,DE,active,jacksonville-jaguars,685000,2011
18650,685000,0,Ashton Youboty,CB,active,jacksonville-jaguars,685000,2011
18651,640000,0,Guy Whimper,G,active,jacksonville-jaguars,640000,2011
18652,405000,212500,D'Anthony Smith,DT,active,jacksonville-jaguars,617500,2011
18653,600000,0,Leger Douzable,DT,active,jacksonville-jaguars,600000,2011
18654,600000,0,Dwight Lowery,FS,active,jacksonville-jaguars,600000,2011
18655,555000,0,Trae Williams,CB,active,jacksonville-jaguars,555000,2011
18656,525000,27625,Zach Miller,TE,active,jacksonville-jaguars,552625,2011
18657,525000,9612,Rashad Jennings,RB,active,jacksonville-jaguars,534612,2011
18658,525000,5000,Russell Allen,OLB,active,jacksonville-jaguars,530000,2011
18659,375000,154868,Will Rackley,G,active,jacksonville-jaguars,529868,2011
18660,480000,48075,Jarett Dillard,WR,active,jacksonville-jaguars,528075,2011
18661,685000,0,Ceandris Brown,CB,active,jacksonville-jaguars,685000,2011
18662,525000,0,Brock Bolen,RB,active,jacksonville-jaguars,525000,2011
18663,525000,0,Courtney Greene,S,active,jacksonville-jaguars,525000,2011
18664,525000,0,Darcel McBath,S,active,jacksonville-jaguars,525000,2011
18665,525000,0,William Middleton,CB,active,jacksonville-jaguars,525000,2011
18666,525000,0,Morgan Trent,CB,active,jacksonville-jaguars,525000,2011
18667,525000,0,Tiquan Underwood,WR,active,jacksonville-jaguars,525000,2011
18668,480000,43625,Thomas Williams,LB,active,jacksonville-jaguars,523625,2011
18669,450000,46049,Austen Lane,DE,active,jacksonville-jaguars,496049,2011
18670,375000,110845,Cecil Shorts,WR,active,jacksonville-jaguars,485845,2011
18671,375000,105027,Chris Prosinski,SS,active,jacksonville-jaguars,480027,2011
18672,480000,0,Slade Norris,LB,active,jacksonville-jaguars,480000,2011
18673,465000,0,Dan LeFevour,QB,active,jacksonville-jaguars,465000,2011
18674,450000,0,Corvey Irvin,DT,active,jacksonville-jaguars,450000,2011
18675,450000,0,Zach Potter,TE,active,jacksonville-jaguars,450000,2011
18676,450000,0,Taylor Price,WR,active,jacksonville-jaguars,450000,2011
18677,405000,27500,Deji Karim,RB,active,jacksonville-jaguars,432500,2011
18678,375000,5000,John Estes,C,active,jacksonville-jaguars,380000,2011
18679,375000,1666,Cameron Bradfield,RT,active,jacksonville-jaguars,376666,2011
18680,375000,1666,Kevin Rutland,CB,active,jacksonville-jaguars,376666,2011
18681,375000,0,John Chick,DT,active,jacksonville-jaguars,375000,2011
18682,375000,0,DuJuan Harris,RB,active,jacksonville-jaguars,375000,2011
18683,375000,0,Richard Murphy,RB,active,jacksonville-jaguars,375000,2011
18684,375000,0,Chastin West,WR,active,jacksonville-jaguars,375000,2011
18685,258000,47490,Roderick Issac,CB,active,jacksonville-jaguars,305490,2011
18686,273000,5833,Kevin Haslam,T,active,jacksonville-jaguars,278833,2011
18687,258000,4167,Kyle Bosworth,OLB,active,jacksonville-jaguars,262167,2011
18688,88235,0,Colin Cloherty,TE,active,jacksonville-jaguars,88235,2011
18689,1000000,1200000,Clint Session,LB,injured_reserve,jacksonville-jaguars,2200000,2011
18690,525000,0,Brian Robiskie,WR,injured_reserve,jacksonville-jaguars,525000,2011
18691,273000,667,Aaron Morgan,DE,injured_reserve,jacksonville-jaguars,273667,2011
18692,96900,0,Brett Brackett,TE,practice_squad,jacksonville-jaguars,96900,2011
18693,96900,0,Colin Cloherty,TE,practice_squad,jacksonville-jaguars,96900,2011
18694,96900,0,Jacob Cutrera,ILB,practice_squad,jacksonville-jaguars,96900,2011
18695,0,3020000,Derrick Harvey,DE,dead_cap,jacksonville-jaguars,3020000,2011
18696,1600000,0,Vince Manuwai,G,dead_cap,jacksonville-jaguars,1600000,2011
18697,0,48200,Larry Hart,LB,dead_cap,jacksonville-jaguars,48200,2011
18698,0,20000,Scotty McGee,KR,dead_cap,jacksonville-jaguars,20000,2011
18699,5000,0,JoJo Dickson,ILB,dead_cap,jacksonville-jaguars,5000,2011
18700,0,3333,Armon Binns,WR,dead_cap,jacksonville-jaguars,3333,2011
18701,1666,0,Tommy Gallarda,TE,dead_cap,jacksonville-jaguars,1666,2011
18702,4200000,4550000,Marcedes Lewis,TE,active,jacksonville-jaguars,8750000,2012
18703,2950000,4050000,Paul Posluszny,OLB,active,jacksonville-jaguars,7000000,2012
18704,5575000,175000,Jason Babin,DE,active,jacksonville-jaguars,5750000,2012
18705,4700000,800000,Daryl Smith,ILB,active,jacksonville-jaguars,5500000,2012
18706,3110000,3309000,Eugene Monroe,LT,active,jacksonville-jaguars,6419000,2012
18707,950000,3898000,Rashean Mathis,CB,active,jacksonville-jaguars,4848000,2012
18708,1850000,2850000,Dawan Landry,S,active,jacksonville-jaguars,4700000,2012
18709,2775000,1094500,Uche Nwaneri,G,active,jacksonville-jaguars,3869500,2012
18710,3200000,600000,Greg Jones,FB,active,jacksonville-jaguars,3800000,2012
18711,390000,2975818,Justin Blackmon,WR,active,jacksonville-jaguars,3365818,2012
18712,2950000,300000,Brad Meester,C,active,jacksonville-jaguars,3250000,2012
18713,1000000,2037500,Montell Owens,FB,active,jacksonville-jaguars,3037500,2012
18714,1000000,2000000,Jeremy Mincey,DE,active,jacksonville-jaguars,3000000,2012
18715,1212500,2940000,Tyson Alualu,DE,active,jacksonville-jaguars,4152500,2012
18716,920529,1807118,Blaine Gabbert,QB,active,jacksonville-jaguars,2727647,2012
18717,1000000,1700000,Laurent Robinson,WR,active,jacksonville-jaguars,2700000,2012
18718,1075000,1525000,Chad Henne,QB,active,jacksonville-jaguars,2600000,2012
18719,1000000,937500,Josh Scobee,K,active,jacksonville-jaguars,1937500,2012
18720,1325000,441667,Russell Allen,OLB,active,jacksonville-jaguars,1766667,2012
18721,1000000,750000,Dwight Lowery,FS,active,jacksonville-jaguars,1750000,2012
18722,950000,583333,Aaron Ross,CB,active,jacksonville-jaguars,1533333,2012
18723,1260000,210964,Terrance Knighton,DT,active,jacksonville-jaguars,1470964,2012
18724,1260000,208250,Derek Cox,CB,active,jacksonville-jaguars,1468250,2012
18725,975000,333333,C.J. Mosley,DT,active,jacksonville-jaguars,1308333,2012
18726,758800,475000,Eben Britton,RT,active,jacksonville-jaguars,1233800,2012
18727,700000,525000,Guy Whimper,G,active,jacksonville-jaguars,1225000,2012
18728,542647,0,Quan Cosby,WR,active,jacksonville-jaguars,542647,2012
18729,850000,183333,Jeremy Cain,LS,active,jacksonville-jaguars,1033333,2012
18730,390000,535442,Andre Branch,DE,active,jacksonville-jaguars,925442,2012
18731,490000,212500,D'Anthony Smith,DT,active,jacksonville-jaguars,702500,2012
18732,507467,154868,Will Rackley,G,active,jacksonville-jaguars,662335,2012
18733,825000,0,Chris Harris,S,active,jacksonville-jaguars,825000,2012
18734,615000,0,Jordan Palmer,QB,active,jacksonville-jaguars,615000,2012
18735,615000,0,Isaiah Stanback,TE,active,jacksonville-jaguars,615000,2012
18736,496461,110845,Cecil Shorts,WR,active,jacksonville-jaguars,607306,2012
18737,495006,105027,Chris Prosinski,SS,active,jacksonville-jaguars,600033,2012
18738,540000,46049,Austen Lane,DE,active,jacksonville-jaguars,586049,2012
18739,565000,9612,Rashad Jennings,RB,active,jacksonville-jaguars,574612,2012
18740,390000,165625,Bryan Anger,P,active,jacksonville-jaguars,555625,2012
18741,700000,0,Maurice Stovall,WR,active,jacksonville-jaguars,700000,2012
18742,540000,0,Zach Potter,TE,active,jacksonville-jaguars,540000,2012
18743,540000,0,Taylor Price,WR,active,jacksonville-jaguars,540000,2012
18744,540000,0,George Selvie,DE,active,jacksonville-jaguars,540000,2012
18745,480000,0,Greg Jones,ILB,active,jacksonville-jaguars,480000,2012
18746,465000,4167,Kyle Bosworth,OLB,active,jacksonville-jaguars,469167,2012
18747,465000,1666,Cameron Bradfield,RT,active,jacksonville-jaguars,466666,2012
18748,465000,0,John Chick,DT,active,jacksonville-jaguars,465000,2012
18749,465000,0,Keith Toston,RB,active,jacksonville-jaguars,465000,2012
18750,465000,0,Bradley Vierling,C,active,jacksonville-jaguars,465000,2012
18751,390000,28947,Mike Harris,CB,active,jacksonville-jaguars,418947,2012
18752,390000,12721,Jeris Pendleton,DT,active,jacksonville-jaguars,402721,2012
18753,390000,1666,Julian Stanford,OLB,active,jacksonville-jaguars,391666,2012
18754,390000,1666,Matt Veldman,TE,active,jacksonville-jaguars,391666,2012
18755,390000,0,Mike Brown,WR,active,jacksonville-jaguars,390000,2012
18756,390000,0,Johnathan Grimes,RB,active,jacksonville-jaguars,390000,2012
18757,390000,0,Jerrell Jackson,WR,active,jacksonville-jaguars,390000,2012
18758,390000,0,Jerome Long,DE,active,jacksonville-jaguars,390000,2012
18759,390000,0,Brandon Marshall,ILB,active,jacksonville-jaguars,390000,2012
18760,390000,0,Richard Murphy,RB,active,jacksonville-jaguars,390000,2012
18761,390000,0,Kevin Elliott,WR,active,jacksonville-jaguars,390000,2012
18762,540000,0,Anthony Armstrong,WR,active,jacksonville-jaguars,540000,2012
18763,700000,0,Steve Vallos,C,active,jacksonville-jaguars,700000,2012
18764,465000,0,Kevin Rutland,CB,active,jacksonville-jaguars,465000,2012
18765,465000,0,Keith Toston,RB,active,jacksonville-jaguars,465000,2012
18766,465000,0,Jordan Shipley,WR,active,jacksonville-jaguars,465000,2012
18767,141176,0,Jordan Todman,RB,active,jacksonville-jaguars,141176,2012
18768,700000,0,Antwaun Molden,CB,active,jacksonville-jaguars,700000,2012
18769,390000,0,Toney Clemons,WR,active,jacksonville-jaguars,390000,2012
18770,390000,0,Will Ta'ufo'ou,FB,active,jacksonville-jaguars,390000,2012
18771,390000,0,Austin Pasztor,T,active,jacksonville-jaguars,390000,2012
18772,4450000,1850000,Maurice Jones-Drew,RB,injured_reserve,jacksonville-jaguars,6300000,2012
18773,1500000,250000,Jason Spitz,G,injured_reserve,jacksonville-jaguars,1750000,2012
18774,1260000,0,William Middleton,CB,injured_reserve,jacksonville-jaguars,1260000,2012
18775,615000,0,Brock Bolen,RB,injured_reserve,jacksonville-jaguars,615000,2012
18776,615000,0,Jalen Parmele,RB,injured_reserve,jacksonville-jaguars,615000,2012
18777,465000,5000,John Estes,C,injured_reserve,jacksonville-jaguars,470000,2012
18778,390000,3333,Mike Brewster,C,injured_reserve,jacksonville-jaguars,393333,2012
18779,390000,0,Drew Nowak,C,injured_reserve,jacksonville-jaguars,390000,2012
18780,22941,0,Brett Brackett,TE,injured_reserve,jacksonville-jaguars,22941,2012
18781,170625,0,Ryan Davis,DE,practice_squad,jacksonville-jaguars,170625,2012
18782,0,6040000,Derrick Harvey,DE,dead_cap,jacksonville-jaguars,6040000,2012
18783,2500000,0,Aaron Kampman,DE,dead_cap,jacksonville-jaguars,2500000,2012
18784,2100000,0,Drew Coleman,CB,dead_cap,jacksonville-jaguars,2100000,2012
18785,733333,0,Kassim Osgood,WR,dead_cap,jacksonville-jaguars,733333,2012
18786,626862,0,Mike Thomas,WR,dead_cap,jacksonville-jaguars,626862,2012
18787,0,250000,Lee Evans,WR,dead_cap,jacksonville-jaguars,250000,2012
18788,237458,0,Brandon Marshall,ILB,dead_cap,jacksonville-jaguars,237458,2012
18789,176041,0,Kevin Rutland,CB,dead_cap,jacksonville-jaguars,176041,2012
18790,102000,0,John Parker Wilson,QB,dead_cap,jacksonville-jaguars,102000,2012
18791,0,96400,Larry Hart,LB,dead_cap,jacksonville-jaguars,96400,2012
18792,65000,0,Nick Harris,P,dead_cap,jacksonville-jaguars,65000,2012
18793,50000,0,Brian Robiskie,WR,dead_cap,jacksonville-jaguars,50000,2012
18794,48075,0,Jarett Dillard,WR,dead_cap,jacksonville-jaguars,48075,2012
18795,0,47490,Roderick Issac,CB,dead_cap,jacksonville-jaguars,47490,2012
18796,0,40000,Scotty McGee,KR,dead_cap,jacksonville-jaguars,40000,2012
18797,27625,0,Zach Miller,TE,dead_cap,jacksonville-jaguars,27625,2012
18798,0,27500,Deji Karim,RB,dead_cap,jacksonville-jaguars,27500,2012
18799,0,6667,Armon Binns,WR,dead_cap,jacksonville-jaguars,6667,2012
18800,5833,0,Kevin Haslam,T,dead_cap,jacksonville-jaguars,5833,2012
18801,3334,0,Tommy Gallarda,TE,dead_cap,jacksonville-jaguars,3334,2012
18802,667,0,Aaron Morgan,DE,dead_cap,jacksonville-jaguars,667,2012
18803,6450000,2050000,Paul Posluszny,OLB,active,jacksonville-jaguars,8500000,2013
18804,4950000,1850000,Maurice Jones-Drew,RB,active,jacksonville-jaguars,6800000,2013
18805,3775000,1094500,Uche Nwaneri,G,active,jacksonville-jaguars,4869500,2013
18806,4200000,1550000,Marcedes Lewis,TE,active,jacksonville-jaguars,5750000,2013
18807,2625000,2025000,Chad Henne,QB,active,jacksonville-jaguars,4650000,2013
18808,4225000,100000,Jason Babin,DE,active,jacksonville-jaguars,4325000,2013
18809,405000,3449836,Luke Joeckel,G,active,jacksonville-jaguars,3854836,2013
18810,1922500,2940000,Tyson Alualu,DE,active,jacksonville-jaguars,4862500,2013
18811,2325000,962500,Josh Scobee,K,active,jacksonville-jaguars,3287500,2013
18812,1466058,1807118,Blaine Gabbert,QB,active,jacksonville-jaguars,3273176,2013
18813,1475000,275000,Roy Miller,DT,active,jacksonville-jaguars,1750000,2013
18814,1275000,225000,Sen'Derrick Marks,DT,active,jacksonville-jaguars,1500000,2013
18815,1075000,425000,Brad Meester,C,active,jacksonville-jaguars,1500000,2013
18816,621361,535442,Andre Branch,DE,active,jacksonville-jaguars,1156803,2013
18817,900000,150000,Justin Forsett,RB,active,jacksonville-jaguars,1050000,2013
18818,405000,589382,John Cyprien,SS,active,jacksonville-jaguars,994382,2013
18819,850000,87500,Geno Hayes,OLB,active,jacksonville-jaguars,937500,2013
18820,639934,154868,Will Rackley,G,active,jacksonville-jaguars,794802,2013
18821,715000,50000,Alan Ball,CB,active,jacksonville-jaguars,765000,2013
18822,617922,110845,Cecil Shorts,WR,active,jacksonville-jaguars,728767,2013
18823,615012,105027,Chris Prosinski,SS,active,jacksonville-jaguars,720039,2013
18824,509913,165625,Bryan Anger,P,active,jacksonville-jaguars,675538,2013
18825,630000,0,Brandon Deaderick,DT,active,jacksonville-jaguars,630000,2013
18826,630000,0,Clay Harbor,TE,active,jacksonville-jaguars,630000,2013
18827,405000,174394,Dwayne Gratz,CB,active,jacksonville-jaguars,579394,2013
18828,575000,0,Taylor Price,WR,active,jacksonville-jaguars,575000,2013
18829,555000,1668,Cameron Bradfield,RT,active,jacksonville-jaguars,556668,2013
18830,715000,0,Will Blackmon,CB,active,jacksonville-jaguars,715000,2013
18831,555000,0,Stephen Burton,WR,active,jacksonville-jaguars,555000,2013
18832,555000,0,Allen Reisner,TE,active,jacksonville-jaguars,555000,2013
18833,555000,0,Jordan Todman,RB,active,jacksonville-jaguars,555000,2013
18834,405000,113282,Ace  Sanders,WR,active,jacksonville-jaguars,518282,2013
18835,480000,28947,Mike Harris,CB,active,jacksonville-jaguars,508947,2013
18836,480000,0,Winston Guy,FS,active,jacksonville-jaguars,480000,2013
18837,480000,0,Austin Pasztor,T,active,jacksonville-jaguars,480000,2013
18838,480000,0,Will Ta'ufo'ou,FB,active,jacksonville-jaguars,480000,2013
18839,480000,0,J.T. Thomas,OLB,active,jacksonville-jaguars,480000,2013
18840,405000,53403,Denard Robinson,RB,active,jacksonville-jaguars,458403,2013
18841,405000,32205,Josh Evans,SS,active,jacksonville-jaguars,437205,2013
18842,495000,0,Jamell Fleming,S,active,jacksonville-jaguars,495000,2013
18843,555000,0,Ricky Stanzi,QB,active,jacksonville-jaguars,555000,2013
18844,405000,16741,Demetrius McCray,CB,active,jacksonville-jaguars,421741,2013
18845,405000,833,Abry Jones,DT,active,jacksonville-jaguars,405833,2013
18846,405000,833,LaRoy Reynolds,ILB,active,jacksonville-jaguars,405833,2013
18847,405000,833,Carson Tinker,LS,active,jacksonville-jaguars,405833,2013
18848,405000,0,Mike Brown,WR,active,jacksonville-jaguars,405000,2013
18849,555000,0,Jacques McClendon,C,active,jacksonville-jaguars,555000,2013
18850,405000,0,John Lotulelei,OLB,active,jacksonville-jaguars,405000,2013
18851,480000,0,Danny Noble,TE,active,jacksonville-jaguars,480000,2013
18852,405000,0,Nathan Stupar,OLB,active,jacksonville-jaguars,405000,2013
18853,405000,0,Kerry Taylor,WR,active,jacksonville-jaguars,405000,2013
18854,405000,0,Ryan Davis,DE,active,jacksonville-jaguars,405000,2013
18855,405000,0,Jeremy Ebert,WR,active,jacksonville-jaguars,405000,2013
18856,555000,0,Delone Carter,RB,active,jacksonville-jaguars,555000,2013
18857,480000,0,Jordan Miller,DT,active,jacksonville-jaguars,480000,2013
18858,405000,0,Patrick Lewis,C,active,jacksonville-jaguars,405000,2013
18859,405000,0,Drew Nowak,C,active,jacksonville-jaguars,405000,2013
18860,405000,0,Gerald Rivers,DE,active,jacksonville-jaguars,405000,2013
18861,405000,0,Lamaar Thomas,WR,active,jacksonville-jaguars,405000,2013
18862,630000,0,Kyle Love,DT,active,jacksonville-jaguars,630000,2013
18863,555000,0,Drake Nevis,DE,active,jacksonville-jaguars,555000,2013
18864,1375000,1441667,Russell Allen,OLB,injured_reserve,jacksonville-jaguars,2816667,2013
18865,480000,3333,Mike Brewster,C,injured_reserve,jacksonville-jaguars,483333,2013
18866,555000,0,Stephen Williams,WR,injured_reserve,jacksonville-jaguars,555000,2013
18867,288000,17225,Jeremy Harris,CB,injured_reserve,jacksonville-jaguars,305225,2013
18868,288000,1000,Stephane Milhim,G,injured_reserve,jacksonville-jaguars,289000,2013
18869,137296,0,Jeremy Ebert,WR,practice_squad,jacksonville-jaguars,137296,2013
18870,130588,0,Ricky Stanzi,QB,practice_squad,jacksonville-jaguars,130588,2013
18871,118941,0,DeMarcus Love,LT,practice_squad,jacksonville-jaguars,118941,2013
18872,100000,0,Kyle Love,DT,practice_squad,jacksonville-jaguars,100000,2013
18873,90000,0,Drew Nowak,C,practice_squad,jacksonville-jaguars,90000,2013
18874,66000,0,Jordan Miller,DT,practice_squad,jacksonville-jaguars,66000,2013
18875,66000,0,Lonnie Pryor,RB,practice_squad,jacksonville-jaguars,66000,2013
18876,24000,0,Danny Noble,TE,practice_squad,jacksonville-jaguars,24000,2013
18877,2600000,6400000,Laurent Robinson,WR,dead_cap,jacksonville-jaguars,9000000,2013
18878,3900000,0,Dawan Landry,S,dead_cap,jacksonville-jaguars,3900000,2013
18879,3875000,0,Dwight Lowery,FS,dead_cap,jacksonville-jaguars,3875000,2013
18880,2500000,1200000,Clint Session,LB,dead_cap,jacksonville-jaguars,3700000,2013
18881,3550000,0,Jeremy Mincey,DE,dead_cap,jacksonville-jaguars,3550000,2013
18882,894117,3104000,Eugene Monroe,LT,dead_cap,jacksonville-jaguars,3998117,2013
18883,2500000,0,Aaron Kampman,DE,dead_cap,jacksonville-jaguars,2500000,2013
18884,1500000,0,Mike Thomas,WR,dead_cap,jacksonville-jaguars,1500000,2013
18885,900000,0,Montell Owens,FB,dead_cap,jacksonville-jaguars,900000,2013
18886,666667,0,C.J. Mosley,DT,dead_cap,jacksonville-jaguars,666667,2013
18887,666667,0,Aaron Ross,CB,dead_cap,jacksonville-jaguars,666667,2013
18888,500000,0,Guy Whimper,G,dead_cap,jacksonville-jaguars,500000,2013
18889,293824,0,D.J. Williams,TE,dead_cap,jacksonville-jaguars,293824,2013
18890,250000,0,Jason Spitz,G,dead_cap,jacksonville-jaguars,250000,2013
18891,212500,0,D'Anthony Smith,DT,dead_cap,jacksonville-jaguars,212500,2013
18892,183334,0,Jeremy Cain,LS,dead_cap,jacksonville-jaguars,183334,2013
18893,163235,0,Jacques McClendon,C,dead_cap,jacksonville-jaguars,163235,2013
18894,150375,0,Brandon Marshall,ILB,dead_cap,jacksonville-jaguars,150375,2013
18895,119118,0,Kyle Knox,OLB,dead_cap,jacksonville-jaguars,119118,2013
18896,0,95850,Roderick Issac,CB,dead_cap,jacksonville-jaguars,95850,2013
18897,66000,0,Lamaar Thomas,WR,dead_cap,jacksonville-jaguars,66000,2013
18898,0,65000,Marcus Trufant,CB,dead_cap,jacksonville-jaguars,65000,2013
18899,59647,0,Chris McCoy,OLB,dead_cap,jacksonville-jaguars,59647,2013
18900,57500,0,Mohamed Massaquoi,WR,dead_cap,jacksonville-jaguars,57500,2013
18901,57500,0,Jordan Shipley,WR,dead_cap,jacksonville-jaguars,57500,2013
18902,48490,0,Tobais Palmer,WR,dead_cap,jacksonville-jaguars,48490,2013
18903,46049,0,Austen Lane,DE,dead_cap,jacksonville-jaguars,46049,2013
18904,42490,0,Marcus Burley,CB,dead_cap,jacksonville-jaguars,42490,2013
18905,38544,0,Jeris Pendleton,DT,dead_cap,jacksonville-jaguars,38544,2013
18906,0,27500,Deji Karim,RB,dead_cap,jacksonville-jaguars,27500,2013
18907,12833,0,Steven Terrell,CB,dead_cap,jacksonville-jaguars,12833,2013
18908,2500,0,Antwon Blake,CB,dead_cap,jacksonville-jaguars,2500,2013
18909,1668,0,Kevin Rutland,CB,dead_cap,jacksonville-jaguars,1668,2013
18910,1666,0,Drew Nowak,C,dead_cap,jacksonville-jaguars,1666,2013
18911,1666,0,Julian Stanford,OLB,dead_cap,jacksonville-jaguars,1666,2013
18912,1666,0,Matt Veldman,TE,dead_cap,jacksonville-jaguars,1666,2013
18913,1166,0,Jeremiah Green,OLB,dead_cap,jacksonville-jaguars,1166,2013
18914,0,1000,Stephane Milhim,G,dead_cap,jacksonville-jaguars,1000,2013
18915,1000,0,Maalik Bomar,OLB,dead_cap,jacksonville-jaguars,1000,2013
18916,833,0,T.J. Barnes,DT,dead_cap,jacksonville-jaguars,833,2013
18917,833,0,R.J. Dill,RT,dead_cap,jacksonville-jaguars,833,2013
18918,833,0,Paul Hazel,DE,dead_cap,jacksonville-jaguars,833,2013
18919,833,0,Ryan Otten,TE,dead_cap,jacksonville-jaguars,833,2013
18920,833,0,Lonnie Pryor,RB,dead_cap,jacksonville-jaguars,833,2013
18921,833,0,Kyler Reed,TE,dead_cap,jacksonville-jaguars,833,2013
18922,833,0,Jordan Rodgers,QB,dead_cap,jacksonville-jaguars,833,2013
18923,833,0,Matt Scott,QB,dead_cap,jacksonville-jaguars,833,2013
18924,833,0,Roderick Tomlin,FB,dead_cap,jacksonville-jaguars,833,2013
18925,833,0,Michael Zimmer,ILB,dead_cap,jacksonville-jaguars,833,2013
18926,666,0,Jamal Miles,WR,dead_cap,jacksonville-jaguars,666,2013
18927,666,0,Trey Wilson,CB,dead_cap,jacksonville-jaguars,666,2013
18928,7450000,2050000,Paul Posluszny,OLB,active,jacksonville-jaguars,9500000,2014
18929,6700000,1550000,Marcedes Lewis,TE,active,jacksonville-jaguars,8250000,2014
18930,2975000,4525000,Zane Beadles,G,active,jacksonville-jaguars,7500000,2014
18931,1500000,4250000,Chad Henne,QB,active,jacksonville-jaguars,5750000,2014
18932,1225000,4243750,Red Bryant,DE,active,jacksonville-jaguars,5468750,2014
18933,1475000,3743750,Chris Clemons,DE,active,jacksonville-jaguars,5218750,2014
18934,1368709,3449836,Luke Joeckel,G,active,jacksonville-jaguars,4818545,2014
18935,2571500,2940000,Tyson Alualu,DE,active,jacksonville-jaguars,5511500,2014
18936,3000000,1225000,Sen'Derrick Marks,DT,active,jacksonville-jaguars,4225000,2014
18937,3225000,962500,Josh Scobee,K,active,jacksonville-jaguars,4187500,2014
18938,2000000,2025000,Evander Hood,DE,active,jacksonville-jaguars,4025000,2014
18939,1000000,3000000,Toby Gerhart,RB,active,jacksonville-jaguars,4000000,2014
18940,420000,3335420,Blake Bortles,QB,active,jacksonville-jaguars,3755420,2014
18941,2625000,375000,Roy Miller,DT,active,jacksonville-jaguars,3000000,2014
18942,975000,737500,Geno Hayes,OLB,active,jacksonville-jaguars,1712500,2014
18943,1431000,110845,Cecil Shorts,WR,active,jacksonville-jaguars,1541845,2014
18944,1350000,150000,Clay Harbor,TE,active,jacksonville-jaguars,1500000,2014
18945,827722,560442,Andre Branch,DE,active,jacksonville-jaguars,1388164,2014
18946,1255000,50000,Alan Ball,CB,active,jacksonville-jaguars,1305000,2014
18947,653596,589382,John Cyprien,SS,active,jacksonville-jaguars,1242978,2014
18948,855000,325000,Will Blackmon,CB,active,jacksonville-jaguars,1180000,2014
18949,420000,520731,Marqise Lee,WR,active,jacksonville-jaguars,940731,2014
18950,730000,50000,Sam Young,LT,active,jacksonville-jaguars,780000,2014
18951,584898,185625,Bryan Anger,P,active,jacksonville-jaguars,770523,2014
18952,533000,174394,Dwayne Gratz,CB,active,jacksonville-jaguars,707394,2014
18953,645000,57500,Tandon Doss,WR,active,jacksonville-jaguars,702500,2014
18954,645000,0,Jacques McClendon,C,active,jacksonville-jaguars,645000,2014
18955,645000,0,J.T. Thomas,OLB,active,jacksonville-jaguars,645000,2014
18956,645000,0,Jordan Todman,RB,active,jacksonville-jaguars,645000,2014
18957,420000,218340,Allen Robinson,WR,active,jacksonville-jaguars,638340,2014
18958,570000,0,Austin Pasztor,T,active,jacksonville-jaguars,570000,2014
18959,570000,0,Will Ta'ufo'ou,FB,active,jacksonville-jaguars,570000,2014
18960,420000,133400,Brandon Linder,C,active,jacksonville-jaguars,553400,2014
18961,495000,53403,Denard Robinson,RB,active,jacksonville-jaguars,548403,2014
18962,495000,32205,Josh Evans,SS,active,jacksonville-jaguars,527205,2014
18963,495000,16741,Demetrius McCray,CB,active,jacksonville-jaguars,511741,2014
18964,495000,833,Abry Jones,DT,active,jacksonville-jaguars,495833,2014
18965,495000,833,LaRoy Reynolds,ILB,active,jacksonville-jaguars,495833,2014
18966,495000,833,Carson Tinker,LS,active,jacksonville-jaguars,495833,2014
18967,495000,0,Ryan Davis,DE,active,jacksonville-jaguars,495000,2014
18968,378529,113282,Ace  Sanders,WR,active,jacksonville-jaguars,491811,2014
18969,420000,52763,Telvin Smith,OLB,active,jacksonville-jaguars,472763,2014
18970,601176,0,Sherrod Martin,SS,active,jacksonville-jaguars,601176,2014
18971,420000,113288,Aaron Colvin,CB,active,jacksonville-jaguars,533288,2014
18972,420000,23513,Luke Bowanko,C,active,jacksonville-jaguars,443513,2014
18973,420000,17225,Jeremy Harris,CB,active,jacksonville-jaguars,437225,2014
18974,420000,15682,Storm Johnson,RB,active,jacksonville-jaguars,435682,2014
18975,420000,1666,Allen Hurns,WR,active,jacksonville-jaguars,421666,2014
18976,420000,1666,Tyler Shatley,G,active,jacksonville-jaguars,421666,2014
18977,420000,1000,Josh Wells,RT,active,jacksonville-jaguars,421000,2014
18978,420000,0,Jeremiah George,ILB,active,jacksonville-jaguars,420000,2014
18979,420000,0,Nic Jacobs,TE,active,jacksonville-jaguars,420000,2014
18980,341470,0,Tommie Campbell,CB,active,jacksonville-jaguars,341470,2014
18981,333000,0,Fendi Onobun,TE,active,jacksonville-jaguars,333000,2014
18982,420000,0,Craig Loston,SS,active,jacksonville-jaguars,420000,2014
18983,318000,0,John Lotulelei,OLB,active,jacksonville-jaguars,318000,2014
18984,303000,1666,Rashaad Reynolds,CB,active,jacksonville-jaguars,304666,2014
18985,420000,0,Chris Smith,DE,active,jacksonville-jaguars,420000,2014
18986,570000,0,Teddy Williams,CB,active,jacksonville-jaguars,570000,2014
18987,183882,0,Khairi Fortt,OLB,active,jacksonville-jaguars,183882,2014
18988,420000,0,Tommy Streeter,WR,active,jacksonville-jaguars,420000,2014
18989,495000,0,A.J. Edds,OLB,active,jacksonville-jaguars,495000,2014
18990,495000,0,Matt Daniels,FS,active,jacksonville-jaguars,495000,2014
18991,420000,0,Stephen Morris,QB,active,jacksonville-jaguars,420000,2014
18992,570000,0,Bradie Ewing,FB,injured_reserve,jacksonville-jaguars,570000,2014
18993,303000,1666,Damian Copeland,WR,injured_reserve,jacksonville-jaguars,304666,2014
18994,107100,0,Tony Washington,WR,practice_squad,jacksonville-jaguars,107100,2014
18995,94500,0,Cody Booth,TE,practice_squad,jacksonville-jaguars,94500,2014
18996,88200,0,Marcel Jensen,TE,practice_squad,jacksonville-jaguars,88200,2014
18997,88200,0,Eric Kettani,FB,practice_squad,jacksonville-jaguars,88200,2014
18998,75600,0,Mickey Shuler,TE,practice_squad,jacksonville-jaguars,75600,2014
18999,44100,0,Peyton Thompson,SS,practice_squad,jacksonville-jaguars,44100,2014
19000,25200,0,Mike Brown,WR,practice_squad,jacksonville-jaguars,25200,2014
19001,4000000,0,Jeremy Mincey,DE,dead_cap,jacksonville-jaguars,4000000,2014
19002,0,3600000,Clint Session,LB,dead_cap,jacksonville-jaguars,3600000,2014
19003,1000000,1500000,Dekoda Watson,OLB,dead_cap,jacksonville-jaguars,2500000,2014
19004,2189000,0,Uche Nwaneri,G,dead_cap,jacksonville-jaguars,2189000,2014
19005,1807118,0,Blaine Gabbert,QB,dead_cap,jacksonville-jaguars,1807118,2014
19006,1500000,0,Dwight Lowery,FS,dead_cap,jacksonville-jaguars,1500000,2014
19007,0,2759000,Eugene Monroe,LT,dead_cap,jacksonville-jaguars,2759000,2014
19008,1225000,25000,Cameron Bradfield,RT,dead_cap,jacksonville-jaguars,1250000,2014
19009,500000,0,Jason Babin,DE,dead_cap,jacksonville-jaguars,500000,2014
19010,416667,0,Russell Allen,OLB,dead_cap,jacksonville-jaguars,416667,2014
19011,378529,0,Mike Brown,WR,dead_cap,jacksonville-jaguars,378529,2014
19012,172945,105027,Chris Prosinski,SS,dead_cap,jacksonville-jaguars,277972,2014
19013,154868,0,Will Rackley,G,dead_cap,jacksonville-jaguars,154868,2014
19014,100000,50000,Sherrod Martin,SS,dead_cap,jacksonville-jaguars,150000,2014
19015,145588,0,Mickey Shuler,TE,dead_cap,jacksonville-jaguars,145588,2014
19016,134118,0,Winston Guy,FS,dead_cap,jacksonville-jaguars,134118,2014
19017,80912,46813,Chris Smith,DE,dead_cap,jacksonville-jaguars,127725,2014
19018,124500,1666,Stephen Morris,QB,dead_cap,jacksonville-jaguars,126166,2014
19019,118218,0,Peyton Thompson,SS,dead_cap,jacksonville-jaguars,118218,2014
19020,100800,0,Henry Josey,RB,dead_cap,jacksonville-jaguars,100800,2014
19021,100000,0,Justin Forsett,RB,dead_cap,jacksonville-jaguars,100000,2014
19022,87353,0,Tavarres King,WR,dead_cap,jacksonville-jaguars,87353,2014
19023,71000,1333,Marcus Whitfield,OLB,dead_cap,jacksonville-jaguars,72333,2014
19024,71294,0,Deion Belue,CB,dead_cap,jacksonville-jaguars,71294,2014
19025,68511,1167,Craig Loston,SS,dead_cap,jacksonville-jaguars,69678,2014
19026,54318,0,Kerry Taylor,WR,dead_cap,jacksonville-jaguars,54318,2014
19027,50400,0,Tommy Streeter,WR,dead_cap,jacksonville-jaguars,50400,2014
19028,47706,1666,Marcel Jensen,TE,dead_cap,jacksonville-jaguars,49372,2014
19029,44100,0,Matt Daniels,FS,dead_cap,jacksonville-jaguars,44100,2014
19030,32500,0,Mohamed Massaquoi,WR,dead_cap,jacksonville-jaguars,32500,2014
19031,32500,0,Jordan Shipley,WR,dead_cap,jacksonville-jaguars,32500,2014
19032,31500,0,Mike Flacco,TE,dead_cap,jacksonville-jaguars,31500,2014
19033,31500,0,Jackson Jeffcoat,OLB,dead_cap,jacksonville-jaguars,31500,2014
19034,0,28947,Mike Harris,CB,dead_cap,jacksonville-jaguars,28947,2014
19035,26400,1666,DeAndre Coleman,DT,dead_cap,jacksonville-jaguars,28066,2014
19036,18900,0,Michael Egnew,TE,dead_cap,jacksonville-jaguars,18900,2014
19037,18900,0,Louis Young,CB,dead_cap,jacksonville-jaguars,18900,2014
19038,0,15000,DeMarcus Love,LT,dead_cap,jacksonville-jaguars,15000,2014
19039,0,12000,Ricky Stanzi,QB,dead_cap,jacksonville-jaguars,12000,2014
19040,10000,833,Ricky Havili-Heimuli,DT,dead_cap,jacksonville-jaguars,10833,2014
19041,6300,0,Cody Booth,TE,dead_cap,jacksonville-jaguars,6300,2014
19042,0,3334,Mike Brewster,C,dead_cap,jacksonville-jaguars,3334,2014
19043,2500,0,Antwon Blake,CB,dead_cap,jacksonville-jaguars,2500,2014
19044,2334,0,Jeremiah Green,OLB,dead_cap,jacksonville-jaguars,2334,2014
19045,0,2000,Stephane Milhim,G,dead_cap,jacksonville-jaguars,2000,2014
19046,2000,0,Maalik Bomar,OLB,dead_cap,jacksonville-jaguars,2000,2014
19047,1668,0,Drew Nowak,C,dead_cap,jacksonville-jaguars,1668,2014
19048,1668,0,Julian Stanford,OLB,dead_cap,jacksonville-jaguars,1668,2014
19049,1668,0,Matt Veldman,TE,dead_cap,jacksonville-jaguars,1668,2014
19050,1667,0,T.J. Barnes,DT,dead_cap,jacksonville-jaguars,1667,2014
19051,1667,0,R.J. Dill,RT,dead_cap,jacksonville-jaguars,1667,2014
19052,1667,0,Paul Hazel,DE,dead_cap,jacksonville-jaguars,1667,2014
19053,1667,0,Ryan Otten,TE,dead_cap,jacksonville-jaguars,1667,2014
19054,1667,0,Lonnie Pryor,RB,dead_cap,jacksonville-jaguars,1667,2014
19055,1667,0,Kyler Reed,TE,dead_cap,jacksonville-jaguars,1667,2014
19056,1667,0,Jordan Rodgers,QB,dead_cap,jacksonville-jaguars,1667,2014
19057,1667,0,Matt Scott,QB,dead_cap,jacksonville-jaguars,1667,2014
19058,1667,0,Steven Terrell,CB,dead_cap,jacksonville-jaguars,1667,2014
19059,1667,0,Roderick Tomlin,FB,dead_cap,jacksonville-jaguars,1667,2014
19060,1667,0,Michael Zimmer,ILB,dead_cap,jacksonville-jaguars,1667,2014
19061,1334,0,Marcus Burley,CB,dead_cap,jacksonville-jaguars,1334,2014
19062,1334,0,Jamal Miles,WR,dead_cap,jacksonville-jaguars,1334,2014
19063,1334,0,Tobais Palmer,WR,dead_cap,jacksonville-jaguars,1334,2014
19064,1334,0,Trey Wilson,CB,dead_cap,jacksonville-jaguars,1334,2014
19065,0,1166,Terreance Cobb,RB,dead_cap,jacksonville-jaguars,1166,2014
19066,0,1000,D.J. Tialavea,TE,dead_cap,jacksonville-jaguars,1000,2014
19067,0,833,Reggie Jordan,TE,dead_cap,jacksonville-jaguars,833,2014
19068,9000000,1300000,Julius Thomas,TE,active,jacksonville-jaguars,10300000,2015
19069,4000000,5000000,Jared Odrick,DE,active,jacksonville-jaguars,9000000,2015
19070,3000000,5000000,Jermey Parnell,RT,active,jacksonville-jaguars,8000000,2015
19071,3950000,2935416,Paul Posluszny,OLB,active,jacksonville-jaguars,6885416,2015
19072,4500000,2000000,Davon House,CB,active,jacksonville-jaguars,6500000,2015
19073,2332418,3449836,Luke Joeckel,G,active,jacksonville-jaguars,5782254,2015
19074,2975000,2025000,Zane Beadles,G,active,jacksonville-jaguars,5000000,2015
19075,2975000,2025000,Chris Clemons,DE,active,jacksonville-jaguars,5000000,2015
19076,1358855,3335420,Blake Bortles,QB,active,jacksonville-jaguars,4694275,2015
19077,2600000,2000000,Dan Skuta,OLB,active,jacksonville-jaguars,4600000,2015
19078,435000,3835955,Dante Fowler Jr.,DE,active,jacksonville-jaguars,4270955,2015
19079,2725000,1125000,Roy Miller,DT,active,jacksonville-jaguars,3850000,2015
19080,2000000,1850000,Marcedes Lewis,TE,active,jacksonville-jaguars,3850000,2015
19081,3500000,0,Chad Henne,QB,active,jacksonville-jaguars,3500000,2015
19082,1750000,1250000,Tyson Alualu,DE,active,jacksonville-jaguars,3000000,2015
19083,1750000,750000,Sergio Brown,FS,active,jacksonville-jaguars,2500000,2015
19084,1250000,1250000,Stefen Wisniewski,C,active,jacksonville-jaguars,2500000,2015
19085,1059083,560442,Andre Branch,DE,active,jacksonville-jaguars,1619525,2015
19086,1500000,0,Clay Harbor,TE,active,jacksonville-jaguars,1500000,2015
19087,902192,589382,John Cyprien,SS,active,jacksonville-jaguars,1491574,2015
19088,655183,520731,Marqise Lee,WR,active,jacksonville-jaguars,1175914,2015
19089,435000,640231,T.J. Yeldon,RB,active,jacksonville-jaguars,1075231,2015
19090,689855,185625,Bryan Anger,P,active,jacksonville-jaguars,875480,2015
19091,675000,174394,Dwayne Gratz,CB,active,jacksonville-jaguars,849394,2015
19092,579585,218340,Allen Robinson,WR,active,jacksonville-jaguars,797925,2015
19093,745000,50000,Sam Young,LT,active,jacksonville-jaguars,795000,2015
19094,522000,133400,Brandon Linder,C,active,jacksonville-jaguars,655400,2015
19095,585000,53403,Denard Robinson,RB,active,jacksonville-jaguars,638403,2015
19096,435000,200399,A.J. Cann,G,active,jacksonville-jaguars,635399,2015
19097,585000,32205,Josh Evans,SS,active,jacksonville-jaguars,617205,2015
19098,585000,16741,Demetrius McCray,CB,active,jacksonville-jaguars,601741,2015
19099,585000,834,Carson Tinker,LS,active,jacksonville-jaguars,585834,2015
19100,585000,0,Ryan Davis,DE,active,jacksonville-jaguars,585000,2015
19101,582352,0,Bryan Walters,WR,active,jacksonville-jaguars,582352,2015
19102,510000,52763,Telvin Smith,OLB,active,jacksonville-jaguars,562763,2015
19103,435000,113288,Aaron Colvin,CB,active,jacksonville-jaguars,548288,2015
19104,510000,23513,Luke Bowanko,C,active,jacksonville-jaguars,533513,2015
19105,510000,1666,Allen Hurns,WR,active,jacksonville-jaguars,511666,2015
19106,510000,1666,Tyler Shatley,G,active,jacksonville-jaguars,511666,2015
19107,510000,0,Nic Jacobs,TE,active,jacksonville-jaguars,510000,2015
19108,510000,0,Chris Smith,DE,active,jacksonville-jaguars,510000,2015
19109,480000,0,Peyton Thompson,SS,active,jacksonville-jaguars,480000,2015
19110,435000,34674,Michael Bennett,DT,active,jacksonville-jaguars,469674,2015
19111,379941,60953,Rashad Greene,WR,active,jacksonville-jaguars,440894,2015
19112,435000,4166,Thurston Armbrister,OLB,active,jacksonville-jaguars,439166,2015
19113,435000,1666,Nick Marshall,CB,active,jacksonville-jaguars,436666,2015
19114,435000,0,Jason Myers,K,active,jacksonville-jaguars,435000,2015
19115,390000,0,Jordan Tripp,ILB,active,jacksonville-jaguars,390000,2015
19116,388000,0,Arrelious Benn,WR,active,jacksonville-jaguars,388000,2015
19117,383823,0,Tony Washington,WR,active,jacksonville-jaguars,383823,2015
19118,378529,0,Joe Banyard,RB,active,jacksonville-jaguars,378529,2015
19119,359294,1666,Corey Grant,RB,active,jacksonville-jaguars,360960,2015
19120,333000,1000,Josh Wells,RT,active,jacksonville-jaguars,334000,2015
19121,281470,0,Neal Sterling,TE,active,jacksonville-jaguars,281470,2015
19122,255882,0,Hayes Pullard,ILB,active,jacksonville-jaguars,255882,2015
19123,210000,0,Craig Loston,SS,active,jacksonville-jaguars,210000,2015
19124,137647,0,Joplo Bartu,OLB,active,jacksonville-jaguars,137647,2015
19125,90000,0,Jonas Gray,RB,active,jacksonville-jaguars,90000,2015
19126,25588,0,Richard Ash,DT,active,jacksonville-jaguars,25588,2015
19127,3000000,2425000,Sen'Derrick Marks,DT,injured_reserve,jacksonville-jaguars,5425000,2015
19128,2500000,500000,Toby Gerhart,RB,injured_reserve,jacksonville-jaguars,3000000,2015
19129,660000,0,Bernard Pierce,RB,injured_reserve,jacksonville-jaguars,660000,2015
19130,585000,834,Abry Jones,DT,injured_reserve,jacksonville-jaguars,585834,2015
19131,386823,137145,James Sample,FS,injured_reserve,jacksonville-jaguars,523968,2015
19132,318000,1666,Damian Copeland,WR,injured_reserve,jacksonville-jaguars,319666,2015
19133,3950000,25000,Evander Hood,DE,dead_cap,jacksonville-jaguars,3975000,2015
19134,0,1887500,Josh Scobee,K,dead_cap,jacksonville-jaguars,1887500,2015
19135,0,2790000,Tyson Alualu,DE,dead_cap,jacksonville-jaguars,2790000,2015
19136,172058,0,John Lotulelei,OLB,dead_cap,jacksonville-jaguars,172058,2015
19137,150176,0,Rashad Lawrence,WR,dead_cap,jacksonville-jaguars,150176,2015
19138,0,140439,Chris Smith,DE,dead_cap,jacksonville-jaguars,140439,2015
19139,112235,25000,Brennan Williams,RT,dead_cap,jacksonville-jaguars,137235,2015
19140,112200,17324,Ben Koyack,TE,dead_cap,jacksonville-jaguars,129524,2015
19141,122200,1666,Chris Reed,T,dead_cap,jacksonville-jaguars,123866,2015
19142,116470,0,James-Michael Johnson,OLB,dead_cap,jacksonville-jaguars,116470,2015
19143,0,113282,Ace  Sanders,WR,dead_cap,jacksonville-jaguars,113282,2015
19144,105600,0,Richard Ash,DT,dead_cap,jacksonville-jaguars,105600,2015
19145,92400,1666,Rashaad Reynolds,CB,dead_cap,jacksonville-jaguars,94066,2015
19146,92400,0,Shaquelle Evans,WR,dead_cap,jacksonville-jaguars,92400,2015
19147,72600,0,Rasheed Bailey,WR,dead_cap,jacksonville-jaguars,72600,2015
19148,68823,834,LaRoy Reynolds,ILB,dead_cap,jacksonville-jaguars,69657,2015
19149,38823,25000,Bryan Walters,WR,dead_cap,jacksonville-jaguars,63823,2015
19150,39600,19407,Neal Sterling,TE,dead_cap,jacksonville-jaguars,59007,2015
19151,0,57500,Tandon Doss,WR,dead_cap,jacksonville-jaguars,57500,2015
19152,52800,2334,Craig Loston,SS,dead_cap,jacksonville-jaguars,55134,2015
19153,52800,0,Kadeem Edwards,G,dead_cap,jacksonville-jaguars,52800,2015
19154,52800,0,Jeff Tuel,QB,dead_cap,jacksonville-jaguars,52800,2015
19155,46200,0,Tyrus Thompson,T,dead_cap,jacksonville-jaguars,46200,2015
19156,39600,0,Quanterus Smith,DE,dead_cap,jacksonville-jaguars,39600,2015
19157,0,28947,Mike Harris,CB,dead_cap,jacksonville-jaguars,28947,2015
19158,26400,0,Sean Porter,ILB,dead_cap,jacksonville-jaguars,26400,2015
19159,0,25000,Will Blackmon,CB,dead_cap,jacksonville-jaguars,25000,2015
19160,18706,1666,Matt Robinson,ILB,dead_cap,jacksonville-jaguars,20372,2015
19161,0,17225,Jeremy Harris,CB,dead_cap,jacksonville-jaguars,17225,2015
19162,0,15682,Storm Johnson,RB,dead_cap,jacksonville-jaguars,15682,2015
19163,13200,0,Jordan Tripp,ILB,dead_cap,jacksonville-jaguars,13200,2015
19164,13200,0,Tony Washington,WR,dead_cap,jacksonville-jaguars,13200,2015
19165,6600,1666,Todd Thomas,OLB,dead_cap,jacksonville-jaguars,8266,2015
19166,6600,0,Joe Banyard,RB,dead_cap,jacksonville-jaguars,6600,2015
19167,6600,0,Jahwan Edwards,RB,dead_cap,jacksonville-jaguars,6600,2015
19168,6600,0,Toby Johnson,DT,dead_cap,jacksonville-jaguars,6600,2015
19169,6600,0,Jordan Leslie,WR,dead_cap,jacksonville-jaguars,6600,2015
19170,6600,0,Patrick Miller,T,dead_cap,jacksonville-jaguars,6600,2015
19171,6600,0,Peyton Thompson,SS,dead_cap,jacksonville-jaguars,6600,2015
19172,0,3334,DeAndre Coleman,DT,dead_cap,jacksonville-jaguars,3334,2015
19173,0,3334,Marcel Jensen,TE,dead_cap,jacksonville-jaguars,3334,2015
19174,0,3334,Stephen Morris,QB,dead_cap,jacksonville-jaguars,3334,2015
19175,0,2667,Marcus Whitfield,OLB,dead_cap,jacksonville-jaguars,2667,2015
19176,0,2500,Jake Waters,QB,dead_cap,jacksonville-jaguars,2500,2015
19177,0,2334,Terreance Cobb,RB,dead_cap,jacksonville-jaguars,2334,2015
19178,0,2000,D.J. Tialavea,TE,dead_cap,jacksonville-jaguars,2000,2015
19179,0,1667,Ricky Havili-Heimuli,DT,dead_cap,jacksonville-jaguars,1667,2015
19180,0,1667,Reggie Jordan,TE,dead_cap,jacksonville-jaguars,1667,2015
19181,0,1666,Connor Hamlett,TE,dead_cap,jacksonville-jaguars,1666,2015
19182,0,833,Eric Crume,DT,dead_cap,jacksonville-jaguars,833,2015
19183,8000000,2000000,Malik Jackson,DT,active,jacksonville-jaguars,10000000,2016
19184,5000000,4001668,Allen Hurns,WR,active,jacksonville-jaguars,9001668,2016
19185,6500000,0,Jermey Parnell,RT,active,jacksonville-jaguars,6500000,2016
19186,6000000,0,Davon House,CB,active,jacksonville-jaguars,6000000,2016
19187,2297710,3335420,Blake Bortles,QB,active,jacksonville-jaguars,5633130,2016
19188,3500000,2093750,Prince Amukamara,CB,active,jacksonville-jaguars,5593750,2016
19189,2500000,3875000,Kelvin Beachum,LT,active,jacksonville-jaguars,6375000,2016
19190,1502739,3835955,Dante Fowler Jr.,DE,active,jacksonville-jaguars,5338694,2016
19191,3950000,1154166,Paul Posluszny,OLB,active,jacksonville-jaguars,5104166,2016
19192,4500000,250000,Chad Henne,QB,active,jacksonville-jaguars,4750000,2016
19193,3450000,1225000,Sen'Derrick Marks,DT,active,jacksonville-jaguars,4675000,2016
19194,450000,3795636,Jalen Ramsey,CB,active,jacksonville-jaguars,4245636,2016
19195,3000000,1206250,Tashaun Gipson,FS,active,jacksonville-jaguars,4206250,2016
19196,3600000,0,Dan Skuta,OLB,active,jacksonville-jaguars,3600000,2016
19197,2000000,1468750,Chris Ivory,RB,active,jacksonville-jaguars,3468750,2016
19198,1750000,1250000,Tyson Alualu,DE,active,jacksonville-jaguars,3000000,2016
19199,2553000,0,Abry Jones,DT,active,jacksonville-jaguars,2553000,2016
19200,1500000,650000,Brad Nortman,P,active,jacksonville-jaguars,2150000,2016
19201,1150788,589382,John Cyprien,SS,active,jacksonville-jaguars,1740170,2016
19202,890366,520731,Marqise Lee,WR,active,jacksonville-jaguars,1411097,2016
19203,450000,701716,Myles Jack,OLB,active,jacksonville-jaguars,1151716,2016
19204,739170,218340,Allen Robinson,WR,active,jacksonville-jaguars,957510,2016
19205,585000,200399,A.J. Cann,G,active,jacksonville-jaguars,785399,2016
19206,612000,133400,Brandon Linder,C,active,jacksonville-jaguars,745400,2016
19207,675000,53403,Denard Robinson,RB,active,jacksonville-jaguars,728403,2016
19208,675000,0,Carson Tinker,LS,active,jacksonville-jaguars,675000,2016
19209,450000,214044,Yannick Ngakoue,DE,active,jacksonville-jaguars,664044,2016
19210,600000,52763,Telvin Smith,OLB,active,jacksonville-jaguars,652763,2016
19211,625882,0,Bryan Walters,WR,active,jacksonville-jaguars,625882,2016
19212,600000,23513,Luke Bowanko,C,active,jacksonville-jaguars,623513,2016
19213,450000,152102,Sheldon Day,DT,active,jacksonville-jaguars,602102,2016
19214,600000,1668,Tyler Shatley,G,active,jacksonville-jaguars,601668,2016
19215,760000,0,Arrelious Benn,WR,active,jacksonville-jaguars,760000,2016
19216,600000,0,Chris Smith,DE,active,jacksonville-jaguars,600000,2016
19217,600000,0,Peyton Thompson,SS,active,jacksonville-jaguars,600000,2016
19218,525000,1666,Corey Grant,RB,active,jacksonville-jaguars,526666,2016
19219,525000,0,Jason Myers,K,active,jacksonville-jaguars,525000,2016
19220,525000,0,Hayes Pullard,ILB,active,jacksonville-jaguars,525000,2016
19221,525000,0,Neal Sterling,TE,active,jacksonville-jaguars,525000,2016
19222,450000,31068,Brandon Allen,QB,active,jacksonville-jaguars,481068,2016
19223,450000,1666,Jarrod Wilson,S,active,jacksonville-jaguars,451666,2016
19224,450000,0,Ben Koyack,TE,active,jacksonville-jaguars,450000,2016
19225,348000,1000,Josh Wells,RT,active,jacksonville-jaguars,349000,2016
19226,238235,0,Jordan Hill,DT,active,jacksonville-jaguars,238235,2016
19227,158820,0,Alex Ellis,TE,active,jacksonville-jaguars,158820,2016
19228,132350,0,Shane Wynn,WR,active,jacksonville-jaguars,132350,2016
19229,105880,0,Bronson Hill,RB,active,jacksonville-jaguars,105880,2016
19230,61764,0,Akeem Davis,SS,active,jacksonville-jaguars,61764,2016
19231,61764,0,Tony Washington,WR,active,jacksonville-jaguars,61764,2016
19232,52940,0,Marcus Rush,OLB,active,jacksonville-jaguars,52940,2016
19233,39706,0,Joe Banyard,RB,active,jacksonville-jaguars,39706,2016
19234,35294,0,Daryl Richardson,RB,active,jacksonville-jaguars,35294,2016
19235,8000000,0,Jared Odrick,DE,injured_reserve,jacksonville-jaguars,8000000,2016
19236,6000000,1300000,Julius Thomas,TE,injured_reserve,jacksonville-jaguars,7300000,2016
19237,3296127,3449836,Luke Joeckel,G,injured_reserve,jacksonville-jaguars,6745963,2016
19238,4000000,0,Marcedes Lewis,TE,injured_reserve,jacksonville-jaguars,4000000,2016
19239,3450000,525000,Roy Miller,DT,injured_reserve,jacksonville-jaguars,3975000,2016
19240,703809,640231,T.J. Yeldon,RB,injured_reserve,jacksonville-jaguars,1344040,2016
19241,675000,0,Patrick Omameh,G,injured_reserve,jacksonville-jaguars,675000,2016
19242,525000,60953,Rashad Greene,WR,injured_reserve,jacksonville-jaguars,585953,2016
19243,458823,113288,Aaron Colvin,CB,injured_reserve,jacksonville-jaguars,572111,2016
19244,348000,137145,James Sample,FS,injured_reserve,jacksonville-jaguars,485145,2016
19245,450000,20000,Chris Reed,T,injured_reserve,jacksonville-jaguars,470000,2016
19246,348000,34674,Michael Bennett,DT,injured_reserve,jacksonville-jaguars,382674,2016
19247,348000,0,Josh Johnson,CB,injured_reserve,jacksonville-jaguars,348000,2016
19248,216176,0,Jeremiah Poutasi,RT,injured_reserve,jacksonville-jaguars,216176,2016
19249,141176,0,Sean Porter,ILB,injured_reserve,jacksonville-jaguars,141176,2016
19250,760000,25000,Bryan Walters,WR,dead_cap,jacksonville-jaguars,785000,2016
19251,500000,375000,Mackenzy Bernadeau,C,dead_cap,jacksonville-jaguars,875000,2016
19252,680334,0,Arthur Brown,ILB,dead_cap,jacksonville-jaguars,680334,2016
19253,491470,174394,Dwayne Gratz,CB,dead_cap,jacksonville-jaguars,665864,2016
19254,268235,0,Bryce Harris,RT,dead_cap,jacksonville-jaguars,268235,2016
19255,151058,50000,Jeff Linkenbach,RT,dead_cap,jacksonville-jaguars,201058,2016
19256,181780,0,Richard Ash,DT,dead_cap,jacksonville-jaguars,181780,2016
19257,0,113282,Ace  Sanders,WR,dead_cap,jacksonville-jaguars,113282,2016
19258,90600,0,Bronson Hill,RB,dead_cap,jacksonville-jaguars,90600,2016
19259,89700,0,Sean Porter,ILB,dead_cap,jacksonville-jaguars,89700,2016
19260,88570,0,Rashod Hill,T,dead_cap,jacksonville-jaguars,88570,2016
19261,82800,0,Shane Wynn,WR,dead_cap,jacksonville-jaguars,82800,2016
19262,0,80000,Bjoern Werner,OLB,dead_cap,jacksonville-jaguars,80000,2016
19263,75900,0,Alex Ellis,TE,dead_cap,jacksonville-jaguars,75900,2016
19264,75900,0,Doran Grant,CB,dead_cap,jacksonville-jaguars,75900,2016
19265,69000,0,Akeem Davis,SS,dead_cap,jacksonville-jaguars,69000,2016
19266,69000,0,Louis Nix,DT,dead_cap,jacksonville-jaguars,69000,2016
19267,69000,0,Jeremiah Poutasi,RT,dead_cap,jacksonville-jaguars,69000,2016
19268,62100,0,Rashad Lawrence,WR,dead_cap,jacksonville-jaguars,62100,2016
19269,0,58221,Neal Sterling,TE,dead_cap,jacksonville-jaguars,58221,2016
19270,0,51972,Ben Koyack,TE,dead_cap,jacksonville-jaguars,51972,2016
19271,48300,0,Arturo Uzdavinis,T,dead_cap,jacksonville-jaguars,48300,2016
19272,41400,0,E.J. Bibbs,TE,dead_cap,jacksonville-jaguars,41400,2016
19273,41400,0,Tony Washington,WR,dead_cap,jacksonville-jaguars,41400,2016
19274,0,36921,Tyrone Holmes,DE,dead_cap,jacksonville-jaguars,36921,2016
19275,34500,1666,Nick Marshall,CB,dead_cap,jacksonville-jaguars,36166,2016
19276,34500,0,MeKale McKay,WR,dead_cap,jacksonville-jaguars,34500,2016
19277,0,32205,Josh Evans,SS,dead_cap,jacksonville-jaguars,32205,2016
19278,0,31364,Storm Johnson,RB,dead_cap,jacksonville-jaguars,31364,2016
19279,0,25000,Brennan Williams,RT,dead_cap,jacksonville-jaguars,25000,2016
19280,20700,0,Marqueston Huff,FS,dead_cap,jacksonville-jaguars,20700,2016
19281,20700,0,Nila Kasitati,G,dead_cap,jacksonville-jaguars,20700,2016
19282,20700,0,Raphael Kirby,ILB,dead_cap,jacksonville-jaguars,20700,2016
19283,20000,0,Craig Loston,SS,dead_cap,jacksonville-jaguars,20000,2016
19284,0,17225,Jeremy Harris,CB,dead_cap,jacksonville-jaguars,17225,2016
19285,0,16741,Demetrius McCray,CB,dead_cap,jacksonville-jaguars,16741,2016
19286,13800,0,Jamal Robinson,WR,dead_cap,jacksonville-jaguars,13800,2016
19287,6900,0,Rodney Coe,DT,dead_cap,jacksonville-jaguars,6900,2016
19288,6900,0,Shaquelle Evans,WR,dead_cap,jacksonville-jaguars,6900,2016
19289,6900,0,Gannon Sinclair,TE,dead_cap,jacksonville-jaguars,6900,2016
19290,0,4167,Thurston Armbrister,OLB,dead_cap,jacksonville-jaguars,4167,2016
19291,0,3334,Connor Hamlett,TE,dead_cap,jacksonville-jaguars,3334,2016
19292,0,3334,Chris Reed,T,dead_cap,jacksonville-jaguars,3334,2016
19293,0,3334,Matt Robinson,ILB,dead_cap,jacksonville-jaguars,3334,2016
19294,0,3334,Todd Thomas,OLB,dead_cap,jacksonville-jaguars,3334,2016
19295,0,1668,Damian Copeland,WR,dead_cap,jacksonville-jaguars,1668,2016
19296,0,1667,Eric Crume,DT,dead_cap,jacksonville-jaguars,1667,2016
19297,0,1667,Rashaad Reynolds,CB,dead_cap,jacksonville-jaguars,1667,2016
19298,13500000,2000000,Malik Jackson,DT,active,jacksonville-jaguars,15500000,2017
19299,5500000,5570900,Brandon Linder,C,active,jacksonville-jaguars,11070900,2017
19300,9000000,1500000,Calais Campbell,DE,active,jacksonville-jaguars,10500000,2017
19301,5000000,3000000,Barry Church,SS,active,jacksonville-jaguars,8000000,2017
19302,7000000,0,Allen Hurns,WR,active,jacksonville-jaguars,7000000,2017
19303,3236565,3335420,Blake Bortles,QB,active,jacksonville-jaguars,6571985,2017
19304,6500000,0,Jermey Parnell,RT,active,jacksonville-jaguars,6500000,2017
19305,2570478,3835955,Dante Fowler Jr.,DE,active,jacksonville-jaguars,6406433,2017
19306,5000000,1300000,Tashaun Gipson,FS,active,jacksonville-jaguars,6300000,2017
19307,3950000,2216668,Paul Posluszny,OLB,active,jacksonville-jaguars,6166668,2017
19308,4500000,1500000,Chris Ivory,RB,active,jacksonville-jaguars,6000000,2017
19309,5735294,0,Marcell Dareus,DT,active,jacksonville-jaguars,5735294,2017
19310,3000000,2468750,A.J. Bouye,CB,active,jacksonville-jaguars,5468750,2017
19311,1511409,3795636,Jalen Ramsey,CB,active,jacksonville-jaguars,5307045,2017
19312,465000,4471516,Leonard Fournette,RB,active,jacksonville-jaguars,4936516,2017
19313,4000000,500000,Marcedes Lewis,TE,active,jacksonville-jaguars,4500000,2017
19314,2500000,1500000,Abry Jones,DT,active,jacksonville-jaguars,4000000,2017
19315,2250000,1250000,Chad Henne,QB,active,jacksonville-jaguars,3500000,2017
19316,1145824,862998,Telvin Smith,OLB,active,jacksonville-jaguars,2008822,2017
19317,1500000,500000,Lerentee McCray,OLB,active,jacksonville-jaguars,2000000,2017
19318,1797000,113288,Aaron Colvin,CB,active,jacksonville-jaguars,1910288,2017
19319,1900000,0,Brad Nortman,P,active,jacksonville-jaguars,1900000,2017
19320,1125549,520731,Marqise Lee,WR,active,jacksonville-jaguars,1646280,2017
19321,972617,640231,T.J. Yeldon,RB,active,jacksonville-jaguars,1612848,2017
19322,737929,701716,Myles Jack,OLB,active,jacksonville-jaguars,1439645,2017
19323,465000,811029,Cam Robinson,LT,active,jacksonville-jaguars,1276029,2017
19324,690000,287500,Tyler Shatley,G,active,jacksonville-jaguars,977500,2017
19325,721000,200399,A.J. Cann,G,active,jacksonville-jaguars,921399,2017
19326,775000,100000,Patrick Omameh,G,active,jacksonville-jaguars,875000,2017
19327,605041,214044,Yannick Ngakoue,DE,active,jacksonville-jaguars,819085,2017
19328,615000,100000,Josh Wells,RT,active,jacksonville-jaguars,715000,2017
19329,465000,241040,Dawuane Smoot,DE,active,jacksonville-jaguars,706040,2017
19330,690000,0,Tommy Bohanon,FB,active,jacksonville-jaguars,690000,2017
19331,690000,0,Peyton Thompson,SS,active,jacksonville-jaguars,690000,2017
19332,615000,1668,Corey Grant,RB,active,jacksonville-jaguars,616668,2017
19333,615000,0,James O'Shaughnessy,TE,active,jacksonville-jaguars,615000,2017
19334,615000,0,Tyler Patmon,CB,active,jacksonville-jaguars,615000,2017
19335,615000,0,Josh Walker,G,active,jacksonville-jaguars,615000,2017
19336,382942,169039,Dede Westbrook,WR,active,jacksonville-jaguars,551981,2017
19337,540000,1666,Jarrod Wilson,S,active,jacksonville-jaguars,541666,2017
19338,540000,0,Ben Koyack,TE,active,jacksonville-jaguars,540000,2017
19339,465000,73678,Blair Brown,OLB,active,jacksonville-jaguars,538678,2017
19340,465000,23416,Jalen Myrick,CB,active,jacksonville-jaguars,488416,2017
19341,465000,1333,Keelan Cole,WR,active,jacksonville-jaguars,466333,2017
19342,465000,0,Eli Ankou,DT,active,jacksonville-jaguars,465000,2017
19343,465000,0,Donald Payne,ILB,active,jacksonville-jaguars,465000,2017
19344,465000,0,William Poehls,G,active,jacksonville-jaguars,465000,2017
19345,412945,0,Chris Reed,T,active,jacksonville-jaguars,412945,2017
19346,397941,0,Josh Lambo,K,active,jacksonville-jaguars,397941,2017
19347,300883,0,Jaydon Mickens,WR,active,jacksonville-jaguars,300883,2017
19348,191471,0,Colin Holba,LS,active,jacksonville-jaguars,191471,2017
19349,136765,0,Carroll Phillips,OLB,active,jacksonville-jaguars,136765,2017
19350,27353,0,Montay Crockett,WR,active,jacksonville-jaguars,27353,2017
19351,1250000,750000,Mychal Rivera,TE,injured_reserve,jacksonville-jaguars,2000000,2017
19352,898755,218340,Allen Robinson,WR,injured_reserve,jacksonville-jaguars,1117095,2017
19353,775000,160000,Arrelious Benn,WR,injured_reserve,jacksonville-jaguars,935000,2017
19354,775000,0,Carson Tinker,LS,injured_reserve,jacksonville-jaguars,775000,2017
19355,615000,60953,Rashad Greene,WR,injured_reserve,jacksonville-jaguars,675953,2017
19356,775000,0,Matt Overton,LS,injured_reserve,jacksonville-jaguars,775000,2017
19357,540000,34674,Michael Bennett,DT,injured_reserve,jacksonville-jaguars,574674,2017
19358,378000,0,Tyler Gaffney,RB,injured_reserve,jacksonville-jaguars,378000,2017
19359,363000,0,Shane Wynn,WR,injured_reserve,jacksonville-jaguars,363000,2017
19360,348000,1666,I'Tavius Mathers,RB,injured_reserve,jacksonville-jaguars,349666,2017
19361,348000,0,Jarrod Harper,S,injured_reserve,jacksonville-jaguars,348000,2017
19362,191471,0,Larry Pinkard,WR,injured_reserve,jacksonville-jaguars,191471,2017
19363,72353,0,Jaelen Strong,WR,injured_reserve,jacksonville-jaguars,72353,2017
19364,0,3600000,Julius Thomas,TE,dead_cap,jacksonville-jaguars,3600000,2017
19365,1587716,0,Calvin Pryor,FS,dead_cap,jacksonville-jaguars,1587716,2017
19366,500000,625000,Earl Watford,RT,dead_cap,jacksonville-jaguars,1125000,2017
19367,0,625000,Stefan Charles,DT,dead_cap,jacksonville-jaguars,625000,2017
19368,317647,152103,Sheldon Day,DT,dead_cap,jacksonville-jaguars,469750,2017
19369,370114,0,Jaelen Strong,WR,dead_cap,jacksonville-jaguars,370114,2017
19370,222355,0,Lafayette Pitts,CB,dead_cap,jacksonville-jaguars,222355,2017
19371,217056,0,Jason Myers,K,dead_cap,jacksonville-jaguars,217056,2017
19372,0,200000,Sen'Derrick Marks,DT,dead_cap,jacksonville-jaguars,200000,2017
19373,0,200000,Roy Miller,DT,dead_cap,jacksonville-jaguars,200000,2017
19374,0,200000,Audie Cole,ILB,dead_cap,jacksonville-jaguars,200000,2017
19375,191471,0,Max McCaffrey,WR,dead_cap,jacksonville-jaguars,191471,2017
19376,0,200000,Bryan Walters,WR,dead_cap,jacksonville-jaguars,200000,2017
19377,122824,17809,Marquez Williams,FB,dead_cap,jacksonville-jaguars,140633,2017
19378,0,137146,James Sample,FS,dead_cap,jacksonville-jaguars,137146,2017
19379,0,125000,Mackenzy Bernadeau,C,dead_cap,jacksonville-jaguars,125000,2017
19380,122400,0,Tim Cook,RB,dead_cap,jacksonville-jaguars,122400,2017
19381,122400,0,Hunter Dimick,DE,dead_cap,jacksonville-jaguars,122400,2017
19382,122400,0,Avery Gennesy,T,dead_cap,jacksonville-jaguars,122400,2017
19383,122400,0,David Grinnage,TE,dead_cap,jacksonville-jaguars,122400,2017
19384,122400,0,Darius Kilgo,DT,dead_cap,jacksonville-jaguars,122400,2017
19385,0,110766,Tyrone Holmes,DE,dead_cap,jacksonville-jaguars,110766,2017
19386,86400,0,Carroll Phillips,OLB,dead_cap,jacksonville-jaguars,86400,2017
19387,86400,0,Brandon Wilds,RB,dead_cap,jacksonville-jaguars,86400,2017
19388,79200,0,Charlie Miller,S,dead_cap,jacksonville-jaguars,79200,2017
19389,91176,0,Ryan Nassib,QB,dead_cap,jacksonville-jaguars,91176,2017
19390,64800,0,Larry Pinkard,WR,dead_cap,jacksonville-jaguars,64800,2017
19391,64800,0,Brandon Thomas,G,dead_cap,jacksonville-jaguars,64800,2017
19392,57600,0,Montay Crockett,WR,dead_cap,jacksonville-jaguars,57600,2017
19393,57600,0,Marcus Hardison,DT,dead_cap,jacksonville-jaguars,57600,2017
19394,51600,0,Jaydon Mickens,WR,dead_cap,jacksonville-jaguars,51600,2017
19395,43200,0,Brooks Ellis,OLB,dead_cap,jacksonville-jaguars,43200,2017
19396,43200,0,Raysean Pringle,CB,dead_cap,jacksonville-jaguars,43200,2017
19397,42706,0,Doran Grant,CB,dead_cap,jacksonville-jaguars,42706,2017
19398,0,31068,Brandon Allen,QB,dead_cap,jacksonville-jaguars,31068,2017
19399,28800,0,Chris Reed,T,dead_cap,jacksonville-jaguars,28800,2017
19400,28800,0,Sammy Seamster,CB,dead_cap,jacksonville-jaguars,28800,2017
19401,0,23513,Luke Bowanko,C,dead_cap,jacksonville-jaguars,23513,2017
19402,20000,1666,Justin Horton,OLB,dead_cap,jacksonville-jaguars,21666,2017
19403,0,20774,Jonathan Woodard,DE,dead_cap,jacksonville-jaguars,20774,2017
19404,14400,0,Amba Etta-Tawo,WR,dead_cap,jacksonville-jaguars,14400,2017
19405,14400,0,Deon King,OLB,dead_cap,jacksonville-jaguars,14400,2017
19406,14400,0,Jhurrell Pressley,RB,dead_cap,jacksonville-jaguars,14400,2017
19407,14400,0,Norman Price,T,dead_cap,jacksonville-jaguars,14400,2017
19408,7200,0,Tracy Howard,CB,dead_cap,jacksonville-jaguars,7200,2017
19409,7200,0,Stanley Jean-Baptiste,CB,dead_cap,jacksonville-jaguars,7200,2017
19410,7200,0,Mike Meyer,K,dead_cap,jacksonville-jaguars,7200,2017
19411,7200,0,Oni Omoile,G,dead_cap,jacksonville-jaguars,7200,2017
19412,7200,0,Jeremiah Poutasi,RT,dead_cap,jacksonville-jaguars,7200,2017
19413,7200,0,Tevaun Smith,WR,dead_cap,jacksonville-jaguars,7200,2017
19414,0,4167,Thurston Armbrister,OLB,dead_cap,jacksonville-jaguars,4167,2017
19415,0,1667,Nick Marshall,CB,dead_cap,jacksonville-jaguars,1667,2017
19416,15000000,3500000,Calais Campbell,DE,active,jacksonville-jaguars,18500000,2018
19417,13500000,2000000,Malik Jackson,DT,active,jacksonville-jaguars,15500000,2018
19418,13000000,2406250,A.J. Bouye,CB,active,jacksonville-jaguars,15406250,2018
19419,9925000,250000,Marcell Dareus,DT,active,jacksonville-jaguars,10175000,2018
19420,5000000,5000000,Blake Bortles,QB,active,jacksonville-jaguars,10000000,2018
19421,5600000,4000000,Donte Moncrief,WR,active,jacksonville-jaguars,9600000,2018
19422,5750000,1300000,Tashaun Gipson,FS,active,jacksonville-jaguars,7050000,2018
19423,2572818,3795636,Jalen Ramsey,CB,active,jacksonville-jaguars,6368454,2018
19424,1699129,4471516,Leonard Fournette,RB,active,jacksonville-jaguars,6170645,2018
19425,3000000,2810235,Telvin Smith,OLB,active,jacksonville-jaguars,5810235,2018
19426,2250000,1666666,D.J. Hayden,CB,active,jacksonville-jaguars,3916666,2018
19427,3000000,500000,Abry Jones,DT,active,jacksonville-jaguars,3500000,2018
19428,1500000,1078125,Lerentee McCray,OLB,active,jacksonville-jaguars,2578125,2018
19429,1500000,875000,Cody Davis,FS,active,jacksonville-jaguars,2375000,2018
19430,1907000,200399,A.J. Cann,G,active,jacksonville-jaguars,2107399,2018
19431,1241421,640234,T.J. Yeldon,RB,active,jacksonville-jaguars,1881655,2018
19432,480000,1366356,Taven Bryan,DT,active,jacksonville-jaguars,1846356,2018
19433,1025858,701716,Myles Jack,ILB,active,jacksonville-jaguars,1727574,2018
19434,970588,275000,Carlos Hyde,RB,active,jacksonville-jaguars,1245588,2018
19435,790000,237500,Tyler Shatley,G,active,jacksonville-jaguars,1027500,2018
19436,735101,214044,Yannick Ngakoue,DE,active,jacksonville-jaguars,949145,2018
19437,640250,241040,Dawuane Smoot,DE,active,jacksonville-jaguars,881290,2018
19438,480000,328587,DJ Chark,WR,active,jacksonville-jaguars,808587,2018
19439,790000,0,Tommy Bohanon,FB,active,jacksonville-jaguars,790000,2018
19440,758098,0,Cody Kessler,QB,active,jacksonville-jaguars,758098,2018
19441,555000,169039,Dede Westbrook,WR,active,jacksonville-jaguars,724039,2018
19442,705000,9000,James O'Shaughnessy,TE,active,jacksonville-jaguars,714000,2018
19443,705000,0,Tyler Patmon,CB,active,jacksonville-jaguars,705000,2018
19444,630000,1668,Jarrod Wilson,S,active,jacksonville-jaguars,631668,2018
19445,630000,0,Chris Reed,T,active,jacksonville-jaguars,630000,2018
19446,555000,73678,Blair Brown,OLB,active,jacksonville-jaguars,628678,2018
19447,555000,1333,Keelan Cole,WR,active,jacksonville-jaguars,556333,2018
19448,555000,0,Eli Ankou,DT,active,jacksonville-jaguars,555000,2018
19449,480000,17905,Logan Cooke,P,active,jacksonville-jaguars,497905,2018
19450,497647,0,Ereck Flowers,RT,active,jacksonville-jaguars,497647,2018
19451,480000,1666,Tre Herndon,CB,active,jacksonville-jaguars,481666,2018
19452,461294,0,Donald Payne,ILB,active,jacksonville-jaguars,461294,2018
19453,456176,0,Blake Bell,TE,active,jacksonville-jaguars,456176,2018
19454,456176,0,Rashad Greene,WR,active,jacksonville-jaguars,456176,2018
19455,557647,0,Matt Overton,LS,active,jacksonville-jaguars,557647,2018
19456,367059,0,Quenton Meeks,CB,active,jacksonville-jaguars,367059,2018
19457,338824,0,David Williams,RB,active,jacksonville-jaguars,338824,2018
19458,325294,0,Patrick Omameh,G,active,jacksonville-jaguars,325294,2018
19459,282350,0,Nick Deluca,ILB,active,jacksonville-jaguars,282350,2018
19460,259413,0,Ben Koyack,TE,active,jacksonville-jaguars,259413,2018
19461,248824,0,Corey Robinson,LT,active,jacksonville-jaguars,248824,2018
19462,141175,0,C.J. Reavis,S,active,jacksonville-jaguars,141175,2018
19463,139412,0,Kai Forbath,K,active,jacksonville-jaguars,139412,2018
19464,84705,0,Lyndon Johnson,DE,active,jacksonville-jaguars,84705,2018
19465,32647,0,Breon Borders,CB,active,jacksonville-jaguars,32647,2018
19466,32647,0,Brandon Thomas,G,active,jacksonville-jaguars,32647,2018
19467,28235,0,Dimitri Flowers,FB,active,jacksonville-jaguars,28235,2018
19468,28235,0,Tanner Lee,QB,active,jacksonville-jaguars,28235,2018
19469,9000000,281250,Brandon Linder,C,injured_reserve,jacksonville-jaguars,9281250,2018
19470,4000000,1000000,Jermey Parnell,RT,injured_reserve,jacksonville-jaguars,5000000,2018
19471,2000000,3000000,Andrew Norwell,G,injured_reserve,jacksonville-jaguars,5000000,2018
19472,2250000,2406250,Marqise Lee,WR,injured_reserve,jacksonville-jaguars,4656250,2018
19473,790000,2511250,Austin Seferian-Jenkins,TE,injured_reserve,jacksonville-jaguars,3301250,2018
19474,2914000,0,Corey Grant,RB,injured_reserve,jacksonville-jaguars,2914000,2018
19475,784007,811029,Cam Robinson,LT,injured_reserve,jacksonville-jaguars,1595036,2018
19476,800000,25000,Carson Tinker,LS,injured_reserve,jacksonville-jaguars,825000,2018
19477,705000,100000,Josh Wells,LT,injured_reserve,jacksonville-jaguars,805000,2018
19478,689000,0,Josh Lambo,K,injured_reserve,jacksonville-jaguars,689000,2018
19479,473118,200758,Ronnie Harrison,SS,injured_reserve,jacksonville-jaguars,673876,2018
19480,657000,0,Josh Walker,G,injured_reserve,jacksonville-jaguars,657000,2018
19481,404282,150698,Will Richardson,T,injured_reserve,jacksonville-jaguars,554980,2018
19482,459346,22670,Leon Jacobs,OLB,injured_reserve,jacksonville-jaguars,482016,2018
19483,440470,0,Jaydon Mickens,WR,injured_reserve,jacksonville-jaguars,440470,2018
19484,363000,1666,Michael Hughes,DT,injured_reserve,jacksonville-jaguars,364666,2018
19485,1498086,3835955,Dante Fowler Jr.,DE,dead_cap,jacksonville-jaguars,5334041,2018
19486,4500000,375000,Barry Church,SS,dead_cap,jacksonville-jaguars,4875000,2018
19487,0,3000000,Chris Ivory,RB,dead_cap,jacksonville-jaguars,3000000,2018
19488,1500000,843750,Niles Paul,TE,dead_cap,jacksonville-jaguars,2343750,2018
19489,290293,60955,Rashad Greene,WR,dead_cap,jacksonville-jaguars,351248,2018
19490,0,304205,Sheldon Day,DT,dead_cap,jacksonville-jaguars,304205,2018
19491,277588,0,DeAndre Goolsby,TE,dead_cap,jacksonville-jaguars,277588,2018
19492,259412,0,Ben Koyack,TE,dead_cap,jacksonville-jaguars,259412,2018
19493,0,250000,Marcedes Lewis,TE,dead_cap,jacksonville-jaguars,250000,2018
19494,0,500000,Brad Nortman,P,dead_cap,jacksonville-jaguars,500000,2018
19495,221340,3333,Dee Delaney,CB,dead_cap,jacksonville-jaguars,224673,2018
19496,222354,0,Martrell Spaight,ILB,dead_cap,jacksonville-jaguars,222354,2018
19497,179175,0,David Grinnage,TE,dead_cap,jacksonville-jaguars,179175,2018
19498,179117,0,Jamaal Charles,RB,dead_cap,jacksonville-jaguars,179117,2018
19499,161824,0,Kaleb Eulls,DT,dead_cap,jacksonville-jaguars,161824,2018
19500,121600,35385,Tanner Lee,QB,dead_cap,jacksonville-jaguars,156985,2018
19501,155647,0,Kapron Lewis-Moore,DE,dead_cap,jacksonville-jaguars,155647,2018
19502,149471,0,Manase Hungalu,LB,dead_cap,jacksonville-jaguars,149471,2018
19503,146500,2500,Allen Lazard,WR,dead_cap,jacksonville-jaguars,149000,2018
19504,139200,3333,K.C. McDermott,T,dead_cap,jacksonville-jaguars,142533,2018
19505,138188,0,Brandon Wilds,RB,dead_cap,jacksonville-jaguars,138188,2018
19506,0,137146,James Sample,FS,dead_cap,jacksonville-jaguars,137146,2018
19507,32647,100000,Don Carey,SS,dead_cap,jacksonville-jaguars,132647,2018
19508,0,125000,Stefan Charles,DT,dead_cap,jacksonville-jaguars,125000,2018
19509,0,125000,Earl Watford,RT,dead_cap,jacksonville-jaguars,125000,2018
19510,121400,3333,Lyndon Johnson,DE,dead_cap,jacksonville-jaguars,124733,2018
19511,139412,0,Landry Jones,QB,dead_cap,jacksonville-jaguars,139412,2018
19512,106400,0,Nick Deluca,ILB,dead_cap,jacksonville-jaguars,106400,2018
19513,96200,1666,C.J. Reavis,S,dead_cap,jacksonville-jaguars,97866,2018
19514,91200,0,Pharoah McKever,TE,dead_cap,jacksonville-jaguars,91200,2018
19515,41471,34676,Michael Bennett,DT,dead_cap,jacksonville-jaguars,76147,2018
19516,76000,0,Bo Scarbrough,RB,dead_cap,jacksonville-jaguars,76000,2018
19517,45600,23416,Jalen Myrick,CB,dead_cap,jacksonville-jaguars,69016,2018
19518,68400,0,Brandon Thomas,G,dead_cap,jacksonville-jaguars,68400,2018
19519,68400,0,Michael Dunn,T,dead_cap,jacksonville-jaguars,68400,2018
19520,0,62137,Brandon Allen,QB,dead_cap,jacksonville-jaguars,62137,2018
19521,60800,0,Breon Borders,CB,dead_cap,jacksonville-jaguars,60800,2018
19522,0,53427,Marquez Williams,FB,dead_cap,jacksonville-jaguars,53427,2018
19523,0,50000,Audie Cole,ILB,dead_cap,jacksonville-jaguars,50000,2018
19524,0,41548,Jonathan Woodard,DE,dead_cap,jacksonville-jaguars,41548,2018
19525,0,40000,Arrelious Benn,WR,dead_cap,jacksonville-jaguars,40000,2018
19526,35400,1666,Quenton Meeks,CB,dead_cap,jacksonville-jaguars,37066,2018
19527,22800,0,C.J. Board,WR,dead_cap,jacksonville-jaguars,22800,2018
19528,22800,0,Richard Jarvis,OLB,dead_cap,jacksonville-jaguars,22800,2018
19529,15200,0,Christian Kuntz,LB,dead_cap,jacksonville-jaguars,15200,2018
19530,15200,0,Jordan Veasy,WR,dead_cap,jacksonville-jaguars,15200,2018
19531,10000,3333,Darius Jackson,LB,dead_cap,jacksonville-jaguars,13333,2018
19532,10000,1000,Andrew Motuapuaka,LB,dead_cap,jacksonville-jaguars,11000,2018
19533,7600,0,Dimitri Flowers,FB,dead_cap,jacksonville-jaguars,7600,2018
19534,7600,0,Andre Levrone,WR,dead_cap,jacksonville-jaguars,7600,2018
19535,7600,0,Salesi Uhatafe,G,dead_cap,jacksonville-jaguars,7600,2018
19536,0,3334,Justin Horton,OLB,dead_cap,jacksonville-jaguars,3334,2018
19537,0,1666,Tony Adams,T,dead_cap,jacksonville-jaguars,1666,2018
19538,0,833,Reggie Hunter,LB,dead_cap,jacksonville-jaguars,833,2018
19539,0,333,Dorren Miller,WR,dead_cap,jacksonville-jaguars,333,2018
19540,13000000,3000000,Andrew Norwell,G,active,jacksonville-jaguars,16000000,2019
19541,13000000,2437500,A.J. Bouye,CB,active,jacksonville-jaguars,15437500,2019
19542,12000000,3500000,Calais Campbell,DE,active,jacksonville-jaguars,15500000,2019
19543,5000000,6750000,Nick Foles,QB,active,jacksonville-jaguars,11750000,2019
19544,5750000,1666666,D.J. Hayden,CB,active,jacksonville-jaguars,7416666,2019
19545,2933258,4471516,Leonard Fournette,RB,active,jacksonville-jaguars,7404774,2019
19546,5500000,500000,Brandon Linder,C,active,jacksonville-jaguars,6000000,2019
19547,495000,3640025,Josh Allen,DE,active,jacksonville-jaguars,4135025,2019
19548,3400000,600000,Abry Jones,DT,active,jacksonville-jaguars,4000000,2019
19549,1750000,875000,Cody Davis,FS,active,jacksonville-jaguars,2625000,2019
19550,805000,1633333,A.J. Cann,G,active,jacksonville-jaguars,2438333,2019
19551,941589,1366356,Taven Bryan,DT,active,jacksonville-jaguars,2307945,2019
19552,2025000,214044,Yannick Ngakoue,DE,active,jacksonville-jaguars,2239044,2019
19553,1000000,1125000,Josh Lambo,K,active,jacksonville-jaguars,2125000,2019
19554,1450000,633333,Jarrod Wilson,FS,active,jacksonville-jaguars,2083333,2019
19555,805000,1261666,Chris Conley,WR,active,jacksonville-jaguars,2066666,2019
19556,1103015,811029,Cam Robinson,LT,active,jacksonville-jaguars,1914044,2019
19557,495000,927527,Jawaan Taylor,RT,active,jacksonville-jaguars,1422527,2019
19558,812500,241040,Dawuane Smoot,DE,active,jacksonville-jaguars,1053540,2019
19559,682147,328587,DJ Chark,WR,active,jacksonville-jaguars,1010734,2019
19560,805000,200000,Tyler Shatley,C,active,jacksonville-jaguars,1005000,2019
19561,617500,200758,Ronnie Harrison,SS,active,jacksonville-jaguars,818258,2019
19562,645000,169039,Dede Westbrook,WR,active,jacksonville-jaguars,814039,2019
19563,805000,90000,Cedric Ogbuehi,LT,active,jacksonville-jaguars,895000,2019
19564,570000,150698,Will Richardson,T,active,jacksonville-jaguars,720698,2019
19565,720000,0,Seth Devalve,TE,active,jacksonville-jaguars,720000,2019
19566,645000,1334,Keelan Cole,WR,active,jacksonville-jaguars,646334,2019
19567,607059,0,Joshua Dobbs,QB,active,jacksonville-jaguars,607059,2019
19568,570000,22670,Leon Jacobs,OLB,active,jacksonville-jaguars,592670,2019
19569,570000,17905,Logan Cooke,P,active,jacksonville-jaguars,587905,2019
19570,495000,86439,Ryquell Armstead,RB,active,jacksonville-jaguars,581439,2019
19571,570000,1666,Tre Herndon,CB,active,jacksonville-jaguars,571666,2019
19572,570000,0,Austin Calitro,ILB,active,jacksonville-jaguars,570000,2019
19573,547059,0,Akeem Spence,DT,active,jacksonville-jaguars,547059,2019
19574,495000,47721,Gardner Minshew,QB,active,jacksonville-jaguars,542721,2019
19575,495000,20796,Dontavius Russell,DT,active,jacksonville-jaguars,515796,2019
19576,508235,0,Ben Koyack,TE,active,jacksonville-jaguars,508235,2019
19577,495000,1666,Andrew Wingard,S,active,jacksonville-jaguars,496666,2019
19578,495000,0,Matthew Orzech,LS,active,jacksonville-jaguars,495000,2019
19579,495000,0,Devine Ozigbo,RB,active,jacksonville-jaguars,495000,2019
19580,379410,0,Donald Payne,ILB,active,jacksonville-jaguars,379410,2019
19581,262059,0,Michael Walker,WR,active,jacksonville-jaguars,262059,2019
19582,262059,0,Brandon Watson,RB,active,jacksonville-jaguars,262059,2019
19583,284118,0,Nick O'Leary,TE,active,jacksonville-jaguars,284118,2019
19584,211765,0,Carl Davis,DT,active,jacksonville-jaguars,211765,2019
19585,174706,0,Charles Jones,TE,active,jacksonville-jaguars,174706,2019
19586,142059,0,Preston Brown,ILB,active,jacksonville-jaguars,142059,2019
19587,134118,0,Parry Nickerson,CB,active,jacksonville-jaguars,134118,2019
19588,116471,0,Joe Giles-Harris,LB,active,jacksonville-jaguars,116471,2019
19589,87354,0,C.J. Board,WR,active,jacksonville-jaguars,87354,2019
19590,87353,0,Dakota Allen,LB,active,jacksonville-jaguars,87353,2019
19591,87353,0,Tyler Gauthier,C,active,jacksonville-jaguars,87353,2019
19592,67059,0,Doug Middleton,FS,active,jacksonville-jaguars,67059,2019
19593,7250000,1750000,Marqise Lee,WR,injured_reserve,jacksonville-jaguars,9000000,2019
19594,2835000,2750000,Marcell Dareus,DT,injured_reserve,jacksonville-jaguars,5585000,2019
19595,1313787,3101718,Myles Jack,ILB,injured_reserve,jacksonville-jaguars,4415505,2019
19596,2000000,875000,Lerentee McCray,DE,injured_reserve,jacksonville-jaguars,2875000,2019
19597,1500000,487500,Geoff Swaim,TE,injured_reserve,jacksonville-jaguars,1987500,2019
19598,1000000,250000,Jake Ryan,ILB,injured_reserve,jacksonville-jaguars,1250000,2019
19599,805000,162500,James O'Shaughnessy,TE,injured_reserve,jacksonville-jaguars,967500,2019
19600,453706,277881,Josh Oliver,TE,injured_reserve,jacksonville-jaguars,731587,2019
19601,474353,205545,Quincy Williams,LB,injured_reserve,jacksonville-jaguars,679898,2019
19602,805000,0,Najee Goode,OLB,injured_reserve,jacksonville-jaguars,805000,2019
19603,546050,0,Brandon Thomas,G,injured_reserve,jacksonville-jaguars,546050,2019
19604,805000,0,D.J. Alexander,ILB,injured_reserve,jacksonville-jaguars,805000,2019
19605,805000,0,Benjamin Ijalana,RT,injured_reserve,jacksonville-jaguars,805000,2019
19606,408000,0,James Onwualu,OLB,injured_reserve,jacksonville-jaguars,408000,2019
19607,378000,20000,K.C. McDermott,T,injured_reserve,jacksonville-jaguars,398000,2019
19608,393000,0,Devante Mays,RB,injured_reserve,jacksonville-jaguars,393000,2019
19609,378000,1666,Donnell Greene,T,injured_reserve,jacksonville-jaguars,379666,2019
19610,378000,0,Taj McGowan,RB,injured_reserve,jacksonville-jaguars,378000,2019
19611,128000,0,Terry Godwin,WR,injured_reserve,jacksonville-jaguars,128000,2019
19612,80000,0,Brian Price,DT,injured_reserve,jacksonville-jaguars,80000,2019
19613,16000,0,Joe Dineen,LB,practice_squad,jacksonville-jaguars,16000,2019
19614,16000,0,Dewayne Hendrix,DE,practice_squad,jacksonville-jaguars,16000,2019
19615,16000,0,Jeremy McNichols,RB,practice_squad,jacksonville-jaguars,16000,2019
19616,5500000,10000000,Blake Bortles,QB,dead_cap,jacksonville-jaguars,15500000,2019
19617,1282668,3795638,Jalen Ramsey,CB,dead_cap,jacksonville-jaguars,5078306,2019
19618,0,4000000,Malik Jackson,DT,dead_cap,jacksonville-jaguars,4000000,2019
19619,0,2810235,Telvin Smith,OLB,dead_cap,jacksonville-jaguars,2810235,2019
19620,0,1605000,Austin Seferian-Jenkins,TE,dead_cap,jacksonville-jaguars,1605000,2019
19621,0,1600000,Tashaun Gipson,FS,dead_cap,jacksonville-jaguars,1600000,2019
19622,508235,0,Tyler Ervin,RB,dead_cap,jacksonville-jaguars,508235,2019
19623,378824,90000,Alfred Blue,RB,dead_cap,jacksonville-jaguars,468824,2019
19624,459877,0,Breon Borders,CB,dead_cap,jacksonville-jaguars,459877,2019
19625,365416,0,C.J. Board,WR,dead_cap,jacksonville-jaguars,365416,2019
19626,378824,0,Josh Robinson,FS,dead_cap,jacksonville-jaguars,378824,2019
19627,244588,6666,Marcus Simms,WR,dead_cap,jacksonville-jaguars,251254,2019
19628,238706,1333,Tae Hayes,CB,dead_cap,jacksonville-jaguars,240039,2019
19629,222350,0,Cody Brown,S,dead_cap,jacksonville-jaguars,222350,2019
19630,184471,0,Leonard Wester,T,dead_cap,jacksonville-jaguars,184471,2019
19631,83471,90000,Benny Cunningham,RB,dead_cap,jacksonville-jaguars,173471,2019
19632,164118,0,Marcus Gilchrist,SS,dead_cap,jacksonville-jaguars,164118,2019
19633,0,147359,Blair Brown,OLB,dead_cap,jacksonville-jaguars,147359,2019
19634,0,144117,Niles Paul,TE,dead_cap,jacksonville-jaguars,144117,2019
19635,136000,0,Blake Hance,T,dead_cap,jacksonville-jaguars,136000,2019
19636,117118,0,Joe Giles-Harris,LB,dead_cap,jacksonville-jaguars,117118,2019
19637,0,112500,Alex McGough,QB,dead_cap,jacksonville-jaguars,112500,2019
19638,111176,0,Davis Tull,DE,dead_cap,jacksonville-jaguars,111176,2019
19639,0,106157,Tanner Lee,QB,dead_cap,jacksonville-jaguars,106157,2019
19640,99000,1666,Michael Walker,WR,dead_cap,jacksonville-jaguars,100666,2019
19641,0,100000,Don Carey,SS,dead_cap,jacksonville-jaguars,100000,2019
19642,0,90000,Josh Wells,RT,dead_cap,jacksonville-jaguars,90000,2019
19643,88000,0,Ka’John Armstrong,T,dead_cap,jacksonville-jaguars,88000,2019
19644,88000,0,Charles Jones,TE,dead_cap,jacksonville-jaguars,88000,2019
19645,81529,0,Parry Nickerson,CB,dead_cap,jacksonville-jaguars,81529,2019
19646,109412,0,Malcolm Smith,OLB,dead_cap,jacksonville-jaguars,109412,2019
19647,64000,3332,Brandon Watson,RB,dead_cap,jacksonville-jaguars,67332,2019
19648,64000,0,Chuck Harris,DE,dead_cap,jacksonville-jaguars,64000,2019
19649,56000,0,Eli Ankou,DT,dead_cap,jacksonville-jaguars,56000,2019
19650,56000,0,Keishawn Bierria,ILB,dead_cap,jacksonville-jaguars,56000,2019
19651,56000,0,Chase Litton,QB,dead_cap,jacksonville-jaguars,56000,2019
19652,48000,0,Ryan Pope,T,dead_cap,jacksonville-jaguars,48000,2019
19653,48000,0,Matt Sokol,TE,dead_cap,jacksonville-jaguars,48000,2019
19654,0,46832,Jalen Myrick,CB,dead_cap,jacksonville-jaguars,46832,2019
19655,32000,0,Jordan Brown,CB,dead_cap,jacksonville-jaguars,32000,2019
19656,32000,0,Paul Perkins,RB,dead_cap,jacksonville-jaguars,32000,2019
19657,25000,1666,Saivion Smith,CB,dead_cap,jacksonville-jaguars,26666,2019
19658,0,25000,Matt Overton,LS,dead_cap,jacksonville-jaguars,25000,2019
19659,24000,0,Doug Middleton,FS,dead_cap,jacksonville-jaguars,24000,2019
19660,0,20000,Thomas Rawls,RB,dead_cap,jacksonville-jaguars,20000,2019
19661,15000,1666,Tyre Brady,WR,dead_cap,jacksonville-jaguars,16666,2019
19662,15000,1666,Bunchy Stallings,G,dead_cap,jacksonville-jaguars,16666,2019
19663,16000,0,Jayson Stanley,WR,dead_cap,jacksonville-jaguars,16000,2019
19664,10000,1666,Picasso Nelson,CB,dead_cap,jacksonville-jaguars,11666,2019
19665,10000,1666,Connor Strachan,LB,dead_cap,jacksonville-jaguars,11666,2019
19666,8000,0,Sutton Smith,OLB,dead_cap,jacksonville-jaguars,8000,2019
19667,0,6667,Dee Delaney,CB,dead_cap,jacksonville-jaguars,6667,2019
19668,0,6667,Darius Jackson,LB,dead_cap,jacksonville-jaguars,6667,2019
19669,0,6667,Lyndon Johnson,DE,dead_cap,jacksonville-jaguars,6667,2019
19670,0,6667,K.C. McDermott,T,dead_cap,jacksonville-jaguars,6667,2019
19671,0,5000,Allen Lazard,WR,dead_cap,jacksonville-jaguars,5000,2019
19672,0,3334,Tony Adams,T,dead_cap,jacksonville-jaguars,3334,2019
19673,0,3334,Quenton Meeks,CB,dead_cap,jacksonville-jaguars,3334,2019
19674,0,3334,C.J. Reavis,S,dead_cap,jacksonville-jaguars,3334,2019
19675,1000,1666,Zedrick Woods,S,dead_cap,jacksonville-jaguars,2666,2019
19676,0,2000,Andrew Motuapuaka,LB,dead_cap,jacksonville-jaguars,2000,2019
19677,0,1667,Reggie Hunter,LB,dead_cap,jacksonville-jaguars,1667,2019
19678,0,1666,Michael Hughes,DT,dead_cap,jacksonville-jaguars,1666,2019
19679,0,1000,Dredrick Snelson,WR,dead_cap,jacksonville-jaguars,1000,2019
19680,0,833,Raphael Leonard,WR,dead_cap,jacksonville-jaguars,833,2019
19681,0,667,Dorren Miller,WR,dead_cap,jacksonville-jaguars,667,2019
19682,0,666,Andrew Williams,DT,dead_cap,jacksonville-jaguars,666,2019
19683,80000,0,Brian Price,DT,dead_cap,jacksonville-jaguars,80000,2019
19684,9500000,13000000,Marcell Dareus,DT,active,jacksonville-jaguars,22500000,2020
19685,15125000,6750000,Nick Foles,QB,active,jacksonville-jaguars,21875000,2020
19686,15000000,3500000,Calais Campbell,DE,active,jacksonville-jaguars,18500000,2020
19687,13000000,2437500,A.J. Bouye,CB,active,jacksonville-jaguars,15437500,2020
19688,12750000,2650000,Myles Jack,ILB,active,jacksonville-jaguars,15400000,2020
19689,11500000,3000000,Andrew Norwell,G,active,jacksonville-jaguars,14500000,2020
19690,6250000,2500000,Marqise Lee,WR,active,jacksonville-jaguars,8750000,2020
19691,4167388,4471519,Leonard Fournette,RB,active,jacksonville-jaguars,8638907,2020
19692,7000000,1000000,Brandon Linder,C,active,jacksonville-jaguars,8000000,2020
19693,6000000,1666668,D.J. Hayden,CB,active,jacksonville-jaguars,7666668,2020
19694,4675000,1633333,A.J. Cann,G,active,jacksonville-jaguars,6308333,2020
19695,5500000,250000,Jake Ryan,ILB,active,jacksonville-jaguars,5750000,2020
19696,1528756,3640025,Josh Allen,DE,active,jacksonville-jaguars,5168781,2020
19697,3000000,1125000,Josh Lambo,K,active,jacksonville-jaguars,4125000,2020
19698,3400000,600000,Abry Jones,DT,active,jacksonville-jaguars,4000000,2020
19699,3500000,487500,Geoff Swaim,TE,active,jacksonville-jaguars,3987500,2020
19700,2450000,633333,Jarrod Wilson,FS,active,jacksonville-jaguars,3083333,2020
19701,1800000,995000,Chris Conley,WR,active,jacksonville-jaguars,2795000,2020
19702,1403178,1366356,Taven Bryan,DT,active,jacksonville-jaguars,2769534,2020
19703,1422022,811031,Cam Robinson,LT,active,jacksonville-jaguars,2233053,2020
19704,850632,927527,Jawaan Taylor,RT,active,jacksonville-jaguars,1778159,2020
19705,884294,328587,DJ Chark,WR,active,jacksonville-jaguars,1212881,2020
19706,964353,241040,Dawuane Smoot,DE,active,jacksonville-jaguars,1205393,2020
19707,820000,162500,James O'Shaughnessy,TE,active,jacksonville-jaguars,982500,2020
19708,688220,277881,Josh Oliver,TE,active,jacksonville-jaguars,966101,2020
19709,708000,200758,Ronnie Harrison,SS,active,jacksonville-jaguars,908758,2020
19710,735000,169039,Dede Westbrook,WR,active,jacksonville-jaguars,904039,2020
19711,641500,205545,Quincy Williams,LB,active,jacksonville-jaguars,847045,2020
19712,660000,150698,Will Richardson,T,active,jacksonville-jaguars,810698,2020
19713,735000,0,Joshua Dobbs,QB,active,jacksonville-jaguars,735000,2020
19714,735000,0,Josh Jones,S,active,jacksonville-jaguars,735000,2020
19715,735000,0,Charone Peake,WR,active,jacksonville-jaguars,735000,2020
19716,735000,0,Brian Price,DT,active,jacksonville-jaguars,735000,2020
19717,660000,22670,Leon Jacobs,OLB,active,jacksonville-jaguars,682670,2020
19718,660000,17905,Logan Cooke,P,active,jacksonville-jaguars,677905,2020
19719,585000,86439,Ryquell Armstead,RB,active,jacksonville-jaguars,671439,2020
19720,660000,1668,Tre Herndon,CB,active,jacksonville-jaguars,661668,2020
19721,660000,0,Parry Nickerson,CB,active,jacksonville-jaguars,660000,2020
19722,585000,47721,Gardner Minshew,QB,active,jacksonville-jaguars,632721,2020
19723,585000,20796,Dontavius Russell,DT,active,jacksonville-jaguars,605796,2020
19724,585000,1666,Andrew Wingard,S,active,jacksonville-jaguars,586666,2020
19725,585000,0,Dakota Allen,LB,active,jacksonville-jaguars,585000,2020
19726,585000,0,C.J. Board,WR,active,jacksonville-jaguars,585000,2020
19727,585000,0,Tyler Gauthier,C,active,jacksonville-jaguars,585000,2020
19728,585000,0,Joe Giles-Harris,LB,active,jacksonville-jaguars,585000,2020
19729,585000,0,Charles Jones,TE,active,jacksonville-jaguars,585000,2020
19730,585000,0,Taj McGowan,RB,active,jacksonville-jaguars,585000,2020
19731,585000,0,Matthew Orzech,LS,active,jacksonville-jaguars,585000,2020
19732,585000,0,Devine Ozigbo,RB,active,jacksonville-jaguars,585000,2020
19733,585000,0,Michael Walker,WR,active,jacksonville-jaguars,585000,2020
19734,585000,0,Brandon Watson,RB,active,jacksonville-jaguars,585000,2020
19735,510000,20000,Blake Hance,T,active,jacksonville-jaguars,530000,2020
19736,510000,1666,Donnell Greene,T,active,jacksonville-jaguars,511666,2020
19737,510000,0,Jonathan Brown,K,active,jacksonville-jaguars,510000,2020
19738,510000,0,Chuck Harris,DE,active,jacksonville-jaguars,510000,2020
19739,510000,0,K.C. McDermott,T,active,jacksonville-jaguars,510000,2020
19740,510000,0,Ryan Pope,T,active,jacksonville-jaguars,510000,2020
19741,510000,0,Jayson Stanley,WR,active,jacksonville-jaguars,510000,2020
19742,0,5620470,Telvin Smith,OLB,dead_cap,jacksonville-jaguars,5620470,2020
19743,0,37500,Alex McGough,QB,dead_cap,jacksonville-jaguars,37500,2020
19744,0,13334,Marcus Simms,WR,dead_cap,jacksonville-jaguars,13334,2020
19745,0,3334,Tyre Brady,WR,dead_cap,jacksonville-jaguars,3334,2020
19746,0,3334,Picasso Nelson,CB,dead_cap,jacksonville-jaguars,3334,2020
19747,0,3334,Saivion Smith,CB,dead_cap,jacksonville-jaguars,3334,2020
19748,0,3334,Bunchy Stallings,G,dead_cap,jacksonville-jaguars,3334,2020
19749,0,3334,Connor Strachan,LB,dead_cap,jacksonville-jaguars,3334,2020
19750,0,3334,Michael Walker,WR,dead_cap,jacksonville-jaguars,3334,2020
19751,0,3334,Brandon Watson,RB,dead_cap,jacksonville-jaguars,3334,2020
19752,0,3334,Brandon Watson,RB,dead_cap,jacksonville-jaguars,3334,2020
19753,0,3334,Zedrick Woods,S,dead_cap,jacksonville-jaguars,3334,2020
19754,0,2667,Tae Hayes,CB,dead_cap,jacksonville-jaguars,2667,2020
19755,0,2000,Dredrick Snelson,WR,dead_cap,jacksonville-jaguars,2000,2020
19756,0,1668,Michael Hughes,DT,dead_cap,jacksonville-jaguars,1668,2020
19757,0,1667,Raphael Leonard,WR,dead_cap,jacksonville-jaguars,1667,2020
19758,0,1334,Andrew Williams,DT,dead_cap,jacksonville-jaguars,1334,2020
19759,720000,5300000,Brian Waters,G,active,kansas-city-chiefs,6020000,2007
19760,870000,235714,Preist Holmes,RB,active,kansas-city-chiefs,1105714,2007
19761,1000000,4198037,Tony Gonzalez,TE,active,kansas-city-chiefs,5198037,2007
19762,285000,2595000,Dwayne Bowe,WR,active,kansas-city-chiefs,2880000,2007
19763,2350000,0,Jared Allen,DE,active,kansas-city-chiefs,2350000,2007
19764,665000,2930000,Derrick Johnson,ILB,active,kansas-city-chiefs,3595000,2007
19765,1000000,1050000,Napolean Harris,LB,active,kansas-city-chiefs,2050000,2007
19766,360000,2180000,Tamba Hali,OLB,active,kansas-city-chiefs,2540000,2007
19767,600000,250000,Ron Edwards,DT,active,kansas-city-chiefs,850000,2007
19768,850000,0,Keyaron Fox,ILB,active,kansas-city-chiefs,850000,2007
19769,285000,285000,Turk McBride,DE,active,kansas-city-chiefs,570000,2007
19770,360000,265000,Bernard Pollard,S,active,kansas-city-chiefs,625000,2007
19771,435000,140000,Dustin Colquitt,P,active,kansas-city-chiefs,575000,2007
19772,360000,257500,Brodie Croyle,QB,active,kansas-city-chiefs,617500,2007
19773,435000,47500,James Grigsby,LB,active,kansas-city-chiefs,482500,2007
19774,435000,25433,Will Svitek,LT,active,kansas-city-chiefs,460433,2007
19775,285000,175000,Tank Tyler,DT,active,kansas-city-chiefs,460000,2007
19776,360000,23250,Jeff Webb,WR,active,kansas-city-chiefs,383250,2007
19777,360000,11985,Jarrad Page,S,active,kansas-city-chiefs,371985,2007
19778,360000,3750,Dimitri Patterson,CB,active,kansas-city-chiefs,363750,2007
19779,285000,44291,Kolby Smith,RB,active,kansas-city-chiefs,329291,2007
19780,285000,22916,Herb Taylor,T,active,kansas-city-chiefs,307916,2007
19781,285000,0,Johnny Baldwin,LB,active,kansas-city-chiefs,285000,2007
19782,285000,0,Rashad Barksdale,CB,active,kansas-city-chiefs,285000,2007
19783,285000,0,Tyler Thigpen,QB,active,kansas-city-chiefs,285000,2007
19784,84705,0,Tre Stallings,G,active,kansas-city-chiefs,84705,2007
19785,285000,0,Jackie Battle,FB,active,kansas-city-chiefs,285000,2007
19786,35625,0,Michael Allan,TE,active,kansas-city-chiefs,35625,2007
19787,750000,2556190,Larry Johnson,RB,injured_reserve,kansas-city-chiefs,3306190,2007
19788,720000,0,Kyle Turley,LT,injured_reserve,kansas-city-chiefs,720000,2007
19789,360000,0,Pat Thomas,LB,injured_reserve,kansas-city-chiefs,360000,2007
19790,190000,5000,Maurice Price,WR,injured_reserve,kansas-city-chiefs,195000,2007
19791,79990,0,Jackie Battle,FB,practice_squad,kansas-city-chiefs,79990,2007
19792,79900,0,Tre Stallings,G,practice_squad,kansas-city-chiefs,79900,2007
19793,0,6190474,Ryan Sims,DT,dead_cap,kansas-city-chiefs,6190474,2007
19794,1648214,0,Preist Holmes,RB,dead_cap,kansas-city-chiefs,1648214,2007
19795,720000,0,Sammy Knight,S,dead_cap,kansas-city-chiefs,720000,2007
19796,700000,0,Junior Siavii,DT,dead_cap,kansas-city-chiefs,700000,2007
19797,79900,0,Jackie Battle,FB,dead_cap,kansas-city-chiefs,79900,2007
19798,41230,0,Justin Medlock,K,dead_cap,kansas-city-chiefs,41230,2007
19799,41066,0,Marcus Maxey,CB,dead_cap,kansas-city-chiefs,41066,2007
19800,23750,0,Tre Stallings,G,dead_cap,kansas-city-chiefs,23750,2007
19801,8750,0,Michael Allan,TE,dead_cap,kansas-city-chiefs,8750,2007
19802,295000,6638250,Glenn Dorsey,DE,active,kansas-city-chiefs,6933250,2008
19803,2085000,4800000,Brian Waters,G,active,kansas-city-chiefs,6885000,2008
19804,2352941,3406190,Larry Johnson,RB,active,kansas-city-chiefs,5759131,2008
19805,1000000,4698041,Tony Gonzalez,TE,active,kansas-city-chiefs,5698041,2008
19806,295000,3800000,Branden Albert,LT,active,kansas-city-chiefs,4095000,2008
19807,950000,2750000,Napolean Harris,LB,active,kansas-city-chiefs,3700000,2008
19808,745000,2930000,Derrick Johnson,ILB,active,kansas-city-chiefs,3675000,2008
19809,1600000,333333,Devard Darling,WR,active,kansas-city-chiefs,1933333,2008
19810,1300000,250000,Ron Edwards,DT,active,kansas-city-chiefs,1550000,2008
19811,650000,2180000,Tamba Hali,OLB,active,kansas-city-chiefs,2830000,2008
19812,295000,1307000,Brandon Flowers,CB,active,kansas-city-chiefs,1602000,2008
19813,1000000,600000,Demorrio Williams,LB,active,kansas-city-chiefs,1600000,2008
19814,370000,1520000,Dwayne Bowe,WR,active,kansas-city-chiefs,1890000,2008
19815,700000,480000,Dustin Colquitt,P,active,kansas-city-chiefs,1180000,2008
19816,927000,0,Will Svitek,LT,active,kansas-city-chiefs,927000,2008
19817,445000,265000,Bernard Pollard,S,active,kansas-city-chiefs,710000,2008
19818,370000,285000,Turk McBride,DE,active,kansas-city-chiefs,655000,2008
19819,605000,0,Wade Smith,G,active,kansas-city-chiefs,605000,2008
19820,370000,175000,Tank Tyler,DT,active,kansas-city-chiefs,545000,2008
19821,295000,200000,Jamaal Charles,RB,active,kansas-city-chiefs,495000,2008
19822,295000,194667,Brad Cottam,TE,active,kansas-city-chiefs,489667,2008
19823,295000,181667,DaJuan Morgan,S,active,kansas-city-chiefs,476667,2008
19824,445000,23250,Jeff Webb,WR,active,kansas-city-chiefs,468250,2008
19825,465000,0,Steve Weatherford,P,active,kansas-city-chiefs,465000,2008
19826,445000,11985,Jarrad Page,S,active,kansas-city-chiefs,456985,2008
19827,445000,3750,Dimitri Patterson,CB,active,kansas-city-chiefs,448750,2008
19828,445000,0,Nick Novak,K,active,kansas-city-chiefs,445000,2008
19829,445000,0,Pat Thomas,LB,active,kansas-city-chiefs,445000,2008
19830,295000,123250,Will Franklin,WR,active,kansas-city-chiefs,418250,2008
19831,370000,44291,Kolby Smith,RB,active,kansas-city-chiefs,414291,2008
19832,370000,22916,Herb Taylor,T,active,kansas-city-chiefs,392916,2008
19833,370000,0,Tyler Thigpen,QB,active,kansas-city-chiefs,370000,2008
19834,295000,70000,Brandon Carr,CB,active,kansas-city-chiefs,365000,2008
19835,295000,27816,Barry Richardson,LT,active,kansas-city-chiefs,322816,2008
19836,320294,0,Oliver Celestin,S,active,kansas-city-chiefs,320294,2008
19837,295000,15759,Brian Johnston,DE,active,kansas-city-chiefs,310759,2008
19838,295000,10667,Michael  Merritt,TE,active,kansas-city-chiefs,305667,2008
19839,295000,5000,Mike Cox,FB,active,kansas-city-chiefs,300000,2008
19840,244706,24467,Kevin Robinson,WR,active,kansas-city-chiefs,269173,2008
19841,258125,0,Andy Studebaker,OLB,active,kansas-city-chiefs,258125,2008
19842,242941,0,Connor Barth,K,active,kansas-city-chiefs,242941,2008
19843,147117,0,Jackie Battle,FB,active,kansas-city-chiefs,147117,2008
19844,138823,0,Brian De La Puente,C,active,kansas-city-chiefs,138823,2008
19845,445000,257500,Brodie Croyle,QB,injured_reserve,kansas-city-chiefs,702500,2008
19846,176800,0,Jackie Battle,FB,practice_squad,kansas-city-chiefs,176800,2008
19847,88400,0,Brian De La Puente,C,practice_squad,kansas-city-chiefs,88400,2008
19848,88400,0,Maurice Price,WR,practice_squad,kansas-city-chiefs,88400,2008
19849,88400,0,Dantrell Savage,RB,practice_squad,kansas-city-chiefs,88400,2008
19850,3296428,0,Preist Holmes,RB,dead_cap,kansas-city-chiefs,3296428,2008
19851,176800,0,Jackie Battle,FB,dead_cap,kansas-city-chiefs,176800,2008
19852,82460,0,Justin Medlock,K,dead_cap,kansas-city-chiefs,82460,2008
19853,41066,0,Marcus Maxey,CB,dead_cap,kansas-city-chiefs,41066,2008
19854,26250,0,Michael Allan,TE,dead_cap,kansas-city-chiefs,26250,2008
19855,23750,0,Tre Stallings,G,dead_cap,kansas-city-chiefs,23750,2008
19856,20800,0,Travarous Bain,CB,dead_cap,kansas-city-chiefs,20800,2008
19857,5000,0,Maurice Price,WR,dead_cap,kansas-city-chiefs,5000,2008
19858,0,3000,Connor Barth,K,dead_cap,kansas-city-chiefs,3000,2008
19859,5000000,10200000,Matt Cassel,QB,active,kansas-city-chiefs,15200000,2009
19860,3600000,2068750,Brian Waters,G,active,kansas-city-chiefs,5668750,2009
19861,2385000,4424000,Glenn Dorsey,DE,active,kansas-city-chiefs,6809000,2009
19862,1500000,2930000,Derrick Johnson,ILB,active,kansas-city-chiefs,4430000,2009
19863,2860000,0,Tyson Jackson,DE,active,kansas-city-chiefs,2860000,2009
19864,1000000,1500000,Demorrio Williams,LB,active,kansas-city-chiefs,2500000,2009
19865,1500000,250000,Ron Edwards,DT,active,kansas-city-chiefs,1750000,2009
19866,940000,2180000,Tamba Hali,OLB,active,kansas-city-chiefs,3120000,2009
19867,493750,2050000,Branden Albert,LT,active,kansas-city-chiefs,2543750,2009
19868,1545000,0,Jarrad Page,S,active,kansas-city-chiefs,1545000,2009
19869,460000,1620000,Dwayne Bowe,WR,active,kansas-city-chiefs,2080000,2009
19870,900000,480000,Dustin Colquitt,P,active,kansas-city-chiefs,1380000,2009
19871,385000,660000,Brandon Flowers,CB,active,kansas-city-chiefs,1045000,2009
19872,535000,257500,Brodie Croyle,QB,active,kansas-city-chiefs,792500,2009
19873,385000,200000,Jamaal Charles,RB,active,kansas-city-chiefs,585000,2009
19874,385000,194667,Brad Cottam,TE,active,kansas-city-chiefs,579667,2009
19875,385000,181667,DaJuan Morgan,S,active,kansas-city-chiefs,566667,2009
19876,535000,0,Corey Mays,LB,active,kansas-city-chiefs,535000,2009
19877,535000,0,Leonard Pope,TE,active,kansas-city-chiefs,535000,2009
19878,460000,44291,Kolby Smith,RB,active,kansas-city-chiefs,504291,2009
19879,620000,0,Terrance Copper,WR,active,kansas-city-chiefs,620000,2009
19880,620000,0,Travis Daniels,S,active,kansas-city-chiefs,620000,2009
19881,460000,0,Andy Alleman,C,active,kansas-city-chiefs,460000,2009
19882,460000,0,Ryan O'Callaghan,T,active,kansas-city-chiefs,460000,2009
19883,460000,0,Justin Rogers,LB,active,kansas-city-chiefs,460000,2009
19884,460000,0,Tyler Thigpen,QB,active,kansas-city-chiefs,460000,2009
19885,385000,70000,Brandon Carr,CB,active,kansas-city-chiefs,455000,2009
19886,310000,129946,Donald Washington,CB,active,kansas-city-chiefs,439946,2009
19887,385000,27816,Barry Richardson,LT,active,kansas-city-chiefs,412816,2009
19888,405882,0,Tim Castille,RB,active,kansas-city-chiefs,405882,2009
19889,385000,5000,Mike Cox,FB,active,kansas-city-chiefs,390000,2009
19890,385000,0,Thomas Gafford,LS,active,kansas-city-chiefs,385000,2009
19891,385000,0,Wallace Gilberry,DE,active,kansas-city-chiefs,385000,2009
19892,385000,0,Andy Studebaker,OLB,active,kansas-city-chiefs,385000,2009
19893,310000,30000,Quinten Lawrence,WR,active,kansas-city-chiefs,340000,2009
19894,310000,11725,Jake O'Connell,TE,active,kansas-city-chiefs,321725,2009
19895,310000,8416,Ryan Succop,K,active,kansas-city-chiefs,318416,2009
19896,310000,1667,Jovan Belcher,LB,active,kansas-city-chiefs,311667,2009
19897,310000,0,Javarris Williams,RB,active,kansas-city-chiefs,310000,2009
19898,460000,0,Jackie Battle,FB,injured_reserve,kansas-city-chiefs,460000,2009
19899,395000,0,Dantrell Savage,RB,injured_reserve,kansas-city-chiefs,395000,2009
19900,215000,51266,Colin Brown,G,injured_reserve,kansas-city-chiefs,266266,2009
19901,88400,0,Logan Payne,WR,practice_squad,kansas-city-chiefs,88400,2009
19902,6000000,0,Tony Gonzalez,TE,dead_cap,kansas-city-chiefs,6000000,2009
19903,2141176,2556190,Larry Johnson,RB,dead_cap,kansas-city-chiefs,4697366,2009
19904,0,4000000,Napolean Harris,LB,dead_cap,kansas-city-chiefs,4000000,2009
19905,800000,333333,Devard Darling,WR,dead_cap,kansas-city-chiefs,1133333,2009
19906,570000,0,Turk McBride,DE,dead_cap,kansas-city-chiefs,570000,2009
19907,369750,0,Will Franklin,WR,dead_cap,kansas-city-chiefs,369750,2009
19908,265000,0,Bernard Pollard,S,dead_cap,kansas-city-chiefs,265000,2009
19909,175000,0,Tank Tyler,DT,dead_cap,kansas-city-chiefs,175000,2009
19910,48934,0,Kevin Robinson,WR,dead_cap,kansas-city-chiefs,48934,2009
19911,31518,0,Brian Johnston,DE,dead_cap,kansas-city-chiefs,31518,2009
19912,23250,0,Jeff Webb,WR,dead_cap,kansas-city-chiefs,23250,2009
19913,22916,0,Herb Taylor,T,dead_cap,kansas-city-chiefs,22916,2009
19914,16283,0,Javarris Williams,RB,dead_cap,kansas-city-chiefs,16283,2009
19915,10667,0,Michael  Merritt,TE,dead_cap,kansas-city-chiefs,10667,2009
19916,0,3000,Connor Barth,K,dead_cap,kansas-city-chiefs,3000,2009
19917,11750000,450000,Matt Cassel,QB,active,kansas-city-chiefs,12200000,2010
19918,10475000,0,Derrick Johnson,ILB,active,kansas-city-chiefs,10475000,2010
19919,3233500,4424000,Glenn Dorsey,DE,active,kansas-city-chiefs,7657500,2010
19920,3400000,1987500,Brian Waters,G,active,kansas-city-chiefs,5387500,2010
19921,3000000,1850000,Thomas Jones,RB,active,kansas-city-chiefs,4850000,2010
19922,2600000,1557000,Eric Berry,FS,active,kansas-city-chiefs,4157000,2010
19923,1075000,5000000,Tyson Jackson,DE,active,kansas-city-chiefs,6075000,2010
19924,1860000,2180000,Tamba Hali,OLB,active,kansas-city-chiefs,4040000,2010
19925,700000,0,Ryan Lilja,C,active,kansas-city-chiefs,700000,2010
19926,1800000,250000,Ron Edwards,DT,active,kansas-city-chiefs,2050000,2010
19927,642500,2150000,Branden Albert,LT,active,kansas-city-chiefs,2792500,2010
19928,470000,2866666,Jamaal Charles,RB,active,kansas-city-chiefs,3336666,2010
19929,1000000,850000,Demorrio Williams,LB,active,kansas-city-chiefs,1850000,2010
19930,1759000,0,Brodie Croyle,QB,active,kansas-city-chiefs,1759000,2010
19931,1759000,0,Corey Mays,LB,active,kansas-city-chiefs,1759000,2010
19932,1759000,0,Ryan O'Callaghan,T,active,kansas-city-chiefs,1759000,2010
19933,1200000,480000,Dustin Colquitt,P,active,kansas-city-chiefs,1680000,2010
19934,600000,1670000,Dwayne Bowe,WR,active,kansas-city-chiefs,2270000,2010
19935,1305000,0,Andy Studebaker,OLB,active,kansas-city-chiefs,1305000,2010
19936,470000,660000,Brandon Flowers,CB,active,kansas-city-chiefs,1130000,2010
19937,320000,560000,Dexter McCluster,RB,active,kansas-city-chiefs,880000,2010
19938,650000,0,Terrance Copper,WR,active,kansas-city-chiefs,650000,2010
19939,320000,358750,Javier Arenas,CB,active,kansas-city-chiefs,678750,2010
19940,470000,194667,Brad Cottam,TE,active,kansas-city-chiefs,664667,2010
19941,630000,0,Shaun Smith,DT,active,kansas-city-chiefs,630000,2010
19942,630000,0,Charlie Anderson,LB,active,kansas-city-chiefs,630000,2010
19943,630000,0,Leonard Pope,TE,active,kansas-city-chiefs,630000,2010
19944,550000,0,Tyler Thigpen,QB,active,kansas-city-chiefs,550000,2010
19945,320000,228030,Jon Asamoah,G,active,kansas-city-chiefs,548030,2010
19946,545000,0,Tim Castille,RB,active,kansas-city-chiefs,545000,2010
19947,470000,70000,Brandon Carr,CB,active,kansas-city-chiefs,540000,2010
19948,470000,66666,Thomas Gafford,LS,active,kansas-city-chiefs,536666,2010
19949,395000,129946,Donald Washington,CB,active,kansas-city-chiefs,524946,2010
19950,470000,27816,Barry Richardson,LT,active,kansas-city-chiefs,497816,2010
19951,320000,171662,Tony Moeaki,TE,active,kansas-city-chiefs,491662,2010
19952,470000,0,Mike Cox,FB,active,kansas-city-chiefs,470000,2010
19953,470000,0,Wallace Gilberry,DE,active,kansas-city-chiefs,470000,2010
19954,395000,30000,Quinten Lawrence,WR,active,kansas-city-chiefs,425000,2010
19955,395000,11725,Jake O'Connell,TE,active,kansas-city-chiefs,406725,2010
19956,395000,1667,Jovan Belcher,LB,active,kansas-city-chiefs,396667,2010
19957,385000,8416,Ryan Succop,K,active,kansas-city-chiefs,393416,2010
19958,320000,51725,Kendrick Lewis,FS,active,kansas-city-chiefs,371725,2010
19959,320000,48612,Cameron Sheffield,LB,active,kansas-city-chiefs,368612,2010
19960,320000,0,Cory Greenwood,OLB,active,kansas-city-chiefs,320000,2010
19961,320000,0,Reshard Langford,CB,active,kansas-city-chiefs,320000,2010
19962,320000,0,Anthony Toribio,DE,active,kansas-city-chiefs,320000,2010
19963,244705,1250,Justin Cole,ILB,active,kansas-city-chiefs,245955,2010
19964,88400,0,Justin Cole,ILB,practice_squad,kansas-city-chiefs,88400,2010
19965,0,6249999,Larry Johnson,RB,dead_cap,kansas-city-chiefs,6249999,2010
19966,0,333334,Devard Darling,WR,dead_cap,kansas-city-chiefs,333334,2010
19967,181667,0,DaJuan Morgan,S,dead_cap,kansas-city-chiefs,181667,2010
19968,51266,0,Colin Brown,G,dead_cap,kansas-city-chiefs,51266,2010
19969,32566,0,Javarris Williams,RB,dead_cap,kansas-city-chiefs,32566,2010
19970,10667,0,Michael  Merritt,TE,dead_cap,kansas-city-chiefs,10667,2010
19971,1790000,12050000,Tyson Jackson,DE,active,kansas-city-chiefs,13840000,2011
19972,7379000,1500000,Kyle Orton,QB,active,kansas-city-chiefs,8879000,2011
19973,450000,7202700,Eric Berry,FS,active,kansas-city-chiefs,7652700,2011
19974,4750000,4200000,Matt Cassel,QB,active,kansas-city-chiefs,8950000,2011
19975,4082250,4424000,Glenn Dorsey,DE,active,kansas-city-chiefs,8506250,2011
19976,3350000,2916666,Jamaal Charles,RB,active,kansas-city-chiefs,6266666,2011
19977,1000000,2964706,Tamba Hali,OLB,active,kansas-city-chiefs,3964706,2011
19978,2765000,1670000,Dwayne Bowe,WR,active,kansas-city-chiefs,4435000,2011
19979,1000000,2560000,Brandon Flowers,CB,active,kansas-city-chiefs,3560000,2011
19980,3150000,250000,Derrick Johnson,ILB,active,kansas-city-chiefs,3400000,2011
19981,2610000,0,Brandon Carr,CB,active,kansas-city-chiefs,2610000,2011
19982,2000000,0,Ryan Lilja,C,active,kansas-city-chiefs,2000000,2011
19983,1500000,800000,Demorrio Williams,LB,active,kansas-city-chiefs,2300000,2011
19984,841250,2200000,Branden Albert,LT,active,kansas-city-chiefs,3041250,2011
19985,1900000,350000,Thomas Jones,RB,active,kansas-city-chiefs,2250000,2011
19986,1500000,480000,Dustin Colquitt,P,active,kansas-city-chiefs,1980000,2011
19987,450000,1470000,Dexter McCluster,RB,active,kansas-city-chiefs,1920000,2011
19988,1835000,0,Wallace Gilberry,DE,active,kansas-city-chiefs,1835000,2011
19989,1835000,0,Barry Richardson,LT,active,kansas-city-chiefs,1835000,2011
19990,700000,1000000,Steve Breaston,WR,active,kansas-city-chiefs,1700000,2011
19991,1000000,0,LeRon McClain,FB,active,kansas-city-chiefs,1000000,2011
19992,375000,998018,Jonathan Baldwin,WR,active,kansas-city-chiefs,1373018,2011
19993,450000,917166,Javier Arenas,CB,active,kansas-city-chiefs,1367166,2011
19994,950000,50000,Andy Studebaker,OLB,active,kansas-city-chiefs,1000000,2011
19995,525000,408416,Ryan Succop,K,active,kansas-city-chiefs,933416,2011
19996,810000,50000,Terrance Copper,WR,active,kansas-city-chiefs,860000,2011
19997,700000,0,Brandon Siler,LB,active,kansas-city-chiefs,700000,2011
19998,600000,91666,Thomas Gafford,LS,active,kansas-city-chiefs,691666,2011
19999,685000,0,Ryan O'Callaghan,T,active,kansas-city-chiefs,685000,2011
20000,450000,228030,Jon Asamoah,G,active,kansas-city-chiefs,678030,2011
20001,525000,129946,Donald Washington,CB,active,kansas-city-chiefs,654946,2011
20002,375000,262473,Rodney Hudson,C,active,kansas-city-chiefs,637473,2011
20003,450000,171662,Tony Moeaki,TE,active,kansas-city-chiefs,621662,2011
20004,375000,167812,Justin Houston,OLB,active,kansas-city-chiefs,542812,2011
20005,525000,11725,Jake O'Connell,TE,active,kansas-city-chiefs,536725,2011
20006,525000,1667,Jovan Belcher,LB,active,kansas-city-chiefs,526667,2011
20007,910000,0,Anthony Becht,TE,active,kansas-city-chiefs,910000,2011
20008,685000,0,Travis Daniels,S,active,kansas-city-chiefs,685000,2011
20009,375000,138986,Allen Bailey,DE,active,kansas-city-chiefs,513986,2011
20010,480000,30000,Quinten Lawrence,WR,active,kansas-city-chiefs,510000,2011
20011,450000,51725,Kendrick Lewis,FS,active,kansas-city-chiefs,501725,2011
20012,375000,107325,Jalil Brown,CB,active,kansas-city-chiefs,482325,2011
20013,480000,0,Reshard Langford,CB,active,kansas-city-chiefs,480000,2011
20014,450000,0,Cory Greenwood,OLB,active,kansas-city-chiefs,450000,2011
20015,450000,0,Jeremy Horne,WR,active,kansas-city-chiefs,450000,2011
20016,375000,52763,Ricky Stanzi,QB,active,kansas-city-chiefs,427763,2011
20017,375000,49625,Gabe Miller,TE,active,kansas-city-chiefs,424625,2011
20018,375000,19670,Jerrell Powe,DT,active,kansas-city-chiefs,394670,2011
20019,330000,48612,Cameron Sheffield,LB,active,kansas-city-chiefs,378612,2011
20020,375000,2333,Brandon Bair,DE,active,kansas-city-chiefs,377333,2011
20021,375000,0,Shaun Draughn,RB,active,kansas-city-chiefs,375000,2011
20022,700000,50000,Jackie Battle,FB,injured_reserve,kansas-city-chiefs,750000,2011
20023,96900,0,Justin Cole,ILB,practice_squad,kansas-city-chiefs,96900,2011
20024,96900,0,Anthony Toribio,DE,practice_squad,kansas-city-chiefs,96900,2011
20025,483529,0,Jared Gaither,T,dead_cap,kansas-city-chiefs,483529,2011
20026,51266,0,Colin Brown,G,dead_cap,kansas-city-chiefs,51266,2011
20027,0,12848,Shane Bannon,RB,dead_cap,kansas-city-chiefs,12848,2011
20028,1250,0,Justin Cole,ILB,dead_cap,kansas-city-chiefs,1250,2011
20029,11250000,3214706,Tamba Hali,OLB,active,kansas-city-chiefs,14464706,2012
20030,9515000,0,Dwayne Bowe,WR,active,kansas-city-chiefs,9515000,2012
20031,4250000,7750000,Tyson Jackson,DE,active,kansas-city-chiefs,12000000,2012
20032,6431000,4424000,Glenn Dorsey,DE,active,kansas-city-chiefs,10855000,2012
20033,4842800,3202700,Eric Berry,FS,active,kansas-city-chiefs,8045500,2012
20034,5750000,2250000,Brandon Flowers,CB,active,kansas-city-chiefs,8000000,2012
20035,5250000,4200000,Matt Cassel,QB,active,kansas-city-chiefs,9450000,2012
20036,1800000,4087500,Stanford Routt,CB,active,kansas-city-chiefs,5887500,2012
20037,3250000,2916666,Jamaal Charles,RB,active,kansas-city-chiefs,6166666,2012
20038,2050000,2500000,Steve Breaston,WR,active,kansas-city-chiefs,4550000,2012
20039,2717500,2250000,Branden Albert,LT,active,kansas-city-chiefs,4967500,2012
20040,3000000,250000,Derrick Johnson,ILB,active,kansas-city-chiefs,3250000,2012
20041,1400000,1400000,Peyton Hillis,RB,active,kansas-city-chiefs,2800000,2012
20042,2100000,0,Ryan Lilja,C,active,kansas-city-chiefs,2100000,2012
20043,900000,1600000,Eric Winston,RT,active,kansas-city-chiefs,2500000,2012
20044,2000000,400000,Ryan Succop,K,active,kansas-city-chiefs,2400000,2012
20045,1800000,505000,Dustin Colquitt,P,active,kansas-city-chiefs,2305000,2012
20046,390000,1668182,Dontari Poe,DT,active,kansas-city-chiefs,2058182,2012
20047,1927000,0,Jovan Belcher,LB,active,kansas-city-chiefs,1927000,2012
20048,750000,1083333,Kevin Boss,TE,active,kansas-city-chiefs,1833333,2012
20049,718255,998018,Jonathan Baldwin,WR,active,kansas-city-chiefs,1716273,2012
20050,1480000,50000,Andy Studebaker,OLB,active,kansas-city-chiefs,1530000,2012
20051,1500000,0,Brady Quinn,QB,active,kansas-city-chiefs,1500000,2012
20052,950000,200000,Ropati Pitoitua,DE,active,kansas-city-chiefs,1150000,2012
20053,540000,560000,Dexter McCluster,RB,active,kansas-city-chiefs,1100000,2012
20054,540000,358750,Javier Arenas,CB,active,kansas-city-chiefs,898750,2012
20055,850000,0,Abram Elam,S,active,kansas-city-chiefs,850000,2012
20056,390000,454331,Jeff Allen,G,active,kansas-city-chiefs,844331,2012
20057,825000,0,Travis Daniels,S,active,kansas-city-chiefs,825000,2012
20058,504000,292473,Rodney Hudson,C,active,kansas-city-chiefs,796473,2012
20059,700000,91668,Thomas Gafford,LS,active,kansas-city-chiefs,791668,2012
20060,540000,228030,Jon Asamoah,G,active,kansas-city-chiefs,768030,2012
20061,700000,0,Brandon Siler,LB,active,kansas-city-chiefs,700000,2012
20062,700000,0,Ray Willis,T,active,kansas-city-chiefs,700000,2012
20063,490000,171662,Tony Moeaki,TE,active,kansas-city-chiefs,661662,2012
20064,465000,192812,Justin Houston,OLB,active,kansas-city-chiefs,657812,2012
20065,465000,138986,Allen Bailey,DE,active,kansas-city-chiefs,603986,2012
20066,465000,127325,Jalil Brown,CB,active,kansas-city-chiefs,592325,2012
20067,540000,51725,Kendrick Lewis,FS,active,kansas-city-chiefs,591725,2012
20068,925000,0,Russ Hochstein,G,active,kansas-city-chiefs,925000,2012
20069,540000,26250,Cory Greenwood,OLB,active,kansas-city-chiefs,566250,2012
20070,390000,159375,Donald Stephenson,LT,active,kansas-city-chiefs,549375,2012
20071,700000,0,Edgar Jones,OLB,active,kansas-city-chiefs,700000,2012
20072,700000,0,Bryan Kehl,ILB,active,kansas-city-chiefs,700000,2012
20073,700000,25000,Leonard Pope,TE,active,kansas-city-chiefs,725000,2012
20074,540000,0,Steve Maneri,TE,active,kansas-city-chiefs,540000,2012
20075,540000,0,Bryan Mattison,G,active,kansas-city-chiefs,540000,2012
20076,540000,0,Anthony Toribio,DE,active,kansas-city-chiefs,540000,2012
20077,465000,52763,Ricky Stanzi,QB,active,kansas-city-chiefs,517763,2012
20078,390000,113850,Devon Wylie,WR,active,kansas-city-chiefs,503850,2012
20079,465000,28170,Jerrell Powe,DT,active,kansas-city-chiefs,493170,2012
20080,390000,34918,Cyrus Gray,RB,active,kansas-city-chiefs,424918,2012
20081,390000,833,Nate Eachus,RB,active,kansas-city-chiefs,390833,2012
20082,390000,333,Dexter Heyman,LB,active,kansas-city-chiefs,390333,2012
20083,390000,0,Patrick DiMarco,FB,active,kansas-city-chiefs,390000,2012
20084,390000,0,Shaun Draughn,RB,active,kansas-city-chiefs,390000,2012
20085,390000,0,Tysyn Hartman,S,active,kansas-city-chiefs,390000,2012
20086,390000,0,Junior Hemingway,WR,active,kansas-city-chiefs,390000,2012
20087,390000,0,Jamar Newsome,WR,active,kansas-city-chiefs,390000,2012
20088,390000,0,Rich Ranglin,G,active,kansas-city-chiefs,390000,2012
20089,390000,0,Alex Tanney,QB,active,kansas-city-chiefs,390000,2012
20090,390000,0,Neiko Thorpe,CB,active,kansas-city-chiefs,390000,2012
20091,825000,0,Shaun Smith,DT,active,kansas-city-chiefs,825000,2012
20092,390000,0,Hayworth Hicks,G,active,kansas-city-chiefs,390000,2012
20093,700000,0,Leon Williams,LB,active,kansas-city-chiefs,700000,2012
20094,390000,0,Josh Bellamy,WR,active,kansas-city-chiefs,390000,2012
20095,825000,50000,Terrance Copper,WR,injured_reserve,kansas-city-chiefs,875000,2012
20096,700000,0,Martin Rucker,TE,injured_reserve,kansas-city-chiefs,700000,2012
20097,615000,0,Jake O'Connell,TE,injured_reserve,kansas-city-chiefs,615000,2012
20098,540000,0,Kyle McCarthy,CB,injured_reserve,kansas-city-chiefs,540000,2012
20099,390000,48613,De'Quan Menzie,CB,injured_reserve,kansas-city-chiefs,438613,2012
20100,800000,4087500,Stanford Routt,CB,dead_cap,kansas-city-chiefs,4887500,2012
20101,0,600000,Demorrio Williams,LB,dead_cap,kansas-city-chiefs,600000,2012
20102,135000,0,Bryan Mattison,G,dead_cap,kansas-city-chiefs,135000,2012
20103,129946,0,Donald Washington,CB,dead_cap,kansas-city-chiefs,129946,2012
20104,93073,0,Neiko Thorpe,CB,dead_cap,kansas-city-chiefs,93073,2012
20105,38544,38544,Shane Bannon,RB,dead_cap,kansas-city-chiefs,77088,2012
20106,0,49625,Gabe Miller,TE,dead_cap,kansas-city-chiefs,49625,2012
20107,48612,0,Cameron Sheffield,LB,dead_cap,kansas-city-chiefs,48612,2012
20108,0,20333,Jerome Long,DE,dead_cap,kansas-city-chiefs,20333,2012
20109,15666,0,Junior Hemingway,WR,dead_cap,kansas-city-chiefs,15666,2012
20110,3500,0,Brandon Bair,DE,dead_cap,kansas-city-chiefs,3500,2012
20111,0,2666,Josh Bellamy,WR,dead_cap,kansas-city-chiefs,2666,2012
20112,1167,0,Chandler Fenner,CB,dead_cap,kansas-city-chiefs,1167,2012
20113,1000,0,Justin Cheadle,G,dead_cap,kansas-city-chiefs,1000,2012
20114,833,0,Brandon Kinnie,WR,dead_cap,kansas-city-chiefs,833,2012
20115,833,0,Terrance Parks,SS,dead_cap,kansas-city-chiefs,833,2012
20116,500,0,Cam Holland,G,dead_cap,kansas-city-chiefs,500,2012
20117,12250000,3214706,Tamba Hali,OLB,active,kansas-city-chiefs,15464706,2013
20118,7009000,3202700,Eric Berry,FS,active,kansas-city-chiefs,10211700,2013
20119,9828000,0,Branden Albert,LT,active,kansas-city-chiefs,9828000,2013
20120,7500000,1000000,Alex Smith,QB,active,kansas-city-chiefs,8500000,2013
20121,4200000,5500000,Tyson Jackson,DE,active,kansas-city-chiefs,9700000,2013
20122,3350000,3250000,Brandon Flowers,CB,active,kansas-city-chiefs,6600000,2013
20123,1750000,3916666,Jamaal Charles,RB,active,kansas-city-chiefs,5666666,2013
20124,405000,3629636,Eric Fisher,LT,active,kansas-city-chiefs,4034636,2013
20125,750000,3250000,Dwayne Bowe,WR,active,kansas-city-chiefs,4000000,2013
20126,2250000,1250000,Derrick Johnson,ILB,active,kansas-city-chiefs,3500000,2013
20127,715000,2285000,Sean Smith,CB,active,kansas-city-chiefs,3000000,2013
20128,950000,1800000,Dunta Robinson,CB,active,kansas-city-chiefs,2750000,2013
20129,904546,1668182,Dontari Poe,DT,active,kansas-city-chiefs,2572728,2013
20130,1200000,1175000,Anthony Fasano,TE,active,kansas-city-chiefs,2375000,2013
20131,850000,1450000,Mike DeVito,DE,active,kansas-city-chiefs,2300000,2013
20132,950000,900000,Dustin Colquitt,P,active,kansas-city-chiefs,1850000,2013
20133,750000,1050000,Donnie Avery,WR,active,kansas-city-chiefs,1800000,2013
20134,750000,1050000,Chase Daniel,QB,active,kansas-city-chiefs,1800000,2013
20135,1323000,228030,Jon Asamoah,G,active,kansas-city-chiefs,1551030,2013
20136,715000,758750,Ryan Succop,K,active,kansas-city-chiefs,1473750,2013
20137,630000,770000,Dexter McCluster,RB,active,kansas-city-chiefs,1400000,2013
20138,1323000,51725,Kendrick Lewis,FS,active,kansas-city-chiefs,1374725,2013
20139,591083,464331,Jeff Allen,G,active,kansas-city-chiefs,1055414,2013
20140,643736,312473,Rodney Hudson,C,active,kansas-city-chiefs,956209,2013
20141,555000,192812,Justin Houston,OLB,active,kansas-city-chiefs,747812,2013
20142,555000,163986,Allen Bailey,DE,active,kansas-city-chiefs,718986,2013
20143,705797,0,A.J.  Jenkins,WR,active,kansas-city-chiefs,705797,2013
20144,630000,70000,Geoff Schwartz,G,active,kansas-city-chiefs,700000,2013
20145,480000,184375,Donald Stephenson,LT,active,kansas-city-chiefs,664375,2013
20146,630000,20000,Frank Zombo,OLB,active,kansas-city-chiefs,650000,2013
20147,405000,175826,Travis Kelce,TE,active,kansas-city-chiefs,580826,2013
20148,715000,20000,Akeem Jordan,ILB,active,kansas-city-chiefs,735000,2013
20149,715000,10000,Thomas Gafford,LS,active,kansas-city-chiefs,725000,2013
20150,715000,0,Husain Abdullah,FS,active,kansas-city-chiefs,715000,2013
20151,715000,0,Quintin Demps,SS,active,kansas-city-chiefs,715000,2013
20152,555000,0,Ron Parker,FS,active,kansas-city-chiefs,555000,2013
20153,555000,0,Anthony Sherman,FB,active,kansas-city-chiefs,555000,2013
20154,405000,126504,Knile Davis,RB,active,kansas-city-chiefs,531504,2013
20155,405000,121500,Nico Johnson,ILB,active,kansas-city-chiefs,526500,2013
20156,480000,34918,Cyrus Gray,RB,active,kansas-city-chiefs,514918,2013
20157,480000,0,Jaye Howard,DE,active,kansas-city-chiefs,480000,2013
20158,480000,0,James-Michael Johnson,OLB,active,kansas-city-chiefs,480000,2013
20159,480000,0,Dezman Moses,OLB,active,kansas-city-chiefs,480000,2013
20160,405000,31279,Eric Kush,G,active,kansas-city-chiefs,436279,2013
20161,405000,30000,Rokevious Watkins,G,active,kansas-city-chiefs,435000,2013
20162,405000,17281,Mike Catapano,DE,active,kansas-city-chiefs,422281,2013
20163,405000,3333,Tyler Bray,QB,active,kansas-city-chiefs,408333,2013
20164,405000,0,Marcus Cooper,CB,active,kansas-city-chiefs,405000,2013
20165,405000,0,Junior Hemingway,WR,active,kansas-city-chiefs,405000,2013
20166,405000,0,Sean McGrath,TE,active,kansas-city-chiefs,405000,2013
20167,480000,0,Rishaw  Johnson,G,active,kansas-city-chiefs,480000,2013
20168,288000,333,Colin Kelly,RT,active,kansas-city-chiefs,288333,2013
20169,630000,0,Kyle Williams,WR,active,kansas-city-chiefs,630000,2013
20170,405000,0,Josh Martin,OLB,active,kansas-city-chiefs,405000,2013
20171,555000,0,Chad Hall,WR,active,kansas-city-chiefs,555000,2013
20172,555000,0,Richard Gordon,TE,active,kansas-city-chiefs,555000,2013
20173,555000,0,Jerrell Powe,DT,active,kansas-city-chiefs,555000,2013
20174,555000,0,Ricky Henry,G,injured_reserve,kansas-city-chiefs,555000,2013
20175,288000,53878,Sanders Commings,FS,injured_reserve,kansas-city-chiefs,341878,2013
20176,480000,0,Dominique Jones,TE,non_fb_injury,kansas-city-chiefs,480000,2013
20177,74118,0,Kyle Love,DT,practice_squad,kansas-city-chiefs,74118,2013
20178,50000,0,Rokevious Watkins,G,practice_squad,kansas-city-chiefs,50000,2013
20179,36000,0,Chandler Burden,C,practice_squad,kansas-city-chiefs,36000,2013
20180,18000,0,Rishaw  Johnson,G,practice_squad,kansas-city-chiefs,18000,2013
20181,12000,0,Jordan Miller,DT,practice_squad,kansas-city-chiefs,12000,2013
20182,6000,0,Jacob Byrne,TE,practice_squad,kansas-city-chiefs,6000,2013
20183,6000,0,Fred Williams,WR,practice_squad,kansas-city-chiefs,6000,2013
20184,3950000,0,Matt Cassel,QB,dead_cap,kansas-city-chiefs,3950000,2013
20185,0,3000000,Steve Breaston,WR,dead_cap,kansas-city-chiefs,3000000,2013
20186,3000000,0,Eric Winston,RT,dead_cap,kansas-city-chiefs,3000000,2013
20187,2700000,0,Glenn Dorsey,DE,dead_cap,kansas-city-chiefs,2700000,2013
20188,0,1166667,Kevin Boss,TE,dead_cap,kansas-city-chiefs,1166667,2013
20189,998018,0,Jonathan Baldwin,WR,dead_cap,kansas-city-chiefs,998018,2013
20190,949879,0,Tony Moeaki,TE,dead_cap,kansas-city-chiefs,949879,2013
20191,457059,0,Chad Hall,WR,dead_cap,kansas-city-chiefs,457059,2013
20192,359118,0,Anthony Toribio,DE,dead_cap,kansas-city-chiefs,359118,2013
20193,358750,0,Javier Arenas,CB,dead_cap,kansas-city-chiefs,358750,2013
20194,288000,0,Lucas Patterson,G,dead_cap,kansas-city-chiefs,288000,2013
20195,237177,0,Dustin Waldron,LT,dead_cap,kansas-city-chiefs,237177,2013
20196,163441,0,Bradley McDougald,SS,dead_cap,kansas-city-chiefs,163441,2013
20197,145839,0,De'Quan Menzie,CB,dead_cap,kansas-city-chiefs,145839,2013
20198,142941,0,Kevin Brock,TE,dead_cap,kansas-city-chiefs,142941,2013
20199,133850,0,Devon Wylie,WR,dead_cap,kansas-city-chiefs,133850,2013
20200,125471,3333,Josh Martin,OLB,dead_cap,kansas-city-chiefs,128804,2013
20201,117325,0,Jalil Brown,CB,dead_cap,kansas-city-chiefs,117325,2013
20202,0,99250,Gabe Miller,TE,dead_cap,kansas-city-chiefs,99250,2013
20203,98000,0,Toben Opurum,DE,dead_cap,kansas-city-chiefs,98000,2013
20204,84964,0,Jerrell Powe,DT,dead_cap,kansas-city-chiefs,84964,2013
20205,75000,0,Terrance Copper,WR,dead_cap,kansas-city-chiefs,75000,2013
20206,52763,12000,Ricky Stanzi,QB,dead_cap,kansas-city-chiefs,64763,2013
20207,48612,0,Cameron Sheffield,LB,dead_cap,kansas-city-chiefs,48612,2013
20208,0,45450,Jerome Long,DE,dead_cap,kansas-city-chiefs,45450,2013
20209,34884,0,Junior Hemingway,WR,dead_cap,kansas-city-chiefs,34884,2013
20210,30000,0,Dominique Jones,TE,dead_cap,kansas-city-chiefs,30000,2013
20211,24833,0,Darin Drakeford,ILB,dead_cap,kansas-city-chiefs,24833,2013
20212,19670,0,Braden Wilson,FB,dead_cap,kansas-city-chiefs,19670,2013
20213,18750,0,Cory Greenwood,OLB,dead_cap,kansas-city-chiefs,18750,2013
20214,10000,0,Zac Diles,ILB,dead_cap,kansas-city-chiefs,10000,2013
20215,10000,0,Edgar Jones,OLB,dead_cap,kansas-city-chiefs,10000,2013
20216,6000,0,Jheranie Boyd,WR,dead_cap,kansas-city-chiefs,6000,2013
20217,0,5334,Josh Bellamy,WR,dead_cap,kansas-city-chiefs,5334,2013
20218,5000,0,Steven Baker,RT,dead_cap,kansas-city-chiefs,5000,2013
20219,4667,0,Brandon Bair,DE,dead_cap,kansas-city-chiefs,4667,2013
20220,3333,0,Neiko Thorpe,CB,dead_cap,kansas-city-chiefs,3333,2013
20221,2833,0,Otha Foster III,S,dead_cap,kansas-city-chiefs,2833,2013
20222,2833,0,Brad Madison,DE,dead_cap,kansas-city-chiefs,2833,2013
20223,2334,0,Chandler Fenner,CB,dead_cap,kansas-city-chiefs,2334,2013
20224,2334,0,Taylor Gentry,FB,dead_cap,kansas-city-chiefs,2334,2013
20225,2000,0,Justin Cheadle,G,dead_cap,kansas-city-chiefs,2000,2013
20226,1833,0,Rob Lohr,DE,dead_cap,kansas-city-chiefs,1833,2013
20227,1667,0,Nate Eachus,RB,dead_cap,kansas-city-chiefs,1667,2013
20228,1667,0,Brandon Kinnie,WR,dead_cap,kansas-city-chiefs,1667,2013
20229,1667,0,Terrance Parks,SS,dead_cap,kansas-city-chiefs,1667,2013
20230,1666,0,Demetrius Harris,TE,dead_cap,kansas-city-chiefs,1666,2013
20231,1000,0,Cam Holland,G,dead_cap,kansas-city-chiefs,1000,2013
20232,833,0,Rico Richardson,WR,dead_cap,kansas-city-chiefs,833,2013
20233,833,0,Ridge Wilson,OLB,dead_cap,kansas-city-chiefs,833,2013
20234,667,0,Dexter Heyman,LB,dead_cap,kansas-city-chiefs,667,2013
20235,666,0,Frankie Hammond,WR,dead_cap,kansas-city-chiefs,666,2013
20236,8235294,3250000,Dwayne Bowe,WR,active,kansas-city-chiefs,11485294,2014
20237,6250000,5214706,Tamba Hali,OLB,active,kansas-city-chiefs,11464706,2014
20238,4100000,6866666,Jamaal Charles,RB,active,kansas-city-chiefs,10966666,2014
20239,3450000,2300000,Sean Smith,CB,active,kansas-city-chiefs,5750000,2014
20240,495000,4548295,Eric Fisher,LT,active,kansas-city-chiefs,5043295,2014
20241,1000000,3600000,Alex Smith,QB,active,kansas-city-chiefs,4600000,2014
20242,3300000,1250000,Derrick Johnson,ILB,active,kansas-city-chiefs,4550000,2014
20243,2950000,1331250,Anthony Fasano,TE,active,kansas-city-chiefs,4281250,2014
20244,2950000,850000,Dustin Colquitt,P,active,kansas-city-chiefs,3800000,2014
20245,2350000,1050000,Chase Daniel,QB,active,kansas-city-chiefs,3400000,2014
20246,1419092,1668182,Dontari Poe,DT,active,kansas-city-chiefs,3087274,2014
20247,1650000,1200000,Donnie Avery,WR,active,kansas-city-chiefs,2850000,2014
20248,645000,2163986,Allen Bailey,DE,active,kansas-city-chiefs,2808986,2014
20249,730000,1238750,Joe Mays,ILB,active,kansas-city-chiefs,1968750,2014
20250,730000,1020000,Vance Walker,DE,active,kansas-city-chiefs,1750000,2014
20251,1406000,192812,Justin Houston,OLB,active,kansas-city-chiefs,1598812,2014
20252,420000,1063400,Dee Ford,OLB,active,kansas-city-chiefs,1483400,2014
20253,762166,504331,Jeff Allen,G,active,kansas-city-chiefs,1266497,2014
20254,645000,500000,Anthony Sherman,FB,active,kansas-city-chiefs,1145000,2014
20255,730000,400000,Husain Abdullah,FS,active,kansas-city-chiefs,1130000,2014
20256,1125000,0,Mike McGlynn,G,active,kansas-city-chiefs,1125000,2014
20257,803104,312473,Rodney Hudson,C,active,kansas-city-chiefs,1115577,2014
20258,750000,150000,Jeff Linkenbach,RT,active,kansas-city-chiefs,900000,2014
20259,730000,75000,Frank Zombo,OLB,active,kansas-city-chiefs,805000,2014
20260,730000,70000,Christopher Owens,CB,active,kansas-city-chiefs,800000,2014
20261,495000,211826,Travis Kelce,TE,active,kansas-city-chiefs,706826,2014
20262,495000,151504,Knile Davis,RB,active,kansas-city-chiefs,646504,2014
20263,645000,0,Josh Mauga,ILB,active,kansas-city-chiefs,645000,2014
20264,645000,0,Ron Parker,FS,active,kansas-city-chiefs,645000,2014
20265,435882,184375,Donald Stephenson,LT,active,kansas-city-chiefs,620257,2014
20266,855000,0,Kevin Vickerson,DT,active,kansas-city-chiefs,855000,2014
20267,730000,25000,Thomas Gafford,LS,active,kansas-city-chiefs,755000,2014
20268,730000,0,Kurt Coleman,FS,active,kansas-city-chiefs,730000,2014
20269,730000,0,Ryan Harris,LT,active,kansas-city-chiefs,730000,2014
20270,570000,0,Jaye Howard,DE,active,kansas-city-chiefs,570000,2014
20271,570000,0,James-Michael Johnson,OLB,active,kansas-city-chiefs,570000,2014
20272,570000,0,Kelcie McCray,SS,active,kansas-city-chiefs,570000,2014
20273,420000,137278,Phillip Gaines,CB,active,kansas-city-chiefs,557278,2014
20274,570000,0,Jamell Fleming,S,active,kansas-city-chiefs,570000,2014
20275,495000,39279,Eric Kush,G,active,kansas-city-chiefs,534279,2014
20276,420000,105027,De'Anthony Thomas,WR,active,kansas-city-chiefs,525027,2014
20277,495000,0,Marcus Cooper,CB,active,kansas-city-chiefs,495000,2014
20278,495000,0,Junior Hemingway,WR,active,kansas-city-chiefs,495000,2014
20279,495000,0,Josh Martin,OLB,active,kansas-city-chiefs,495000,2014
20280,420000,45606,Aaron Murray,QB,active,kansas-city-chiefs,465606,2014
20281,420000,26055,Zach Fulton,G,active,kansas-city-chiefs,446055,2014
20282,420000,25075,Laurent Duvernay-Tardif,G,active,kansas-city-chiefs,445075,2014
20283,645000,0,Joe McKnight,RB,active,kansas-city-chiefs,645000,2014
20284,420000,3333,Albert Wilson,WR,active,kansas-city-chiefs,423333,2014
20285,420000,666,Cairo Santos,K,active,kansas-city-chiefs,420666,2014
20286,420000,0,Frankie Hammond,WR,active,kansas-city-chiefs,420000,2014
20287,420000,0,Demetrius Harris,TE,active,kansas-city-chiefs,420000,2014
20288,318000,25281,Mike Catapano,DE,active,kansas-city-chiefs,343281,2014
20289,318000,3333,Tyler Bray,QB,active,kansas-city-chiefs,321333,2014
20290,855000,0,Jason Avant,WR,active,kansas-city-chiefs,855000,2014
20291,222352,0,Daniel Sorensen,SS,active,kansas-city-chiefs,222352,2014
20292,420000,0,Charcandrick West,RB,active,kansas-city-chiefs,420000,2014
20293,645000,0,Richard Gordon,TE,active,kansas-city-chiefs,645000,2014
20294,420000,0,Nick Williams,DE,active,kansas-city-chiefs,420000,2014
20295,3250000,1650000,Mike DeVito,DE,injured_reserve,kansas-city-chiefs,4900000,2014
20296,1021594,0,A.J.  Jenkins,WR,injured_reserve,kansas-city-chiefs,1021594,2014
20297,570000,35418,Cyrus Gray,RB,injured_reserve,kansas-city-chiefs,605418,2014
20298,570000,0,Dezman Moses,OLB,injured_reserve,kansas-city-chiefs,570000,2014
20299,303000,61878,Sanders Commings,FS,injured_reserve,kansas-city-chiefs,364878,2014
20300,107100,0,Ricky Henry,G,practice_squad,kansas-city-chiefs,107100,2014
20301,75600,0,Deji Olatoye,CB,practice_squad,kansas-city-chiefs,75600,2014
20302,69300,0,Brandon Barden,TE,practice_squad,kansas-city-chiefs,69300,2014
20303,63000,0,Darin Drakeford,ILB,practice_squad,kansas-city-chiefs,63000,2014
20304,50400,0,Hebron Fangupo,DT,practice_squad,kansas-city-chiefs,50400,2014
20305,18900,0,JoJo Dickson,ILB,practice_squad,kansas-city-chiefs,18900,2014
20306,18900,0,Jarrod Pughsley,LT,practice_squad,kansas-city-chiefs,18900,2014
20307,12600,0,Corbin Louks,WR,practice_squad,kansas-city-chiefs,12600,2014
20308,6300,0,Adam Schiltz,TE,practice_squad,kansas-city-chiefs,6300,2014
20309,0,0,Fred Williams,WR,practice_squad,kansas-city-chiefs,0,2014
20310,0,3250000,Brandon Flowers,CB,dead_cap,kansas-city-chiefs,3250000,2014
20311,2000000,0,Dunta Robinson,CB,dead_cap,kansas-city-chiefs,2000000,2014
20312,998018,0,Jonathan Baldwin,WR,dead_cap,kansas-city-chiefs,998018,2014
20313,0,758750,Ryan Succop,K,dead_cap,kansas-city-chiefs,758750,2014
20314,308065,0,Jerry Franklin,OLB,dead_cap,kansas-city-chiefs,308065,2014
20315,262059,0,Damion Square,DT,dead_cap,kansas-city-chiefs,262059,2014
20316,227700,0,Devon Wylie,WR,dead_cap,kansas-city-chiefs,227700,2014
20317,200000,0,Tyson Jackson,DE,dead_cap,kansas-city-chiefs,200000,2014
20318,37800,129500,Nico Johnson,ILB,dead_cap,kansas-city-chiefs,167300,2014
20319,160412,0,Damond Smith,CB,dead_cap,kansas-city-chiefs,160412,2014
20320,109706,0,DeMarcus Van Dyke,CB,dead_cap,kansas-city-chiefs,109706,2014
20321,107325,0,Jalil Brown,CB,dead_cap,kansas-city-chiefs,107325,2014
20322,100800,0,Curtis Feigt,RT,dead_cap,kansas-city-chiefs,100800,2014
20323,88200,0,Armon Binns,WR,dead_cap,kansas-city-chiefs,88200,2014
20324,68806,2666,Daniel Sorensen,SS,dead_cap,kansas-city-chiefs,71472,2014
20325,63000,1333,Charcandrick West,RB,dead_cap,kansas-city-chiefs,64333,2014
20326,59010,0,Braden Wilson,FB,dead_cap,kansas-city-chiefs,59010,2014
20327,56118,0,Ryan McKee,T,dead_cap,kansas-city-chiefs,56118,2014
20328,52763,0,Ricky Stanzi,QB,dead_cap,kansas-city-chiefs,52763,2014
20329,44100,0,Jarrod Pughsley,LT,dead_cap,kansas-city-chiefs,44100,2014
20330,37800,0,Jerel Worthy,DT,dead_cap,kansas-city-chiefs,37800,2014
20331,37800,0,Adam Schiltz,TE,dead_cap,kansas-city-chiefs,37800,2014
20332,23412,10000,Kyle Williams,WR,dead_cap,kansas-city-chiefs,33412,2014
20333,0,30000,Rokevious Watkins,G,dead_cap,kansas-city-chiefs,30000,2014
20334,25200,0,Jordan Campbell,OLB,dead_cap,kansas-city-chiefs,25200,2014
20335,19670,0,Jerrell Powe,DT,dead_cap,kansas-city-chiefs,19670,2014
20336,18900,0,Justin Jones,TE,dead_cap,kansas-city-chiefs,18900,2014
20337,12600,3333,Kona Schwenke,DT,dead_cap,kansas-city-chiefs,15933,2014
20338,12600,0,Ja'Gared Davis,ILB,dead_cap,kansas-city-chiefs,12600,2014
20339,6300,2833,Darryl Surgent,WR,dead_cap,kansas-city-chiefs,9133,2014
20340,6300,1000,Ben Gottschalk,RT,dead_cap,kansas-city-chiefs,7300,2014
20341,0,6667,Josh Martin,OLB,dead_cap,kansas-city-chiefs,6667,2014
20342,6300,0,Hebron Fangupo,DT,dead_cap,kansas-city-chiefs,6300,2014
20343,6300,0,Charley Hughlett,LS,dead_cap,kansas-city-chiefs,6300,2014
20344,6300,0,Orie Lemon,ILB,dead_cap,kansas-city-chiefs,6300,2014
20345,6300,0,Robert Steeples,CB,dead_cap,kansas-city-chiefs,6300,2014
20346,5667,0,Otha Foster III,S,dead_cap,kansas-city-chiefs,5667,2014
20347,5667,0,Brad Madison,DE,dead_cap,kansas-city-chiefs,5667,2014
20348,5000,0,Steven Baker,RT,dead_cap,kansas-city-chiefs,5000,2014
20349,5000,0,Bradley McDougald,SS,dead_cap,kansas-city-chiefs,5000,2014
20350,3667,0,Rob Lohr,DE,dead_cap,kansas-city-chiefs,3667,2014
20351,3334,0,Demetrius Harris,TE,dead_cap,kansas-city-chiefs,3334,2014
20352,0,2666,James Baker,RB,dead_cap,kansas-city-chiefs,2666,2014
20353,0,2000,Ben Johnson,OLB,dead_cap,kansas-city-chiefs,2000,2014
20354,0,2000,David Van Dyke,CB,dead_cap,kansas-city-chiefs,2000,2014
20355,1667,0,Darin Drakeford,ILB,dead_cap,kansas-city-chiefs,1667,2014
20356,1667,0,Rico Richardson,WR,dead_cap,kansas-city-chiefs,1667,2014
20357,1667,0,Ridge Wilson,OLB,dead_cap,kansas-city-chiefs,1667,2014
20358,1334,0,Frankie Hammond,WR,dead_cap,kansas-city-chiefs,1334,2014
20359,0,333,DeRon Furr,S,dead_cap,kansas-city-chiefs,333,2014
20360,0,333,Colin Kelly,RT,dead_cap,kansas-city-chiefs,333,2014
20361,11900000,3700000,Alex Smith,QB,active,kansas-city-chiefs,15600000,2015
20362,5155000,3202700,Eric Berry,FS,active,kansas-city-chiefs,8357700,2015
20363,4450000,4854170,Jamaal Charles,RB,active,kansas-city-chiefs,9304170,2015
20364,3500000,3500000,Sean Smith,CB,active,kansas-city-chiefs,7000000,2015
20365,585000,5466954,Eric Fisher,LT,active,kansas-city-chiefs,6051954,2015
20366,4000000,1250000,Derrick Johnson,ILB,active,kansas-city-chiefs,5250000,2015
20367,1000000,4100000,Justin Houston,OLB,active,kansas-city-chiefs,5100000,2015
20368,1000000,3964706,Tamba Hali,OLB,active,kansas-city-chiefs,4964706,2015
20369,3750000,1050000,Chase Daniel,QB,active,kansas-city-chiefs,4800000,2015
20370,2950000,850000,Dustin Colquitt,P,active,kansas-city-chiefs,3800000,2015
20371,1933640,1668182,Dontari Poe,DT,active,kansas-city-chiefs,3601822,2015
20372,750000,2650000,Jeremy Maclin,WR,active,kansas-city-chiefs,3400000,2015
20373,1000000,2231250,Allen Bailey,DE,active,kansas-city-chiefs,3231250,2015
20374,870000,1750000,Mike DeVito,DE,active,kansas-city-chiefs,2620000,2015
20375,750000,1250000,Ron Parker,FS,active,kansas-city-chiefs,2000000,2015
20376,790850,1063400,Dee Ford,OLB,active,kansas-city-chiefs,1854250,2015
20377,750000,1000000,Josh Mauga,ILB,active,kansas-city-chiefs,1750000,2015
20378,435000,1307574,Marcus Peters,CB,active,kansas-city-chiefs,1742574,2015
20379,745000,775000,Jah Reid,RT,active,kansas-city-chiefs,1520000,2015
20380,750000,750000,Anthony Sherman,FB,active,kansas-city-chiefs,1500000,2015
20381,973249,504331,Jeff Allen,G,active,kansas-city-chiefs,1477580,2015
20382,750000,633333,Paul Fanaika,G,active,kansas-city-chiefs,1383333,2015
20383,870000,417500,Tyvon Branch,SS,active,kansas-city-chiefs,1287500,2015
20384,745000,400000,Husain Abdullah,FS,active,kansas-city-chiefs,1145000,2015
20385,585000,268826,Travis Kelce,TE,active,kansas-city-chiefs,853826,2015
20386,435000,414649,Mitch Morse,C,active,kansas-city-chiefs,849649,2015
20387,660000,184375,Donald Stephenson,LT,active,kansas-city-chiefs,844375,2015
20388,745000,75000,Frank Zombo,OLB,active,kansas-city-chiefs,820000,2015
20389,585000,151504,Knile Davis,RB,active,kansas-city-chiefs,736504,2015
20390,870000,80000,Jason Avant,WR,active,kansas-city-chiefs,950000,2015
20391,660000,0,Jamell Fleming,S,active,kansas-city-chiefs,660000,2015
20392,660000,0,Jaye Howard,DE,active,kansas-city-chiefs,660000,2015
20393,435000,178108,Chris Conley,WR,active,kansas-city-chiefs,613108,2015
20394,585000,0,Marcus Cooper,CB,active,kansas-city-chiefs,585000,2015
20395,585000,0,Dezman Moses,OLB,active,kansas-city-chiefs,585000,2015
20396,435000,145488,Steven Nelson,CB,active,kansas-city-chiefs,580488,2015
20397,510000,53606,Aaron Murray,QB,active,kansas-city-chiefs,563606,2015
20398,435000,125030,Ramik Wilson,ILB,active,kansas-city-chiefs,560030,2015
20399,510000,34055,Zach Fulton,G,active,kansas-city-chiefs,544055,2015
20400,510000,33075,Laurent Duvernay-Tardif,G,active,kansas-city-chiefs,543075,2015
20401,510000,3333,Albert Wilson,WR,active,kansas-city-chiefs,513333,2015
20402,510000,666,Cairo Santos,K,active,kansas-city-chiefs,510666,2015
20403,510000,0,Demetrius Harris,TE,active,kansas-city-chiefs,510000,2015
20404,510000,0,Daniel Sorensen,SS,active,kansas-city-chiefs,510000,2015
20405,510000,0,Charcandrick West,RB,active,kansas-city-chiefs,510000,2015
20406,510000,0,Nick Williams,DE,active,kansas-city-chiefs,510000,2015
20407,364235,145278,Phillip Gaines,CB,active,kansas-city-chiefs,509513,2015
20408,435000,41563,D.J. Alexander,ILB,active,kansas-city-chiefs,476563,2015
20409,435000,22621,Rakeem Nunez-Roches,DE,active,kansas-city-chiefs,457621,2015
20410,435000,0,Brian Parker,TE,active,kansas-city-chiefs,435000,2015
20411,435000,0,James Winchester,LS,active,kansas-city-chiefs,435000,2015
20412,360000,0,Spencer Ware,RB,active,kansas-city-chiefs,360000,2015
20413,318000,3333,Justin March,ILB,active,kansas-city-chiefs,321333,2015
20414,210000,0,David King,DE,active,kansas-city-chiefs,210000,2015
20415,180000,0,Frankie Hammond,WR,active,kansas-city-chiefs,180000,2015
20416,102352,0,Jarrod Pughsley,LT,active,kansas-city-chiefs,102352,2015
20417,900000,1500000,Ben Grubbs,G,injured_reserve,kansas-city-chiefs,2400000,2015
20418,386823,41563,James O'Shaughnessy,TE,injured_reserve,kansas-city-chiefs,428386,2015
20419,510000,113027,De'Anthony Thomas,WR,non_fb_injury,kansas-city-chiefs,623027,2015
20420,435000,0,Curtis Feigt,RT,non_fb_injury,kansas-city-chiefs,435000,2015
20421,112200,0,Da'Ron Brown,WR,practice_squad,kansas-city-chiefs,112200,2015
20422,112200,0,Laurence Gibson,T,practice_squad,kansas-city-chiefs,112200,2015
20423,92400,0,Jimmy Staten,DT,practice_squad,kansas-city-chiefs,92400,2015
20424,79200,0,Michael Liedtke,G,practice_squad,kansas-city-chiefs,79200,2015
20425,66000,0,Fred Williams,WR,practice_squad,kansas-city-chiefs,66000,2015
20426,59400,0,Tyrell Adams,OLB,practice_squad,kansas-city-chiefs,59400,2015
20427,46200,0,Ross Travis,TE,practice_squad,kansas-city-chiefs,46200,2015
20428,0,8894118,Dwayne Bowe,WR,dead_cap,kansas-city-chiefs,8894118,2015
20429,0,4000000,Brandon Flowers,CB,dead_cap,kansas-city-chiefs,4000000,2015
20430,0,2250000,Anthony Fasano,TE,dead_cap,kansas-city-chiefs,2250000,2015
20431,0,2000000,Vance Walker,DE,dead_cap,kansas-city-chiefs,2000000,2015
20432,0,1017500,Ryan Succop,K,dead_cap,kansas-city-chiefs,1017500,2015
20433,0,1000000,Joe Mays,ILB,dead_cap,kansas-city-chiefs,1000000,2015
20434,0,500000,Donnie Avery,WR,dead_cap,kansas-city-chiefs,500000,2015
20435,358235,62378,Sanders Commings,FS,dead_cap,kansas-city-chiefs,420613,2015
20436,283200,0,Frankie Hammond,WR,dead_cap,kansas-city-chiefs,283200,2015
20437,0,243000,Nico Johnson,ILB,dead_cap,kansas-city-chiefs,243000,2015
20438,95223,0,Saalim Hakim,WR,dead_cap,kansas-city-chiefs,95223,2015
20439,91588,0,Daniel Munyer,C,dead_cap,kansas-city-chiefs,91588,2015
20440,85800,0,Jarrod Pughsley,LT,dead_cap,kansas-city-chiefs,85800,2015
20441,79200,0,Darrin Reaves,RB,dead_cap,kansas-city-chiefs,79200,2015
20442,66000,0,Hebron Fangupo,DT,dead_cap,kansas-city-chiefs,66000,2015
20443,0,62500,Kelcie McCray,SS,dead_cap,kansas-city-chiefs,62500,2015
20444,0,39779,Eric Kush,G,dead_cap,kansas-city-chiefs,39779,2015
20445,0,35418,Cyrus Gray,RB,dead_cap,kansas-city-chiefs,35418,2015
20446,33000,0,Jeremy Harris,CB,dead_cap,kansas-city-chiefs,33000,2015
20447,33000,0,Spencer Ware,RB,dead_cap,kansas-city-chiefs,33000,2015
20448,0,30000,Rokevious Watkins,G,dead_cap,kansas-city-chiefs,30000,2015
20449,26400,1666,Kenny Cook,WR,dead_cap,kansas-city-chiefs,28066,2015
20450,26400,0,Reid Fragel,RT,dead_cap,kansas-city-chiefs,26400,2015
20451,26400,0,Fred Williams,WR,dead_cap,kansas-city-chiefs,26400,2015
20452,0,25781,Mike Catapano,DE,dead_cap,kansas-city-chiefs,25781,2015
20453,0,25000,Dezman Moses,OLB,dead_cap,kansas-city-chiefs,25000,2015
20454,19800,3333,David Irving,DT,dead_cap,kansas-city-chiefs,23133,2015
20455,19800,0,Tyrell Adams,OLB,dead_cap,kansas-city-chiefs,19800,2015
20456,0,17014,Da'Ron Brown,WR,dead_cap,kansas-city-chiefs,17014,2015
20457,0,6667,Kona Schwenke,DT,dead_cap,kansas-city-chiefs,6667,2015
20458,6600,0,Jayson Dimanche,ILB,dead_cap,kansas-city-chiefs,6600,2015
20459,6600,0,Josh Keyes,ILB,dead_cap,kansas-city-chiefs,6600,2015
20460,6600,0,Ross Travis,TE,dead_cap,kansas-city-chiefs,6600,2015
20461,0,6000,Charles Sweeton,T,dead_cap,kansas-city-chiefs,6000,2015
20462,0,5667,Darryl Surgent,WR,dead_cap,kansas-city-chiefs,5667,2015
20463,0,5334,James Baker,RB,dead_cap,kansas-city-chiefs,5334,2015
20464,0,5334,Daniel Sorensen,SS,dead_cap,kansas-city-chiefs,5334,2015
20465,0,5000,Manasseh Garner,RB,dead_cap,kansas-city-chiefs,5000,2015
20466,0,4000,Ben Johnson,OLB,dead_cap,kansas-city-chiefs,4000,2015
20467,0,4000,David Van Dyke,CB,dead_cap,kansas-city-chiefs,4000,2015
20468,0,3333,Justin Cox,CB,dead_cap,kansas-city-chiefs,3333,2015
20469,0,3333,Andrew East,LS,dead_cap,kansas-city-chiefs,3333,2015
20470,0,3333,Donatella Luckett,WR,dead_cap,kansas-city-chiefs,3333,2015
20471,0,2667,Charcandrick West,RB,dead_cap,kansas-city-chiefs,2667,2015
20472,0,2666,DeVante Bausby,CB,dead_cap,kansas-city-chiefs,2666,2015
20473,0,2000,Ben Gottschalk,RT,dead_cap,kansas-city-chiefs,2000,2015
20474,0,1666,Kevin Short,CB,dead_cap,kansas-city-chiefs,1666,2015
20475,0,1666,Charles Tuaau,DT,dead_cap,kansas-city-chiefs,1666,2015
20476,0,667,DeRon Furr,S,dead_cap,kansas-city-chiefs,667,2015
20477,0,334,Colin Kelly,RT,dead_cap,kansas-city-chiefs,334,2015
20478,0,333,Sage Harold,DE,dead_cap,kansas-city-chiefs,333,2015
20479,14100000,3700000,Alex Smith,QB,active,kansas-city-chiefs,17800000,2016
20480,7400000,5700000,Justin Houston,OLB,active,kansas-city-chiefs,13100000,2016
20481,9750000,2650000,Jeremy Maclin,WR,active,kansas-city-chiefs,12400000,2016
20482,10806000,0,Eric Berry,FS,active,kansas-city-chiefs,10806000,2016
20483,675000,6179636,Eric Fisher,LT,active,kansas-city-chiefs,6854636,2016
20484,6146000,0,Dontari Poe,DT,active,kansas-city-chiefs,6146000,2016
20485,3600000,850000,Dustin Colquitt,P,active,kansas-city-chiefs,4450000,2016
20486,1000000,2802083,Tamba Hali,OLB,active,kansas-city-chiefs,3802083,2016
20487,1900000,1700000,Ron Parker,FS,active,kansas-city-chiefs,3600000,2016
20488,675000,2273226,Travis Kelce,TE,active,kansas-city-chiefs,2948226,2016
20489,760000,1640000,Mitchell Schwartz,RT,active,kansas-city-chiefs,2400000,2016
20490,1161700,1063400,Dee Ford,OLB,active,kansas-city-chiefs,2225100,2016
20491,870643,1307574,Marcus Peters,CB,active,kansas-city-chiefs,2178217,2016
20492,1250000,750000,Anthony Sherman,FB,active,kansas-city-chiefs,2000000,2016
20493,860000,908750,Jah Reid,RT,active,kansas-city-chiefs,1768750,2016
20494,1250000,500000,Nick Foles,QB,active,kansas-city-chiefs,1750000,2016
20495,450000,682950,Chris Jones,DE,active,kansas-city-chiefs,1132950,2016
20496,760000,306666,Frank Zombo,OLB,active,kansas-city-chiefs,1066666,2016
20497,622413,439649,Mitch Morse,C,active,kansas-city-chiefs,1062062,2016
20498,600000,358333,Spencer Ware,RB,active,kansas-city-chiefs,958333,2016
20499,600000,358333,Charcandrick West,RB,active,kansas-city-chiefs,958333,2016
20500,600000,350000,Demetrius Harris,TE,active,kansas-city-chiefs,950000,2016
20501,610000,145778,Phillip Gaines,CB,active,kansas-city-chiefs,755778,2016
20502,535000,203108,Chris Conley,WR,active,kansas-city-chiefs,738108,2016
20503,600000,113527,De'Anthony Thomas,WR,active,kansas-city-chiefs,713527,2016
20504,527500,155488,Steven Nelson,CB,active,kansas-city-chiefs,682988,2016
20505,600000,34555,Zach Fulton,G,active,kansas-city-chiefs,634555,2016
20506,600000,33575,Laurent Duvernay-Tardif,G,active,kansas-city-chiefs,633575,2016
20507,600000,20000,Tyler Bray,QB,active,kansas-city-chiefs,620000,2016
20508,600000,3334,Albert Wilson,WR,active,kansas-city-chiefs,603334,2016
20509,600000,667,Cairo Santos,K,active,kansas-city-chiefs,600667,2016
20510,600000,0,Kenneth Acker,CB,active,kansas-city-chiefs,600000,2016
20511,600000,0,Daniel Sorensen,SS,active,kansas-city-chiefs,600000,2016
20512,450000,149950,Eric Murray,CB,active,kansas-city-chiefs,599950,2016
20513,450000,129293,Demarcus Robinson,WR,active,kansas-city-chiefs,579293,2016
20514,525000,50563,D.J. Alexander,ILB,active,kansas-city-chiefs,575563,2016
20515,525000,50563,James O'Shaughnessy,TE,active,kansas-city-chiefs,575563,2016
20516,525000,0,James Winchester,LS,active,kansas-city-chiefs,525000,2016
20517,450000,47500,Tyreek Hill,WR,active,kansas-city-chiefs,497500,2016
20518,491764,0,Kendall Reyes,DE,active,kansas-city-chiefs,491764,2016
20519,450000,39253,D.J. White,CB,active,kansas-city-chiefs,489253,2016
20520,450000,0,Sam Ficken,K,active,kansas-city-chiefs,450000,2016
20521,450000,0,Ross Travis,TE,active,kansas-city-chiefs,450000,2016
20522,450000,0,Bryan Witzmann,G,active,kansas-city-chiefs,450000,2016
20523,408698,3333,Justin March,ILB,active,kansas-city-chiefs,412031,2016
20524,402352,0,Michael Person,G,active,kansas-city-chiefs,402352,2016
20525,357352,0,Knile Davis,RB,active,kansas-city-chiefs,357352,2016
20526,339705,0,Rakeem Nunez-Roches,DE,active,kansas-city-chiefs,339705,2016
20527,339705,0,Ramik Wilson,ILB,active,kansas-city-chiefs,339705,2016
20528,312941,0,Jarvis Jenkins,DE,active,kansas-city-chiefs,312941,2016
20529,238230,0,Terrance Smith,ILB,active,kansas-city-chiefs,238230,2016
20530,211764,0,Terrance Mitchell,CB,active,kansas-city-chiefs,211764,2016
20531,176470,0,T.J. Barnes,DT,active,kansas-city-chiefs,176470,2016
20532,2750000,2562500,Jamaal Charles,RB,injured_reserve,kansas-city-chiefs,5312500,2016
20533,3000000,2212500,Allen Bailey,DE,injured_reserve,kansas-city-chiefs,5212500,2016
20534,1500000,2000000,Derrick Johnson,ILB,injured_reserve,kansas-city-chiefs,3500000,2016
20535,760000,2740000,Jaye Howard,DE,injured_reserve,kansas-city-chiefs,3500000,2016
20536,1550000,1150000,Josh Mauga,ILB,injured_reserve,kansas-city-chiefs,2700000,2016
20537,450000,150727,Parker Ehinger,G,injured_reserve,kansas-city-chiefs,600727,2016
20538,450000,30803,Dadi Nicolas,OLB,injured_reserve,kansas-city-chiefs,480803,2016
20539,333000,1666,Vernon Harris,CB,injured_reserve,kansas-city-chiefs,334666,2016
20540,333000,0,Kenny Cook,WR,injured_reserve,kansas-city-chiefs,333000,2016
20541,333000,0,Trey Millard,FB,injured_reserve,kansas-city-chiefs,333000,2016
20542,1000000,4200000,Ben Grubbs,G,dead_cap,kansas-city-chiefs,5200000,2016
20543,0,4000000,Tamba Hali,OLB,dead_cap,kansas-city-chiefs,4000000,2016
20544,0,1166667,Paul Fanaika,G,dead_cap,kansas-city-chiefs,1166667,2016
20545,238235,151504,Knile Davis,RB,dead_cap,kansas-city-chiefs,389739,2016
20546,317647,0,Sam Barrington,ILB,dead_cap,kansas-city-chiefs,317647,2016
20547,309158,0,Jordan Devey,G,dead_cap,kansas-city-chiefs,309158,2016
20548,26470,203282,Keivarae Russell,CB,dead_cap,kansas-city-chiefs,229752,2016
20549,223976,0,David King,DE,dead_cap,kansas-city-chiefs,223976,2016
20550,211764,0,Nick Williams,DE,dead_cap,kansas-city-chiefs,211764,2016
20551,41400,134030,Ramik Wilson,ILB,dead_cap,kansas-city-chiefs,175430,2016
20552,161082,0,Terrance Mitchell,CB,dead_cap,kansas-city-chiefs,161082,2016
20553,158823,0,Sio Moore,OLB,dead_cap,kansas-city-chiefs,158823,2016
20554,119117,0,Dezman Moses,OLB,dead_cap,kansas-city-chiefs,119117,2016
20555,117300,0,Frankie Hammond,WR,dead_cap,kansas-city-chiefs,117300,2016
20556,117300,0,Darrin Reaves,RB,dead_cap,kansas-city-chiefs,117300,2016
20557,110400,0,Seantavius Jones,WR,dead_cap,kansas-city-chiefs,110400,2016
20558,105882,0,Bishop Sankey,RB,dead_cap,kansas-city-chiefs,105882,2016
20559,96600,0,Earl Okine,DE,dead_cap,kansas-city-chiefs,96600,2016
20560,58482,31622,Rakeem Nunez-Roches,DE,dead_cap,kansas-city-chiefs,90104,2016
20561,62100,0,Joseph Cheek,T,dead_cap,kansas-city-chiefs,62100,2016
20562,55200,5000,Terrance Smith,ILB,dead_cap,kansas-city-chiefs,60200,2016
20563,0,56929,Kevin Hogan,QB,dead_cap,kansas-city-chiefs,56929,2016
20564,55200,0,Jimmy Hall,ILB,dead_cap,kansas-city-chiefs,55200,2016
20565,55200,0,Joel Stave,QB,dead_cap,kansas-city-chiefs,55200,2016
20566,0,54106,Aaron Murray,QB,dead_cap,kansas-city-chiefs,54106,2016
20567,0,53878,Sanders Commings,FS,dead_cap,kansas-city-chiefs,53878,2016
20568,0,51042,Da'Ron Brown,WR,dead_cap,kansas-city-chiefs,51042,2016
20569,0,50000,Rod Streater,WR,dead_cap,kansas-city-chiefs,50000,2016
20570,41400,0,T.J. Barnes,DT,dead_cap,kansas-city-chiefs,41400,2016
20571,0,40000,Jamell Fleming,S,dead_cap,kansas-city-chiefs,40000,2016
20572,0,37500,Kelcie McCray,SS,dead_cap,kansas-city-chiefs,37500,2016
20573,0,31279,Eric Kush,G,dead_cap,kansas-city-chiefs,31279,2016
20574,27600,0,Darnell Sankey,ILB,dead_cap,kansas-city-chiefs,27600,2016
20575,0,20000,Andy Mulumba,OLB,dead_cap,kansas-city-chiefs,20000,2016
20576,0,17281,Mike Catapano,DE,dead_cap,kansas-city-chiefs,17281,2016
20577,13800,0,Zac Brooks,RB,dead_cap,kansas-city-chiefs,13800,2016
20578,13800,0,Cory Johnson,DT,dead_cap,kansas-city-chiefs,13800,2016
20579,13800,0,Tyler Patmon,CB,dead_cap,kansas-city-chiefs,13800,2016
20580,13800,0,Bobby Richardson,DE,dead_cap,kansas-city-chiefs,13800,2016
20581,13800,0,Daniel Munyer,C,dead_cap,kansas-city-chiefs,13800,2016
20582,6900,0,Tyrell Adams,OLB,dead_cap,kansas-city-chiefs,6900,2016
20583,6900,0,Deion Barnes,DE,dead_cap,kansas-city-chiefs,6900,2016
20584,6900,0,Jarrod Pughsley,LT,dead_cap,kansas-city-chiefs,6900,2016
20585,6900,0,Shakiel Randolph,S,dead_cap,kansas-city-chiefs,6900,2016
20586,6900,0,Zach Sterup,T,dead_cap,kansas-city-chiefs,6900,2016
20587,6900,0,Brock Vereen,FS,dead_cap,kansas-city-chiefs,6900,2016
20588,6900,0,Julian Wilson,CB,dead_cap,kansas-city-chiefs,6900,2016
20589,0,6667,Justin Cox,CB,dead_cap,kansas-city-chiefs,6667,2016
20590,0,6667,Andrew East,LS,dead_cap,kansas-city-chiefs,6667,2016
20591,0,6667,David Irving,DT,dead_cap,kansas-city-chiefs,6667,2016
20592,0,6667,Donatella Luckett,WR,dead_cap,kansas-city-chiefs,6667,2016
20593,0,5334,DeVante Bausby,CB,dead_cap,kansas-city-chiefs,5334,2016
20594,0,3334,Kenny Cook,WR,dead_cap,kansas-city-chiefs,3334,2016
20595,0,3334,Kevin Short,CB,dead_cap,kansas-city-chiefs,3334,2016
20596,0,3334,Charles Tuaau,DT,dead_cap,kansas-city-chiefs,3334,2016
20597,0,667,Sage Harold,DE,dead_cap,kansas-city-chiefs,667,2016
20598,0,333,Tre Jones,CB,dead_cap,kansas-city-chiefs,333,2016
20599,16350000,5750000,Justin Houston,OLB,active,kansas-city-chiefs,22100000,2017
20600,10800000,6100000,Alex Smith,QB,active,kansas-city-chiefs,16900000,2017
20601,6857977,2600000,Eric Fisher,LT,active,kansas-city-chiefs,9457977,2017
20602,5750000,2958333,Tamba Hali,OLB,active,kansas-city-chiefs,8708333,2017
20603,6680000,1273125,Bennie Logan,DT,active,kansas-city-chiefs,7953125,2017
20604,4900000,2000000,Mitchell Schwartz,RT,active,kansas-city-chiefs,6900000,2017
20605,3900000,2256250,Allen Bailey,DE,active,kansas-city-chiefs,6156250,2017
20606,3900000,1700000,Ron Parker,FS,active,kansas-city-chiefs,5600000,2017
20607,2700000,2718400,Travis Kelce,TE,active,kansas-city-chiefs,5418400,2017
20608,4050000,850000,Dustin Colquitt,P,active,kansas-city-chiefs,4900000,2017
20609,1000000,2500000,Derrick Johnson,ILB,active,kansas-city-chiefs,3500000,2017
20610,465000,2521506,Patrick Mahomes,QB,active,kansas-city-chiefs,2986506,2017
20611,690000,2033575,Laurent Duvernay-Tardif,G,active,kansas-city-chiefs,2723575,2017
20612,1229447,1307574,Marcus Peters,CB,active,kansas-city-chiefs,2537021,2017
20613,1788500,34555,Zach Fulton,G,active,kansas-city-chiefs,1823055,2017
20614,1797000,0,Albert Wilson,WR,active,kansas-city-chiefs,1797000,2017
20615,1100000,650000,Anthony Sherman,FB,active,kansas-city-chiefs,1750000,2017
20616,690000,1010000,Daniel Sorensen,SS,active,kansas-city-chiefs,1700000,2017
20617,1100000,450000,Demetrius Harris,TE,active,kansas-city-chiefs,1550000,2017
20618,708238,707950,Chris Jones,DE,active,kansas-city-chiefs,1416188,2017
20619,900000,456666,Frank Zombo,OLB,active,kansas-city-chiefs,1356666,2017
20620,1252500,66250,Tyler Bray,QB,active,kansas-city-chiefs,1318750,2017
20621,1292188,0,Cameron Erving,G,active,kansas-city-chiefs,1292188,2017
20622,700000,452083,Charcandrick West,RB,active,kansas-city-chiefs,1152083,2017
20623,465000,320676,Tanoh Kpassagnon,DE,active,kansas-city-chiefs,785676,2017
20624,618500,155488,Steven Nelson,CB,active,kansas-city-chiefs,773988,2017
20625,615000,110000,James Winchester,LS,active,kansas-city-chiefs,725000,2017
20626,715517,0,Reggie Ragland,ILB,active,kansas-city-chiefs,715517,2017
20627,540000,159727,Parker Ehinger,G,active,kansas-city-chiefs,699727,2017
20628,540000,158950,Eric Murray,CB,active,kansas-city-chiefs,698950,2017
20629,690000,0,Kenneth Acker,CB,active,kansas-city-chiefs,690000,2017
20630,690000,0,Terrance Mitchell,CB,active,kansas-city-chiefs,690000,2017
20631,690000,0,Kevin Pierre-Louis,OLB,active,kansas-city-chiefs,690000,2017
20632,540000,138293,Demarcus Robinson,WR,active,kansas-city-chiefs,678293,2017
20633,775000,50000,Jarvis Jenkins,DE,active,kansas-city-chiefs,825000,2017
20634,465000,193988,Kareem Hunt,RB,active,kansas-city-chiefs,658988,2017
20635,649408,0,Jordan Devey,G,active,kansas-city-chiefs,649408,2017
20636,540000,100000,Bryan Witzmann,G,active,kansas-city-chiefs,640000,2017
20637,615000,0,Rakeem Nunez-Roches,DE,active,kansas-city-chiefs,615000,2017
20638,615000,0,Ramik Wilson,ILB,active,kansas-city-chiefs,615000,2017
20639,540000,46260,Tyreek Hill,WR,active,kansas-city-chiefs,586260,2017
20640,465000,104912,Jehu Chesson,WR,active,kansas-city-chiefs,569912,2017
20641,540000,0,Terrance Smith,ILB,active,kansas-city-chiefs,540000,2017
20642,465000,50484,Ukeme Eligwe,ILB,active,kansas-city-chiefs,515484,2017
20643,382941,0,Harrison Butker,K,active,kansas-city-chiefs,382941,2017
20644,352941,0,Darrelle Revis,CB,active,kansas-city-chiefs,352941,2017
20645,202940,0,Orson Charles,FB,active,kansas-city-chiefs,202940,2017
20646,109412,0,Justin Hamilton,DT,active,kansas-city-chiefs,109412,2017
20647,108529,0,Keith Reaser,CB,active,kansas-city-chiefs,108529,2017
20648,82059,0,Leon McQuay III,S,active,kansas-city-chiefs,82059,2017
20649,465000,0,Marcus Kemp,WR,active,kansas-city-chiefs,465000,2017
20650,0,0,C.J. Spiller,RB,active,kansas-city-chiefs,0,2017
20651,900000,4100000,Eric Berry,FS,injured_reserve,kansas-city-chiefs,5000000,2017
20652,957704,1638264,Dee Ford,OLB,injured_reserve,kansas-city-chiefs,2595968,2017
20653,1797000,0,Cairo Santos,K,injured_reserve,kansas-city-chiefs,1797000,2017
20654,1300000,445833,Spencer Ware,RB,injured_reserve,kansas-city-chiefs,1745833,2017
20655,834826,439649,Mitch Morse,C,injured_reserve,kansas-city-chiefs,1274475,2017
20656,700000,155778,Phillip Gaines,CB,injured_reserve,kansas-city-chiefs,855778,2017
20657,635000,203108,Chris Conley,WR,injured_reserve,kansas-city-chiefs,838108,2017
20658,690000,113527,De'Anthony Thomas,WR,injured_reserve,kansas-city-chiefs,803527,2017
20659,690000,0,Steven Terrell,CB,injured_reserve,kansas-city-chiefs,690000,2017
20660,578824,0,Akeem Hunt,RB,injured_reserve,kansas-city-chiefs,578824,2017
20661,348000,4000,Ashton Lampkin,CB,injured_reserve,kansas-city-chiefs,352000,2017
20662,348000,3333,Jordan Sterns,S,injured_reserve,kansas-city-chiefs,351333,2017
20663,348000,2666,Devin Chappell,CB,injured_reserve,kansas-city-chiefs,350666,2017
20664,348000,0,Keith Baxter,CB,injured_reserve,kansas-city-chiefs,348000,2017
20665,2500000,2500000,Jaye Howard,DE,dead_cap,kansas-city-chiefs,5000000,2017
20666,0,2400000,Jeremy Maclin,WR,dead_cap,kansas-city-chiefs,2400000,2017
20667,1797000,0,Cairo Santos,K,dead_cap,kansas-city-chiefs,1797000,2017
20668,1000000,306250,Roy Miller,DT,dead_cap,kansas-city-chiefs,1306250,2017
20669,0,875000,Jah Reid,RT,dead_cap,kansas-city-chiefs,875000,2017
20670,0,750000,Josh Mauga,ILB,dead_cap,kansas-city-chiefs,750000,2017
20671,0,609846,Keivarae Russell,CB,dead_cap,kansas-city-chiefs,609846,2017
20672,381180,0,Ross Travis,TE,dead_cap,kansas-city-chiefs,381180,2017
20673,254120,48253,D.J. White,CB,dead_cap,kansas-city-chiefs,302373,2017
20674,0,250060,Ramik Wilson,ILB,dead_cap,kansas-city-chiefs,250060,2017
20675,222350,0,Donald Hawkins,G,dead_cap,kansas-city-chiefs,222350,2017
20676,0,170787,Kevin Hogan,QB,dead_cap,kansas-city-chiefs,170787,2017
20677,142553,0,Marcus Kemp,WR,dead_cap,kansas-city-chiefs,142553,2017
20678,100800,27503,Leon McQuay III,S,dead_cap,kansas-city-chiefs,128303,2017
20679,122400,0,Joseph Cheek,T,dead_cap,kansas-city-chiefs,122400,2017
20680,122400,0,Gehrig Dieter,WR,dead_cap,kansas-city-chiefs,122400,2017
20681,105882,25000,C.J. Spiller,RB,dead_cap,kansas-city-chiefs,130882,2017
20682,100800,0,George Atkinson,RB,dead_cap,kansas-city-chiefs,100800,2017
20683,100800,0,Damien Mama,T,dead_cap,kansas-city-chiefs,100800,2017
20684,86400,0,Orson Charles,FB,dead_cap,kansas-city-chiefs,86400,2017
20685,0,83128,James O'Shaughnessy,TE,dead_cap,kansas-city-chiefs,83128,2017
20686,0,80000,Gavin Escobar,TE,dead_cap,kansas-city-chiefs,80000,2017
20687,79200,0,Keith Reaser,CB,dead_cap,kansas-city-chiefs,79200,2017
20688,57600,0,Will Redmond,CB,dead_cap,kansas-city-chiefs,57600,2017
20689,0,50563,D.J. Alexander,ILB,dead_cap,kansas-city-chiefs,50563,2017
20690,0,50000,Michael Person,G,dead_cap,kansas-city-chiefs,50000,2017
20691,0,50000,Marqueston Huff,FS,dead_cap,kansas-city-chiefs,50000,2017
20692,0,45606,Aaron Murray,QB,dead_cap,kansas-city-chiefs,45606,2017
20693,0,45244,Rakeem Nunez-Roches,DE,dead_cap,kansas-city-chiefs,45244,2017
20694,43200,0,Daniel Ross,DE,dead_cap,kansas-city-chiefs,43200,2017
20695,52941,0,Cam Thomas,DT,dead_cap,kansas-city-chiefs,52941,2017
20696,36000,0,Anthony Firkser,RB,dead_cap,kansas-city-chiefs,36000,2017
20697,36000,0,Akeem Hunt,RB,dead_cap,kansas-city-chiefs,36000,2017
20698,36000,0,Mike Purcell,DT,dead_cap,kansas-city-chiefs,36000,2017
20699,36000,0,Isaiah Williams,T,dead_cap,kansas-city-chiefs,36000,2017
20700,36000,0,Rickey Hatley,DT,dead_cap,kansas-city-chiefs,36000,2017
20701,0,30000,Isaiah Battle,LT,dead_cap,kansas-city-chiefs,30000,2017
20702,28800,0,Amba Etta-Tawo,WR,dead_cap,kansas-city-chiefs,28800,2017
20703,21600,0,Dillon Gordon,TE,dead_cap,kansas-city-chiefs,21600,2017
20704,21600,0,Tyrone Holmes,DE,dead_cap,kansas-city-chiefs,21600,2017
20705,21600,0,Kaleb Johnson,T,dead_cap,kansas-city-chiefs,21600,2017
20706,21600,0,Devin Lucien,WR,dead_cap,kansas-city-chiefs,21600,2017
20707,21600,0,Neal Sterling,TE,dead_cap,kansas-city-chiefs,21600,2017
20708,20000,333,Jordan Sterns,S,dead_cap,kansas-city-chiefs,20333,2017
20709,14400,0,Nick Becton,LT,dead_cap,kansas-city-chiefs,14400,2017
20710,14400,0,Taurean Nixon,CB,dead_cap,kansas-city-chiefs,14400,2017
20711,0,13200,David King,DE,dead_cap,kansas-city-chiefs,13200,2017
20712,0,10000,Terrance Smith,ILB,dead_cap,kansas-city-chiefs,10000,2017
20713,7200,0,Devine Redding,RB,dead_cap,kansas-city-chiefs,7200,2017
20714,7200,0,Marcus Rush,OLB,dead_cap,kansas-city-chiefs,7200,2017
20715,7200,0,Andrew Wylie,T,dead_cap,kansas-city-chiefs,7200,2017
20716,0,3334,Vernon Harris,CB,dead_cap,kansas-city-chiefs,3334,2017
20717,0,3334,Justin March,ILB,dead_cap,kansas-city-chiefs,3334,2017
20718,0,667,Tre Jones,CB,dead_cap,kansas-city-chiefs,667,2017
20719,14750000,5850000,Justin Houston,OLB,active,kansas-city-chiefs,20600000,2018
20720,11150000,2800000,Eric Fisher,LT,active,kansas-city-chiefs,13950000,2018
20721,8900000,4100000,Eric Berry,SS,active,kansas-city-chiefs,13000000,2018
20722,6800000,3218400,Travis Kelce,TE,active,kansas-city-chiefs,10018400,2018
20723,8718000,0,Dee Ford,OLB,active,kansas-city-chiefs,8718000,2018
20724,5400000,2600000,Allen Bailey,DE,active,kansas-city-chiefs,8000000,2018
20725,790000,7010000,Sammy Watkins,WR,active,kansas-city-chiefs,7800000,2018
20726,5700000,2000000,Mitchell Schwartz,RT,active,kansas-city-chiefs,7700000,2018
20727,3650000,1593750,Daniel Sorensen,FS,active,kansas-city-chiefs,5243750,2018
20728,555000,3178141,Patrick Mahomes,QB,active,kansas-city-chiefs,3733141,2018
20729,790000,2810000,Anthony Hitchens,ILB,active,kansas-city-chiefs,3600000,2018
20730,1015000,1585000,Chad Henne,QB,active,kansas-city-chiefs,2600000,2018
20731,705000,1431666,Cameron Erving,G,active,kansas-city-chiefs,2136666,2018
20732,705000,1420000,Xavier Williams,DT,active,kansas-city-chiefs,2125000,2018
20733,1750000,347059,Demetrius Harris,TE,active,kansas-city-chiefs,2097059,2018
20734,1882000,203110,Chris Conley,WR,active,kansas-city-chiefs,2085110,2018
20735,1897000,155488,Steven Nelson,CB,active,kansas-city-chiefs,2052488,2018
20736,2000000,0,Anthony Sherman,FB,active,kansas-city-chiefs,2000000,2018
20737,725000,1195834,Spencer Ware,RB,active,kansas-city-chiefs,1920834,2018
20738,790000,943333,Damien Williams,RB,active,kansas-city-chiefs,1733333,2018
20739,1015000,685000,Dustin Colquitt,P,active,kansas-city-chiefs,1700000,2018
20740,916476,782950,Chris Jones,DE,active,kansas-city-chiefs,1699426,2018
20741,1047239,439651,Mitch Morse,C,active,kansas-city-chiefs,1486890,2018
20742,915000,500000,Orlando Scandrick,CB,active,kansas-city-chiefs,1415000,2018
20743,480000,629184,Breeland Speaks,LB,active,kansas-city-chiefs,1109184,2018
20744,636419,345676,Tanoh Kpassagnon,DE,active,kansas-city-chiefs,982095,2018
20745,931034,50000,Reggie Ragland,ILB,active,kansas-city-chiefs,981034,2018
20746,630000,333333,Austin Reiter,C,active,kansas-city-chiefs,963333,2018
20747,720000,110000,James Winchester,LS,active,kansas-city-chiefs,830000,2018
20748,630000,158950,Eric Murray,SS,active,kansas-city-chiefs,788950,2018
20749,630000,138293,Demarcus Robinson,WR,active,kansas-city-chiefs,768293,2018
20750,480000,239850,Derrick Nnadi,DT,active,kansas-city-chiefs,719850,2018
20751,630000,74996,Tyreek Hill,WR,active,kansas-city-chiefs,704996,2018
20752,480000,190379,Dorian O'Daniel,DE,active,kansas-city-chiefs,670379,2018
20753,647500,0,Kendall Fuller,CB,active,kansas-city-chiefs,647500,2018
20754,630000,0,Jordan Lucas,S,active,kansas-city-chiefs,630000,2018
20755,555000,0,Harrison Butker,K,active,kansas-city-chiefs,555000,2018
20756,555000,0,Justin Hamilton,DT,active,kansas-city-chiefs,555000,2018
20757,480000,38451,Tremon Smith,CB,active,kansas-city-chiefs,518451,2018
20758,480000,37736,Kahlil McKenzie,G,active,kansas-city-chiefs,517736,2018
20759,511176,0,Jeff Allen,G,active,kansas-city-chiefs,511176,2018
20760,480000,5000,Darrel Williams,RB,active,kansas-city-chiefs,485000,2018
20761,480000,2000,Ben Niemann,LB,active,kansas-city-chiefs,482000,2018
20762,480000,0,Marcus Kemp,WR,active,kansas-city-chiefs,480000,2018
20763,480000,0,Charvarius Ward,CB,active,kansas-city-chiefs,480000,2018
20764,480000,0,Andrew Wylie,G,active,kansas-city-chiefs,480000,2018
20765,557647,0,Frank Zombo,OLB,active,kansas-city-chiefs,557647,2018
20766,352941,0,Kelvin Benjamin,WR,active,kansas-city-chiefs,352941,2018
20767,282350,0,Jimmy Murray,C,active,kansas-city-chiefs,282350,2018
20768,282350,0,Deon Yelder,TE,active,kansas-city-chiefs,282350,2018
20769,169412,0,Gehrig Dieter,WR,active,kansas-city-chiefs,169412,2018
20770,148235,0,Charcandrick West,RB,active,kansas-city-chiefs,148235,2018
20771,3310000,2050000,Laurent Duvernay-Tardif,G,injured_reserve,kansas-city-chiefs,5360000,2018
20772,790000,90000,Jordan Devey,G,injured_reserve,kansas-city-chiefs,880000,2018
20773,630000,0,Terrance Smith,ILB,injured_reserve,kansas-city-chiefs,630000,2018
20774,397399,158058,Armani Watts,S,injured_reserve,kansas-city-chiefs,555457,2018
20775,790000,90000,De'Anthony Thomas,WR,injured_reserve,kansas-city-chiefs,880000,2018
20776,419647,0,Alex Ellis,TE,injured_reserve,kansas-city-chiefs,419647,2018
20777,378000,0,Dillon Gordon,TE,injured_reserve,kansas-city-chiefs,378000,2018
20778,363000,5000,Byron Pringle,WR,injured_reserve,kansas-city-chiefs,368000,2018
20779,363000,1666,J.D. Moore,RB,injured_reserve,kansas-city-chiefs,364666,2018
20780,363000,0,Step Durham,S,injured_reserve,kansas-city-chiefs,363000,2018
20781,363000,0,Tejan Koroma,C,injured_reserve,kansas-city-chiefs,363000,2018
20782,0,4800000,Jeremy Maclin,WR,dead_cap,kansas-city-chiefs,4800000,2018
20783,0,3600000,Alex Smith,QB,dead_cap,kansas-city-chiefs,3600000,2018
20784,915000,2000000,Ron Parker,FS,dead_cap,kansas-city-chiefs,2915000,2018
20785,0,2250000,Derrick Johnson,ILB,dead_cap,kansas-city-chiefs,2250000,2018
20786,0,1708334,Tamba Hali,OLB,dead_cap,kansas-city-chiefs,1708334,2018
20787,0,1307574,Marcus Peters,CB,dead_cap,kansas-city-chiefs,1307574,2018
20788,0,775000,Jah Reid,RT,dead_cap,kansas-city-chiefs,775000,2018
20789,764706,0,Josh Shaw,CB,dead_cap,kansas-city-chiefs,764706,2018
20790,790000,90000,Jarvis Jenkins,DE,dead_cap,kansas-city-chiefs,880000,2018
20791,439897,202988,Kareem Hunt,RB,dead_cap,kansas-city-chiefs,642885,2018
20792,0,625000,David Amerson,CB,dead_cap,kansas-city-chiefs,625000,2018
20793,0,383334,Charcandrick West,RB,dead_cap,kansas-city-chiefs,383334,2018
20794,236765,82512,Leon McQuay III,S,dead_cap,kansas-city-chiefs,319277,2018
20795,0,206668,Frank Zombo,OLB,dead_cap,kansas-city-chiefs,206668,2018
20796,165882,0,Nate Orchard,OLB,dead_cap,kansas-city-chiefs,165882,2018
20797,0,159729,Parker Ehinger,G,dead_cap,kansas-city-chiefs,159729,2018
20798,0,130000,Bryan Witzmann,G,dead_cap,kansas-city-chiefs,130000,2018
20799,129200,0,Josh Crockett,RB,dead_cap,kansas-city-chiefs,129200,2018
20800,129200,0,Ryan Hunter,T,dead_cap,kansas-city-chiefs,129200,2018
20801,129200,0,Joey Ivie,DT,dead_cap,kansas-city-chiefs,129200,2018
20802,129200,0,Chase Litton,QB,dead_cap,kansas-city-chiefs,129200,2018
20803,129200,0,Robert McCray,LB,dead_cap,kansas-city-chiefs,129200,2018
20804,129200,0,D’Montre Wade,S,dead_cap,kansas-city-chiefs,129200,2018
20805,114000,0,David Wells,TE,dead_cap,kansas-city-chiefs,114000,2018
20806,0,113912,Jehu Chesson,WR,dead_cap,kansas-city-chiefs,113912,2018
20807,0,78507,D.J. White,CB,dead_cap,kansas-city-chiefs,78507,2018
20808,76000,0,Raymond Davison,LB,dead_cap,kansas-city-chiefs,76000,2018
20809,76000,0,Gehrig Dieter,WR,dead_cap,kansas-city-chiefs,76000,2018
20810,76000,0,Pace Murphy,T,dead_cap,kansas-city-chiefs,76000,2018
20811,0,61607,Dadi Nicolas,OLB,dead_cap,kansas-city-chiefs,61607,2018
20812,0,59484,Ukeme Eligwe,ILB,dead_cap,kansas-city-chiefs,59484,2018
20813,53200,0,Jimmy Murray,C,dead_cap,kansas-city-chiefs,53200,2018
20814,0,41564,D.J. Alexander,ILB,dead_cap,kansas-city-chiefs,41564,2018
20815,28235,0,Ike Boettger,G,dead_cap,kansas-city-chiefs,28235,2018
20816,25471,0,Keith Reaser,CB,dead_cap,kansas-city-chiefs,25471,2018
20817,22800,0,Horace Richardson,CB,dead_cap,kansas-city-chiefs,22800,2018
20818,22800,0,Deon Yelder,TE,dead_cap,kansas-city-chiefs,22800,2018
20819,0,17000,T.Y. McGill,DT,dead_cap,kansas-city-chiefs,17000,2018
20820,15200,0,Arrion Springs,S,dead_cap,kansas-city-chiefs,15200,2018
20821,7600,0,Josh Hawkins,CB,dead_cap,kansas-city-chiefs,7600,2018
20822,0,5334,Devin Chappell,CB,dead_cap,kansas-city-chiefs,5334,2018
20823,0,4000,Jordan Sterns,S,dead_cap,kansas-city-chiefs,4000,2018
20824,11950000,7250000,Sammy Watkins,WR,active,kansas-city-chiefs,19200000,2019
20825,7500000,3218400,Travis Kelce,TE,active,kansas-city-chiefs,10718400,2019
20826,6203000,2050000,Laurent Duvernay-Tardif,G,active,kansas-city-chiefs,8253000,2019
20827,805000,6231667,Eric Fisher,LT,active,kansas-city-chiefs,7036667,2019
20828,805000,5695000,Frank Clark,DE,active,kansas-city-chiefs,6500000,2019
20829,930000,5500000,Mitchell Schwartz,RT,active,kansas-city-chiefs,6430000,2019
20830,850000,5083333,Tyrann Mathieu,FS,active,kansas-city-chiefs,5933333,2019
20831,805000,4423750,Anthony Hitchens,ILB,active,kansas-city-chiefs,5228750,2019
20832,3600000,1150000,Daniel Sorensen,SS,active,kansas-city-chiefs,4750000,2019
20833,645000,3834776,Patrick Mahomes,QB,active,kansas-city-chiefs,4479776,2019
20834,2500000,1600000,Chad Henne,QB,active,kansas-city-chiefs,4100000,2019
20835,2257000,1081250,Xavier Williams,DT,active,kansas-city-chiefs,3338250,2019
20836,1450000,1731666,Cameron Erving,T,active,kansas-city-chiefs,3181666,2019
20837,2450000,700000,Dustin Colquitt,P,active,kansas-city-chiefs,3150000,2019
20838,3000000,0,LeSean McCoy,RB,active,kansas-city-chiefs,3000000,2019
20839,825882,1991176,Morris Claiborne,CB,active,kansas-city-chiefs,2817058,2019
20840,720000,1477000,Tyreek Hill,WR,active,kansas-city-chiefs,2197000,2019
20841,2015500,138793,Demarcus Robinson,WR,active,kansas-city-chiefs,2154293,2019
20842,2025000,0,Kendall Fuller,CB,active,kansas-city-chiefs,2025000,2019
20843,2025000,0,Jordan Lucas,S,active,kansas-city-chiefs,2025000,2019
20844,805000,1195000,Bashaud Breeland,CB,active,kansas-city-chiefs,2000000,2019
20845,1199714,782951,Chris Jones,DT,active,kansas-city-chiefs,1982665,2019
20846,720000,1155000,Damien Wilson,OLB,active,kansas-city-chiefs,1875000,2019
20847,1843861,0,Darron Lee,ILB,active,kansas-city-chiefs,1843861,2019
20848,1050000,683333,Damien Williams,RB,active,kansas-city-chiefs,1733333,2019
20849,975000,483333,Austin Reiter,C,active,kansas-city-chiefs,1458333,2019
20850,645000,700000,Harrison Butker,K,active,kansas-city-chiefs,1345000,2019
20851,1196551,50000,Reggie Ragland,ILB,active,kansas-city-chiefs,1246551,2019
20852,832838,345676,Tanoh Kpassagnon,DE,active,kansas-city-chiefs,1178514,2019
20853,820000,110000,James Winchester,LS,active,kansas-city-chiefs,930000,2019
20854,495000,413191,Mecole Hardman,WR,active,kansas-city-chiefs,908191,2019
20855,601500,289850,Derrick Nnadi,DT,active,kansas-city-chiefs,891350,2019
20856,495000,344139,Juan Thornhill,S,active,kansas-city-chiefs,839139,2019
20857,584000,213879,Dorian O'Daniel,OLB,active,kansas-city-chiefs,797879,2019
20858,570000,167558,Armani Watts,S,active,kansas-city-chiefs,737558,2019
20859,930000,90000,Anthony Sherman,FB,active,kansas-city-chiefs,1020000,2019
20860,805000,90000,Blake Bell,TE,active,kansas-city-chiefs,895000,2019
20861,495000,228795,Khalen Saunders,DT,active,kansas-city-chiefs,723795,2019
20862,1030000,0,Matt Moore,QB,active,kansas-city-chiefs,1030000,2019
20863,570000,2000,Ben Niemann,LB,active,kansas-city-chiefs,572000,2019
20864,570000,0,Charvarius Ward,CB,active,kansas-city-chiefs,570000,2019
20865,570000,0,Andrew Wylie,T,active,kansas-city-chiefs,570000,2019
20866,570000,0,Deon Yelder,TE,active,kansas-city-chiefs,570000,2019
20867,495000,38205,Rashad Fenton,CB,active,kansas-city-chiefs,533205,2019
20868,495000,31960,Darwin Thompson,RB,active,kansas-city-chiefs,526960,2019
20869,495000,27988,Nick Allegretti,C,active,kansas-city-chiefs,522988,2019
20870,465882,0,Byron Pringle,WR,active,kansas-city-chiefs,465882,2019
20871,656471,0,Stefen Wisniewski,C,active,kansas-city-chiefs,656471,2019
20872,473529,0,Mike Pennel,DE,active,kansas-city-chiefs,473529,2019
20873,352941,0,Terrell Suggs,OLB,active,kansas-city-chiefs,352941,2019
20874,203824,0,Jackson Barton,T,active,kansas-city-chiefs,203824,2019
20875,201174,0,Demone Harris,OLB,active,kansas-city-chiefs,201174,2019
20876,116471,0,Alex Brown,CB,active,kansas-city-chiefs,116471,2019
20877,805000,2148125,Alex Okafor,DE,injured_reserve,kansas-city-chiefs,2953125,2019
20878,1351315,0,Emmanuel Ogbah,DE,injured_reserve,kansas-city-chiefs,1351315,2019
20879,579109,629184,Breeland Speaks,DE,injured_reserve,kansas-city-chiefs,1208293,2019
20880,720000,75000,Keith Reaser,CB,injured_reserve,kansas-city-chiefs,795000,2019
20881,634000,0,Martinas Rankin,G,injured_reserve,kansas-city-chiefs,634000,2019
20882,570000,0,Marcus Kemp,WR,injured_reserve,kansas-city-chiefs,570000,2019
20883,528353,5000,Darrel Williams,RB,injured_reserve,kansas-city-chiefs,533353,2019
20884,502935,0,Greg Senat,T,injured_reserve,kansas-city-chiefs,502935,2019
20885,378000,1666,Felton Davis,WR,injured_reserve,kansas-city-chiefs,379666,2019
20886,378000,0,John Lovett,TE,injured_reserve,kansas-city-chiefs,378000,2019
20887,378000,0,David Wells,TE,injured_reserve,kansas-city-chiefs,378000,2019
20888,189412,0,Spencer Ware,RB,injured_reserve,kansas-city-chiefs,189412,2019
20889,495000,833,Tim Ward,DE,non_fb_injury,kansas-city-chiefs,495833,2019
20890,320000,3333,Darius Harris,OLB,non_fb_injury,kansas-city-chiefs,323333,2019
20891,136000,0,Joe Fortson,TE,practice_squad,kansas-city-chiefs,136000,2019
20892,136000,0,Nick Keizer,TE,practice_squad,kansas-city-chiefs,136000,2019
20893,136000,0,Emmanuel Smith,LB,practice_squad,kansas-city-chiefs,136000,2019
20894,125000,0,Devaroe Lawrence,DT,practice_squad,kansas-city-chiefs,125000,2019
20895,96000,0,Ryan Hunter,T,practice_squad,kansas-city-chiefs,96000,2019
20896,80000,0,Braxton Hoyett,DT,practice_squad,kansas-city-chiefs,80000,2019
20897,64000,0,Kyle Shurmur,QB,practice_squad,kansas-city-chiefs,64000,2019
20898,40000,0,Elijah McGuire,RB,practice_squad,kansas-city-chiefs,40000,2019
20899,32000,0,Gehrig Dieter,WR,practice_squad,kansas-city-chiefs,32000,2019
20900,24000,0,Chris Lammons,CB,practice_squad,kansas-city-chiefs,24000,2019
20901,0,7100000,Justin Houston,OLB,dead_cap,kansas-city-chiefs,7100000,2019
20902,2950000,4000000,Eric Berry,SS,dead_cap,kansas-city-chiefs,6950000,2019
20903,930000,1130000,Jeff Allen,G,dead_cap,kansas-city-chiefs,2060000,2019
20904,0,900000,Carlos Hyde,RB,dead_cap,kansas-city-chiefs,900000,2019
20905,0,387976,Kareem Hunt,RB,dead_cap,kansas-city-chiefs,387976,2019
20906,234000,0,Alex Brown,CB,dead_cap,kansas-city-chiefs,234000,2019
20907,284118,0,De'Anthony Thomas,WR,dead_cap,kansas-city-chiefs,284118,2019
20908,0,209824,Jehu Chesson,WR,dead_cap,kansas-city-chiefs,209824,2019
20909,172471,0,Joey Ivie,DT,dead_cap,kansas-city-chiefs,172471,2019
20910,152618,2500,Kyle Shurmur,QB,dead_cap,kansas-city-chiefs,155118,2019
20911,0,150729,Parker Ehinger,G,dead_cap,kansas-city-chiefs,150729,2019
20912,0,149953,Eric Murray,CB,dead_cap,kansas-city-chiefs,149953,2019
20913,149588,0,Ryan Hunter,T,dead_cap,kansas-city-chiefs,149588,2019
20914,114000,2500,Cody Thompson,WR,dead_cap,kansas-city-chiefs,116500,2019
20915,67059,47951,Tremon Smith,RB,dead_cap,kansas-city-chiefs,115010,2019
20916,113824,0,Terrell McClain,DT,dead_cap,kansas-city-chiefs,113824,2019
20917,112000,0,Cameron Malveaux,DE,dead_cap,kansas-city-chiefs,112000,2019
20918,111176,0,Davon Grayson,WR,dead_cap,kansas-city-chiefs,111176,2019
20919,108588,0,Gehrig Dieter,WR,dead_cap,kansas-city-chiefs,108588,2019
20920,104000,0,Jamal Custis,WR,dead_cap,kansas-city-chiefs,104000,2019
20921,0,100968,Ukeme Eligwe,ILB,dead_cap,kansas-city-chiefs,100968,2019
20922,0,90000,Jeremiah Attaochu,OLB,dead_cap,kansas-city-chiefs,90000,2019
20923,53000,3333,Jack Fox,P,dead_cap,kansas-city-chiefs,56333,2019
20924,0,47236,Kahlil McKenzie,G,dead_cap,kansas-city-chiefs,47236,2019
20925,37118,5000,Byron Pringle,WR,dead_cap,kansas-city-chiefs,42118,2019
20926,40000,0,Marcus Marshall,RB,dead_cap,kansas-city-chiefs,40000,2019
20927,24000,0,Alize Mack,TE,dead_cap,kansas-city-chiefs,24000,2019
20928,24000,0,Torry McTyer,CB,dead_cap,kansas-city-chiefs,24000,2019
20929,16000,0,Braxton Hoyett,DT,dead_cap,kansas-city-chiefs,16000,2019
20930,8000,0,Jimmy Murray,C,dead_cap,kansas-city-chiefs,8000,2019
20931,0,3334,J.D. Moore,RB,dead_cap,kansas-city-chiefs,3334,2019
20932,0,3334,Jordan Sterns,S,dead_cap,kansas-city-chiefs,3334,2019
20933,17000000,5700000,Frank Clark,DE,active,kansas-city-chiefs,22700000,2020
20934,13750000,7250000,Sammy Watkins,WR,active,kansas-city-chiefs,21000000,2020
20935,820000,16830000,Tyreek Hill,WR,active,kansas-city-chiefs,17650000,2020
20936,11150000,5183333,Tyrann Mathieu,FS,active,kansas-city-chiefs,16333333,2020
20937,8750000,6231666,Eric Fisher,LT,active,kansas-city-chiefs,14981666,2020
20938,7800000,4892500,Anthony Hitchens,ILB,active,kansas-city-chiefs,12692500,2020
20939,8000000,3218400,Travis Kelce,TE,active,kansas-city-chiefs,11218400,2020
20940,5320000,5500000,Mitchell Schwartz,RT,active,kansas-city-chiefs,10820000,2020
20941,6450000,2487500,Laurent Duvernay-Tardif,G,active,kansas-city-chiefs,8937500,2020
20942,4700000,2271875,Alex Okafor,DE,active,kansas-city-chiefs,6971875,2020
20943,735000,4491413,Patrick Mahomes,QB,active,kansas-city-chiefs,5226413,2020
20944,3600000,1150000,Daniel Sorensen,SS,active,kansas-city-chiefs,4750000,2020
20945,2700000,1981668,Cameron Erving,T,active,kansas-city-chiefs,4681668,2020
20946,2700000,1175000,Damien Wilson,OLB,active,kansas-city-chiefs,3875000,2020
20947,2345000,850000,Harrison Butker,K,active,kansas-city-chiefs,3195000,2020
20948,1850000,983334,Damien Williams,RB,active,kansas-city-chiefs,2833334,2020
20949,1875000,883334,Austin Reiter,C,active,kansas-city-chiefs,2758334,2020
20950,1950000,700000,Dustin Colquitt,P,active,kansas-city-chiefs,2650000,2020
20951,1034592,629184,Breeland Speaks,DE,active,kansas-city-chiefs,1663776,2020
20952,1029257,345679,Tanoh Kpassagnon,DE,active,kansas-city-chiefs,1374936,2020
20953,722048,413191,Mecole Hardman,WR,active,kansas-city-chiefs,1135239,2020
20954,704785,344139,Juan Thornhill,S,active,kansas-city-chiefs,1048924,2020
20955,726500,289850,Derrick Nnadi,DT,active,kansas-city-chiefs,1016350,2020
20956,860000,110000,James Winchester,LS,active,kansas-city-chiefs,970000,2020
20957,679000,213879,Dorian O'Daniel,OLB,active,kansas-city-chiefs,892879,2020
20958,634500,253795,Khalen Saunders,DT,active,kansas-city-chiefs,888295,2020
20959,660000,167558,Armani Watts,S,active,kansas-city-chiefs,827558,2020
20960,735000,0,Anthony Lanier,DE,active,kansas-city-chiefs,735000,2020
20961,724000,0,Martinas Rankin,G,active,kansas-city-chiefs,724000,2020
20962,660000,5000,Darrel Williams,RB,active,kansas-city-chiefs,665000,2020
20963,660000,2000,Ben Niemann,LB,active,kansas-city-chiefs,662000,2020
20964,660000,0,Demone Harris,OLB,active,kansas-city-chiefs,660000,2020
20965,660000,0,Greg Senat,T,active,kansas-city-chiefs,660000,2020
20966,660000,0,Charvarius Ward,CB,active,kansas-city-chiefs,660000,2020
20967,585000,47705,Rashad Fenton,CB,active,kansas-city-chiefs,632705,2020
20968,585000,41460,Darwin Thompson,RB,active,kansas-city-chiefs,626460,2020
20969,585000,37488,Nick Allegretti,C,active,kansas-city-chiefs,622488,2020
20970,585000,3333,Darius Harris,OLB,active,kansas-city-chiefs,588333,2020
20971,585000,833,Tim Ward,DE,active,kansas-city-chiefs,585833,2020
20972,585000,0,Jackson Barton,T,active,kansas-city-chiefs,585000,2020
20973,585000,0,Alex Brown,CB,active,kansas-city-chiefs,585000,2020
20974,585000,0,Byron Pringle,WR,active,kansas-city-chiefs,585000,2020
20975,510000,1666,Felton Davis,WR,active,kansas-city-chiefs,511666,2020
20976,510000,0,John Lovett,TE,active,kansas-city-chiefs,510000,2020
20977,510000,0,Alize Mack,TE,active,kansas-city-chiefs,510000,2020
20978,510000,0,Marcus Marshall,RB,active,kansas-city-chiefs,510000,2020
20979,0,8000000,Eric Berry,SS,dead_cap,kansas-city-chiefs,8000000,2020
20980,0,76902,Tremon Smith,RB,dead_cap,kansas-city-chiefs,76902,2020
20981,0,75472,Kahlil McKenzie,G,dead_cap,kansas-city-chiefs,75472,2020
20982,0,6667,Jack Fox,P,dead_cap,kansas-city-chiefs,6667,2020
20983,0,5000,Byron Pringle,WR,dead_cap,kansas-city-chiefs,5000,2020
20984,0,5000,Kyle Shurmur,QB,dead_cap,kansas-city-chiefs,5000,2020
20985,0,5000,Cody Thompson,WR,dead_cap,kansas-city-chiefs,5000,2020
20986,1000000,9433332,Quentin Jammer,S,active,los-angeles-chargers,10433332,2007
20987,5750000,4250000,Philip Rivers,QB,active,los-angeles-chargers,10000000,2007
20988,5000000,2100000,LaDainian Tomlinson,RB,active,los-angeles-chargers,7100000,2007
20989,1500000,500000,Shane Olivea,G,active,los-angeles-chargers,2000000,2007
20990,1000000,4266667,Shaun Phillips,DE,active,los-angeles-chargers,5266667,2007
20991,2625000,1000000,Antonio Gates,TE,active,los-angeles-chargers,3625000,2007
20992,750000,2300000,Nick Hardwick,C,active,los-angeles-chargers,3050000,2007
20993,600000,2040000,Kris Dielman,G,active,los-angeles-chargers,2640000,2007
20994,2350000,0,Michael Turner,RB,active,los-angeles-chargers,2350000,2007
20995,680000,3175000,Shawne Merriman,LB,active,los-angeles-chargers,3855000,2007
20996,600000,500000,Nate Kaeding,K,active,los-angeles-chargers,1100000,2007
20997,285000,1806000,Buster Davis,WR,active,los-angeles-chargers,2091000,2007
20998,595000,0,Brandon Manumaleuna,TE,active,los-angeles-chargers,595000,2007
20999,360000,2155000,Antonio Cromartie,CB,active,los-angeles-chargers,2515000,2007
21000,285000,1142500,Eric Weddle,FS,active,los-angeles-chargers,1427500,2007
21001,498500,1541000,Luis Castillo,DE,active,los-angeles-chargers,2039500,2007
21002,896000,340000,Drayton Florence,CB,active,los-angeles-chargers,1236000,2007
21003,800000,288600,Mike Scifres,P,active,los-angeles-chargers,1088600,2007
21004,625000,450000,Igor Olshansky,DE,active,los-angeles-chargers,1075000,2007
21005,750000,100000,Kassim Osgood,WR,active,los-angeles-chargers,850000,2007
21006,600000,250000,Jacques Cesaire,DE,active,los-angeles-chargers,850000,2007
21007,435000,325000,Ryon Bingham,DE,active,los-angeles-chargers,760000,2007
21008,595000,158333,Clinton Hart,S,active,los-angeles-chargers,753333,2007
21009,435000,275000,Vincent Jackson,WR,active,los-angeles-chargers,710000,2007
21010,360000,306000,Marcus McNeill,T,active,los-angeles-chargers,666000,2007
21011,360000,177000,Charlie Whitehurst,QB,active,los-angeles-chargers,537000,2007
21012,510000,0,Malcom Floyd,WR,active,los-angeles-chargers,510000,2007
21013,385000,98000,Darren Sproles,RB,active,los-angeles-chargers,483000,2007
21014,435000,0,Dave Rayner,K,active,los-angeles-chargers,435000,2007
21015,285000,149500,Anthony Waters,LB,active,los-angeles-chargers,434500,2007
21016,360000,42000,Tim Dobbins,ILB,active,los-angeles-chargers,402000,2007
21017,385000,10833,Scott Mruczkowski,G,active,los-angeles-chargers,395833,2007
21018,285000,106812,Brandon Siler,LB,active,los-angeles-chargers,391812,2007
21019,285000,99625,Scott Chandler,TE,active,los-angeles-chargers,384625,2007
21020,285000,35250,Legedu Naanee,WR,active,los-angeles-chargers,320250,2007
21021,285000,5000,Antwan Applewhite,DE,active,los-angeles-chargers,290000,2007
21022,285000,0,Jeromey Clary,G,active,los-angeles-chargers,285000,2007
21023,100588,0,Jyles Tucker,LB,active,los-angeles-chargers,100588,2007
21024,227500,0,A.J. Feeley,QB,dead_cap,los-angeles-chargers,227500,2007
21025,69900,0,Kurt Smith,KR,dead_cap,los-angeles-chargers,69900,2007
21026,38436,0,Chase Page,DT,dead_cap,los-angeles-chargers,38436,2007
21027,36561,0,Jimmy Martin,C,dead_cap,los-angeles-chargers,36561,2007
21028,23250,0,Jeromey Clary,G,dead_cap,los-angeles-chargers,23250,2007
21029,5000,0,Jyles Tucker,LB,dead_cap,los-angeles-chargers,5000,2007
21030,1000,0,Nick Roach,ILB,dead_cap,los-angeles-chargers,1000,2007
21031,6500000,4500000,Philip Rivers,QB,active,los-angeles-chargers,11000000,2008
21032,5750000,2100000,LaDainian Tomlinson,RB,active,los-angeles-chargers,7850000,2008
21033,700000,6916000,Luis Castillo,DE,active,los-angeles-chargers,7616000,2008
21034,2400000,4266667,Shaun Phillips,DE,active,los-angeles-chargers,6666667,2008
21035,3700000,2040000,Kris Dielman,G,active,los-angeles-chargers,5740000,2008
21036,3000000,1000000,Antonio Gates,TE,active,los-angeles-chargers,4000000,2008
21037,370000,3550000,Jyles Tucker,LB,active,los-angeles-chargers,3920000,2008
21038,1500000,1900000,Quentin Jammer,S,active,los-angeles-chargers,3400000,2008
21039,605000,258334,Clinton Hart,S,active,los-angeles-chargers,863334,2008
21040,1050000,3175000,Shawne Merriman,LB,active,los-angeles-chargers,4225000,2008
21041,295000,2281000,Antoine Cason,CB,active,los-angeles-chargers,2576000,2008
21042,2000000,0,Nick Hardwick,C,active,los-angeles-chargers,2000000,2008
21043,445000,0,Steve Gregory,S,active,los-angeles-chargers,445000,2008
21044,1250000,500000,Nate Kaeding,K,active,los-angeles-chargers,1750000,2008
21045,647500,2155000,Antonio Cromartie,CB,active,los-angeles-chargers,2802500,2008
21046,1200000,450000,Igor Olshansky,DE,active,los-angeles-chargers,1650000,2008
21047,1350000,0,Brandon Manumaleuna,TE,active,los-angeles-chargers,1350000,2008
21048,1300000,250000,Jacques Cesaire,DE,active,los-angeles-chargers,1550000,2008
21049,830000,670000,Jeremy Newberry,C,active,los-angeles-chargers,1500000,2008
21050,1100000,98000,Darren Sproles,RB,active,los-angeles-chargers,1198000,2008
21051,900000,250000,Mike Scifres,P,active,los-angeles-chargers,1150000,2008
21052,750000,333333,Billy Volek,QB,active,los-angeles-chargers,1083333,2008
21053,750000,325000,Ryon Bingham,DE,active,los-angeles-chargers,1075000,2008
21054,950000,100000,Kassim Osgood,WR,active,los-angeles-chargers,1050000,2008
21055,370000,452500,Eric Weddle,FS,active,los-angeles-chargers,822500,2008
21056,520000,275000,Vincent Jackson,WR,active,los-angeles-chargers,795000,2008
21057,520000,266667,Scott Mruczkowski,G,active,los-angeles-chargers,786667,2008
21058,445000,306000,Marcus McNeill,T,active,los-angeles-chargers,751000,2008
21059,445000,177000,Charlie Whitehurst,QB,active,los-angeles-chargers,622000,2008
21060,370000,149500,Anthony Waters,LB,active,los-angeles-chargers,519500,2008
21061,295000,208462,Jacob Hester,RB,active,los-angeles-chargers,503462,2008
21062,445000,42000,Tim Dobbins,ILB,active,los-angeles-chargers,487000,2008
21063,370000,106812,Brandon Siler,LB,active,los-angeles-chargers,476812,2008
21064,370000,99625,Scott Chandler,TE,active,los-angeles-chargers,469625,2008
21065,605000,0,Malcom Floyd,WR,active,los-angeles-chargers,605000,2008
21066,370000,35250,Legedu Naanee,WR,active,los-angeles-chargers,405250,2008
21067,370000,5000,Antwan Applewhite,DE,active,los-angeles-chargers,375000,2008
21068,370000,0,Jeromey Clary,G,active,los-angeles-chargers,370000,2008
21069,295000,11412,Corey Clark,T,active,los-angeles-chargers,306412,2008
21070,295000,3750,Brandyn Dombrowski,G,active,los-angeles-chargers,298750,2008
21071,295000,3750,Mike Tolbert,FB,active,los-angeles-chargers,298750,2008
21072,295000,0,Marcus Thomas,RB,active,los-angeles-chargers,295000,2008
21073,88400,0,DeJuan Tribble,CB,active,los-angeles-chargers,88400,2008
21074,370000,1291000,Buster Davis,WR,injured_reserve,los-angeles-chargers,1661000,2008
21075,2000000,0,Shane Olivea,G,dead_cap,los-angeles-chargers,2000000,2008
21076,46500,0,Jeromey Clary,G,dead_cap,los-angeles-chargers,46500,2008
21077,37996,0,Marcus Thomas,RB,dead_cap,los-angeles-chargers,37996,2008
21078,7500,0,Andrew Crummey,G,dead_cap,los-angeles-chargers,7500,2008
21079,5000,0,Jyles Tucker,LB,dead_cap,los-angeles-chargers,5000,2008
21080,2000,0,Nick Roach,ILB,dead_cap,los-angeles-chargers,2000,2008
21081,6000000,9460000,Philip Rivers,QB,active,los-angeles-chargers,15460000,2009
21082,1300000,7391000,Luis Castillo,DE,active,los-angeles-chargers,8691000,2009
21083,5500000,2040000,Kris Dielman,G,active,los-angeles-chargers,7540000,2009
21084,3850000,3058333,LaDainian Tomlinson,RB,active,los-angeles-chargers,6908333,2009
21085,6621000,0,Darren Sproles,RB,active,los-angeles-chargers,6621000,2009
21086,2972000,3175000,Shawne Merriman,LB,active,los-angeles-chargers,6147000,2009
21087,3250000,1000000,Antonio Gates,TE,active,los-angeles-chargers,4250000,2009
21088,2900000,1266667,Shaun Phillips,DE,active,los-angeles-chargers,4166667,2009
21089,3250000,400000,Quentin Jammer,S,active,los-angeles-chargers,3650000,2009
21090,2500000,333333,Billy Volek,QB,active,los-angeles-chargers,2833333,2009
21091,1600000,1000000,Kevin Burnett,OLB,active,los-angeles-chargers,2600000,2009
21092,2500000,0,Nick Hardwick,C,active,los-angeles-chargers,2500000,2009
21093,841176,100000,Clinton Hart,S,active,los-angeles-chargers,941176,2009
21094,935000,2155000,Antonio Cromartie,CB,active,los-angeles-chargers,3090000,2009
21095,1450000,500000,Nate Kaeding,K,active,los-angeles-chargers,1950000,2009
21096,1500000,250000,Jacques Cesaire,DE,active,los-angeles-chargers,1750000,2009
21097,1450000,0,Brandon Manumaleuna,TE,active,los-angeles-chargers,1450000,2009
21098,1545000,0,Malcom Floyd,WR,active,los-angeles-chargers,1545000,2009
21099,310000,1060000,Larry English,OLB,active,los-angeles-chargers,1370000,2009
21100,510000,1291000,Buster Davis,WR,active,los-angeles-chargers,1801000,2009
21101,385000,1406000,Antoine Cason,CB,active,los-angeles-chargers,1791000,2009
21102,1000000,250000,Mike Scifres,P,active,los-angeles-chargers,1250000,2009
21103,1050000,100000,Kassim Osgood,WR,active,los-angeles-chargers,1150000,2009
21104,535000,0,Steve Gregory,S,active,los-angeles-chargers,535000,2009
21105,1030000,0,Travis Johnson,OLB,active,los-angeles-chargers,1030000,2009
21106,460000,452500,Eric Weddle,FS,active,los-angeles-chargers,912500,2009
21107,620000,275000,Vincent Jackson,WR,active,los-angeles-chargers,895000,2009
21108,620000,266667,Scott Mruczkowski,G,active,los-angeles-chargers,886667,2009
21109,535000,306000,Marcus McNeill,T,active,los-angeles-chargers,841000,2009
21110,535000,177000,Charlie Whitehurst,QB,active,los-angeles-chargers,712000,2009
21111,385000,208462,Jacob Hester,RB,active,los-angeles-chargers,593462,2009
21112,535000,42000,Tim Dobbins,ILB,active,los-angeles-chargers,577000,2009
21113,460000,106812,Brandon Siler,LB,active,los-angeles-chargers,566812,2009
21114,310000,198625,Louis Vasquez,G,active,los-angeles-chargers,508625,2009
21115,460000,35250,Legedu Naanee,WR,active,los-angeles-chargers,495250,2009
21116,620000,0,Eric Ghiaciuc,C,active,los-angeles-chargers,620000,2009
21117,460000,0,Jeromey Clary,G,active,los-angeles-chargers,460000,2009
21118,460000,0,Dante Hughes,CB,active,los-angeles-chargers,460000,2009
21119,310000,121562,Vaughn Martin,DE,active,los-angeles-chargers,431562,2009
21120,310000,102312,Tyronne Green,G,active,los-angeles-chargers,412312,2009
21121,385000,3750,Mike Tolbert,FB,active,los-angeles-chargers,388750,2009
21122,385000,0,Marcus Thomas,RB,active,los-angeles-chargers,385000,2009
21123,310000,25293,Kevin Ellison,S,active,los-angeles-chargers,335293,2009
21124,310000,25293,Kevin Ellison,S,active,los-angeles-chargers,335293,2009
21125,310000,4500,C.J. Spillman,S,active,los-angeles-chargers,314500,2009
21126,310000,3750,Brandyn Dombrowski,G,active,los-angeles-chargers,313750,2009
21127,310000,3000,Curtis Brinkley,RB,active,los-angeles-chargers,313000,2009
21128,310000,0,Ogemdi Nwaguo,DT,active,los-angeles-chargers,310000,2009
21129,1350000,325000,Ryon Bingham,DE,injured_reserve,los-angeles-chargers,1675000,2009
21130,460000,50000,Jyles Tucker,LB,injured_reserve,los-angeles-chargers,510000,2009
21131,299000,0,Anthony Waters,LB,dead_cap,los-angeles-chargers,299000,2009
21132,203440,0,Gartrell Johnson,RB,dead_cap,los-angeles-chargers,203440,2009
21133,113988,0,Marcus Thomas,RB,dead_cap,los-angeles-chargers,113988,2009
21134,100000,0,Clinton Hart,S,dead_cap,los-angeles-chargers,100000,2009
21135,99625,0,Scott Chandler,TE,dead_cap,los-angeles-chargers,99625,2009
21136,22975,0,DeJuan Tribble,CB,dead_cap,los-angeles-chargers,22975,2009
21137,13750,0,Demetrius Byrd,WR,dead_cap,los-angeles-chargers,13750,2009
21138,11412,0,Corey Clark,T,dead_cap,los-angeles-chargers,11412,2009
21139,6600000,6310000,Philip Rivers,QB,active,los-angeles-chargers,12910000,2010
21140,4942000,3350000,Luis Castillo,DE,active,los-angeles-chargers,8292000,2010
21141,7281300,0,Darren Sproles,RB,active,los-angeles-chargers,7281300,2010
21142,4500000,2040000,Kris Dielman,G,active,los-angeles-chargers,6540000,2010
21143,472500,6540000,Larry English,OLB,active,los-angeles-chargers,7012500,2010
21144,755000,5232500,Antonio Gates,TE,active,los-angeles-chargers,5987500,2010
21145,3400000,1266667,Shaun Phillips,DE,active,los-angeles-chargers,4666667,2010
21146,3500000,400000,Quentin Jammer,S,active,los-angeles-chargers,3900000,2010
21147,3168000,0,Malcom Floyd,WR,active,los-angeles-chargers,3168000,2010
21148,2750000,333333,Billy Volek,QB,active,los-angeles-chargers,3083333,2010
21149,3000000,0,Nick Hardwick,C,active,los-angeles-chargers,3000000,2010
21150,1900000,1000000,Kevin Burnett,OLB,active,los-angeles-chargers,2900000,2010
21151,1600000,500000,Nate Kaeding,K,active,los-angeles-chargers,2100000,2010
21152,2000000,0,Patrick Crayton,WR,active,los-angeles-chargers,2000000,2010
21153,1700000,250000,Jacques Cesaire,DE,active,los-angeles-chargers,1950000,2010
21154,320000,1411000,Ryan Mathews,RB,active,los-angeles-chargers,1731000,2010
21155,1684000,0,Jeromey Clary,G,active,los-angeles-chargers,1684000,2010
21156,490000,1406000,Antoine Cason,CB,active,los-angeles-chargers,1896000,2010
21157,1100000,250000,Mike Scifres,P,active,los-angeles-chargers,1350000,2010
21158,1226000,0,Travis Johnson,OLB,active,los-angeles-chargers,1226000,2010
21159,1101000,0,Antwan Barnes,OLB,active,los-angeles-chargers,1101000,2010
21160,550000,452500,Eric Weddle,FS,active,los-angeles-chargers,1002500,2010
21161,583000,358200,Marcus McNeill,T,active,los-angeles-chargers,941200,2010
21162,635000,266667,Scott Mruczkowski,G,active,los-angeles-chargers,901667,2010
21163,630000,150000,Antonio Garay,DE,active,los-angeles-chargers,780000,2010
21164,755000,0,Randy McMichael,TE,active,los-angeles-chargers,755000,2010
21165,545000,205000,Fred Bennett,CB,active,los-angeles-chargers,750000,2010
21166,470000,208462,Jacob Hester,RB,active,los-angeles-chargers,678462,2010
21167,550000,106812,Brandon Siler,LB,active,los-angeles-chargers,656812,2010
21168,630000,0,Pat Watkins,S,active,los-angeles-chargers,630000,2010
21169,611765,0,Steve Gregory,S,active,los-angeles-chargers,611765,2010
21170,395000,198625,Louis Vasquez,G,active,los-angeles-chargers,593625,2010
21171,550000,35250,Legedu Naanee,WR,active,los-angeles-chargers,585250,2010
21172,545000,25000,Jackie Battle,FB,active,los-angeles-chargers,570000,2010
21173,561647,0,Vincent Jackson,WR,active,los-angeles-chargers,561647,2010
21174,395000,121562,Vaughn Martin,DE,active,los-angeles-chargers,516562,2010
21175,512941,0,Dante Hughes,CB,active,los-angeles-chargers,512941,2010
21176,395000,102312,Tyronne Green,G,active,los-angeles-chargers,497312,2010
21177,470000,0,Antwan Applewhite,DE,active,los-angeles-chargers,470000,2010
21178,470000,0,Marcus Thomas,RB,active,los-angeles-chargers,470000,2010
21179,470000,0,Mike Tolbert,FB,active,los-angeles-chargers,470000,2010
21180,320000,126500,Darrell Stuckey,FS,active,los-angeles-chargers,446500,2010
21181,225000,202125,Donald Butler,ILB,active,los-angeles-chargers,427125,2010
21182,395000,3000,Curtis Brinkley,RB,active,los-angeles-chargers,398000,2010
21183,395000,0,Brandyn Dombrowski,G,active,los-angeles-chargers,395000,2010
21184,395000,0,Ogemdi Nwaguo,DT,active,los-angeles-chargers,395000,2010
21185,320000,47825,Cam Thomas,DT,active,los-angeles-chargers,367825,2010
21186,320000,3750,Seyi Ajirotutu,WR,active,los-angeles-chargers,323750,2010
21187,320000,3750,Richard Goodman,WR,active,los-angeles-chargers,323750,2010
21188,320000,250,Bryan Walters,WR,active,los-angeles-chargers,320250,2010
21189,320000,0,Mike Windt,LS,active,los-angeles-chargers,320000,2010
21190,244705,5000,Brandon Lang,LB,active,los-angeles-chargers,249705,2010
21191,225000,6875,Richie Brockel,TE,active,los-angeles-chargers,231875,2010
21192,162647,0,Kory Sperry,TE,active,los-angeles-chargers,162647,2010
21193,675000,1291000,Buster Davis,WR,injured_reserve,los-angeles-chargers,1966000,2010
21194,570000,800000,Jyles Tucker,LB,injured_reserve,los-angeles-chargers,1370000,2010
21195,225000,0,Kion Wilson,ILB,injured_reserve,los-angeles-chargers,225000,2010
21196,88400,0,Danario Alexander,WR,practice_squad,los-angeles-chargers,88400,2010
21197,88400,0,Kion Wilson,ILB,practice_squad,los-angeles-chargers,88400,2010
21198,26000,0,Bryan Walters,WR,practice_squad,los-angeles-chargers,26000,2010
21199,2916666,0,LaDainian Tomlinson,RB,dead_cap,los-angeles-chargers,2916666,2010
21200,0,2155000,Antonio Cromartie,CB,dead_cap,los-angeles-chargers,2155000,2010
21201,325000,0,Ryon Bingham,DE,dead_cap,los-angeles-chargers,325000,2010
21202,203440,0,Gartrell Johnson,RB,dead_cap,los-angeles-chargers,203440,2010
21203,200000,0,Clinton Hart,S,dead_cap,los-angeles-chargers,200000,2010
21204,0,125000,Nathan Vasher,CB,dead_cap,los-angeles-chargers,125000,2010
21205,99625,0,Scott Chandler,TE,dead_cap,los-angeles-chargers,99625,2010
21206,68925,0,DeJuan Tribble,CB,dead_cap,los-angeles-chargers,68925,2010
21207,50586,0,Kevin Ellison,S,dead_cap,los-angeles-chargers,50586,2010
21208,41250,0,Demetrius Byrd,WR,dead_cap,los-angeles-chargers,41250,2010
21209,22824,0,Corey Clark,T,dead_cap,los-angeles-chargers,22824,2010
21210,0,12050,Dedrick Epps,TE,dead_cap,los-angeles-chargers,12050,2010
21211,5000,0,Kion Wilson,ILB,dead_cap,los-angeles-chargers,5000,2010
21212,4500,0,C.J. Spillman,S,dead_cap,los-angeles-chargers,4500,2010
21213,0,3750,Seyi Ajirotutu,WR,dead_cap,los-angeles-chargers,3750,2010
21214,8400000,6310000,Philip Rivers,QB,active,los-angeles-chargers,14710000,2011
21215,11424000,0,Vincent Jackson,WR,active,los-angeles-chargers,11424000,2011
21216,10000000,358200,Marcus McNeill,T,active,los-angeles-chargers,10358200,2011
21217,4500000,2040000,Kris Dielman,G,active,los-angeles-chargers,6540000,2011
21218,5200000,762500,Antonio Gates,TE,active,los-angeles-chargers,5962500,2011
21219,3900000,1266667,Shaun Phillips,DE,active,los-angeles-chargers,5166667,2011
21220,3750000,0,Quentin Jammer,S,active,los-angeles-chargers,3750000,2011
21221,3675000,0,Nick Hardwick,C,active,los-angeles-chargers,3675000,2011
21222,1000000,2600000,Eric Weddle,FS,active,los-angeles-chargers,3600000,2011
21223,1800000,1700000,Jeromey Clary,G,active,los-angeles-chargers,3500000,2011
21224,1740000,0,Billy Volek,QB,active,los-angeles-chargers,1740000,2011
21225,2350000,0,Patrick Crayton,WR,active,los-angeles-chargers,2350000,2011
21226,1525000,700000,Takeo Spikes,LB,active,los-angeles-chargers,2225000,2011
21227,450000,2767500,Ryan Mathews,RB,active,los-angeles-chargers,3217500,2011
21228,1000000,0,Bob Sanders,S,active,los-angeles-chargers,1000000,2011
21229,810000,1190000,Malcom Floyd,WR,active,los-angeles-chargers,2000000,2011
21230,1835000,0,Mike Tolbert,FB,active,los-angeles-chargers,1835000,2011
21231,1800000,0,Nate Kaeding,K,active,los-angeles-chargers,1800000,2011
21232,665000,1406000,Antoine Cason,CB,active,los-angeles-chargers,2071000,2011
21233,375000,1136954,Corey Liuget,DT,active,los-angeles-chargers,1511954,2011
21234,1155000,185000,Mike Scifres,P,active,los-angeles-chargers,1340000,2011
21235,1000000,300000,Antwan Barnes,OLB,active,los-angeles-chargers,1300000,2011
21236,1000000,200000,Travis LaBoy,DT,active,los-angeles-chargers,1200000,2011
21237,810000,250000,Jacques Cesaire,DE,active,los-angeles-chargers,1060000,2011
21238,1020000,0,Steve Gregory,S,active,los-angeles-chargers,1020000,2011
21239,685000,200000,Scott Mruczkowski,G,active,los-angeles-chargers,885000,2011
21240,910000,0,Nail Diggs,LB,active,los-angeles-chargers,910000,2011
21241,700000,150000,Dante Hughes,CB,active,los-angeles-chargers,850000,2011
21242,640000,150000,Antonio Garay,DE,active,los-angeles-chargers,790000,2011
21243,810000,0,Tommie Harris,DT,active,los-angeles-chargers,810000,2011
21244,555000,208462,Jacob Hester,RB,active,los-angeles-chargers,763462,2011
21245,525000,198625,Louis Vasquez,G,active,los-angeles-chargers,723625,2011
21246,375000,344200,Marcus Gilchrist,SS,active,los-angeles-chargers,719200,2011
21247,685000,0,Tony Moll,T,active,los-angeles-chargers,685000,2011
21248,525000,121562,Vaughn Martin,DE,active,los-angeles-chargers,646562,2011
21249,525000,102312,Tyronne Green,G,active,los-angeles-chargers,627312,2011
21250,405000,202125,Donald Butler,ILB,active,los-angeles-chargers,607125,2011
21251,375000,218340,Jonas Mouton,ILB,active,los-angeles-chargers,593340,2011
21252,450000,126500,Darrell Stuckey,FS,active,los-angeles-chargers,576500,2011
21253,555000,0,Marcus Thomas,RB,active,los-angeles-chargers,555000,2011
21254,810000,0,Randy McMichael,TE,active,los-angeles-chargers,810000,2011
21255,525000,0,Brandyn Dombrowski,G,active,los-angeles-chargers,525000,2011
21256,525000,0,Ogemdi Nwaguo,DT,active,los-angeles-chargers,525000,2011
21257,525000,0,Kory Sperry,TE,active,los-angeles-chargers,525000,2011
21258,375000,146517,Vincent Brown,WR,active,los-angeles-chargers,521517,2011
21259,375000,136035,Shareece Wright,CB,active,los-angeles-chargers,511035,2011
21260,450000,47825,Cam Thomas,DT,active,los-angeles-chargers,497825,2011
21261,480000,0,Everette Brown,OLB,active,los-angeles-chargers,480000,2011
21262,450000,13750,Richard Goodman,WR,active,los-angeles-chargers,463750,2011
21263,465000,0,Nathan Triplett,LB,active,los-angeles-chargers,465000,2011
21264,450000,0,Curtis Brinkley,RB,active,los-angeles-chargers,450000,2011
21265,450000,0,Mike Windt,LS,active,los-angeles-chargers,450000,2011
21266,405000,5000,Brandon Lang,LB,active,los-angeles-chargers,410000,2011
21267,405000,250,Bryan Walters,WR,active,los-angeles-chargers,405250,2011
21268,405000,0,Seyi Ajirotutu,WR,active,los-angeles-chargers,405000,2011
21269,375000,11475,Andrew Gachkar,OLB,active,los-angeles-chargers,386475,2011
21270,375000,0,Darryl Gamble,LB,active,los-angeles-chargers,375000,2011
21271,375000,0,Bryan Walters,WR,active,los-angeles-chargers,375000,2011
21272,220588,0,Steve Schilling,G,active,los-angeles-chargers,220588,2011
21273,685000,0,Jared Gaither,T,active,los-angeles-chargers,685000,2011
21274,195500,0,Jordan Todman,RB,active,los-angeles-chargers,195500,2011
21275,4500000,1100000,Luis Castillo,DE,injured_reserve,los-angeles-chargers,5600000,2011
21276,740000,2030000,Larry English,OLB,injured_reserve,los-angeles-chargers,2770000,2011
21277,258000,666,Patrick DiMarco,FB,injured_reserve,los-angeles-chargers,258666,2011
21278,258000,0,Bront Bird,ILB,injured_reserve,los-angeles-chargers,258000,2011
21279,96900,0,Bront Bird,ILB,practice_squad,los-angeles-chargers,96900,2011
21280,96900,0,Steve Schilling,G,practice_squad,los-angeles-chargers,96900,2011
21281,0,836000,Buster Davis,WR,dead_cap,los-angeles-chargers,836000,2011
21282,193800,0,Frank Summers,FB,dead_cap,los-angeles-chargers,193800,2011
21283,0,125000,Nathan Vasher,CB,dead_cap,los-angeles-chargers,125000,2011
21284,101172,0,Kevin Ellison,S,dead_cap,los-angeles-chargers,101172,2011
21285,50000,0,Jyles Tucker,LB,dead_cap,los-angeles-chargers,50000,2011
21286,0,36150,Dedrick Epps,TE,dead_cap,los-angeles-chargers,36150,2011
21287,0,26018,Jordan Todman,RB,dead_cap,los-angeles-chargers,26018,2011
21288,0,19670,Steve Schilling,G,dead_cap,los-angeles-chargers,19670,2011
21289,5000,0,Kion Wilson,ILB,dead_cap,los-angeles-chargers,5000,2011
21290,0,4166,Scott Tolzien,QB,dead_cap,los-angeles-chargers,4166,2011
21291,0,3750,Seyi Ajirotutu,WR,dead_cap,los-angeles-chargers,3750,2011
21292,1333,0,Bront Bird,ILB,dead_cap,los-angeles-chargers,1333,2011
21293,10200000,6310000,Philip Rivers,QB,active,los-angeles-chargers,16510000,2012
21294,5000000,2600000,Eric Weddle,FS,active,los-angeles-chargers,7600000,2012
21295,712800,7951250,Ryan Mathews,RB,active,los-angeles-chargers,8664050,2012
21296,4000000,3962500,Antonio Gates,TE,active,los-angeles-chargers,7962500,2012
21297,4400000,1266667,Shaun Phillips,DE,active,los-angeles-chargers,5666667,2012
21298,2850000,1700000,Jeromey Clary,G,active,los-angeles-chargers,4550000,2012
21299,4000000,0,Quentin Jammer,S,active,los-angeles-chargers,4000000,2012
21300,2875000,700000,Takeo Spikes,LB,active,los-angeles-chargers,3575000,2012
21301,1500000,1875000,Robert Meachem,WR,active,los-angeles-chargers,3375000,2012
21302,1500000,1500000,Eddie Royal,WR,active,los-angeles-chargers,3000000,2012
21303,1250000,1750000,Nick Hardwick,C,active,los-angeles-chargers,3000000,2012
21304,1000000,2000000,Jared Gaither,T,active,los-angeles-chargers,3000000,2012
21305,1000000,1500000,Jarret Johnson,OLB,active,los-angeles-chargers,2500000,2012
21306,1007500,2030000,Larry English,OLB,active,los-angeles-chargers,3037500,2012
21307,1240000,1406000,Antoine Cason,CB,active,los-angeles-chargers,2646000,2012
21308,1600000,300000,Antwan Barnes,OLB,active,los-angeles-chargers,1900000,2012
21309,752998,1136954,Corey Liuget,DT,active,los-angeles-chargers,1889952,2012
21310,1000000,833333,LeRon McClain,FB,active,los-angeles-chargers,1833333,2012
21311,825000,1385000,Mike Scifres,P,active,los-angeles-chargers,2210000,2012
21312,825000,0,Antonio Garay,DE,active,los-angeles-chargers,825000,2012
21313,390000,1136952,Melvin Ingram,OLB,active,los-angeles-chargers,1526952,2012
21314,1260000,198625,Louis Vasquez,G,active,los-angeles-chargers,1458625,2012
21315,1260000,102312,Tyronne Green,G,active,los-angeles-chargers,1362312,2012
21316,1260000,0,Brandyn Dombrowski,G,active,los-angeles-chargers,1260000,2012
21317,750000,500000,Charlie Whitehurst,QB,active,los-angeles-chargers,1250000,2012
21318,2000000,0,Nate Kaeding,K,active,los-angeles-chargers,2000000,2012
21319,925000,135000,Randy McMichael,TE,active,los-angeles-chargers,1060000,2012
21320,825000,175000,Ronnie Brown,RB,active,los-angeles-chargers,1000000,2012
21321,554800,344200,Marcus Gilchrist,SS,active,los-angeles-chargers,899000,2012
21322,825000,0,Chris Carr,CB,active,los-angeles-chargers,825000,2012
21323,390000,360545,Kendall Reyes,DE,active,los-angeles-chargers,750545,2012
21324,523335,218340,Jonas Mouton,ILB,active,los-angeles-chargers,741675,2012
21325,490000,202125,Donald Butler,ILB,active,los-angeles-chargers,692125,2012
21326,540000,126500,Darrell Stuckey,FS,active,los-angeles-chargers,666500,2012
21327,465000,146517,Vincent Brown,WR,active,los-angeles-chargers,611517,2012
21328,825000,65000,Rex Hadnot,G,active,los-angeles-chargers,890000,2012
21329,825000,65000,Rex Hadnot,G,active,los-angeles-chargers,890000,2012
21330,465000,136035,Shareece Wright,CB,active,los-angeles-chargers,601035,2012
21331,540000,47825,Cam Thomas,DT,active,los-angeles-chargers,587825,2012
21332,565000,0,Everette Brown,OLB,active,los-angeles-chargers,565000,2012
21333,825000,65000,Demorrio Williams,LB,active,los-angeles-chargers,890000,2012
21334,700000,0,Jackie Battle,FB,active,los-angeles-chargers,700000,2012
21335,700000,0,Corey Lynch,S,active,los-angeles-chargers,700000,2012
21336,700000,0,Nick Novak,K,active,los-angeles-chargers,700000,2012
21337,700000,0,Dante Rosario,TE,active,los-angeles-chargers,700000,2012
21338,700000,0,Micheal Spurlock,WR,active,los-angeles-chargers,700000,2012
21339,540000,0,Seyi Ajirotutu,WR,active,los-angeles-chargers,540000,2012
21340,540000,0,Mike Windt,LS,active,los-angeles-chargers,540000,2012
21341,390000,112725,Ladarius Green,TE,active,los-angeles-chargers,502725,2012
21342,465000,11475,Andrew Gachkar,OLB,active,los-angeles-chargers,476475,2012
21343,465000,0,Kevin Haslam,T,active,los-angeles-chargers,465000,2012
21344,540000,0,Curtis Brinkley,RB,active,los-angeles-chargers,540000,2012
21345,390000,13988,David Molk,C,active,los-angeles-chargers,403988,2012
21346,390000,1166,Mike Harris,G,active,los-angeles-chargers,391166,2012
21347,390000,0,Sean Cattouse,S,active,los-angeles-chargers,390000,2012
21348,390000,0,Greg Gatson,CB,active,los-angeles-chargers,390000,2012
21349,390000,0,DeAndre McDaniel,S,active,los-angeles-chargers,390000,2012
21350,390000,0,Nick Polk,CB,active,los-angeles-chargers,390000,2012
21351,390000,0,Damik Scafe,DE,active,los-angeles-chargers,390000,2012
21352,390000,0,Michael Willie,WR,active,los-angeles-chargers,390000,2012
21353,465000,0,Colin Baxter,C,active,los-angeles-chargers,465000,2012
21354,540000,0,Danario Alexander,WR,active,los-angeles-chargers,540000,2012
21355,540000,0,Richard Goodman,WR,active,los-angeles-chargers,540000,2012
21356,257812,0,Reggie Wells,G,active,los-angeles-chargers,257812,2012
21357,825000,0,Reggie Wells,G,active,los-angeles-chargers,825000,2012
21358,465000,0,Bront Bird,ILB,active,los-angeles-chargers,465000,2012
21359,465000,0,Steve Schilling,G,active,los-angeles-chargers,465000,2012
21360,2000000,250000,Malcom Floyd,WR,injured_reserve,los-angeles-chargers,2250000,2012
21361,700000,150000,Atari Bigby,S,injured_reserve,los-angeles-chargers,850000,2012
21362,615000,121562,Vaughn Martin,DE,injured_reserve,los-angeles-chargers,736562,2012
21363,825000,65000,Aubrayo Franklin,DT,injured_reserve,los-angeles-chargers,890000,2012
21364,390000,160969,Brandon Taylor,S,injured_reserve,los-angeles-chargers,550969,2012
21365,390000,47938,Johnnie Troutman,G,injured_reserve,los-angeles-chargers,437938,2012
21366,5200000,0,Marcus McNeill,T,dead_cap,los-angeles-chargers,5200000,2012
21367,125000,2175000,Luis Castillo,DE,dead_cap,los-angeles-chargers,2300000,2012
21368,1700000,0,Kris Dielman,G,dead_cap,los-angeles-chargers,1700000,2012
21369,250000,0,Jacques Cesaire,DE,dead_cap,los-angeles-chargers,250000,2012
21370,200000,0,Travis LaBoy,DT,dead_cap,los-angeles-chargers,200000,2012
21371,150000,0,Dante Hughes,CB,dead_cap,los-angeles-chargers,150000,2012
21372,50000,0,Jyles Tucker,LB,dead_cap,los-angeles-chargers,50000,2012
21373,0,39340,Steve Schilling,G,dead_cap,los-angeles-chargers,39340,2012
21374,11474,0,Edwin Baker,RB,dead_cap,los-angeles-chargers,11474,2012
21375,0,8332,Scott Tolzien,QB,dead_cap,los-angeles-chargers,8332,2012
21376,2667,0,Bront Bird,ILB,dead_cap,los-angeles-chargers,2667,2012
21377,0,1334,Patrick DiMarco,FB,dead_cap,los-angeles-chargers,1334,2012
21378,7000000,7976666,Philip Rivers,QB,active,los-angeles-chargers,14976666,2013
21379,6000000,2600000,Eric Weddle,FS,active,los-angeles-chargers,8600000,2013
21380,4500000,3962500,Antonio Gates,TE,active,los-angeles-chargers,8462500,2013
21381,4000000,1700000,Jeromey Clary,G,active,los-angeles-chargers,5700000,2013
21382,3000000,1500000,Jarret Johnson,OLB,active,los-angeles-chargers,4500000,2013
21383,3000000,1500000,Eddie Royal,WR,active,los-angeles-chargers,4500000,2013
21384,2600000,1750000,Nick Hardwick,C,active,los-angeles-chargers,4350000,2013
21385,3000000,1385000,Mike Scifres,P,active,los-angeles-chargers,4385000,2013
21386,1500000,2062500,Dwight Freeney,OLB,active,los-angeles-chargers,3562500,2013
21387,2250000,833333,LeRon McClain,FB,active,los-angeles-chargers,3083333,2013
21388,1195500,2767500,Ryan Mathews,RB,active,los-angeles-chargers,3963000,2013
21389,1130976,1136954,Corey Liuget,DT,active,los-angeles-chargers,2267930,2013
21390,800000,1300000,Derek Cox,CB,active,los-angeles-chargers,2100000,2013
21391,405000,1668182,D.J. Fluker,G,active,los-angeles-chargers,2073182,2013
21392,771738,1136952,Melvin Ingram,OLB,active,los-angeles-chargers,1908690,2013
21393,950000,875000,King Dunlap,LT,active,los-angeles-chargers,1825000,2013
21394,1300000,500000,Charlie Whitehurst,QB,active,los-angeles-chargers,1800000,2013
21395,1323000,202125,Donald Butler,ILB,active,los-angeles-chargers,1525125,2013
21396,1323000,47825,Cam Thomas,DT,active,los-angeles-chargers,1370825,2013
21397,650000,666666,John Phillips,TE,active,los-angeles-chargers,1316666,2013
21398,850000,400000,Chad Rinehart,G,active,los-angeles-chargers,1250000,2013
21399,750000,500000,Danny Woodhead,RB,active,los-angeles-chargers,1250000,2013
21400,750000,375000,Nick Novak,K,active,los-angeles-chargers,1125000,2013
21401,734600,344200,Marcus Gilchrist,SS,active,los-angeles-chargers,1078800,2013
21402,840000,110000,Ronnie Brown,RB,active,los-angeles-chargers,950000,2013
21403,405000,535440,Manti Te'o,ILB,active,los-angeles-chargers,940440,2013
21404,577636,360545,Kendall Reyes,DE,active,los-angeles-chargers,938181,2013
21405,671670,218340,Jonas Mouton,ILB,active,los-angeles-chargers,890010,2013
21406,630000,126500,Darrell Stuckey,FS,active,los-angeles-chargers,756500,2013
21407,630000,112500,Mike Windt,LS,active,los-angeles-chargers,742500,2013
21408,555000,146517,Vincent Brown,WR,active,los-angeles-chargers,701517,2013
21409,555000,136035,Shareece Wright,CB,active,los-angeles-chargers,691035,2013
21410,630000,45000,Rich Ohrnberger,C,active,los-angeles-chargers,675000,2013
21411,480000,168469,Brandon Taylor,S,active,los-angeles-chargers,648469,2013
21412,630000,0,Seyi Ajirotutu,WR,active,los-angeles-chargers,630000,2013
21413,630000,0,Sean Lissemore,DT,active,los-angeles-chargers,630000,2013
21414,480000,112725,Ladarius Green,TE,active,los-angeles-chargers,592725,2013
21415,840000,15000,Richard Marshall,CB,active,los-angeles-chargers,855000,2013
21416,715000,15000,Reggie Walker,ILB,active,los-angeles-chargers,730000,2013
21417,555000,11475,Andrew Gachkar,OLB,active,los-angeles-chargers,566475,2013
21418,405000,153450,Keenan Allen,WR,active,los-angeles-chargers,558450,2013
21419,555000,0,Bront Bird,ILB,active,los-angeles-chargers,555000,2013
21420,555000,0,Johnny Patrick,CB,active,los-angeles-chargers,555000,2013
21421,715000,0,Lavelle Hawkins,WR,active,los-angeles-chargers,715000,2013
21422,555000,0,Crezdon Butler,CB,active,los-angeles-chargers,555000,2013
21423,480000,1166,Mike Harris,G,active,los-angeles-chargers,481166,2013
21424,555000,0,Steve Schilling,G,active,los-angeles-chargers,555000,2013
21425,405000,47938,Johnnie Troutman,G,active,los-angeles-chargers,452938,2013
21426,405000,27515,Tourek Williams,OLB,active,los-angeles-chargers,432515,2013
21427,555000,0,Thomas Keiser,OLB,active,los-angeles-chargers,555000,2013
21428,405000,14850,Brad Sorensen,QB,active,los-angeles-chargers,419850,2013
21429,405000,1666,Jahleel Addae,SS,active,los-angeles-chargers,406666,2013
21430,405000,1000,Kwame Geathers,DT,active,los-angeles-chargers,406000,2013
21431,480000,0,Lawrence Guy,DE,active,los-angeles-chargers,480000,2013
21432,288000,48200,Steve Williams,CB,active,los-angeles-chargers,336200,2013
21433,555000,0,Willie Smith,LT,active,los-angeles-chargers,555000,2013
21434,405000,0,Kenny Wiggins,G,active,los-angeles-chargers,405000,2013
21435,405000,0,Marcus Cromartie,CB,active,los-angeles-chargers,405000,2013
21436,405000,0,Jacob Byrne,TE,active,los-angeles-chargers,405000,2013
21437,1500000,2083332,Malcom Floyd,WR,injured_reserve,los-angeles-chargers,3583332,2013
21438,1275000,2030000,Larry English,OLB,injured_reserve,los-angeles-chargers,3305000,2013
21439,1323000,0,Danario Alexander,WR,injured_reserve,los-angeles-chargers,1323000,2013
21440,288000,1666,Byron Jerideau,DT,injured_reserve,los-angeles-chargers,289666,2013
21441,90000,0,Marcus Cromartie,CB,practice_squad,los-angeles-chargers,90000,2013
21442,68235,0,Drake Nevis,DE,practice_squad,los-angeles-chargers,68235,2013
21443,30000,0,Jacob Byrne,TE,practice_squad,los-angeles-chargers,30000,2013
21444,24000,0,Thomas Keiser,OLB,practice_squad,los-angeles-chargers,24000,2013
21445,12000,0,Miguel Maysonet,RB,practice_squad,los-angeles-chargers,12000,2013
21446,6000,0,Will Pericak,DT,practice_squad,los-angeles-chargers,6000,2013
21447,6875000,0,Robert Meachem,WR,dead_cap,los-angeles-chargers,6875000,2013
21448,0,2000000,Jared Gaither,T,dead_cap,los-angeles-chargers,2000000,2013
21449,700000,0,Takeo Spikes,LB,dead_cap,los-angeles-chargers,700000,2013
21450,585000,0,Jarius Wynn,OLB,dead_cap,los-angeles-chargers,585000,2013
21451,375000,0,Antonio Garay,DE,dead_cap,los-angeles-chargers,375000,2013
21452,211088,0,Nick Becton,LT,dead_cap,los-angeles-chargers,211088,2013
21453,166765,0,Mike Remmers,RT,dead_cap,los-angeles-chargers,166765,2013
21454,0,160000,Max Starks,LT,dead_cap,los-angeles-chargers,160000,2013
21455,150000,0,Atari Bigby,S,dead_cap,los-angeles-chargers,150000,2013
21456,135000,0,Randy McMichael,TE,dead_cap,los-angeles-chargers,135000,2013
21457,112941,0,Terrell Manning,ILB,dead_cap,los-angeles-chargers,112941,2013
21458,112941,0,Adrian Robinson,OLB,dead_cap,los-angeles-chargers,112941,2013
21459,103152,0,D.J. Smith,ILB,dead_cap,los-angeles-chargers,103152,2013
21460,95294,0,Fozzy Whittaker,RB,dead_cap,los-angeles-chargers,95294,2013
21461,84706,0,Damik Scafe,DE,dead_cap,los-angeles-chargers,84706,2013
21462,83824,0,Kenny Wiggins,G,dead_cap,los-angeles-chargers,83824,2013
21463,72666,0,Brandon Moore,DE,dead_cap,los-angeles-chargers,72666,2013
21464,65000,0,Deon Butler,WR,dead_cap,los-angeles-chargers,65000,2013
21465,60000,0,Josh Bellamy,WR,dead_cap,los-angeles-chargers,60000,2013
21466,48000,0,Andrew Tiller,G,dead_cap,los-angeles-chargers,48000,2013
21467,34422,0,Edwin Baker,RB,dead_cap,los-angeles-chargers,34422,2013
21468,24000,0,Toney Clemons,WR,dead_cap,los-angeles-chargers,24000,2013
21469,17941,0,Devan Walker,LB,dead_cap,los-angeles-chargers,17941,2013
21470,13988,0,David Molk,C,dead_cap,los-angeles-chargers,13988,2013
21471,0,1666,Marcus Cromartie,CB,dead_cap,los-angeles-chargers,1666,2013
21472,1666,0,Michael Hill,RB,dead_cap,los-angeles-chargers,1666,2013
21473,1666,0,Daniel Molls,ILB,dead_cap,los-angeles-chargers,1666,2013
21474,1666,0,Randy Richards,RT,dead_cap,los-angeles-chargers,1666,2013
21475,1000,0,Josh Johnson,CB,dead_cap,los-angeles-chargers,1000,2013
21476,833,0,Greg Brown,CB,dead_cap,los-angeles-chargers,833,2013
21477,666,0,Ben Cotton,TE,dead_cap,los-angeles-chargers,666,2013
21478,666,0,Chukky Okobi,C,dead_cap,los-angeles-chargers,666,2013
21479,333,0,Frank Beltre,OLB,dead_cap,los-angeles-chargers,333,2013
21480,333,0,Mike Hermann,QB,dead_cap,los-angeles-chargers,333,2013
21481,333,0,Richard Kent,P,dead_cap,los-angeles-chargers,333,2013
21482,333,0,Jamarkus McFarland,DE,dead_cap,los-angeles-chargers,333,2013
21483,333,0,David Rolf,TE,dead_cap,los-angeles-chargers,333,2013
21484,333,0,Luke Tasker,WR,dead_cap,los-angeles-chargers,333,2013
21485,13800000,4066666,Philip Rivers,QB,active,los-angeles-chargers,17866666,2014
21486,7500000,2600000,Eric Weddle,FS,active,los-angeles-chargers,10100000,2014
21487,2000000,5462500,Antonio Gates,TE,active,los-angeles-chargers,7462500,2014
21488,1750000,3250000,Eddie Royal,WR,active,los-angeles-chargers,5000000,2014
21489,1625000,2453125,Dwight Freeney,OLB,active,los-angeles-chargers,4078125,2014
21490,2750000,2083332,Malcom Floyd,WR,active,los-angeles-chargers,4833332,2014
21491,1978250,2767500,Ryan Mathews,RB,active,los-angeles-chargers,4745750,2014
21492,1000000,3500000,Jarret Johnson,OLB,active,los-angeles-chargers,4500000,2014
21493,1600000,1700000,Jeromey Clary,G,active,los-angeles-chargers,3300000,2014
21494,1500000,1500000,Brandon Flowers,CB,active,los-angeles-chargers,3000000,2014
21495,750000,2230000,Donald Butler,ILB,active,los-angeles-chargers,2980000,2014
21496,758964,1886954,Corey Liuget,DT,active,los-angeles-chargers,2645918,2014
21497,923294,1668182,D.J. Fluker,G,active,los-angeles-chargers,2591476,2014
21498,1600000,825000,King Dunlap,LT,active,los-angeles-chargers,2425000,2014
21499,1153476,1136952,Melvin Ingram,OLB,active,los-angeles-chargers,2290428,2014
21500,750000,1500000,Danny Woodhead,RB,active,los-angeles-chargers,2250000,2014
21501,1175000,666666,John Phillips,TE,active,los-angeles-chargers,1841666,2014
21502,750000,1083333,Donald Brown,RB,active,los-angeles-chargers,1833333,2014
21503,750000,1000000,Chad Rinehart,G,active,los-angeles-chargers,1750000,2014
21504,1325000,375000,Nick Novak,K,active,los-angeles-chargers,1700000,2014
21505,303000,1014364,Jason Verrett,CB,active,los-angeles-chargers,1317364,2014
21506,914400,344200,Marcus Gilchrist,SS,active,los-angeles-chargers,1258600,2014
21507,855000,322500,Kellen Clemens,QB,active,los-angeles-chargers,1177500,2014
21508,640110,535440,Manti Te'o,ILB,active,los-angeles-chargers,1175550,2014
21509,730000,433750,Darrell Stuckey,FS,active,los-angeles-chargers,1163750,2014
21510,765272,360545,Kendall Reyes,DE,active,los-angeles-chargers,1125817,2014
21511,1000000,0,Sean Lissemore,DT,active,los-angeles-chargers,1000000,2014
21512,730000,160000,Reggie Walker,ILB,active,los-angeles-chargers,890000,2014
21513,730000,112500,Mike Windt,LS,active,los-angeles-chargers,842500,2014
21514,730000,110000,David Johnson,TE,active,los-angeles-chargers,840000,2014
21515,730000,90000,Kavell Conner,ILB,active,los-angeles-chargers,820000,2014
21516,645000,136035,Shareece Wright,CB,active,los-angeles-chargers,781035,2014
21517,420000,344200,Jeremiah Attaochu,OLB,active,los-angeles-chargers,764200,2014
21518,570000,112725,Ladarius Green,TE,active,los-angeles-chargers,682725,2014
21519,495000,163450,Keenan Allen,WR,active,los-angeles-chargers,658450,2014
21520,645000,11475,Andrew Gachkar,OLB,active,los-angeles-chargers,656475,2014
21521,645000,0,Willie Smith,LT,active,los-angeles-chargers,645000,2014
21522,730000,65000,Seyi Ajirotutu,WR,active,los-angeles-chargers,795000,2014
21523,730000,0,Ricardo Mathews,DT,active,los-angeles-chargers,730000,2014
21524,420000,136035,Chris Watt,C,active,los-angeles-chargers,556035,2014
21525,495000,27515,Tourek Williams,OLB,active,los-angeles-chargers,522515,2014
21526,495000,1666,Jahleel Addae,SS,active,los-angeles-chargers,496666,2014
21527,420000,48200,Steve Williams,CB,active,los-angeles-chargers,468200,2014
21528,420000,44633,Ryan Carrethers,DT,active,los-angeles-chargers,464633,2014
21529,420000,7500,Dontrelle Inman,WR,active,los-angeles-chargers,427500,2014
21530,420000,4166,Tenny Palepoi,DT,active,los-angeles-chargers,424166,2014
21531,420000,2000,Chris Davis,CB,active,los-angeles-chargers,422000,2014
21532,420000,0,Branden Oliver,RB,active,los-angeles-chargers,420000,2014
21533,855000,0,Ronnie Brown,RB,active,los-angeles-chargers,855000,2014
21534,570000,0,Trevor Robinson,C,active,los-angeles-chargers,570000,2014
21535,495000,0,Damion Square,DT,active,los-angeles-chargers,495000,2014
21536,420000,0,Cordarro Law,OLB,active,los-angeles-chargers,420000,2014
21537,420000,0,Jeremiah Sirles,G,active,los-angeles-chargers,420000,2014
21538,955000,0,Mat McBriar,P,active,los-angeles-chargers,955000,2014
21539,420000,0,Greg Ducre,CB,active,los-angeles-chargers,420000,2014
21540,495000,0,Kenny Wiggins,G,active,los-angeles-chargers,495000,2014
21541,420000,0,Jeff Baca,G,active,los-angeles-chargers,420000,2014
21542,3400000,2750000,Nick Hardwick,C,injured_reserve,los-angeles-chargers,6150000,2014
21543,3250000,1385000,Mike Scifres,P,injured_reserve,los-angeles-chargers,4635000,2014
21544,730000,0,Doug Legursky,C,injured_reserve,los-angeles-chargers,730000,2014
21545,730000,65000,Rich Ohrnberger,C,injured_reserve,los-angeles-chargers,795000,2014
21546,495000,47938,Johnnie Troutman,G,injured_reserve,los-angeles-chargers,542938,2014
21547,303000,1000,Alvin Scioneaux,ILB,injured_reserve,los-angeles-chargers,304000,2014
21548,303000,833,Ricky Tjong-A-Tjoe,DT,injured_reserve,los-angeles-chargers,303833,2014
21549,303000,0,Damik Scafe,DE,injured_reserve,los-angeles-chargers,303000,2014
21550,107100,0,Torrence Allen,WR,practice_squad,los-angeles-chargers,107100,2014
21551,107100,0,Javontee Herndon,WR,practice_squad,los-angeles-chargers,107100,2014
21552,88200,0,David Paulson,TE,practice_squad,los-angeles-chargers,88200,2014
21553,88200,0,Colton Underwood,DE,practice_squad,los-angeles-chargers,88200,2014
21554,81900,0,Chas Alecxih,DT,practice_squad,los-angeles-chargers,81900,2014
21555,31500,0,Richard Crawford,CB,practice_squad,los-angeles-chargers,31500,2014
21556,25200,0,Adrian Phillips,FS,practice_squad,los-angeles-chargers,25200,2014
21557,25200,0,Bryce Quigley,G,practice_squad,los-angeles-chargers,25200,2014
21558,18900,0,Kwame Geathers,DT,practice_squad,los-angeles-chargers,18900,2014
21559,12600,0,Brad Sorensen,QB,practice_squad,los-angeles-chargers,12600,2014
21560,0,4000000,Jared Gaither,T,dead_cap,los-angeles-chargers,4000000,2014
21561,3900000,0,Derek Cox,CB,dead_cap,los-angeles-chargers,3900000,2014
21562,3750000,0,Robert Meachem,WR,dead_cap,los-angeles-chargers,3750000,2014
21563,865000,0,Larry English,OLB,dead_cap,los-angeles-chargers,865000,2014
21564,833333,0,LeRon McClain,FB,dead_cap,los-angeles-chargers,833333,2014
21565,570000,0,Richard Marshall,CB,dead_cap,los-angeles-chargers,570000,2014
21566,243176,1000,Kwame Geathers,DT,dead_cap,los-angeles-chargers,244176,2014
21567,222847,1250,Cordarro Law,OLB,dead_cap,los-angeles-chargers,224097,2014
21568,0,218340,Jonas Mouton,ILB,dead_cap,los-angeles-chargers,218340,2014
21569,201176,0,Shaun Draughn,RB,dead_cap,los-angeles-chargers,201176,2014
21570,70000,115000,Brandon Ghee,CB,dead_cap,los-angeles-chargers,185000,2014
21571,0,168469,Brandon Taylor,S,dead_cap,los-angeles-chargers,168469,2014
21572,160182,0,Ryan Miller,RT,dead_cap,los-angeles-chargers,160182,2014
21573,0,146517,Vincent Brown,WR,dead_cap,los-angeles-chargers,146517,2014
21574,116471,0,Richard Crawford,CB,dead_cap,los-angeles-chargers,116471,2014
21575,100588,0,Lawrence Guy,DE,dead_cap,los-angeles-chargers,100588,2014
21576,88200,667,D.J. Adams,RB,dead_cap,los-angeles-chargers,88867,2014
21577,75600,3000,Jeremiah Sirles,G,dead_cap,los-angeles-chargers,78600,2014
21578,68806,0,Adrian Phillips,FS,dead_cap,los-angeles-chargers,68806,2014
21579,63000,0,Ryan Lindley,QB,dead_cap,los-angeles-chargers,63000,2014
21580,58235,0,Kevin Reddick,ILB,dead_cap,los-angeles-chargers,58235,2014
21581,53471,3334,Marcus Cromartie,CB,dead_cap,los-angeles-chargers,56805,2014
21582,18900,24724,Marion Grice,RB,dead_cap,los-angeles-chargers,43624,2014
21583,37800,1333,Greg Ducre,CB,dead_cap,los-angeles-chargers,39133,2014
21584,37800,0,Kendall James,CB,dead_cap,los-angeles-chargers,37800,2014
21585,35418,0,Jeff Baca,G,dead_cap,los-angeles-chargers,35418,2014
21586,27976,0,David Molk,C,dead_cap,los-angeles-chargers,27976,2014
21587,25200,0,Chas Alecxih,DT,dead_cap,los-angeles-chargers,25200,2014
21588,25200,0,Aaron Hester,CB,dead_cap,los-angeles-chargers,25200,2014
21589,25200,0,Bryce Quigley,G,dead_cap,los-angeles-chargers,25200,2014
21590,0,14850,Brad Sorensen,QB,dead_cap,los-angeles-chargers,14850,2014
21591,0,12358,Tevin Reese,WR,dead_cap,los-angeles-chargers,12358,2014
21592,0,8750,Nick McDonald,C,dead_cap,los-angeles-chargers,8750,2014
21593,5000,0,Nick Becton,LT,dead_cap,los-angeles-chargers,5000,2014
21594,0,4000,Torrence Allen,WR,dead_cap,los-angeles-chargers,4000,2014
21595,0,3334,Byron Jerideau,DT,dead_cap,los-angeles-chargers,3334,2014
21596,3334,0,Michael Hill,RB,dead_cap,los-angeles-chargers,3334,2014
21597,3334,0,Daniel Molls,ILB,dead_cap,los-angeles-chargers,3334,2014
21598,3334,0,Randy Richards,RT,dead_cap,los-angeles-chargers,3334,2014
21599,0,2500,Ian White,RT,dead_cap,los-angeles-chargers,2500,2014
21600,2000,0,Josh Johnson,CB,dead_cap,los-angeles-chargers,2000,2014
21601,2000,0,Devan Walker,LB,dead_cap,los-angeles-chargers,2000,2014
21602,1667,0,Greg Brown,CB,dead_cap,los-angeles-chargers,1667,2014
21603,0,1666,Alden Darby,FS,dead_cap,los-angeles-chargers,1666,2014
21604,0,1500,Javontee Herndon,WR,dead_cap,los-angeles-chargers,1500,2014
21605,1334,0,Ben Cotton,TE,dead_cap,los-angeles-chargers,1334,2014
21606,1334,0,Brandon Moore,DE,dead_cap,los-angeles-chargers,1334,2014
21607,1334,0,Chukky Okobi,C,dead_cap,los-angeles-chargers,1334,2014
21608,0,1168,Mike Harris,G,dead_cap,los-angeles-chargers,1168,2014
21609,0,1166,D.J. Johnson,G,dead_cap,los-angeles-chargers,1166,2014
21610,0,1000,Brelan Chancellor,WR,dead_cap,los-angeles-chargers,1000,2014
21611,0,1000,Colton Underwood,DE,dead_cap,los-angeles-chargers,1000,2014
21612,667,0,Frank Beltre,OLB,dead_cap,los-angeles-chargers,667,2014
21613,667,0,Mike Hermann,QB,dead_cap,los-angeles-chargers,667,2014
21614,667,0,Richard Kent,P,dead_cap,los-angeles-chargers,667,2014
21615,667,0,Jamarkus McFarland,DE,dead_cap,los-angeles-chargers,667,2014
21616,667,0,David Rolf,TE,dead_cap,los-angeles-chargers,667,2014
21617,667,0,Luke Tasker,WR,dead_cap,los-angeles-chargers,667,2014
21618,0,666,Micah Hatfield,WR,dead_cap,los-angeles-chargers,666,2014
21619,0,333,Mike Flacco,TE,dead_cap,los-angeles-chargers,333,2014
21620,0,333,Chase Tenpenny,P,dead_cap,los-angeles-chargers,333,2014
21621,15000000,6166668,Philip Rivers,QB,active,los-angeles-chargers,21166668,2015
21622,4511764,5462500,Antonio Gates,TE,active,los-angeles-chargers,9974264,2015
21623,3250000,2230000,Donald Butler,ILB,active,los-angeles-chargers,5480000,2015
21624,3000000,2633336,Malcom Floyd,WR,active,los-angeles-chargers,5633336,2015
21625,3000000,1600000,Orlando Franklin,G,active,los-angeles-chargers,4600000,2015
21626,3562500,1385000,Mike Scifres,P,active,los-angeles-chargers,4947500,2015
21627,2000000,2125000,King Dunlap,LT,active,los-angeles-chargers,4125000,2015
21628,1441589,1668182,D.J. Fluker,G,active,los-angeles-chargers,3109771,2015
21629,785214,1886952,Melvin Ingram,OLB,active,los-angeles-chargers,2672166,2015
21630,1500000,1000000,Danny Woodhead,RB,active,los-angeles-chargers,2500000,2015
21631,3000000,0,Donald Brown,RB,active,los-angeles-chargers,3000000,2015
21632,1100000,1000000,Stevie Johnson,WR,active,los-angeles-chargers,2100000,2015
21633,745000,1350000,Joe Barksdale,RT,active,los-angeles-chargers,2095000,2015
21634,1000000,1000000,Patrick Robinson,CB,active,los-angeles-chargers,2000000,2015
21635,1250000,572500,Kellen Clemens,QB,active,los-angeles-chargers,1822500,2015
21636,778591,1014364,Jason Verrett,CB,active,los-angeles-chargers,1792955,2015
21637,875220,535440,Manti Te'o,ILB,active,los-angeles-chargers,1410660,2015
21638,952908,360545,Kendall Reyes,DE,active,los-angeles-chargers,1313453,2015
21639,611050,344200,Jeremiah Attaochu,OLB,active,los-angeles-chargers,955250,2015
21640,745000,175000,Ricardo Mathews,DT,active,los-angeles-chargers,920000,2015
21641,745000,137500,Mike Windt,LS,active,los-angeles-chargers,882500,2015
21642,435000,433449,Denzel Perryman,ILB,active,los-angeles-chargers,868449,2015
21643,750000,110000,David Johnson,TE,active,los-angeles-chargers,860000,2015
21644,750000,90000,Kavell Conner,ILB,active,los-angeles-chargers,840000,2015
21645,750000,75000,Trevor Robinson,C,active,los-angeles-chargers,825000,2015
21646,660000,25000,Chris Hairston,LT,active,los-angeles-chargers,685000,2015
21647,435000,165394,Craig Mager,CB,active,los-angeles-chargers,600394,2015
21648,585000,1668,Jahleel Addae,SS,active,los-angeles-chargers,586668,2015
21649,745000,0,John Phillips,TE,active,los-angeles-chargers,745000,2015
21650,510000,48200,Steve Williams,CB,active,los-angeles-chargers,558200,2015
21651,510000,44633,Ryan Carrethers,DT,active,los-angeles-chargers,554633,2015
21652,510000,7500,Dontrelle Inman,WR,active,los-angeles-chargers,517500,2015
21653,510000,0,Cordarro Law,OLB,active,los-angeles-chargers,510000,2015
21654,435000,54643,Kyle Emanuel,OLB,active,los-angeles-chargers,489643,2015
21655,480000,0,Kenny Wiggins,G,active,los-angeles-chargers,480000,2015
21656,435000,30146,Darius Philon,DE,active,los-angeles-chargers,465146,2015
21657,435000,1666,Nick Dzubnar,ILB,active,los-angeles-chargers,436666,2015
21658,435000,1666,Josh Lambo,K,active,los-angeles-chargers,436666,2015
21659,358235,0,Tyreek Burwell,T,active,los-angeles-chargers,358235,2015
21660,511764,0,Joe Mays,ILB,active,los-angeles-chargers,511764,2015
21661,333000,4166,Tenny Palepoi,DT,active,los-angeles-chargers,337166,2015
21662,318000,2500,Brock Hekking,OLB,active,los-angeles-chargers,320500,2015
21663,394411,0,J.D. Walton,C,active,los-angeles-chargers,394411,2015
21664,309705,0,Damion Square,DT,active,los-angeles-chargers,309705,2015
21665,270000,0,Greg Ducre,CB,active,los-angeles-chargers,270000,2015
21666,230294,0,Javontee Herndon,WR,active,los-angeles-chargers,230294,2015
21667,179117,0,Tyrell Williams,WR,active,los-angeles-chargers,179117,2015
21668,131470,0,Jeff Linkenbach,RT,active,los-angeles-chargers,131470,2015
21669,90000,0,Adrian Phillips,FS,active,los-angeles-chargers,90000,2015
21670,51176,0,Dreamius Smith,RB,active,los-angeles-chargers,51176,2015
21671,43823,0,Cassius Vaughn,CB,active,los-angeles-chargers,43823,2015
21672,38823,0,Brandian Ross,CB,active,los-angeles-chargers,38823,2015
21673,34411,0,Matt Daniels,FS,active,los-angeles-chargers,34411,2015
21674,30000,0,Asante Cleveland,TE,active,los-angeles-chargers,30000,2015
21675,25588,0,Sean McGrath,TE,active,los-angeles-chargers,25588,2015
21676,7500000,2600000,Eric Weddle,FS,injured_reserve,los-angeles-chargers,10100000,2015
21677,1000000,6977000,Corey Liuget,DT,injured_reserve,los-angeles-chargers,7977000,2015
21678,2250000,2000000,Brandon Flowers,CB,injured_reserve,los-angeles-chargers,4250000,2015
21679,421235,1504958,Melvin Gordon,RB,injured_reserve,los-angeles-chargers,1926193,2015
21680,1542000,47938,Johnnie Troutman,G,injured_reserve,los-angeles-chargers,1589938,2015
21681,1000000,433750,Darrell Stuckey,FS,injured_reserve,los-angeles-chargers,1433750,2015
21682,1250000,0,Sean Lissemore,DT,injured_reserve,los-angeles-chargers,1250000,2015
21683,660000,112725,Ladarius Green,TE,injured_reserve,los-angeles-chargers,772725,2015
21684,459529,168450,Keenan Allen,WR,injured_reserve,los-angeles-chargers,627979,2015
21685,426705,153535,Chris Watt,C,injured_reserve,los-angeles-chargers,580240,2015
21686,459529,27515,Tourek Williams,OLB,injured_reserve,los-angeles-chargers,487044,2015
21687,451588,0,Branden Oliver,RB,injured_reserve,los-angeles-chargers,451588,2015
21688,318000,1333,Chi Chi Ariguzo,ILB,injured_reserve,los-angeles-chargers,319333,2015
21689,3000000,1083333,Donald Brown,RB,dead_cap,los-angeles-chargers,4083333,2015
21690,0,3500000,Jarret Johnson,OLB,dead_cap,los-angeles-chargers,3500000,2015
21691,1000000,1250000,Jimmy Wilson,SS,dead_cap,los-angeles-chargers,2250000,2015
21692,0,2767500,Ryan Mathews,RB,dead_cap,los-angeles-chargers,2767500,2015
21693,423529,800000,Jacoby Jones,WR,dead_cap,los-angeles-chargers,1223529,2015
21694,0,1000000,Chad Rinehart,G,dead_cap,los-angeles-chargers,1000000,2015
21695,0,666668,John Phillips,TE,dead_cap,los-angeles-chargers,666668,2015
21696,0,375000,Nick Novak,K,dead_cap,los-angeles-chargers,375000,2015
21697,349800,0,Adrian Phillips,FS,dead_cap,los-angeles-chargers,349800,2015
21698,318000,8000,Torrence Allen,WR,dead_cap,los-angeles-chargers,326000,2015
21699,88235,125000,Mitch Unrein,DE,dead_cap,los-angeles-chargers,213235,2015
21700,135600,29700,Brad Sorensen,QB,dead_cap,los-angeles-chargers,165300,2015
21701,0,160969,Brandon Taylor,S,dead_cap,los-angeles-chargers,160969,2015
21702,0,160000,Reggie Walker,ILB,dead_cap,los-angeles-chargers,160000,2015
21703,137117,2000,Chris Davis,CB,dead_cap,los-angeles-chargers,139117,2015
21704,175294,0,J.D. Walton,C,dead_cap,los-angeles-chargers,175294,2015
21705,116470,0,Vincent Brown,WR,dead_cap,los-angeles-chargers,116470,2015
21706,0,115000,Brandon Ghee,CB,dead_cap,los-angeles-chargers,115000,2015
21707,111388,0,Craig Watts,G,dead_cap,los-angeles-chargers,111388,2015
21708,109411,0,Kyle Miller,TE,dead_cap,los-angeles-chargers,109411,2015
21709,85800,0,Alex Bayer,TE,dead_cap,los-angeles-chargers,85800,2015
21710,79800,0,Michael Ola,T,dead_cap,los-angeles-chargers,79800,2015
21711,78388,1166,Tyrell Williams,WR,dead_cap,los-angeles-chargers,79554,2015
21712,0,74172,Marion Grice,RB,dead_cap,los-angeles-chargers,74172,2015
21713,72600,0,Andrew McDonald,RT,dead_cap,los-angeles-chargers,72600,2015
21714,63000,0,Sean McGrath,TE,dead_cap,los-angeles-chargers,63000,2015
21715,59400,0,Isaiah Burse,WR,dead_cap,los-angeles-chargers,59400,2015
21716,59400,0,Ben Gardner,DE,dead_cap,los-angeles-chargers,59400,2015
21717,56117,2000,Gordon Hill,SS,dead_cap,los-angeles-chargers,58117,2015
21718,52800,3000,Javontee Herndon,WR,dead_cap,los-angeles-chargers,55800,2015
21719,52800,2667,Greg Ducre,CB,dead_cap,los-angeles-chargers,55467,2015
21720,52800,333,Ryan Mueller,FB,dead_cap,los-angeles-chargers,53133,2015
21721,52800,0,Damion Square,DT,dead_cap,los-angeles-chargers,52800,2015
21722,46200,666,Dreamius Smith,RB,dead_cap,los-angeles-chargers,46866,2015
21723,0,37074,Tevin Reese,WR,dead_cap,los-angeles-chargers,37074,2015
21724,33000,0,Michael Huey,G,dead_cap,los-angeles-chargers,33000,2015
21725,26400,0,Tim Semisch,TE,dead_cap,los-angeles-chargers,26400,2015
21726,26400,0,Matt Daniels,FS,dead_cap,los-angeles-chargers,26400,2015
21727,19800,3333,Tyreek Burwell,T,dead_cap,los-angeles-chargers,23133,2015
21728,19800,0,Keith Lewis,CB,dead_cap,los-angeles-chargers,19800,2015
21729,13200,0,Donte Foster,WR,dead_cap,los-angeles-chargers,13200,2015
21730,0,8750,Nick McDonald,C,dead_cap,los-angeles-chargers,8750,2015
21731,6600,0,Carrington Byndom,CB,dead_cap,los-angeles-chargers,6600,2015
21732,6600,0,Richard Crawford,CB,dead_cap,los-angeles-chargers,6600,2015
21733,6600,0,Donatella Luckett,WR,dead_cap,los-angeles-chargers,6600,2015
21734,6600,0,Kasey Redfern,P,dead_cap,los-angeles-chargers,6600,2015
21735,6600,0,Shane Wynn,WR,dead_cap,los-angeles-chargers,6600,2015
21736,0,6000,Jeremiah Sirles,G,dead_cap,los-angeles-chargers,6000,2015
21737,0,5000,Cameron Clemmons,T,dead_cap,los-angeles-chargers,5000,2015
21738,0,3334,Alden Darby,FS,dead_cap,los-angeles-chargers,3334,2015
21739,0,2500,Titus Davis,WR,dead_cap,los-angeles-chargers,2500,2015
21740,0,2334,D.J. Johnson,G,dead_cap,los-angeles-chargers,2334,2015
21741,0,2333,Brian Parker,TE,dead_cap,los-angeles-chargers,2333,2015
21742,0,2000,Brelan Chancellor,WR,dead_cap,los-angeles-chargers,2000,2015
21743,0,2000,Alvin Scioneaux,ILB,dead_cap,los-angeles-chargers,2000,2015
21744,0,2000,Cole Stoudt,QB,dead_cap,los-angeles-chargers,2000,2015
21745,0,2000,Colton Underwood,DE,dead_cap,los-angeles-chargers,2000,2015
21746,0,1334,Micah Hatfield,WR,dead_cap,los-angeles-chargers,1334,2015
21747,0,1333,D.J. Adams,RB,dead_cap,los-angeles-chargers,1333,2015
21748,0,1333,Curtis Grant,ILB,dead_cap,los-angeles-chargers,1333,2015
21749,0,1250,Cordarro Law,OLB,dead_cap,los-angeles-chargers,1250,2015
21750,0,1000,Ben Beckwith,G,dead_cap,los-angeles-chargers,1000,2015
21751,0,1000,Kwame Geathers,DT,dead_cap,los-angeles-chargers,1000,2015
21752,0,833,John Lowdermilk,SS,dead_cap,los-angeles-chargers,833,2015
21753,0,833,Ricky Tjong-A-Tjoe,DT,dead_cap,los-angeles-chargers,833,2015
21754,0,667,Mike Flacco,TE,dead_cap,los-angeles-chargers,667,2015
21755,0,667,Chase Tenpenny,P,dead_cap,los-angeles-chargers,667,2015
21756,0,666,Manuel Asprilla,CB,dead_cap,los-angeles-chargers,666,2015
21757,0,666,Jahwan Edwards,RB,dead_cap,los-angeles-chargers,666,2015
21758,0,500,Demetrious Wilson,WR,dead_cap,los-angeles-chargers,500,2015
21759,0,333,Cameron Botticelli,DE,dead_cap,los-angeles-chargers,333,2015
21760,0,333,Eric Frohnapfel,TE,dead_cap,los-angeles-chargers,333,2015
21761,10500000,6000000,Philip Rivers,QB,active,los-angeles-chargers,16500000,2016
21762,3000000,7000000,Corey Liuget,DT,active,los-angeles-chargers,10000000,2016
21763,7751000,0,Melvin Ingram,OLB,active,los-angeles-chargers,7751000,2016
21764,5500000,1700000,Orlando Franklin,G,active,los-angeles-chargers,7200000,2016
21765,3000000,2500000,Antonio Gates,TE,active,los-angeles-chargers,5500000,2016
21766,3300000,1843750,King Dunlap,LT,active,los-angeles-chargers,5143750,2016
21767,1000000,4133333,Casey Hayward,CB,active,los-angeles-chargers,5133333,2016
21768,450000,4254306,Joey Bosa,DE,active,los-angeles-chargers,4704306,2016
21769,3500000,1050000,Joe Barksdale,RT,active,los-angeles-chargers,4550000,2016
21770,2750000,1250000,Travis Benjamin,WR,active,los-angeles-chargers,4000000,2016
21771,1959885,1668182,D.J. Fluker,G,active,los-angeles-chargers,3628067,2016
21772,2553000,0,Jahleel Addae,SS,active,los-angeles-chargers,2553000,2016
21773,919990,1504958,Melvin Gordon,RB,active,los-angeles-chargers,2424948,2016
21774,1200000,500000,Dwight Lowery,FS,active,los-angeles-chargers,1700000,2016
21775,1235000,433750,Darrell Stuckey,FS,active,los-angeles-chargers,1668750,2016
21776,900000,300000,Matt Slauson,G,active,los-angeles-chargers,1200000,2016
21777,450000,710055,Hunter Henry,TE,active,los-angeles-chargers,1160055,2016
21778,800000,300000,Chris Hairston,LT,active,los-angeles-chargers,1100000,2016
21779,652113,433449,Denzel Perryman,ILB,active,los-angeles-chargers,1085562,2016
21780,760000,137500,Mike Windt,LS,active,los-angeles-chargers,897500,2016
21781,675000,27515,Tourek Williams,OLB,active,los-angeles-chargers,702515,2016
21782,985000,80000,Kellen Clemens,QB,active,los-angeles-chargers,1065000,2016
21783,450000,222255,Max Tuerk,C,active,los-angeles-chargers,672255,2016
21784,450000,153521,Joshua Perry,ILB,active,los-angeles-chargers,603521,2016
21785,600000,0,Dontrelle Inman,WR,active,los-angeles-chargers,600000,2016
21786,600000,0,Adrian Phillips,FS,active,los-angeles-chargers,600000,2016
21787,600000,0,Kenny Wiggins,G,active,los-angeles-chargers,600000,2016
21788,525000,54643,Kyle Emanuel,OLB,active,los-angeles-chargers,579643,2016
21789,516176,50000,Damion Square,DT,active,los-angeles-chargers,566176,2016
21790,525000,30146,Darius Philon,DE,active,los-angeles-chargers,555146,2016
21791,529410,0,Asante Cleveland,TE,active,los-angeles-chargers,529410,2016
21792,525000,1666,Josh Lambo,K,active,los-angeles-chargers,526666,2016
21793,525000,0,Sean McGrath,TE,active,los-angeles-chargers,525000,2016
21794,525000,0,Tyrell Williams,WR,active,los-angeles-chargers,525000,2016
21795,450000,46096,Jatavis Brown,ILB,active,los-angeles-chargers,496096,2016
21796,494117,0,Korey Toomer,ILB,active,los-angeles-chargers,494117,2016
21797,450000,38456,Drew Kaser,P,active,los-angeles-chargers,488456,2016
21798,450000,32420,Derek Watt,FB,active,los-angeles-chargers,482420,2016
21799,450000,666,Spencer Pulley,C,active,los-angeles-chargers,450666,2016
21800,450000,0,Dexter McCoil,S,active,los-angeles-chargers,450000,2016
21801,344110,0,Trevor Williams,CB,active,los-angeles-chargers,344110,2016
21802,317647,0,Isaiah Burse,WR,active,los-angeles-chargers,317647,2016
21803,291170,0,Chris Landrum,OLB,active,los-angeles-chargers,291170,2016
21804,277941,0,Jeremy Butler,WR,active,los-angeles-chargers,277941,2016
21805,268235,0,Ronnie Hillman,RB,active,los-angeles-chargers,268235,2016
21806,247058,0,Geremy Davis,WR,active,los-angeles-chargers,247058,2016
21807,216176,0,Tyreek Burwell,T,active,los-angeles-chargers,216176,2016
21808,185292,0,Trovon Reed,CB,active,los-angeles-chargers,185292,2016
21809,176470,0,Ryan Carrethers,DT,active,los-angeles-chargers,176470,2016
21810,134117,0,Robert McClain,CB,active,los-angeles-chargers,134117,2016
21811,92646,0,Kaleb Eulls,DT,active,los-angeles-chargers,92646,2016
21812,35294,0,Andre Williams,RB,active,los-angeles-chargers,35294,2016
21813,26470,0,Carlos Fields,OLB,active,los-angeles-chargers,26470,2016
21814,7750000,2000000,Brandon Flowers,CB,injured_reserve,los-angeles-chargers,9750000,2016
21815,1656000,6068450,Keenan Allen,WR,injured_reserve,los-angeles-chargers,7724450,2016
21816,2900000,1000000,Stevie Johnson,WR,injured_reserve,los-angeles-chargers,3900000,2016
21817,2500000,1000000,Brandon Mebane,DT,injured_reserve,los-angeles-chargers,3500000,2016
21818,2000000,1000000,Danny Woodhead,RB,injured_reserve,los-angeles-chargers,3000000,2016
21819,1137182,1014364,Jason Verrett,CB,injured_reserve,los-angeles-chargers,2151546,2016
21820,1750000,0,Sean Lissemore,DT,injured_reserve,los-angeles-chargers,1750000,2016
21821,1110330,535440,Manti Te'o,ILB,injured_reserve,los-angeles-chargers,1645770,2016
21822,802100,344200,Jeremiah Attaochu,OLB,injured_reserve,los-angeles-chargers,1146300,2016
21823,525000,183144,Craig Mager,CB,injured_reserve,los-angeles-chargers,708144,2016
21824,600000,0,Branden Oliver,RB,injured_reserve,los-angeles-chargers,600000,2016
21825,460588,0,Caraun Reid,DE,injured_reserve,los-angeles-chargers,460588,2016
21826,450000,1666,Kenneth Farrow,RB,injured_reserve,los-angeles-chargers,451666,2016
21827,428000,80000,Jeff Cumberland,TE,injured_reserve,los-angeles-chargers,508000,2016
21828,400050,1666,Nick Dzubnar,ILB,injured_reserve,los-angeles-chargers,401716,2016
21829,333000,21524,Donavan Clark,G,injured_reserve,los-angeles-chargers,354524,2016
21830,348000,0,Javontee Herndon,WR,injured_reserve,los-angeles-chargers,348000,2016
21831,333000,2500,Brock Hekking,OLB,injured_reserve,los-angeles-chargers,335500,2016
21832,333000,0,Zamir Carlis,DT,injured_reserve,los-angeles-chargers,333000,2016
21833,333000,0,Tyler Johnstone,T,injured_reserve,los-angeles-chargers,333000,2016
21834,670588,0,Dexter McCluster,RB,non_fb_injury,los-angeles-chargers,670588,2016
21835,20700,0,Chuka Ndule,DT,practice_squad,los-angeles-chargers,20700,2016
21836,0,6690000,Donald Butler,ILB,dead_cap,los-angeles-chargers,6690000,2016
21837,0,1083334,Donald Brown,RB,dead_cap,los-angeles-chargers,1083334,2016
21838,0,800000,Jacoby Jones,WR,dead_cap,los-angeles-chargers,800000,2016
21839,0,1200000,Mike Scifres,P,dead_cap,los-angeles-chargers,1200000,2016
21840,352941,153535,Chris Watt,C,dead_cap,los-angeles-chargers,506476,2016
21841,0,375000,Nick Novak,K,dead_cap,los-angeles-chargers,375000,2016
21842,357352,0,Griff Whalen,WR,dead_cap,los-angeles-chargers,357352,2016
21843,253956,6667,Tyreek Burwell,T,dead_cap,los-angeles-chargers,260623,2016
21844,198529,48200,Steve Williams,CB,dead_cap,los-angeles-chargers,246729,2016
21845,196376,44633,Ryan Carrethers,DT,dead_cap,los-angeles-chargers,241009,2016
21846,211764,0,Pierre Desir,CB,dead_cap,los-angeles-chargers,211764,2016
21847,195880,0,Carlos Wray,DE,dead_cap,los-angeles-chargers,195880,2016
21848,160288,0,Andre Williams,RB,dead_cap,los-angeles-chargers,160288,2016
21849,127146,0,Isaiah Burse,WR,dead_cap,los-angeles-chargers,127146,2016
21850,0,125000,Mitch Unrein,DE,dead_cap,los-angeles-chargers,125000,2016
21851,117528,0,Tyler Marcordes,OLB,dead_cap,los-angeles-chargers,117528,2016
21852,117300,0,Adrian McDonald,S,dead_cap,los-angeles-chargers,117300,2016
21853,117300,0,Jake McGee,TE,dead_cap,los-angeles-chargers,117300,2016
21854,117300,0,Dominique Williams,WR,dead_cap,los-angeles-chargers,117300,2016
21855,96600,0,Kaleb Eulls,DT,dead_cap,los-angeles-chargers,96600,2016
21856,0,90000,Kavell Conner,ILB,dead_cap,los-angeles-chargers,90000,2016
21857,89700,0,Brett Boyko,G,dead_cap,los-angeles-chargers,89700,2016
21858,80540,0,Deon King,OLB,dead_cap,los-angeles-chargers,80540,2016
21859,0,75000,Trevor Robinson,C,dead_cap,los-angeles-chargers,75000,2016
21860,58764,0,Terrell Chestnut,CB,dead_cap,los-angeles-chargers,58764,2016
21861,55200,0,Michael Lee,CB,dead_cap,los-angeles-chargers,55200,2016
21862,41400,0,Chris Landrum,OLB,dead_cap,los-angeles-chargers,41400,2016
21863,41400,0,Chris McCain,OLB,dead_cap,los-angeles-chargers,41400,2016
21864,34500,0,Carlos Fields,OLB,dead_cap,los-angeles-chargers,34500,2016
21865,27600,0,Randall Evans,CB,dead_cap,los-angeles-chargers,27600,2016
21866,27600,0,Ben Gardner,DE,dead_cap,los-angeles-chargers,27600,2016
21867,27600,0,Kevin Norwood,WR,dead_cap,los-angeles-chargers,27600,2016
21868,27600,0,Trovon Reed,CB,dead_cap,los-angeles-chargers,27600,2016
21869,27600,0,Trevor Williams,CB,dead_cap,los-angeles-chargers,27600,2016
21870,13800,0,James Burgess,ILB,dead_cap,los-angeles-chargers,13800,2016
21871,13800,0,Asante Cleveland,TE,dead_cap,los-angeles-chargers,13800,2016
21872,13800,0,Jonathan Krause,WR,dead_cap,los-angeles-chargers,13800,2016
21873,13800,0,Austin Shepherd,RT,dead_cap,los-angeles-chargers,13800,2016
21874,13800,0,Austin Traylor,TE,dead_cap,los-angeles-chargers,13800,2016
21875,6900,0,Gus Johnson,RB,dead_cap,los-angeles-chargers,6900,2016
21876,0,5000,Titus Davis,WR,dead_cap,los-angeles-chargers,5000,2016
21877,0,4667,Brian Parker,TE,dead_cap,los-angeles-chargers,4667,2016
21878,0,4000,Gordon Hill,SS,dead_cap,los-angeles-chargers,4000,2016
21879,0,2667,Chi Chi Ariguzo,ILB,dead_cap,los-angeles-chargers,2667,2016
21880,0,2667,Curtis Grant,ILB,dead_cap,los-angeles-chargers,2667,2016
21881,0,2334,Tyrell Williams,WR,dead_cap,los-angeles-chargers,2334,2016
21882,0,2000,Ben Beckwith,G,dead_cap,los-angeles-chargers,2000,2016
21883,0,2000,Chris Davis,CB,dead_cap,los-angeles-chargers,2000,2016
21884,0,1667,John Lowdermilk,SS,dead_cap,los-angeles-chargers,1667,2016
21885,0,1666,Mike McQueen,T,dead_cap,los-angeles-chargers,1666,2016
21886,0,1334,Manuel Asprilla,CB,dead_cap,los-angeles-chargers,1334,2016
21887,0,1334,Jahwan Edwards,RB,dead_cap,los-angeles-chargers,1334,2016
21888,0,1334,Dreamius Smith,RB,dead_cap,los-angeles-chargers,1334,2016
21889,0,1000,Zeth Ramsay,T,dead_cap,los-angeles-chargers,1000,2016
21890,0,1000,Demetrious Wilson,WR,dead_cap,los-angeles-chargers,1000,2016
21891,0,834,Ricky Tjong-A-Tjoe,DT,dead_cap,los-angeles-chargers,834,2016
21892,0,833,Jamaal Jones,WR,dead_cap,los-angeles-chargers,833,2016
21893,0,667,Cameron Botticelli,DE,dead_cap,los-angeles-chargers,667,2016
21894,0,667,Eric Frohnapfel,TE,dead_cap,los-angeles-chargers,667,2016
21895,0,667,Ryan Mueller,FB,dead_cap,los-angeles-chargers,667,2016
21896,11000000,7000000,Philip Rivers,QB,active,los-angeles-chargers,18000000,2017
21897,5000000,9875000,Melvin Ingram,OLB,active,los-angeles-chargers,14875000,2017
21898,8000000,1500000,Corey Liuget,DT,active,los-angeles-chargers,9500000,2017
21899,1000000,7650000,Keenan Allen,WR,active,los-angeles-chargers,8650000,2017
21900,5250000,1250000,Travis Benjamin,WR,active,los-angeles-chargers,6500000,2017
21901,3000000,3000000,Russell Okung,LT,active,los-angeles-chargers,6000000,2017
21902,540000,5340383,Joey Bosa,DE,active,los-angeles-chargers,5880383,2017
21903,4500000,1046875,Joe Barksdale,RT,active,los-angeles-chargers,5546875,2017
21904,4500000,937500,Antonio Gates,TE,active,los-angeles-chargers,5437500,2017
21905,3250000,1833333,Casey Hayward,CB,active,los-angeles-chargers,5083333,2017
21906,3500000,1000000,Brandon Mebane,DT,active,los-angeles-chargers,4500000,2017
21907,1500000,2750000,Jahleel Addae,SS,active,los-angeles-chargers,4250000,2017
21908,465000,3125896,Mike Williams,WR,active,los-angeles-chargers,3590896,2017
21909,1404980,1504958,Melvin Gordon,RB,active,los-angeles-chargers,2909938,2017
21910,1797000,0,Michael Schofield,RT,active,los-angeles-chargers,1797000,2017
21911,1797000,0,Korey Toomer,ILB,active,los-angeles-chargers,1797000,2017
21912,775000,612500,Damion Square,DT,active,los-angeles-chargers,1387500,2017
21913,993150,344200,Jeremiah Attaochu,OLB,active,los-angeles-chargers,1337350,2017
21914,831724,470949,Denzel Perryman,ILB,active,los-angeles-chargers,1302673,2017
21915,900000,155000,Mike Windt,LS,active,los-angeles-chargers,1055000,2017
21916,1000000,0,Kellen Clemens,QB,active,los-angeles-chargers,1000000,2017
21917,700000,193750,Tre Boston,FS,active,los-angeles-chargers,893750,2017
21918,690000,156250,Kenny Wiggins,G,active,los-angeles-chargers,846250,2017
21919,750000,50000,Branden Oliver,RB,active,los-angeles-chargers,800000,2017
21920,465000,231158,Dan Feeney,G,active,los-angeles-chargers,696158,2017
21921,690000,0,Adrian Phillips,FS,active,los-angeles-chargers,690000,2017
21922,615000,54643,Kyle Emanuel,OLB,active,los-angeles-chargers,669643,2017
21923,615000,30146,Darius Philon,DE,active,los-angeles-chargers,645146,2017
21924,465000,165552,Rayshawn Jenkins,S,active,los-angeles-chargers,630552,2017
21925,615000,0,Chris McCain,OLB,active,los-angeles-chargers,615000,2017
21926,615000,0,Sean McGrath,TE,active,los-angeles-chargers,615000,2017
21927,615000,0,Hayes Pullard,ILB,active,los-angeles-chargers,615000,2017
21928,615000,0,Tyrell Williams,WR,active,los-angeles-chargers,615000,2017
21929,540000,46096,Jatavis Brown,ILB,active,los-angeles-chargers,586096,2017
21930,578824,0,Tenny Palepoi,DT,active,los-angeles-chargers,578824,2017
21931,540000,38456,Drew Kaser,P,active,los-angeles-chargers,578456,2017
21932,540000,32420,Derek Watt,FB,active,los-angeles-chargers,572420,2017
21933,542647,0,Nick Dzubnar,ILB,active,los-angeles-chargers,542647,2017
21934,540000,666,Spencer Pulley,C,active,los-angeles-chargers,540666,2017
21935,540000,0,Cardale Jones,QB,active,los-angeles-chargers,540000,2017
21936,540000,0,Trevor Williams,CB,active,los-angeles-chargers,540000,2017
21937,465000,69998,Desmond King,S,active,los-angeles-chargers,534998,2017
21938,465000,40447,Sam Tevi,T,active,los-angeles-chargers,505447,2017
21939,465000,4000,Sean Culkin,TE,active,los-angeles-chargers,469000,2017
21940,465000,1666,Austin Ekeler,RB,active,los-angeles-chargers,466666,2017
21941,437647,0,Michael Davis,CB,active,los-angeles-chargers,437647,2017
21942,405882,0,Michael Ola,T,active,los-angeles-chargers,405882,2017
21943,364706,0,Jeff Cumberland,TE,active,los-angeles-chargers,364706,2017
21944,361765,0,Geremy Davis,WR,active,los-angeles-chargers,361765,2017
21945,108529,0,Craig Mager,CB,active,los-angeles-chargers,108529,2017
21946,82059,0,Isaac Rochell,DT,active,los-angeles-chargers,82059,2017
21947,54706,0,Nick Rose,K,active,los-angeles-chargers,54706,2017
21948,31765,0,Russell Hansbrough,RB,active,los-angeles-chargers,31765,2017
21949,2000000,800000,Matt Slauson,G,injured_reserve,los-angeles-chargers,2800000,2017
21950,860000,1650137,Jason Verrett,CB,injured_reserve,los-angeles-chargers,2510137,2017
21951,740014,710055,Hunter Henry,TE,injured_reserve,los-angeles-chargers,1450069,2017
21952,348000,747167,Forrest Lamp,G,injured_reserve,los-angeles-chargers,1095167,2017
21953,688235,0,Nick Novak,K,injured_reserve,los-angeles-chargers,688235,2017
21954,615000,0,Isaiah Burse,WR,injured_reserve,los-angeles-chargers,615000,2017
21955,527644,0,Andre Williams,RB,injured_reserve,los-angeles-chargers,527644,2017
21956,378000,0,Kaleb Eulls,DT,injured_reserve,los-angeles-chargers,378000,2017
21957,348000,21524,Donavan Clark,G,injured_reserve,los-angeles-chargers,369524,2017
21958,363000,1666,Kenneth Farrow,RB,injured_reserve,los-angeles-chargers,364666,2017
21959,363000,0,Chris Landrum,OLB,injured_reserve,los-angeles-chargers,363000,2017
21960,348000,3333,Charmeachealle Moore,OLB,injured_reserve,los-angeles-chargers,351333,2017
21961,0,275000,Chris Hairston,LT,non_fb_injury,los-angeles-chargers,275000,2017
21962,3500000,1600000,Orlando Franklin,G,dead_cap,los-angeles-chargers,5100000,2017
21963,0,4000000,Brandon Flowers,CB,dead_cap,los-angeles-chargers,4000000,2017
21964,0,3250000,King Dunlap,LT,dead_cap,los-angeles-chargers,3250000,2017
21965,1130710,0,Dontrelle Inman,WR,dead_cap,los-angeles-chargers,1130710,2017
21966,0,1000000,Stevie Johnson,WR,dead_cap,los-angeles-chargers,1000000,2017
21967,0,500000,Dwight Lowery,FS,dead_cap,los-angeles-chargers,500000,2017
21968,0,433750,Darrell Stuckey,FS,dead_cap,los-angeles-chargers,433750,2017
21969,411342,8333,James Onwualu,OLB,dead_cap,los-angeles-chargers,419675,2017
21970,100800,183145,Craig Mager,CB,dead_cap,los-angeles-chargers,283945,2017
21971,14400,222255,Max Tuerk,C,dead_cap,los-angeles-chargers,236655,2017
21972,191471,0,Tyler Marz,T,dead_cap,los-angeles-chargers,191471,2017
21973,164118,0,Nigel Harris,OLB,dead_cap,los-angeles-chargers,164118,2017
21974,0,153521,Joshua Perry,ILB,dead_cap,los-angeles-chargers,153521,2017
21975,120953,21939,Isaac Rochell,DT,dead_cap,los-angeles-chargers,142892,2017
21976,0,136035,Chris Watt,C,dead_cap,los-angeles-chargers,136035,2017
21977,135353,0,Brett Boyko,G,dead_cap,los-angeles-chargers,135353,2017
21978,127060,0,Dexter McCoil,S,dead_cap,los-angeles-chargers,127060,2017
21979,122400,0,Andre Patton,WR,dead_cap,los-angeles-chargers,122400,2017
21980,122400,0,Artavis Scott,WR,dead_cap,los-angeles-chargers,122400,2017
21981,122400,0,Braedon Bowman,TE,dead_cap,los-angeles-chargers,122400,2017
21982,115200,0,Jeff Richards,CB,dead_cap,los-angeles-chargers,115200,2017
21983,109412,0,Younghoe Koo,K,dead_cap,los-angeles-chargers,109412,2017
21984,108529,0,Josh Keyes,ILB,dead_cap,los-angeles-chargers,108529,2017
21985,95294,0,Travis Coons,K,dead_cap,los-angeles-chargers,95294,2017
21986,93600,0,Whitney Richardson,DE,dead_cap,los-angeles-chargers,93600,2017
21987,86400,0,A.J. Hendy,S,dead_cap,los-angeles-chargers,86400,2017
21988,0,80000,Kellen Clemens,QB,dead_cap,los-angeles-chargers,80000,2017
21989,0,75000,Kenjon Barner,RB,dead_cap,los-angeles-chargers,75000,2017
21990,64976,0,Geremy Davis,WR,dead_cap,los-angeles-chargers,64976,2017
21991,57600,0,Cole Toner,G,dead_cap,los-angeles-chargers,57600,2017
21992,0,44633,Ryan Carrethers,DT,dead_cap,los-angeles-chargers,44633,2017
21993,28800,0,Andre Williams,RB,dead_cap,los-angeles-chargers,28800,2017
21994,14400,1668,Nick Dzubnar,ILB,dead_cap,los-angeles-chargers,16068,2017
21995,14400,0,LeShun Daniels,RB,dead_cap,los-angeles-chargers,14400,2017
21996,14400,0,Russell Hansbrough,RB,dead_cap,los-angeles-chargers,14400,2017
21997,7200,0,Michael Davis,CB,dead_cap,los-angeles-chargers,7200,2017
21998,7200,0,Joe Jones,OLB,dead_cap,los-angeles-chargers,7200,2017
21999,7200,0,Jalen Simmons,RB,dead_cap,los-angeles-chargers,7200,2017
22000,7200,0,Andrew Wylie,T,dead_cap,los-angeles-chargers,7200,2017
22001,0,3334,Mike McQueen,T,dead_cap,los-angeles-chargers,3334,2017
22002,0,2500,Brock Hekking,OLB,dead_cap,los-angeles-chargers,2500,2017
22003,0,2000,Zeth Ramsay,T,dead_cap,los-angeles-chargers,2000,2017
22004,0,1668,Josh Lambo,K,dead_cap,los-angeles-chargers,1668,2017
22005,0,1667,Jamaal Jones,WR,dead_cap,los-angeles-chargers,1667,2017
22006,10000000,12000000,Philip Rivers,QB,active,los-angeles-chargers,22000000,2018
22007,12000000,2968750,Russell Okung,LT,active,los-angeles-chargers,14968750,2018
22008,11250000,2625000,Melvin Ingram,DE,active,los-angeles-chargers,13875000,2018
22009,7500000,2150000,Keenan Allen,WR,active,los-angeles-chargers,9650000,2018
22010,630000,6426459,Joey Bosa,DE,active,los-angeles-chargers,7056459,2018
22011,5750000,1250000,Travis Benjamin,WR,active,los-angeles-chargers,7000000,2018
22012,4000000,2833334,Casey Hayward,CB,active,los-angeles-chargers,6833334,2018
22013,5000000,1250000,Mike Pouncey,C,active,los-angeles-chargers,6250000,2018
22014,4500000,1000000,Jahleel Addae,SS,active,los-angeles-chargers,5500000,2018
22015,4500000,1000000,Brandon Mebane,DT,active,los-angeles-chargers,5500000,2018
22016,1362724,3125896,Mike Williams,WR,active,los-angeles-chargers,4488620,2018
22017,1889968,1504961,Melvin Gordon,RB,active,los-angeles-chargers,3394929,2018
22018,2914000,0,Tyrell Williams,WR,active,los-angeles-chargers,2914000,2018
22019,2000000,612500,Damion Square,DT,active,los-angeles-chargers,2612500,2018
22020,1500000,1000000,Antonio Gates,TE,active,los-angeles-chargers,2500000,2018
22021,480000,1772537,Derwin James,S,active,los-angeles-chargers,2252537,2018
22022,1907000,54643,Kyle Emanuel,OLB,active,los-angeles-chargers,1961643,2018
22023,1000000,800000,Virgil Green,TE,active,los-angeles-chargers,1800000,2018
22024,1000000,750000,Michael Schofield,G,active,los-angeles-chargers,1750000,2018
22025,880028,860055,Hunter Henry,TE,active,los-angeles-chargers,1740083,2018
22026,768042,747167,Forrest Lamp,G,active,los-angeles-chargers,1515209,2018
22027,1000000,500000,Adrian Phillips,FS,active,los-angeles-chargers,1500000,2018
22028,705000,422500,Nick Dzubnar,ILB,active,los-angeles-chargers,1127500,2018
22029,915000,155000,Mike Windt,LS,active,los-angeles-chargers,1070000,2018
22030,480000,567195,Uchenna Nwosu,LB,active,los-angeles-chargers,1047195,2018
22031,790000,210000,Geno Smith,QB,active,los-angeles-chargers,1000000,2018
22032,634000,231158,Dan Feeney,G,active,los-angeles-chargers,865158,2018
22033,705000,58750,Geremy Davis,WR,active,los-angeles-chargers,763750,2018
22034,705000,30149,Darius Philon,DT,active,los-angeles-chargers,735149,2018
22035,555000,165552,Rayshawn Jenkins,FS,active,los-angeles-chargers,720552,2018
22036,480000,213535,Justin Jones,DT,active,los-angeles-chargers,693535,2018
22037,630000,46096,Jatavis Brown,OLB,active,los-angeles-chargers,676096,2018
22038,630000,32420,Derek Watt,FB,active,los-angeles-chargers,662420,2018
22039,555000,69998,Desmond King,S,active,los-angeles-chargers,624998,2018
22040,555000,40447,Sam Tevi,RT,active,los-angeles-chargers,595447,2018
22041,555000,4000,Sean Culkin,TE,active,los-angeles-chargers,559000,2018
22042,555000,1666,Austin Ekeler,RB,active,los-angeles-chargers,556666,2018
22043,555000,0,Michael Davis,CB,active,los-angeles-chargers,555000,2018
22044,555000,0,Isaac Rochell,DT,active,los-angeles-chargers,555000,2018
22045,555000,0,Cole Toner,G,active,los-angeles-chargers,555000,2018
22046,480000,71063,Scott Quessenberry,C,active,los-angeles-chargers,551063,2018
22047,480000,3333,Brandon Facyson,CB,active,los-angeles-chargers,483333,2018
22048,776176,0,Donnie Jones,P,active,los-angeles-chargers,776176,2018
22049,451765,0,Trenton Scott,G,active,los-angeles-chargers,451765,2018
22050,395294,0,Justin Jackson,RB,active,los-angeles-chargers,395294,2018
22051,373235,0,Hayes Pullard,ILB,active,los-angeles-chargers,373235,2018
22052,310585,0,Detrez Newsome,RB,active,los-angeles-chargers,310585,2018
22053,254115,0,Jeff Richards,CB,active,los-angeles-chargers,254115,2018
22054,248824,0,T.Y. McGill,DT,active,los-angeles-chargers,248824,2018
22055,225880,0,Michael Badgley,K,active,los-angeles-chargers,225880,2018
22056,112940,0,Dylan Cantrell,WR,active,los-angeles-chargers,112940,2018
22057,84705,0,Kyle Wilson,LB,active,los-angeles-chargers,84705,2018
22058,74118,0,Anthony Lanier,DE,active,los-angeles-chargers,74118,2018
22059,8526000,0,Jason Verrett,CB,injured_reserve,los-angeles-chargers,8526000,2018
22060,935000,3439559,Corey Liuget,DT,injured_reserve,los-angeles-chargers,4374559,2018
22061,1048836,470952,Denzel Perryman,ILB,injured_reserve,los-angeles-chargers,1519788,2018
22062,790000,90000,Jaylen Watkins,S,injured_reserve,los-angeles-chargers,880000,2018
22063,630000,0,Trevor Williams,CB,injured_reserve,los-angeles-chargers,630000,2018
22064,418048,163610,Kyzir White,OLB,injured_reserve,los-angeles-chargers,581658,2018
22065,363000,5000,Zachary Crabtree,T,injured_reserve,los-angeles-chargers,368000,2018
22066,363000,0,Austin Roberts,TE,injured_reserve,los-angeles-chargers,363000,2018
22067,363000,0,Artavis Scott,WR,injured_reserve,los-angeles-chargers,363000,2018
22068,0,0,Dexter McCoil,S,practice_squad,los-angeles-chargers,0,2018
22069,0,0,Fish Smithson,S,practice_squad,los-angeles-chargers,0,2018
22070,4500000,1112500,Joe Barksdale,RT,dead_cap,los-angeles-chargers,5612500,2018
22071,0,3200000,Orlando Franklin,G,dead_cap,los-angeles-chargers,3200000,2018
22072,1000000,750000,Caleb Sturgis,K,dead_cap,los-angeles-chargers,1750000,2018
22073,0,500000,Dwight Lowery,FS,dead_cap,los-angeles-chargers,500000,2018
22074,489705,0,Chris Landrum,OLB,dead_cap,los-angeles-chargers,489705,2018
22075,0,444510,Max Tuerk,C,dead_cap,los-angeles-chargers,444510,2018
22076,0,307042,Joshua Perry,ILB,dead_cap,los-angeles-chargers,307042,2018
22077,124412,165395,Craig Mager,CB,dead_cap,los-angeles-chargers,289807,2018
22078,185294,38456,Drew Kaser,P,dead_cap,los-angeles-chargers,223750,2018
22079,192353,15000,T.Y. McGill,DT,dead_cap,los-angeles-chargers,207353,2018
22080,197647,0,Emmanuel Ellerbe,LB,dead_cap,los-angeles-chargers,197647,2018
22081,177880,16669,James Onwualu,OLB,dead_cap,los-angeles-chargers,194549,2018
22082,177047,833,J.J. Jones,WR,dead_cap,los-angeles-chargers,177880,2018
22083,174640,0,Tre'Von Johnson,OLB,dead_cap,los-angeles-chargers,174640,2018
22084,98800,39211,Dylan Cantrell,WR,dead_cap,los-angeles-chargers,138011,2018
22085,129200,0,Patrick Afriyie,DE,dead_cap,los-angeles-chargers,129200,2018
22086,129200,0,A.J. Hendy,S,dead_cap,los-angeles-chargers,129200,2018
22087,129200,0,Cardale Jones,QB,dead_cap,los-angeles-chargers,129200,2018
22088,129200,0,Andre Patton,WR,dead_cap,los-angeles-chargers,129200,2018
22089,114000,0,Spencer Drango,G,dead_cap,los-angeles-chargers,114000,2018
22090,113141,0,Troymaine Pope,RB,dead_cap,los-angeles-chargers,113141,2018
22091,107505,0,Detrez Newsome,RB,dead_cap,los-angeles-chargers,107505,2018
22092,106400,0,Vince Mayle,WR,dead_cap,los-angeles-chargers,106400,2018
22093,92305,0,Michael Badgley,K,dead_cap,los-angeles-chargers,92305,2018
22094,0,65817,Isaac Rochell,DT,dead_cap,los-angeles-chargers,65817,2018
22095,45600,0,Anthony Lanier,DE,dead_cap,los-angeles-chargers,45600,2018
22096,22800,17267,Justin Jackson,RB,dead_cap,los-angeles-chargers,40067,2018
22097,38000,0,Kyle Wilson,LB,dead_cap,los-angeles-chargers,38000,2018
22098,30400,0,Justice Liggins,WR,dead_cap,los-angeles-chargers,30400,2018
22099,30400,0,Steven Richardson,DT,dead_cap,los-angeles-chargers,30400,2018
22100,22800,0,Thomas Duarte,TE,dead_cap,los-angeles-chargers,22800,2018
22101,22800,0,Jeff Richards,CB,dead_cap,los-angeles-chargers,22800,2018
22102,0,21524,Donavan Clark,G,dead_cap,los-angeles-chargers,21524,2018
22103,15200,0,Jonathan Celestin,LB,dead_cap,los-angeles-chargers,15200,2018
22104,15200,0,D’Juan Hines,LB,dead_cap,los-angeles-chargers,15200,2018
22105,15200,0,Arrion Springs,S,dead_cap,los-angeles-chargers,15200,2018
22106,15200,0,Channing Stribling,CB,dead_cap,los-angeles-chargers,15200,2018
22107,7600,0,Tyrone Holmes,DE,dead_cap,los-angeles-chargers,7600,2018
22108,7600,0,Jamar McGloster,G,dead_cap,los-angeles-chargers,7600,2018
22109,7600,0,Trenton Scott,G,dead_cap,los-angeles-chargers,7600,2018
22110,0,6667,Charmeachealle Moore,OLB,dead_cap,los-angeles-chargers,6667,2018
22111,0,1668,Kenneth Farrow,RB,dead_cap,los-angeles-chargers,1668,2018
22112,0,668,Spencer Pulley,C,dead_cap,los-angeles-chargers,668,2018
22113,11000000,12000000,Philip Rivers,QB,active,los-angeles-chargers,23000000,2019
22114,17000000,2625000,Melvin Ingram,DE,active,los-angeles-chargers,19625000,2019
22115,13000000,2531250,Russell Okung,LT,active,los-angeles-chargers,15531250,2019
22116,10000000,2150000,Keenan Allen,WR,active,los-angeles-chargers,12150000,2019
22117,8000000,2000000,Casey Hayward,CB,active,los-angeles-chargers,10000000,2019
22118,720000,7512538,Joey Bosa,DE,active,los-angeles-chargers,8232538,2019
22119,2260448,3125896,Mike Williams,WR,active,los-angeles-chargers,5386344,2019
22120,4615882,0,Melvin Gordon,RB,active,los-angeles-chargers,4615882,2019
22121,2000000,2500000,Michael Schofield,G,active,los-angeles-chargers,4500000,2019
22122,1050000,3250000,Brandon Mebane,DT,active,los-angeles-chargers,4300000,2019
22123,1000000,2500000,Tyrod Taylor,QB,active,los-angeles-chargers,3500000,2019
22124,850000,2587500,Denzel Perryman,ILB,active,los-angeles-chargers,3437500,2019
22125,2500000,800000,Virgil Green,TE,active,los-angeles-chargers,3300000,2019
22126,1250000,2000000,Thomas Davis,OLB,active,los-angeles-chargers,3250000,2019
22127,1043134,1772537,Derwin James,S,active,los-angeles-chargers,2815671,2019
22128,495000,1581756,Jerry Tillery,DT,active,los-angeles-chargers,2076756,2019
22129,2025000,46097,Jatavis Brown,OLB,active,los-angeles-chargers,2071097,2019
22130,1170042,860058,Hunter Henry,TE,active,los-angeles-chargers,2030100,2019
22131,1500000,500000,Adrian Phillips,FS,active,los-angeles-chargers,2000000,2019
22132,1500000,500000,Damion Square,DT,active,los-angeles-chargers,2000000,2019
22133,1375000,547500,Nick Dzubnar,ILB,active,los-angeles-chargers,1922500,2019
22134,741799,567195,Uchenna Nwosu,LB,active,los-angeles-chargers,1308994,2019
22135,793000,231158,Dan Feeney,G,active,los-angeles-chargers,1024158,2019
22136,621481,213535,Justin Jones,DT,active,los-angeles-chargers,835016,2019
22137,645000,165552,Rayshawn Jenkins,S,active,los-angeles-chargers,810552,2019
22138,805000,0,Jaylen Watkins,CB,active,los-angeles-chargers,805000,2019
22139,720000,32422,Derek Watt,FB,active,los-angeles-chargers,752422,2019
22140,570000,163610,Kyzir White,OLB,active,los-angeles-chargers,733610,2019
22141,645000,69998,Desmond King,CB,active,los-angeles-chargers,714998,2019
22142,495000,219269,Trey Pipkins,T,active,los-angeles-chargers,714269,2019
22143,645000,40447,Sam Tevi,RT,active,los-angeles-chargers,685447,2019
22144,495000,164702,Drue Tranquill,LB,active,los-angeles-chargers,659702,2019
22145,645000,1668,Austin Ekeler,RB,active,los-angeles-chargers,646668,2019
22146,645000,0,Troymaine Pope,RB,active,los-angeles-chargers,645000,2019
22147,645000,0,Isaac Rochell,DE,active,los-angeles-chargers,645000,2019
22148,570000,71063,Scott Quessenberry,C,active,los-angeles-chargers,641063,2019
22149,570000,3333,Brandon Facyson,CB,active,los-angeles-chargers,573333,2019
22150,570000,0,Michael Badgley,K,active,los-angeles-chargers,570000,2019
22151,570000,0,Justin Jackson,RB,active,los-angeles-chargers,570000,2019
22152,570000,0,Trenton Scott,LT,active,los-angeles-chargers,570000,2019
22153,820588,0,Lance Kendricks,TE,active,los-angeles-chargers,820588,2019
22154,569118,0,Michael Davis,CB,active,los-angeles-chargers,569118,2019
22155,495000,69391,Easton Stick,QB,active,los-angeles-chargers,564391,2019
22156,495000,39091,Emeke Egbule,LB,active,los-angeles-chargers,534091,2019
22157,495000,666,Roderic Teamer,S,active,los-angeles-chargers,495666,2019
22158,495000,0,Ty Long,P,active,los-angeles-chargers,495000,2019
22159,495000,0,Cole Mazza,LS,active,los-angeles-chargers,495000,2019
22160,568235,0,Ryan Groy,G,active,los-angeles-chargers,568235,2019
22161,407647,0,Andre Patton,WR,active,los-angeles-chargers,407647,2019
22162,473529,0,Sylvester Williams,DT,active,los-angeles-chargers,473529,2019
22163,349412,0,Jason Moore,WR,active,los-angeles-chargers,349412,2019
22164,265587,0,Spencer Drango,G,active,los-angeles-chargers,265587,2019
22165,145588,0,Jalen Guyton,WR,active,los-angeles-chargers,145588,2019
22166,6000000,4070000,Mike Pouncey,C,injured_reserve,los-angeles-chargers,10070000,2019
22167,1000000,2750000,Travis Benjamin,WR,injured_reserve,los-angeles-chargers,3750000,2019
22168,1071084,747167,Forrest Lamp,G,injured_reserve,los-angeles-chargers,1818251,2019
22169,805000,67500,Geremy Davis,WR,injured_reserve,los-angeles-chargers,872500,2019
22170,495000,365384,Nasir Adderley,S,injured_reserve,los-angeles-chargers,860384,2019
22171,645000,4000,Sean Culkin,TE,injured_reserve,los-angeles-chargers,649000,2019
22172,393000,0,Dylan Cantrell,WR,injured_reserve,los-angeles-chargers,393000,2019
22173,378000,3000,Koda Martin,G,injured_reserve,los-angeles-chargers,381000,2019
22174,378000,0,Andrew Vollert,TE,injured_reserve,los-angeles-chargers,378000,2019
22175,136000,0,Artavis Scott,WR,injured_reserve,los-angeles-chargers,136000,2019
22176,48000,0,Detrez Newsome,RB,injured_reserve,los-angeles-chargers,48000,2019
22177,495000,19505,Cortez Broughton,DT,non_fb_injury,los-angeles-chargers,514505,2019
22178,0,1500000,Corey Liuget,DT,dead_cap,los-angeles-chargers,1500000,2019
22179,0,1000000,Jahleel Addae,SS,dead_cap,los-angeles-chargers,1000000,2019
22180,0,1000000,Joe Barksdale,RT,dead_cap,los-angeles-chargers,1000000,2019
22181,805000,13846,Dontrelle Inman,WR,dead_cap,los-angeles-chargers,818846,2019
22182,595590,0,Trevor Williams,CB,dead_cap,los-angeles-chargers,595590,2019
22183,0,500000,Caleb Sturgis,K,dead_cap,los-angeles-chargers,500000,2019
22184,300534,0,Tre'Von Johnson,OLB,dead_cap,los-angeles-chargers,300534,2019
22185,289000,10000,Zachary Crabtree,T,dead_cap,los-angeles-chargers,299000,2019
22186,254118,0,T.Y. McGill,DT,dead_cap,los-angeles-chargers,254118,2019
22187,201824,0,Cole Toner,G,dead_cap,los-angeles-chargers,201824,2019
22188,175765,0,Shalom Luani,S,dead_cap,los-angeles-chargers,175765,2019
22189,0,155000,Mike Windt,LS,dead_cap,los-angeles-chargers,155000,2019
22190,151765,0,Dontae Johnson,CB,dead_cap,los-angeles-chargers,151765,2019
22191,149941,0,Stephen Anderson,TE,dead_cap,los-angeles-chargers,149941,2019
22192,141118,0,Tevaughn Campbell,CB,dead_cap,los-angeles-chargers,141118,2019
22193,136000,0,Anthony Lanier,DE,dead_cap,los-angeles-chargers,136000,2019
22194,136000,0,Artavis Scott,WR,dead_cap,los-angeles-chargers,136000,2019
22195,128000,0,Anthony Johnson,WR,dead_cap,los-angeles-chargers,128000,2019
22196,0,117633,Dylan Cantrell,WR,dead_cap,los-angeles-chargers,117633,2019
22197,116471,0,Chase McLaughlin,K,dead_cap,los-angeles-chargers,116471,2019
22198,108000,0,Vince Mayle,WR,dead_cap,los-angeles-chargers,108000,2019
22199,104000,0,Quenton Meeks,CB,dead_cap,los-angeles-chargers,104000,2019
22200,96000,0,Jeff Holland,LB,dead_cap,los-angeles-chargers,96000,2019
22201,96000,0,Tyree St. Louis,T,dead_cap,los-angeles-chargers,96000,2019
22202,91019,0,Chris Peace,DE,dead_cap,los-angeles-chargers,91019,2019
22203,80000,0,Spencer Drango,G,dead_cap,los-angeles-chargers,80000,2019
22204,0,60000,Jaylen Watkins,S,dead_cap,los-angeles-chargers,60000,2019
22205,0,51803,Justin Jackson,RB,dead_cap,los-angeles-chargers,51803,2019
22206,48000,0,Detrez Newsome,RB,dead_cap,los-angeles-chargers,48000,2019
22207,45118,0,Andre Patton,WR,dead_cap,los-angeles-chargers,45118,2019
22208,40000,0,Jalen Guyton,WR,dead_cap,los-angeles-chargers,40000,2019
22209,40000,0,Malik Jefferson,OLB,dead_cap,los-angeles-chargers,40000,2019
22210,40000,0,Jason Moore,WR,dead_cap,los-angeles-chargers,40000,2019
22211,0,38458,Drew Kaser,P,dead_cap,los-angeles-chargers,38458,2019
22212,32000,0,Chris Brown,G,dead_cap,los-angeles-chargers,32000,2019
22213,32000,0,Tyron Johnson,WR,dead_cap,los-angeles-chargers,32000,2019
22214,32000,0,P.J. Johnson,DT,dead_cap,los-angeles-chargers,32000,2019
22215,24000,0,Matt Sokol,TE,dead_cap,los-angeles-chargers,24000,2019
22216,0,21524,Donavan Clark,G,dead_cap,los-angeles-chargers,21524,2019
22217,16000,0,Adarius Pickett,S,dead_cap,los-angeles-chargers,16000,2019
22218,16000,0,Keivarae Russell,CB,dead_cap,los-angeles-chargers,16000,2019
22219,0,8500,Eurndraus Bryant,DT,dead_cap,los-angeles-chargers,8500,2019
22220,8000,0,Curtis Akins,LB,dead_cap,los-angeles-chargers,8000,2019
22221,8000,0,Kemon Hall,CB,dead_cap,los-angeles-chargers,8000,2019
22222,0,1667,J.J. Jones,WR,dead_cap,los-angeles-chargers,1667,2019
22223,14000000,2625000,Melvin Ingram,DE,active,los-angeles-chargers,16625000,2020
22224,13000000,2531250,Russell Okung,LT,active,los-angeles-chargers,15531250,2020
22225,14360000,0,Joey Bosa,DE,active,los-angeles-chargers,14360000,2020
22226,10500000,2150000,Keenan Allen,WR,active,los-angeles-chargers,12650000,2020
22227,8750000,2000000,Casey Hayward,CB,active,los-angeles-chargers,10750000,2020
22228,4050000,4462500,Denzel Perryman,ILB,active,los-angeles-chargers,8512500,2020
22229,5000000,2500000,Tyrod Taylor,QB,active,los-angeles-chargers,7500000,2020
22230,6000000,1250000,Mike Pouncey,C,active,los-angeles-chargers,7250000,2020
22231,4250000,3000000,Thomas Davis,OLB,active,los-angeles-chargers,7250000,2020
22232,3158172,3125896,Mike Williams,WR,active,los-angeles-chargers,6284068,2020
22233,3000000,3250000,Brandon Mebane,DT,active,los-angeles-chargers,6250000,2020
22234,2700000,800000,Virgil Green,TE,active,los-angeles-chargers,3500000,2020
22235,1606269,1772537,Derwin James,S,active,los-angeles-chargers,3378806,2020
22236,1014189,1581756,Jerry Tillery,DT,active,los-angeles-chargers,2595945,2020
22237,1374125,747168,Forrest Lamp,G,active,los-angeles-chargers,2121293,2020
22238,1003598,567195,Uchenna Nwosu,LB,active,los-angeles-chargers,1570793,2020
22239,0,1500000,Travis Benjamin,WR,active,los-angeles-chargers,1500000,2020
22240,915000,231158,Dan Feeney,G,active,los-angeles-chargers,1146158,2020
22241,710096,365384,Nasir Adderley,S,active,los-angeles-chargers,1075480,2020
22242,718000,213535,Justin Jones,DT,active,los-angeles-chargers,931535,2020
22243,735000,165553,Rayshawn Jenkins,S,active,los-angeles-chargers,900553,2020
22244,654750,219269,Trey Pipkins,T,active,los-angeles-chargers,874019,2020
22245,660000,163610,Kyzir White,OLB,active,los-angeles-chargers,823610,2020
22246,735000,69998,Desmond King,CB,active,los-angeles-chargers,804998,2020
22247,735000,40450,Sam Tevi,RT,active,los-angeles-chargers,775450,2020
22248,585000,164702,Drue Tranquill,LB,active,los-angeles-chargers,749702,2020
22249,660000,71063,Scott Quessenberry,C,active,los-angeles-chargers,731063,2020
22250,660000,3334,Brandon Facyson,CB,active,los-angeles-chargers,663334,2020
22251,660000,0,Stephen Anderson,TE,active,los-angeles-chargers,660000,2020
22252,660000,0,Michael Badgley,K,active,los-angeles-chargers,660000,2020
22253,660000,0,Justin Jackson,RB,active,los-angeles-chargers,660000,2020
22254,660000,0,Malik Jefferson,OLB,active,los-angeles-chargers,660000,2020
22255,660000,0,Cole Toner,G,active,los-angeles-chargers,660000,2020
22256,585000,69391,Easton Stick,QB,active,los-angeles-chargers,654391,2020
22257,585000,39091,Emeke Egbule,LB,active,los-angeles-chargers,624091,2020
22258,585000,19505,Cortez Broughton,DT,active,los-angeles-chargers,604505,2020
22259,585000,666,Roderic Teamer,S,active,los-angeles-chargers,585666,2020
22260,585000,0,Jalen Guyton,WR,active,los-angeles-chargers,585000,2020
22261,585000,0,Ty Long,P,active,los-angeles-chargers,585000,2020
22262,585000,0,Cole Mazza,LS,active,los-angeles-chargers,585000,2020
22263,585000,0,Quenton Meeks,CB,active,los-angeles-chargers,585000,2020
22264,585000,0,Jason Moore,WR,active,los-angeles-chargers,585000,2020
22265,585000,0,Jason Moore,WR,active,los-angeles-chargers,585000,2020
22266,585000,0,Andre Patton,WR,active,los-angeles-chargers,585000,2020
22267,510000,3000,Koda Martin,G,active,los-angeles-chargers,513000,2020
22268,510000,0,Tevaughn Campbell,CB,active,los-angeles-chargers,510000,2020
22269,510000,0,P.J. Johnson,DT,active,los-angeles-chargers,510000,2020
22270,510000,0,Tyron Johnson,WR,active,los-angeles-chargers,510000,2020
22271,510000,0,Tyree St. Louis,T,active,los-angeles-chargers,510000,2020
22272,510000,0,Andrew Vollert,TE,active,los-angeles-chargers,510000,2020
22273,0,155000,Mike Windt,LS,dead_cap,los-angeles-chargers,155000,2020
22274,7000000,5800000,Marc Bulger,QB,active,los-angeles-rams,12800000,2007
22275,4150000,3554714,Torry Holt,WR,active,los-angeles-rams,7704714,2007
22276,4000000,1800000,Will Witherspoon,OLB,active,los-angeles-rams,5800000,2007
22277,4550000,0,A.J. Feeley,QB,active,los-angeles-rams,4550000,2007
22278,2500000,1833333,Issac Bruce,WR,active,los-angeles-rams,4333333,2007
22279,2750000,0,James Hall,DE,active,los-angeles-rams,2750000,2007
22280,2000000,1250000,Drew Bennett,C,active,los-angeles-rams,3250000,2007
22281,2250000,800000,Corey Chavous,S,active,los-angeles-rams,3050000,2007
22282,1500000,1000000,Randy McMichael,TE,active,los-angeles-rams,2500000,2007
22283,617500,2455000,Alex Barron,LT,active,los-angeles-rams,3072500,2007
22284,285000,1115000,Adam Carriker,DE,active,los-angeles-rams,1400000,2007
22285,667500,680000,Steven Jackson,RB,active,los-angeles-rams,1347500,2007
22286,435000,373500,Ron Bartell,CB,active,los-angeles-rams,808500,2007
22287,850000,0,Brandon Chillar,LB,active,los-angeles-rams,850000,2007
22288,510000,235000,Donnie Jones,P,active,los-angeles-rams,745000,2007
22289,360000,325000,Joe Klopfenstein,TE,active,los-angeles-rams,685000,2007
22290,435000,197050,Oshiomogho Atogwe,S,active,los-angeles-rams,632050,2007
22291,595000,0,Brett Romberg,C,active,los-angeles-rams,595000,2007
22292,385000,137250,Richie Incognito,G,active,los-angeles-rams,522250,2007
22293,360000,155333,Dominique Byrd,T,active,los-angeles-rams,515333,2007
22294,510000,0,Trevor  Johnson,DE,active,los-angeles-rams,510000,2007
22295,510000,0,Nick Leckey,C,active,los-angeles-rams,510000,2007
22296,270000,201250,Claude Wroten,T,active,los-angeles-rams,471250,2007
22297,270000,201250,Claude Wroten,T,active,los-angeles-rams,471250,2007
22298,360000,109583,Victor Adeyanju,DT,active,los-angeles-rams,469583,2007
22299,285000,172125,Jonathan Wade,CB,active,los-angeles-rams,457125,2007
22300,435000,0,Eric Moore,DE,active,los-angeles-rams,435000,2007
22301,435000,0,Rob Petitti,T,active,los-angeles-rams,435000,2007
22302,360000,0,Brandon Williams,WR,active,los-angeles-rams,360000,2007
22303,285000,43000,Clifton Ryan,T,active,los-angeles-rams,328000,2007
22304,285000,0,Quinton Culberson,LB,active,los-angeles-rams,285000,2007
22305,285000,0,Marques Hagans,WR,active,los-angeles-rams,285000,2007
22306,285000,0,Tim McGarigle,LB,active,los-angeles-rams,285000,2007
22307,285000,0,Antonio Pittman,RB,active,los-angeles-rams,285000,2007
22308,205000,9667,Mark Setterstrom,G,active,los-angeles-rams,214667,2007
22309,292500,2665000,Tye Hill,CB,injured_reserve,los-angeles-rams,2957500,2007
22310,435000,106333,Jerome Carter,S,injured_reserve,los-angeles-rams,541333,2007
22311,2027857,0,Marshall Faulk,RB,dead_cap,los-angeles-rams,2027857,2007
22312,0,1325000,Jimmy Kennedy,DT,dead_cap,los-angeles-rams,1325000,2007
22313,183333,0,Jon Alston,LB,dead_cap,los-angeles-rams,183333,2007
22314,95000,0,Claude Terrell,G,dead_cap,los-angeles-rams,95000,2007
22315,92000,0,Marques Hagans,WR,dead_cap,los-angeles-rams,92000,2007
22316,48400,0,Dustin Fry,C,dead_cap,los-angeles-rams,48400,2007
22317,27334,0,Tim McGarigle,LB,dead_cap,los-angeles-rams,27334,2007
22318,23667,0,Ken Shackleford,T,dead_cap,los-angeles-rams,23667,2007
22319,19266,0,Tony Palmer,G,dead_cap,los-angeles-rams,19266,2007
22320,0,9416,Ryan Fitzpatrick,QB,dead_cap,los-angeles-rams,9416,2007
22321,9400,0,Keith Jackson,DT,dead_cap,los-angeles-rams,9400,2007
22322,9300,0,Madison Hedgecock,FB,dead_cap,los-angeles-rams,9300,2007
22323,9300,0,Derek Stanley,WR,dead_cap,los-angeles-rams,9300,2007
22324,5650000,3554714,Torry Holt,WR,active,los-angeles-rams,9204714,2008
22325,6500000,2000000,Marc Bulger,QB,active,los-angeles-rams,8500000,2008
22326,4000000,1800000,Will Witherspoon,OLB,active,los-angeles-rams,5800000,2008
22327,5600000,0,A.J. Feeley,QB,active,los-angeles-rams,5600000,2008
22328,1707500,2959000,Steven Jackson,RB,active,los-angeles-rams,4666500,2008
22329,2900000,1000000,Randy McMichael,TE,active,los-angeles-rams,3900000,2008
22330,3000000,800000,Corey Chavous,S,active,los-angeles-rams,3800000,2008
22331,295000,2605000,Chris Long,DE,active,los-angeles-rams,2900000,2008
22332,925000,2455000,Alex Barron,LT,active,los-angeles-rams,3380000,2008
22333,2017000,0,Oshiomogho Atogwe,S,active,los-angeles-rams,2017000,2008
22334,2000000,0,Jacob Bell,G,active,los-angeles-rams,2000000,2008
22335,1000000,800000,Josh Brown,K,active,los-angeles-rams,1800000,2008
22336,370000,2760000,Adam Carriker,DE,active,los-angeles-rams,3130000,2008
22337,1300000,350000,James Hall,DE,active,los-angeles-rams,1650000,2008
22338,700000,235000,Donnie Jones,P,active,los-angeles-rams,935000,2008
22339,730000,135000,Anthony Becht,TE,active,los-angeles-rams,865000,2008
22340,445000,325000,Joe Klopfenstein,TE,active,los-angeles-rams,770000,2008
22341,295000,456000,Donnie Avery,WR,active,los-angeles-rams,751000,2008
22342,520000,373500,Ron Bartell,CB,active,los-angeles-rams,893500,2008
22343,605000,0,Nick Leckey,C,active,los-angeles-rams,605000,2008
22344,460000,137250,Richie Incognito,G,active,los-angeles-rams,597250,2008
22345,445000,109583,Victor Adeyanju,DT,active,los-angeles-rams,554583,2008
22346,370000,172125,Jonathan Wade,CB,active,los-angeles-rams,542125,2008
22347,295000,214667,John Greco,G,active,los-angeles-rams,509667,2008
22348,460000,0,Eric Moore,DE,active,los-angeles-rams,460000,2008
22349,445000,9667,Mark Setterstrom,G,active,los-angeles-rams,454667,2008
22350,730000,0,Dan Kreider,RB,active,los-angeles-rams,730000,2008
22351,605000,40000,Brett Romberg,C,active,los-angeles-rams,645000,2008
22352,295000,125333,Justin King,CB,active,los-angeles-rams,420333,2008
22353,370000,43000,Clifton Ryan,T,active,los-angeles-rams,413000,2008
22354,295000,103000,Keenan Burton,WR,active,los-angeles-rams,398000,2008
22355,370000,0,Brannon Condren,S,active,los-angeles-rams,370000,2008
22356,370000,0,Quinton Culberson,LB,active,los-angeles-rams,370000,2008
22357,370000,0,Antonio Pittman,RB,active,los-angeles-rams,370000,2008
22358,295000,42667,Roy Schuening,G,active,los-angeles-rams,337667,2008
22359,310000,0,Daniel Fells,TE,active,los-angeles-rams,310000,2008
22360,310000,0,David Vobora,LB,active,los-angeles-rams,310000,2008
22361,295000,12033,Chris Chamberlain,ILB,active,los-angeles-rams,307033,2008
22362,520000,0,Rob Petitti,T,active,los-angeles-rams,520000,2008
22363,2500000,2250000,Drew Bennett,C,injured_reserve,los-angeles-rams,4750000,2008
22364,611187,2665000,Tye Hill,CB,injured_reserve,los-angeles-rams,3276187,2008
22365,20800,0,Lance Ball,RB,practice_squad,los-angeles-rams,20800,2008
22366,0,333334,Issac Bruce,WR,dead_cap,los-angeles-rams,333334,2008
22367,183333,0,Jon Alston,LB,dead_cap,los-angeles-rams,183333,2008
22368,0,155333,Dominique Byrd,T,dead_cap,los-angeles-rams,155333,2008
22369,96800,0,Dustin Fry,C,dead_cap,los-angeles-rams,96800,2008
22370,47334,0,Ken Shackleford,T,dead_cap,los-angeles-rams,47334,2008
22371,18800,0,Keith Jackson,DT,dead_cap,los-angeles-rams,18800,2008
22372,18600,0,Derek Stanley,WR,dead_cap,los-angeles-rams,18600,2008
22373,5500000,2279000,Steven Jackson,RB,active,los-angeles-rams,7779000,2009
22374,385000,9952500,Chris Long,DE,active,los-angeles-rams,10337500,2009
22375,4000000,2200000,Jason Brown,G,active,los-angeles-rams,6200000,2009
22376,4100000,1130000,Ron Bartell,CB,active,los-angeles-rams,5230000,2009
22377,3600000,1000000,Randy McMichael,TE,active,los-angeles-rams,4600000,2009
22378,4000000,0,Jacob Bell,G,active,los-angeles-rams,4000000,2009
22379,2482500,2455000,Alex Barron,LT,active,los-angeles-rams,4937500,2009
22380,310000,2620000,Jason Smith,LT,active,los-angeles-rams,2930000,2009
22381,1175294,956176,Josh Brown,K,active,los-angeles-rams,2131470,2009
22382,1250000,250000,Kyle Boller,QB,active,los-angeles-rams,1500000,2009
22383,1007280,235000,Donnie Jones,P,active,los-angeles-rams,1242280,2009
22384,1010000,0,Victor Adeyanju,DT,active,los-angeles-rams,1010000,2009
22385,800000,0,James Hall,DE,active,los-angeles-rams,800000,2009
22386,456250,456000,Donnie Avery,WR,active,los-angeles-rams,912250,2009
22387,310000,540000,James Laurinaitis,ILB,active,los-angeles-rams,850000,2009
22388,530000,189412,Claude Wroten,T,active,los-angeles-rams,719412,2009
22389,620000,33333,Billy Bajema,TE,active,los-angeles-rams,653333,2009
22390,460000,172125,Jonathan Wade,CB,active,los-angeles-rams,632125,2009
22391,620000,0,Adam Goldberg,G,active,los-angeles-rams,620000,2009
22392,385000,214667,John Greco,G,active,los-angeles-rams,599667,2009
22393,535000,0,Ruvell Martin,WR,active,los-angeles-rams,535000,2009
22394,310000,223074,Bradley Fletcher,CB,active,los-angeles-rams,533074,2009
22395,530000,0,LaJuan Ramsey,DT,active,los-angeles-rams,530000,2009
22396,460000,43000,Clifton Ryan,T,active,los-angeles-rams,503000,2009
22397,385000,103000,Keenan Burton,WR,active,los-angeles-rams,488000,2009
22398,745000,0,Paris Lenon,ILB,active,los-angeles-rams,745000,2009
22399,460000,0,Kenneth Darby,RB,active,los-angeles-rams,460000,2009
22400,460000,0,Daniel Fells,TE,active,los-angeles-rams,460000,2009
22401,460000,0,Laurent Robinson,WR,active,los-angeles-rams,460000,2009
22402,460000,0,Mark Setterstrom,G,active,los-angeles-rams,460000,2009
22403,310000,129929,Darell Scott,DT,active,los-angeles-rams,439929,2009
22404,310000,125333,Justin King,CB,active,los-angeles-rams,435333,2009
22405,385000,42500,Craig Dahl,SS,active,los-angeles-rams,427500,2009
22406,385000,12033,Chris Chamberlain,ILB,active,los-angeles-rams,397033,2009
22407,385000,0,Jordan Kent,WR,active,los-angeles-rams,385000,2009
22408,310000,24500,Keith Null,QB,active,los-angeles-rams,334500,2009
22409,310000,0,Chris Ogbonnaya,RB,active,los-angeles-rams,310000,2009
22410,273529,0,Danny Amendola,WR,active,los-angeles-rams,273529,2009
22411,215000,43892,Brooks Foster,WR,active,los-angeles-rams,258892,2009
22412,57500,0,Derek Stanley,WR,active,los-angeles-rams,57500,2009
22413,8500000,2000000,Marc Bulger,QB,injured_reserve,los-angeles-rams,10500000,2009
22414,6342021,0,Oshiomogho Atogwe,S,injured_reserve,los-angeles-rams,6342021,2009
22415,720000,2760000,Adam Carriker,DE,injured_reserve,los-angeles-rams,3480000,2009
22416,460000,125937,Gary Gibson,DT,injured_reserve,los-angeles-rams,585937,2009
22417,5000000,0,Drew Bennett,C,dead_cap,los-angeles-rams,5000000,2009
22418,0,2623714,Torry Holt,WR,dead_cap,los-angeles-rams,2623714,2009
22419,1800000,0,Will Witherspoon,OLB,dead_cap,los-angeles-rams,1800000,2009
22420,0,1600000,Corey Chavous,S,dead_cap,los-angeles-rams,1600000,2009
22421,0,2665000,Tye Hill,CB,dead_cap,los-angeles-rams,2665000,2009
22422,325000,0,Joe Klopfenstein,TE,dead_cap,los-angeles-rams,325000,2009
22423,0,135000,Anthony Becht,TE,dead_cap,los-angeles-rams,135000,2009
22424,42667,0,Roy Schuening,G,dead_cap,los-angeles-rams,42667,2009
22425,41600,0,Marcus Brown,CB,dead_cap,los-angeles-rams,41600,2009
22426,18235,0,Eric Moore,DE,dead_cap,los-angeles-rams,18235,2009
22427,16675,0,Chris Ogbonnaya,RB,dead_cap,los-angeles-rams,16675,2009
22428,1100000,13962500,Chris Long,DE,active,los-angeles-rams,15062500,2010
22429,6105000,2279000,Steven Jackson,RB,active,los-angeles-rams,8384000,2010
22430,5000000,2200000,Jason Brown,G,active,los-angeles-rams,7200000,2010
22431,4500000,1130000,Ron Bartell,CB,active,los-angeles-rams,5630000,2010
22432,5000000,0,Jacob Bell,G,active,los-angeles-rams,5000000,2010
22433,2100000,2000000,Oshiomogho Atogwe,S,active,los-angeles-rams,4100000,2010
22434,395000,3267700,Jason Smith,LT,active,los-angeles-rams,3662700,2010
22435,320000,2880000,Sam Bradford,QB,active,los-angeles-rams,3200000,2010
22436,2100000,956176,Josh Brown,K,active,los-angeles-rams,3056176,2010
22437,855000,0,James Hall,DE,active,los-angeles-rams,855000,2010
22438,1750000,1000000,A.J. Feeley,QB,active,los-angeles-rams,2750000,2010
22439,395000,1868332,James Laurinaitis,ILB,active,los-angeles-rams,2263332,2010
22440,1250000,0,Nail Diggs,LB,active,los-angeles-rams,1250000,2010
22441,1100000,235000,Donnie Jones,P,active,los-angeles-rams,1335000,2010
22442,545000,755000,Craig Dahl,SS,active,los-angeles-rams,1300000,2010
22443,1176000,0,Victor Adeyanju,DT,active,los-angeles-rams,1176000,2010
22444,1101000,0,Kevin Payne,S,active,los-angeles-rams,1101000,2010
22445,547500,456000,Donnie Avery,WR,active,los-angeles-rams,1003500,2010
22446,320000,580000,Rodger Saffold,G,active,los-angeles-rams,900000,2010
22447,800000,33333,Billy Bajema,TE,active,los-angeles-rams,833333,2010
22448,800000,0,Adam Goldberg,G,active,los-angeles-rams,800000,2010
22449,695000,75000,Gary Gibson,DT,active,los-angeles-rams,770000,2010
22450,755000,0,Michael Lewis,S,active,los-angeles-rams,755000,2010
22451,470000,214667,John Greco,G,active,los-angeles-rams,684667,2010
22452,395000,223074,Bradley Fletcher,CB,active,los-angeles-rams,618074,2010
22453,545000,0,Mark Setterstrom,G,active,los-angeles-rams,545000,2010
22454,320000,234434,Jerome Murphy,CB,active,los-angeles-rams,554434,2010
22455,550000,0,Laurent Robinson,WR,active,los-angeles-rams,550000,2010
22456,395000,129929,Darell Scott,DT,active,los-angeles-rams,524929,2010
22457,395000,125333,Justin King,CB,active,los-angeles-rams,520333,2010
22458,470000,12033,Chris Chamberlain,ILB,active,los-angeles-rams,482033,2010
22459,470000,0,Kenneth Darby,RB,active,los-angeles-rams,470000,2010
22460,470000,0,Larry Grant,LB,active,los-angeles-rams,470000,2010
22461,470000,0,Bryan Kehl,ILB,active,los-angeles-rams,470000,2010
22462,320000,138063,Mardy Gilyard,WR,active,los-angeles-rams,458063,2010
22463,395000,0,C.J. Ah You,DE,active,los-angeles-rams,395000,2010
22464,395000,0,Danny Amendola,WR,active,los-angeles-rams,395000,2010
22465,395000,0,Brandon Gibson,WR,active,los-angeles-rams,395000,2010
22466,320000,53878,Michael Hoomanawanui,TE,active,los-angeles-rams,373878,2010
22467,320000,43892,Brooks Foster,WR,active,los-angeles-rams,363892,2010
22468,320000,32250,Fendi Onobun,TE,active,los-angeles-rams,352250,2010
22469,320000,25825,Eugene Sims,DE,active,los-angeles-rams,345825,2010
22470,320000,13988,George Selvie,DE,active,los-angeles-rams,333988,2010
22471,320000,8888,Danario Alexander,WR,active,los-angeles-rams,328888,2010
22472,320000,8888,Josh Hull,ILB,active,los-angeles-rams,328888,2010
22473,320000,6250,Darian Stewart,FS,active,los-angeles-rams,326250,2010
22474,320000,0,Marquis Johnson,CB,active,los-angeles-rams,320000,2010
22475,310000,0,Ryan McKee,T,active,los-angeles-rams,310000,2010
22476,263529,0,Jermelle Cudjo,DT,active,los-angeles-rams,263529,2010
22477,240000,0,Brit Miller,RB,active,los-angeles-rams,240000,2010
22478,60000,0,Bobby Carpenter,LB,active,los-angeles-rams,60000,2010
22479,2277000,0,Mark Clayton,WR,injured_reserve,los-angeles-rams,2277000,2010
22480,855000,0,Chris Hovan,DT,injured_reserve,los-angeles-rams,855000,2010
22481,225000,0,Dominique Curry,WR,injured_reserve,los-angeles-rams,225000,2010
22482,88400,0,Jermelle Cudjo,DT,practice_squad,los-angeles-rams,88400,2010
22483,6000000,0,Marc Bulger,QB,dead_cap,los-angeles-rams,6000000,2010
22484,0,5520000,Adam Carriker,DE,dead_cap,los-angeles-rams,5520000,2010
22485,1800000,0,Will Witherspoon,OLB,dead_cap,los-angeles-rams,1800000,2010
22486,0,2665000,Tye Hill,CB,dead_cap,los-angeles-rams,2665000,2010
22487,103000,0,Keenan Burton,WR,dead_cap,los-angeles-rams,103000,2010
22488,50025,0,Chris Ogbonnaya,RB,dead_cap,los-angeles-rams,50025,2010
22489,0,47220,Hall Davis,DE,dead_cap,los-angeles-rams,47220,2010
22490,42667,0,Roy Schuening,G,dead_cap,los-angeles-rams,42667,2010
22491,0,16741,Marquis Johnson,CB,dead_cap,los-angeles-rams,16741,2010
22492,1750,0,Jermelle Cudjo,DT,dead_cap,los-angeles-rams,1750,2010
22493,0,1250,Thaddeus Lewis,QB,dead_cap,los-angeles-rams,1250,2010
22494,450000,12015000,Sam Bradford,QB,active,los-angeles-rams,12465000,2011
22495,8500000,3267700,Jason Smith,LT,active,los-angeles-rams,11767700,2011
22496,1235000,12297500,Chris Long,DE,active,los-angeles-rams,13532500,2011
22497,7200000,2279000,Steven Jackson,RB,active,los-angeles-rams,9479000,2011
22498,5200000,1130000,Ron Bartell,CB,active,los-angeles-rams,6330000,2011
22499,4000000,2200000,Jason Brown,G,active,los-angeles-rams,6200000,2011
22500,4297078,0,Jacob Bell,G,active,los-angeles-rams,4297078,2011
22501,1000000,3000000,Harvey Dahl,G,active,los-angeles-rams,4000000,2011
22502,1000000,5000000,Quintin Mikell,S,active,los-angeles-rams,6000000,2011
22503,2600000,956176,Josh Brown,K,active,los-angeles-rams,3556176,2011
22504,2250000,1000000,A.J. Feeley,QB,active,los-angeles-rams,3250000,2011
22505,2750000,0,James Hall,DE,active,los-angeles-rams,2750000,2011
22506,375000,1340646,Robert Quinn,OLB,active,los-angeles-rams,1715646,2011
22507,1600000,0,Craig Dahl,SS,active,los-angeles-rams,1600000,2011
22508,1100000,235000,Donnie Jones,P,active,los-angeles-rams,1335000,2011
22509,525000,1428332,James Laurinaitis,ILB,active,los-angeles-rams,1953332,2011
22510,450000,780000,Rodger Saffold,G,active,los-angeles-rams,1230000,2011
22511,1200000,0,Chris Chamberlain,ILB,active,los-angeles-rams,1200000,2011
22512,638750,456000,Donnie Avery,WR,active,los-angeles-rams,1094750,2011
22513,985000,33334,Billy Bajema,TE,active,los-angeles-rams,1018334,2011
22514,902647,0,Brandon Lloyd,WR,active,los-angeles-rams,902647,2011
22515,810000,0,Adam Goldberg,G,active,los-angeles-rams,810000,2011
22516,775500,0,Justin King,CB,active,los-angeles-rams,775500,2011
22517,375000,393437,Lance Kendricks,TE,active,los-angeles-rams,768437,2011
22518,525000,223074,Bradley Fletcher,CB,active,los-angeles-rams,748074,2011
22519,450000,234434,Jerome Murphy,CB,active,los-angeles-rams,684434,2011
22520,525000,129929,Darell Scott,DT,active,los-angeles-rams,654929,2011
22521,600000,0,Bryan Kehl,ILB,active,los-angeles-rams,600000,2011
22522,685000,50000,Gary Gibson,DT,active,los-angeles-rams,735000,2011
22523,685000,0,Jerious Norwood,RB,active,los-angeles-rams,685000,2011
22524,685000,0,Brady Poppinga,LB,active,los-angeles-rams,685000,2011
22525,685000,50000,Carnell Williams,RB,active,los-angeles-rams,735000,2011
22526,525000,0,Danny Amendola,WR,active,los-angeles-rams,525000,2011
22527,525000,0,Brandon Gibson,WR,active,los-angeles-rams,525000,2011
22528,525000,0,Brit Miller,RB,active,los-angeles-rams,525000,2011
22529,375000,144567,Austin Pettis,WR,active,los-angeles-rams,519567,2011
22530,450000,53878,Michael Hoomanawanui,TE,active,los-angeles-rams,503878,2011
22531,375000,112788,Greg Salas,WR,active,los-angeles-rams,487788,2011
22532,480000,0,C.J. Ah You,DE,active,los-angeles-rams,480000,2011
22533,450000,8888,Danario Alexander,WR,active,los-angeles-rams,458888,2011
22534,450000,6250,Darian Stewart,FS,active,los-angeles-rams,456250,2011
22535,450000,0,Tom Brandstater,QB,active,los-angeles-rams,450000,2011
22536,450000,0,Dominique Curry,WR,active,los-angeles-rams,450000,2011
22537,450000,0,Josh Gordy,CB,active,los-angeles-rams,450000,2011
22538,405000,25825,Eugene Sims,DE,active,los-angeles-rams,430825,2011
22539,405000,0,Keith Toston,RB,active,los-angeles-rams,405000,2011
22540,375000,14873,Mikail Baker,CB,active,los-angeles-rams,389873,2011
22541,375000,8888,Josh Hull,ILB,active,los-angeles-rams,383888,2011
22542,375000,2333,Mike McNeill,TE,active,los-angeles-rams,377333,2011
22543,375000,1000,Ben Guidugli ,TE,active,los-angeles-rams,376000,2011
22544,375000,833,Jake McQuaide,LS,active,los-angeles-rams,375833,2011
22545,375000,0,Marquis Johnson,CB,active,los-angeles-rams,375000,2011
22546,375000,0,Chris Smith,CB,active,los-angeles-rams,375000,2011
22547,185294,0,Justin Cole,ILB,active,los-angeles-rams,185294,2011
22548,375000,0,Kevin Hughes,T,active,los-angeles-rams,375000,2011
22549,0,1666,Kevin Hughes,T,active,los-angeles-rams,1666,2011
22550,500000,39378,Mark Clayton,WR,injured_reserve,los-angeles-rams,539378,2011
22551,273000,0,Jermelle Cudjo,DT,injured_reserve,los-angeles-rams,273000,2011
22552,96900,0,Tim Barnes,C,practice_squad,los-angeles-rams,96900,2011
22553,96900,0,Kendric Burney,CB,practice_squad,los-angeles-rams,96900,2011
22554,96900,0,Scott Lutrus,ILB,practice_squad,los-angeles-rams,96900,2011
22555,154411,12273,Jabara Williams,OLB,dead_cap,los-angeles-rams,166684,2011
22556,0,141660,Hall Davis,DE,dead_cap,los-angeles-rams,141660,2011
22557,0,138063,Mardy Gilyard,WR,dead_cap,los-angeles-rams,138063,2011
22558,96900,0,Kevin Hughes,T,dead_cap,los-angeles-rams,96900,2011
22559,0,50223,Marquis Johnson,CB,dead_cap,los-angeles-rams,50223,2011
22560,0,32250,Fendi Onobun,TE,dead_cap,los-angeles-rams,32250,2011
22561,0,13988,George Selvie,DE,dead_cap,los-angeles-rams,13988,2011
22562,0,12273,Jonathan Nelson,CB,dead_cap,los-angeles-rams,12273,2011
22563,0,2500,Thaddeus Lewis,QB,dead_cap,los-angeles-rams,2500,2011
22564,1750,0,Jermelle Cudjo,DT,dead_cap,los-angeles-rams,1750,2011
22565,10310000,13197500,Chris Long,DE,active,los-angeles-rams,23507500,2012
22566,6000000,9595000,Sam Bradford,QB,active,los-angeles-rams,15595000,2012
22567,7000000,2279000,Steven Jackson,RB,active,los-angeles-rams,9279000,2012
22568,5000000,1000000,Cortland Finnegan,CB,active,los-angeles-rams,6000000,2012
22569,1000000,5000000,Quintin Mikell,S,active,los-angeles-rams,6000000,2012
22570,2000000,1000000,Kendall Langford,DE,active,los-angeles-rams,3000000,2012
22571,2450000,50000,Wayne Hunter,T,active,los-angeles-rams,2500000,2012
22572,1000000,0,Steve Smith,WR,active,los-angeles-rams,1000000,2012
22573,803941,1340646,Robert Quinn,OLB,active,los-angeles-rams,2144587,2012
22574,1972000,0,Danny Amendola,WR,active,los-angeles-rams,1972000,2012
22575,620000,1828336,James Laurinaitis,ILB,active,los-angeles-rams,2448336,2012
22576,390000,1341272,Michael Brockers,DT,active,los-angeles-rams,1731272,2012
22577,750000,750000,JoLonn Dunbar,OLB,active,los-angeles-rams,1500000,2012
22578,1202202,223074,Bradley Fletcher,CB,active,los-angeles-rams,1425276,2012
22579,540000,790000,Rodger Saffold,G,active,los-angeles-rams,1330000,2012
22580,1250000,0,Chris Williams,G,active,los-angeles-rams,1250000,2012
22581,1200000,0,Craig Dahl,SS,active,los-angeles-rams,1200000,2012
22582,700000,100000,Barry Richardson,LT,active,los-angeles-rams,800000,2012
22583,1000000,0,Brandon Gibson,WR,active,los-angeles-rams,1000000,2012
22584,390000,589382,Brian Quick,WR,active,los-angeles-rams,979382,2012
22585,567059,393437,Lance Kendricks,TE,active,los-angeles-rams,960496,2012
22586,390000,517331,Janoris Jenkins,CB,active,los-angeles-rams,907331,2012
22587,800000,100000,William Hayes,DE,active,los-angeles-rams,900000,2012
22588,675000,100000,Matthew Mulligan,TE,active,los-angeles-rams,775000,2012
22589,390000,344200,Isaiah Pead,RB,active,los-angeles-rams,734200,2012
22590,490000,144567,Austin Pettis,WR,active,los-angeles-rams,634567,2012
22591,615000,0,Brit Miller,RB,active,los-angeles-rams,615000,2012
22592,540000,25825,Eugene Sims,DE,active,los-angeles-rams,565825,2012
22593,390000,167794,Trumaine Johnson,CB,active,los-angeles-rams,557794,2012
22594,825000,65000,Mario Haggan,LB,active,los-angeles-rams,890000,2012
22595,700000,10000,Kellen Clemens,QB,active,los-angeles-rams,710000,2012
22596,700000,0,Rocky McIntosh,OLB,active,los-angeles-rams,700000,2012
22597,700000,0,Robert Turner,C,active,los-angeles-rams,700000,2012
22598,540000,0,Justin Cole,ILB,active,los-angeles-rams,540000,2012
22599,540000,0,Josh Gordy,CB,active,los-angeles-rams,540000,2012
22600,540000,0,Darian Stewart,FS,active,los-angeles-rams,540000,2012
22601,390000,124257,Chris Givens,WR,active,los-angeles-rams,514257,2012
22602,490000,8888,Josh Hull,ILB,active,los-angeles-rams,498888,2012
22603,490000,0,Shelley Smith,G,active,los-angeles-rams,490000,2012
22604,465000,833,Jake McQuaide,LS,active,los-angeles-rams,465833,2012
22605,465000,0,Joe Barksdale,RT,active,los-angeles-rams,465000,2012
22606,465000,0,Jermelle Cudjo,DT,active,los-angeles-rams,465000,2012
22607,465000,0,Mike McNeill,TE,active,los-angeles-rams,465000,2012
22608,390000,32205,Greg Zuerlein,K,active,los-angeles-rams,422205,2012
22609,390000,11474,Daryl Richardson,RB,active,los-angeles-rams,401474,2012
22610,390000,3333,Johnny Hekker,P,active,los-angeles-rams,393333,2012
22611,390000,2000,Matt Conrath,DT,active,los-angeles-rams,392000,2012
22612,390000,1333,Rodney McLeod,FS,active,los-angeles-rams,391333,2012
22613,390000,0,Austin Davis,QB,active,los-angeles-rams,390000,2012
22614,367058,0,Tim Barnes,C,active,los-angeles-rams,367058,2012
22615,390000,0,Quinton Pointer,CB,active,los-angeles-rams,390000,2012
22616,160588,0,Cory Harkey,FB,active,los-angeles-rams,160588,2012
22617,390000,0,Sammy Brown,DE,active,los-angeles-rams,390000,2012
22618,0,3334,Kevin Hughes,T,active,los-angeles-rams,3334,2012
22619,3000000,1000000,Harvey Dahl,G,injured_reserve,los-angeles-rams,4000000,2012
22620,2500000,1000000,Scott Wells,C,injured_reserve,los-angeles-rams,3500000,2012
22621,700000,0,Trevor Laws,DT,injured_reserve,los-angeles-rams,700000,2012
22622,390000,47825,Rokevious Watkins,G,injured_reserve,los-angeles-rams,437825,2012
22623,273000,3333,Matt Daniels,FS,injured_reserve,los-angeles-rams,276333,2012
22624,161500,0,Ty Nsekhe,LT,practice_squad,los-angeles-rams,161500,2012
22625,161500,0,Brandon Washington,RT,practice_squad,los-angeles-rams,161500,2012
22626,96900,0,Tim Barnes,C,practice_squad,los-angeles-rams,96900,2012
22627,96900,0,Sammy Brown,DE,practice_squad,los-angeles-rams,96900,2012
22628,96900,0,Cory Harkey,FB,practice_squad,los-angeles-rams,96900,2012
22629,4400000,0,Jason Brown,G,dead_cap,los-angeles-rams,4400000,2012
22630,0,3267700,Jason Smith,LT,dead_cap,los-angeles-rams,3267700,2012
22631,1130000,0,Ron Bartell,CB,dead_cap,los-angeles-rams,1130000,2012
22632,800000,0,Josh Brown,K,dead_cap,los-angeles-rams,800000,2012
22633,387600,0,Mason Brodine,DE,dead_cap,los-angeles-rams,387600,2012
22634,0,276126,Mardy Gilyard,WR,dead_cap,los-angeles-rams,276126,2012
22635,234434,0,Jerome Murphy,CB,dead_cap,los-angeles-rams,234434,2012
22636,129929,0,Darell Scott,DT,dead_cap,los-angeles-rams,129929,2012
22637,112788,0,Greg Salas,WR,dead_cap,los-angeles-rams,112788,2012
22638,65000,0,Ovie Mughelli,RB,dead_cap,los-angeles-rams,65000,2012
22639,0,64500,Fendi Onobun,TE,dead_cap,los-angeles-rams,64500,2012
22640,0,53878,Michael Hoomanawanui,TE,dead_cap,los-angeles-rams,53878,2012
22641,0,44619,Mikail Baker,CB,dead_cap,los-angeles-rams,44619,2012
22642,0,36820,Jonathan Nelson,CB,dead_cap,los-angeles-rams,36820,2012
22643,0,36819,Jabara Williams,OLB,dead_cap,los-angeles-rams,36819,2012
22644,33482,0,Marquis Johnson,CB,dead_cap,los-angeles-rams,33482,2012
22645,0,27976,George Selvie,DE,dead_cap,los-angeles-rams,27976,2012
22646,0,17225,Aaron Brown,LB,dead_cap,los-angeles-rams,17225,2012
22647,0,8888,Danario Alexander,WR,dead_cap,los-angeles-rams,8888,2012
22648,6000,0,DeAngelo  Peterson,TE,dead_cap,los-angeles-rams,6000,2012
22649,4000,0,Jamaar Jarrett,DE,dead_cap,los-angeles-rams,4000,2012
22650,4000,0,Noah Keller,LB,dead_cap,los-angeles-rams,4000,2012
22651,4000,0,Scott Smith,DT,dead_cap,los-angeles-rams,4000,2012
22652,3000,0,Alex Hoffman-Ellis,LB,dead_cap,los-angeles-rams,3000,2012
22653,2333,0,Sammy Brown,DE,dead_cap,los-angeles-rams,2333,2012
22654,2000,0,Ben Guidugli ,TE,dead_cap,los-angeles-rams,2000,2012
22655,833,0,Cory Harkey,FB,dead_cap,los-angeles-rams,833,2012
22656,9000000,6000000,Cortland Finnegan,CB,active,los-angeles-rams,15000000,2013
22657,1000000,11900000,James Laurinaitis,ILB,active,los-angeles-rams,12900000,2013
22658,9000000,3595000,Sam Bradford,QB,active,los-angeles-rams,12595000,2013
22659,7050000,1500000,Chris Long,DE,active,los-angeles-rams,8550000,2013
22660,5000000,1000000,Kendall Langford,DE,active,los-angeles-rams,6000000,2013
22661,3000000,1250000,Jake Long,LT,active,los-angeles-rams,4250000,2013
22662,3000000,1000000,Jared Cook,TE,active,los-angeles-rams,4000000,2013
22663,850000,1900000,Harvey Dahl,G,active,los-angeles-rams,2750000,2013
22664,1232829,1340646,Robert Quinn,OLB,active,los-angeles-rams,2573475,2013
22665,405000,1913364,Tavon Austin,WR,active,los-angeles-rams,2318364,2013
22666,822818,1341272,Michael Brockers,DT,active,los-angeles-rams,2164090,2013
22667,800000,1250000,William Hayes,DE,active,los-angeles-rams,2050000,2013
22668,655000,805000,Rodger Saffold,G,active,los-angeles-rams,1460000,2013
22669,925000,451154,Chris Williams,G,active,los-angeles-rams,1376154,2013
22670,405000,873188,Alec Ogletree,ILB,active,los-angeles-rams,1278188,2013
22671,634845,589382,Brian Quick,WR,active,los-angeles-rams,1224227,2013
22672,759118,393437,Lance Kendricks,TE,active,los-angeles-rams,1152555,2013
22673,480000,654163,Janoris Jenkins,CB,active,los-angeles-rams,1134163,2013
22674,700000,300000,Darian Stewart,FS,active,los-angeles-rams,1000000,2013
22675,539812,344200,Isaiah Pead,RB,active,los-angeles-rams,884012,2013
22676,651156,142509,Eugene Sims,DE,active,los-angeles-rams,793665,2013
22677,555000,175000,Jermelle Cudjo,DT,active,los-angeles-rams,730000,2013
22678,580000,144567,Austin Pettis,WR,active,los-angeles-rams,724567,2013
22679,499000,197794,Trumaine Johnson,CB,active,los-angeles-rams,696794,2013
22680,555000,100833,Jake McQuaide,LS,active,los-angeles-rams,655833,2013
22681,850000,0,JoLonn Dunbar,OLB,active,los-angeles-rams,850000,2013
22682,480000,124257,Chris Givens,WR,active,los-angeles-rams,604257,2013
22683,575000,0,Shelley Smith,G,active,los-angeles-rams,575000,2013
22684,405000,162000,T.J. McDonald,FS,active,los-angeles-rams,567000,2013
22685,940000,0,Will Witherspoon,OLB,active,los-angeles-rams,940000,2013
22686,840000,30000,Kellen Clemens,QB,active,los-angeles-rams,870000,2013
22687,840000,0,Matt Giordano,S,active,los-angeles-rams,840000,2013
22688,555000,0,Joe Barksdale,RT,active,los-angeles-rams,555000,2013
22689,555000,0,Mike McNeill,TE,active,los-angeles-rams,555000,2013
22690,405000,131850,Stedman Bailey,WR,active,los-angeles-rams,536850,2013
22691,405000,111300,Barrett Jones,G,active,los-angeles-rams,516300,2013
22692,480000,32205,Greg Zuerlein,K,active,los-angeles-rams,512205,2013
22693,480000,11474,Daryl Richardson,RB,active,los-angeles-rams,491474,2013
22694,555000,0,Michael Person,G,active,los-angeles-rams,555000,2013
22695,480000,3333,Johnny Hekker,P,active,los-angeles-rams,483333,2013
22696,480000,2000,Matt Conrath,DT,active,los-angeles-rams,482000,2013
22697,480000,1333,Rodney McLeod,FS,active,los-angeles-rams,481333,2013
22698,480000,0,Tim Barnes,C,active,los-angeles-rams,480000,2013
22699,480000,0,Cory Harkey,FB,active,los-angeles-rams,480000,2013
22700,405000,47790,Brandon McGee,CB,active,los-angeles-rams,452790,2013
22701,405000,44125,Zac Stacy,RB,active,los-angeles-rams,449125,2013
22702,405000,3333,Benny Cunningham,RB,active,los-angeles-rams,408333,2013
22703,405000,0,Ray-Ray Armstrong,OLB,active,los-angeles-rams,405000,2013
22704,405000,0,Daren Bates,ILB,active,los-angeles-rams,405000,2013
22705,405000,0,Chase Reynolds,RB,active,los-angeles-rams,405000,2013
22706,405000,0,Cody Davis,FS,active,los-angeles-rams,405000,2013
22707,480000,0,Quinton Pointer,CB,active,los-angeles-rams,480000,2013
22708,484484,0,Brandon Washington,RT,active,los-angeles-rams,484484,2013
22709,405000,0,Justin Veltung,WR,active,los-angeles-rams,405000,2013
22710,480000,0,Sammy Brown,DE,active,los-angeles-rams,480000,2013
22711,5500000,1000000,Scott Wells,C,injured_reserve,los-angeles-rams,6500000,2013
22712,480000,3333,Matt Daniels,FS,injured_reserve,los-angeles-rams,483333,2013
22713,288000,3333,Philip Steward,OLB,injured_reserve,los-angeles-rams,291333,2013
22714,288000,0,Graham Pocic,RT,injured_reserve,los-angeles-rams,288000,2013
22715,420588,0,Brady Quinn,QB,injured_reserve,los-angeles-rams,420588,2013
22716,357353,0,Gerald Rivers,DE,practice_squad,los-angeles-rams,357353,2013
22717,96000,0,Sammy Brown,DE,practice_squad,los-angeles-rams,96000,2013
22718,84000,0,Justin Veltung,WR,practice_squad,los-angeles-rams,84000,2013
22719,0,6535400,Jason Smith,LT,dead_cap,los-angeles-rams,6535400,2013
22720,6000000,0,Quintin Mikell,S,dead_cap,los-angeles-rams,6000000,2013
22721,500000,0,JoLonn Dunbar,OLB,dead_cap,los-angeles-rams,500000,2013
22722,235493,0,Brandon Washington,RT,dead_cap,los-angeles-rams,235493,2013
22723,234434,0,Jerome Murphy,CB,dead_cap,los-angeles-rams,234434,2013
22724,225576,0,Greg Salas,WR,dead_cap,los-angeles-rams,225576,2013
22725,197647,0,Max Starks,LT,dead_cap,los-angeles-rams,197647,2013
22726,132706,0,Quinton Pointer,CB,dead_cap,los-angeles-rams,132706,2013
22727,119254,0,C.J. Akins,WR,dead_cap,los-angeles-rams,119254,2013
22728,100000,0,Matthew Mulligan,TE,dead_cap,los-angeles-rams,100000,2013
22729,89706,0,Braden Brown,RT,dead_cap,los-angeles-rams,89706,2013
22730,63157,0,Jonathan Stewart,OLB,dead_cap,los-angeles-rams,63157,2013
22731,0,53878,Michael Hoomanawanui,TE,dead_cap,los-angeles-rams,53878,2013
22732,0,51675,Aaron Brown,LB,dead_cap,los-angeles-rams,51675,2013
22733,47825,0,Rokevious Watkins,G,dead_cap,los-angeles-rams,47825,2013
22734,25666,0,Eric Stevens,FB,dead_cap,los-angeles-rams,25666,2013
22735,24000,0,Emory Blake,WR,dead_cap,los-angeles-rams,24000,2013
22736,8889,0,Josh Hull,ILB,dead_cap,los-angeles-rams,8889,2013
22737,6000,0,Brad Smelley,TE,dead_cap,los-angeles-rams,6000,2013
22738,5000,0,Cody Davis,FS,dead_cap,los-angeles-rams,5000,2013
22739,4667,0,Sammy Brown,DE,dead_cap,los-angeles-rams,4667,2013
22740,1667,0,Cory Harkey,FB,dead_cap,los-angeles-rams,1667,2013
22741,1033,0,Philip Lutzenkirchen,TE,dead_cap,los-angeles-rams,1033,2013
22742,666,0,Gerald Rivers,DE,dead_cap,los-angeles-rams,666,2013
22743,666,0,Darren Woodard,CB,dead_cap,los-angeles-rams,666,2013
22744,333,0,Cannon Smith,S,dead_cap,los-angeles-rams,333,2013
22745,166,0,Robert Steeples,CB,dead_cap,los-angeles-rams,166,2013
22746,14015000,3595000,Sam Bradford,QB,active,los-angeles-rams,17610000,2014
22747,10200000,2700000,Chris Long,DE,active,los-angeles-rams,12900000,2014
22748,9000000,900000,James Laurinaitis,ILB,active,los-angeles-rams,9900000,2014
22749,8000000,1250000,Jake Long,LT,active,los-angeles-rams,9250000,2014
22750,1798236,4300441,Jared Cook,TE,active,los-angeles-rams,6098677,2014
22751,5000000,1000000,Kendall Langford,DE,active,los-angeles-rams,6000000,2014
22752,1000000,3340625,Scott Wells,C,active,los-angeles-rams,4340625,2014
22753,3000000,1000000,Rodger Saffold,G,active,los-angeles-rams,4000000,2014
22754,420000,3449836,Greg Robinson,LT,active,los-angeles-rams,3869836,2014
22755,2595000,1250000,William Hayes,DE,active,los-angeles-rams,3845000,2014
22756,646646,2355711,Robert Quinn,OLB,active,los-angeles-rams,3002357,2014
22757,984591,1913364,Tavon Austin,WR,active,los-angeles-rams,2897955,2014
22758,1255636,1341272,Michael Brockers,DT,active,los-angeles-rams,2596908,2014
22759,420000,1423000,Aaron Donald,DT,active,los-angeles-rams,1843000,2014
22760,1250000,500000,Shaun Hill,QB,active,los-angeles-rams,1750000,2014
22761,1100000,650000,Davin Joseph,G,active,los-angeles-rams,1750000,2014
22762,724547,873188,Alec Ogletree,ILB,active,los-angeles-rams,1597735,2014
22763,1000000,500000,Alex Carrington,DT,active,los-angeles-rams,1500000,2014
22764,879690,589382,Brian Quick,WR,active,los-angeles-rams,1469072,2014
22765,1000000,375000,Kenny Britt,WR,active,los-angeles-rams,1375000,2014
22766,570000,790995,Janoris Jenkins,CB,active,los-angeles-rams,1360995,2014
22767,951177,393437,Lance Kendricks,TE,active,los-angeles-rams,1344614,2014
22768,950000,266684,Eugene Sims,DE,active,los-angeles-rams,1216684,2014
22769,420000,494578,LaMarcus Joyner,FS,active,los-angeles-rams,914578,2014
22770,902646,0,Mark Barron,ILB,active,los-angeles-rams,902646,2014
22771,751157,128821,JoLonn Dunbar,OLB,active,los-angeles-rams,879978,2014
22772,656000,167794,Trumaine Johnson,CB,active,los-angeles-rams,823794,2014
22773,645000,100000,Jake McQuaide,LS,active,los-angeles-rams,745000,2014
22774,570000,154884,Johnny Hekker,P,active,los-angeles-rams,724884,2014
22775,570000,124257,Chris Givens,WR,active,los-angeles-rams,694257,2014
22776,518815,162000,T.J. McDonald,FS,active,los-angeles-rams,680815,2014
22777,645000,0,Joe Barksdale,RT,active,los-angeles-rams,645000,2014
22778,645000,0,Michael Person,G,active,los-angeles-rams,645000,2014
22779,570000,47756,Greg Zuerlein,K,active,los-angeles-rams,617756,2014
22780,495000,111300,Barrett Jones,G,active,los-angeles-rams,606300,2014
22781,452058,131850,Stedman Bailey,WR,active,los-angeles-rams,583908,2014
22782,420000,159375,Tre Mason,RB,active,los-angeles-rams,579375,2014
22783,570000,1333,Rodney McLeod,FS,active,los-angeles-rams,571333,2014
22784,570000,0,Tim Barnes,C,active,los-angeles-rams,570000,2014
22785,570000,0,Austin Davis,QB,active,los-angeles-rams,570000,2014
22786,570000,0,Cory Harkey,FB,active,los-angeles-rams,570000,2014
22787,495000,44125,Zac Stacy,RB,active,los-angeles-rams,539125,2014
22788,420000,116065,Maurice Alexander,SS,active,los-angeles-rams,536065,2014
22789,495000,3333,Benny Cunningham,RB,active,los-angeles-rams,498333,2014
22790,495000,0,Daren Bates,ILB,active,los-angeles-rams,495000,2014
22791,495000,0,Cody Davis,FS,active,los-angeles-rams,495000,2014
22792,495000,0,Chase Reynolds,RB,active,los-angeles-rams,495000,2014
22793,420000,26918,E.J. Gaines,CB,active,los-angeles-rams,446918,2014
22794,420000,6666,Ethan Westbrooks,DE,active,los-angeles-rams,426666,2014
22795,420000,5000,Marcus Roberson,CB,active,los-angeles-rams,425000,2014
22796,420000,3333,Alex Bayer,TE,active,los-angeles-rams,423333,2014
22797,420000,2000,Trey Watts,RB,active,los-angeles-rams,422000,2014
22798,855000,0,Will Herring,LB,active,los-angeles-rams,855000,2014
22799,303000,11474,Demetrius Rhaney,C,active,los-angeles-rams,314474,2014
22800,262058,0,Brandon Washington,RT,active,los-angeles-rams,262058,2014
22801,420000,0,Korey Toomer,ILB,active,los-angeles-rams,420000,2014
22802,420000,0,Justice Cunningham,TE,active,los-angeles-rams,420000,2014
22803,757100,344200,Isaiah Pead,RB,injured_reserve,los-angeles-rams,1101300,2014
22804,495000,47790,Brandon McGee,CB,injured_reserve,los-angeles-rams,542790,2014
22805,318000,0,Mason Brodine,DE,injured_reserve,los-angeles-rams,318000,2014
22806,107100,0,Christian Bryant,FS,practice_squad,los-angeles-rams,107100,2014
22807,94500,0,Matt Conrath,DT,practice_squad,los-angeles-rams,94500,2014
22808,81900,0,Brad Smelley,TE,practice_squad,los-angeles-rams,81900,2014
22809,63000,0,Devon Wylie,WR,practice_squad,los-angeles-rams,63000,2014
22810,56700,0,Steven Baker,RT,practice_squad,los-angeles-rams,56700,2014
22811,56700,0,Emory Blake,WR,practice_squad,los-angeles-rams,56700,2014
22812,56700,0,Travis Bond,G,practice_squad,los-angeles-rams,56700,2014
22813,25200,0,Marshall McFadden,ILB,practice_squad,los-angeles-rams,25200,2014
22814,6000000,0,Cortland Finnegan,CB,dead_cap,los-angeles-rams,6000000,2014
22815,288235,394567,Austin Pettis,WR,dead_cap,los-angeles-rams,682802,2014
22816,277041,0,Case Keenum,QB,dead_cap,los-angeles-rams,277041,2014
22817,187305,0,Marshall McFadden,ILB,dead_cap,los-angeles-rams,187305,2014
22818,175000,0,Jermelle Cudjo,DT,dead_cap,los-angeles-rams,175000,2014
22819,145588,0,Ray-Ray Armstrong,OLB,dead_cap,los-angeles-rams,145588,2014
22820,111720,9670,Garrett Gilbert,QB,dead_cap,los-angeles-rams,121390,2014
22821,95650,0,Rokevious Watkins,G,dead_cap,los-angeles-rams,95650,2014
22822,69300,0,Kourtnei Brown,OLB,dead_cap,los-angeles-rams,69300,2014
22823,63000,0,Jemea Thomas,CB,dead_cap,los-angeles-rams,63000,2014
22824,60847,0,Justice Cunningham,TE,dead_cap,los-angeles-rams,60847,2014
22825,50400,0,Mike Remmers,RT,dead_cap,los-angeles-rams,50400,2014
22826,50400,0,Brandon Washington,RT,dead_cap,los-angeles-rams,50400,2014
22827,44100,0,Denicos Allen,OLB,dead_cap,los-angeles-rams,44100,2014
22828,44100,0,Emory Blake,WR,dead_cap,los-angeles-rams,44100,2014
22829,39829,2000,Matt Conrath,DT,dead_cap,los-angeles-rams,41829,2014
22830,35314,333,Jemaine Sherman,WR,dead_cap,los-angeles-rams,35647,2014
22831,35647,0,Pat Schiller,ILB,dead_cap,los-angeles-rams,35647,2014
22832,31500,0,Justin Veltung,WR,dead_cap,los-angeles-rams,31500,2014
22833,25200,0,Brad Smelley,TE,dead_cap,los-angeles-rams,25200,2014
22834,0,22948,Daryl Richardson,RB,dead_cap,los-angeles-rams,22948,2014
22835,12600,3333,Matt Daniels,FS,dead_cap,los-angeles-rams,15933,2014
22836,0,15150,Mitchell Van Dyk,LT,dead_cap,los-angeles-rams,15150,2014
22837,12600,0,Kadron Boone,WR,dead_cap,los-angeles-rams,12600,2014
22838,12600,0,Kevin Reddick,ILB,dead_cap,los-angeles-rams,12600,2014
22839,0,12250,Christian Bryant,FS,dead_cap,los-angeles-rams,12250,2014
22840,0,11474,Michael Sam,DE,dead_cap,los-angeles-rams,11474,2014
22841,10000,0,Braden Brown,RT,dead_cap,los-angeles-rams,10000,2014
22842,10000,0,Cody Davis,FS,dead_cap,los-angeles-rams,10000,2014
22843,6667,0,Jonathan Stewart,OLB,dead_cap,los-angeles-rams,6667,2014
22844,6300,0,Sean Hooey,RT,dead_cap,los-angeles-rams,6300,2014
22845,6300,0,Korey Toomer,ILB,dead_cap,los-angeles-rams,6300,2014
22846,0,5833,Austin Franklin,WR,dead_cap,los-angeles-rams,5833,2014
22847,3334,0,Eric Stevens,FB,dead_cap,los-angeles-rams,3334,2014
22848,0,3333,Philip Steward,OLB,dead_cap,los-angeles-rams,3333,2014
22849,2067,0,Philip Lutzenkirchen,TE,dead_cap,los-angeles-rams,2067,2014
22850,1334,0,C.J. Akins,WR,dead_cap,los-angeles-rams,1334,2014
22851,1334,0,Gerald Rivers,DE,dead_cap,los-angeles-rams,1334,2014
22852,1334,0,Darren Woodard,CB,dead_cap,los-angeles-rams,1334,2014
22853,1084,0,Sammy Brown,DE,dead_cap,los-angeles-rams,1084,2014
22854,0,1000,Emmanuel McCray,G,dead_cap,los-angeles-rams,1000,2014
22855,667,0,Cannon Smith,S,dead_cap,los-angeles-rams,667,2014
22856,0,666,Aaron Hill,OLB,dead_cap,los-angeles-rams,666,2014
22857,0,666,Abasi Salimu,RT,dead_cap,los-angeles-rams,666,2014
22858,334,0,Robert Steeples,CB,dead_cap,los-angeles-rams,334,2014
22859,0,333,Jarrid Bryant,CB,dead_cap,los-angeles-rams,333,2014
22860,0,333,Deantre Harlan,DT,dead_cap,los-angeles-rams,333,2014
22861,0,333,Kadeem Jones,FB,dead_cap,los-angeles-rams,333,2014
22862,7000000,5500000,Chris Long,DE,active,los-angeles-rams,12500000,2015
22863,7000000,1300441,Jared Cook,TE,active,los-angeles-rams,8300441,2015
22864,1500000,4100000,Lance Kendricks,TE,active,los-angeles-rams,5600000,2015
22865,1387459,3449836,Greg Robinson,LT,active,los-angeles-rams,4837295,2015
22866,3105000,1375000,William Hayes,DE,active,los-angeles-rams,4480000,2015
22867,2550000,1750000,Kenny Britt,WR,active,los-angeles-rams,4300000,2015
22868,3625000,900000,James Laurinaitis,ILB,active,los-angeles-rams,4525000,2015
22869,1022000,3020000,Nick Foles,QB,active,los-angeles-rams,4042000,2015
22870,1564182,1913364,Tavon Austin,WR,active,los-angeles-rams,3477546,2015
22871,1688454,1341273,Michael Brockers,DT,active,los-angeles-rams,3029727,2015
22872,1250000,1671875,Akeem Ayers,OLB,active,los-angeles-rams,2921875,2015
22873,435000,2078306,Todd Gurley,RB,active,los-angeles-rams,2513306,2015
22874,1900000,491686,Eugene Sims,DE,active,los-angeles-rams,2391686,2015
22875,1111111,1262662,Johnny Hekker,P,active,los-angeles-rams,2373773,2015
22876,2362704,0,Mark Barron,ILB,active,los-angeles-rams,2362704,2015
22877,2356000,0,Rodney McLeod,FS,active,los-angeles-rams,2356000,2015
22878,880750,1423000,Aaron Donald,DT,active,los-angeles-rams,2303750,2015
22879,1124536,589382,Brian Quick,WR,active,los-angeles-rams,1713918,2015
22880,1542000,167794,Trumaine Johnson,CB,active,los-angeles-rams,1709794,2015
22881,660000,927829,Janoris Jenkins,CB,active,los-angeles-rams,1587829,2015
22882,1542000,0,Cory Harkey,FB,active,los-angeles-rams,1542000,2015
22883,648645,494578,LaMarcus Joyner,FS,active,los-angeles-rams,1143223,2015
22884,750000,249999,Garrett Reynolds,G,active,los-angeles-rams,999999,2015
22885,750000,100000,Jake McQuaide,LS,active,los-angeles-rams,850000,2015
22886,691102,32205,Greg Zuerlein,K,active,los-angeles-rams,723307,2015
22887,435000,286822,Rob Havenstein,G,active,los-angeles-rams,721822,2015
22888,660000,50017,Tim Barnes,C,active,los-angeles-rams,710017,2015
22889,530035,159375,Tre Mason,RB,active,los-angeles-rams,689410,2015
22890,510000,116065,Maurice Alexander,SS,active,los-angeles-rams,626065,2015
22891,435000,156449,Sean Mannion,QB,active,los-angeles-rams,591449,2015
22892,585000,3334,Benny Cunningham,RB,active,los-angeles-rams,588334,2015
22893,585000,0,Daren Bates,ILB,active,los-angeles-rams,585000,2015
22894,585000,0,Cody Davis,FS,active,los-angeles-rams,585000,2015
22895,585000,0,Case Keenum,QB,active,los-angeles-rams,585000,2015
22896,585000,0,Chase Reynolds,RB,active,los-angeles-rams,585000,2015
22897,435000,124233,Andrew Donnal,RT,active,los-angeles-rams,559233,2015
22898,510000,6666,Ethan Westbrooks,DE,active,los-angeles-rams,516666,2015
22899,510000,5000,Marcus Roberson,CB,active,los-angeles-rams,515000,2015
22900,435000,22621,Cody Wichmann,G,active,los-angeles-rams,457621,2015
22901,435000,18035,Bryce Hager,ILB,active,los-angeles-rams,453035,2015
22902,435000,11474,Demetrius Rhaney,C,active,los-angeles-rams,446474,2015
22903,435000,2166,Bradley Marquez,WR,active,los-angeles-rams,437166,2015
22904,435000,666,Cameron Lynch,OLB,active,los-angeles-rams,435666,2015
22905,333000,26918,E.J. Gaines,CB,active,los-angeles-rams,359918,2015
22906,456470,0,Wes Welker,WR,active,los-angeles-rams,456470,2015
22907,255882,0,Christian Bryant,FS,active,los-angeles-rams,255882,2015
22908,240882,0,Brian Folkerts,C,active,los-angeles-rams,240882,2015
22909,240882,0,Eric Kush,G,active,los-angeles-rams,240882,2015
22910,230294,0,Matt Longacre,DE,active,los-angeles-rams,230294,2015
22911,179117,0,Isaiah Battle,LT,active,los-angeles-rams,179117,2015
22912,76764,0,Louis Trinca-Pasat,DT,active,los-angeles-rams,76764,2015
22913,34411,0,Nick Toon,WR,active,los-angeles-rams,34411,2015
22914,25588,0,Malcolm Brown,RB,active,los-angeles-rams,25588,2015
22915,25588,0,Troy Hill,CB,active,los-angeles-rams,25588,2015
22916,5555555,11188556,Robert Quinn,OLB,injured_reserve,los-angeles-rams,16744111,2015
22917,4250000,4000000,Rodger Saffold,G,injured_reserve,los-angeles-rams,8250000,2015
22918,2500000,2250000,Nick Fairley,DT,injured_reserve,los-angeles-rams,4750000,2015
22919,1044094,873188,Alec Ogletree,ILB,injured_reserve,los-angeles-rams,1917282,2015
22920,624426,162000,T.J. McDonald,FS,injured_reserve,los-angeles-rams,786426,2015
22921,386823,188704,Jamon Brown,RT,injured_reserve,los-angeles-rams,575527,2015
22922,386823,2500,Darrell Williams,T,injured_reserve,los-angeles-rams,389323,2015
22923,318000,333,Isiah Ferguson,WR,injured_reserve,los-angeles-rams,318333,2015
22924,102352,0,Eric Patterson,CB,injured_reserve,los-angeles-rams,102352,2015
22925,90000,0,Doug Worthington,DE,injured_reserve,los-angeles-rams,90000,2015
22926,459767,127972,Stedman Bailey,WR,non_fb_injury,los-angeles-rams,587739,2015
22927,0,3595000,Sam Bradford,QB,dead_cap,los-angeles-rams,3595000,2015
22928,0,2500000,Jake Long,LT,dead_cap,los-angeles-rams,2500000,2015
22929,0,1000000,Kendall Langford,DE,dead_cap,los-angeles-rams,1000000,2015
22930,0,1000000,Scott Wells,C,dead_cap,los-angeles-rams,1000000,2015
22931,362823,124257,Chris Givens,WR,dead_cap,los-angeles-rams,487080,2015
22932,103325,344200,Isaiah Pead,RB,dead_cap,los-angeles-rams,447525,2015
22933,246000,0,Justice Cunningham,TE,dead_cap,los-angeles-rams,246000,2015
22934,256991,0,JoLonn Dunbar,OLB,dead_cap,los-angeles-rams,256991,2015
22935,162600,0,Doug Worthington,DE,dead_cap,los-angeles-rams,162600,2015
22936,134118,0,Damian Williams,WR,dead_cap,los-angeles-rams,134118,2015
22937,96564,36750,Christian Bryant,FS,dead_cap,los-angeles-rams,133314,2015
22938,66000,57216,Isaiah Battle,LT,dead_cap,los-angeles-rams,123216,2015
22939,112200,1000,Zach Laskey,RB,dead_cap,los-angeles-rams,113200,2015
22940,0,111300,Barrett Jones,G,dead_cap,los-angeles-rams,111300,2015
22941,105600,2833,Malcolm Brown,RB,dead_cap,los-angeles-rams,108433,2015
22942,102400,5000,Louis Trinca-Pasat,DT,dead_cap,los-angeles-rams,107400,2015
22943,105600,0,Melvin White,CB,dead_cap,los-angeles-rams,105600,2015
22944,47611,47790,Brandon McGee,CB,dead_cap,los-angeles-rams,95401,2015
22945,0,88250,Zac Stacy,RB,dead_cap,los-angeles-rams,88250,2015
22946,85800,0,Nick Toon,WR,dead_cap,los-angeles-rams,85800,2015
22947,76764,0,Zach Hocker,K,dead_cap,los-angeles-rams,76764,2015
22948,66000,0,Zack Hodges,OLB,dead_cap,los-angeles-rams,66000,2015
22949,52800,1333,Matt Longacre,DE,dead_cap,los-angeles-rams,54133,2015
22950,52800,0,Eric Patterson,CB,dead_cap,los-angeles-rams,52800,2015
22951,46200,0,David Arkin,G,dead_cap,los-angeles-rams,46200,2015
22952,0,45450,Mitchell Van Dyk,LT,dead_cap,los-angeles-rams,45450,2015
22953,39600,0,Matthew Wells,LB,dead_cap,los-angeles-rams,39600,2015
22954,36600,2000,Trey Watts,RB,dead_cap,los-angeles-rams,38600,2015
22955,0,34422,Michael Sam,DE,dead_cap,los-angeles-rams,34422,2015
22956,0,29010,Garrett Gilbert,QB,dead_cap,los-angeles-rams,29010,2015
22957,0,28434,Bud Sasser,WR,dead_cap,los-angeles-rams,28434,2015
22958,19800,0,Gerald Rivers,DE,dead_cap,los-angeles-rams,19800,2015
22959,0,17774,Martin Ifedi,DE,dead_cap,los-angeles-rams,17774,2015
22960,13200,0,Deon Long,WR,dead_cap,los-angeles-rams,13200,2015
22961,0,11666,Austin Franklin,WR,dead_cap,los-angeles-rams,11666,2015
22962,6600,333,Jacob Hagen,FS,dead_cap,los-angeles-rams,6933,2015
22963,6600,0,Trovon Reed,CB,dead_cap,los-angeles-rams,6600,2015
22964,0,3334,Philip Steward,OLB,dead_cap,los-angeles-rams,3334,2015
22965,0,3333,Alex Bayer,TE,dead_cap,los-angeles-rams,3333,2015
22966,0,1666,Imoan Claiborne,CB,dead_cap,los-angeles-rams,1666,2015
22967,0,1334,Aaron Hill,OLB,dead_cap,los-angeles-rams,1334,2015
22968,0,1334,Abasi Salimu,RT,dead_cap,los-angeles-rams,1334,2015
22969,0,1333,Jay Hughes,SS,dead_cap,los-angeles-rams,1333,2015
22970,0,833,Terrance Franks,RB,dead_cap,los-angeles-rams,833,2015
22971,0,833,Montell Garner,CB,dead_cap,los-angeles-rams,833,2015
22972,0,667,Jarrid Bryant,CB,dead_cap,los-angeles-rams,667,2015
22973,0,667,Deantre Harlan,DT,dead_cap,los-angeles-rams,667,2015
22974,0,667,Kadeem Jones,FB,dead_cap,los-angeles-rams,667,2015
22975,0,667,Jemaine Sherman,WR,dead_cap,los-angeles-rams,667,2015
22976,0,333,Isiah Ferguson,WR,dead_cap,los-angeles-rams,333,2015
22977,0,333,Keshaun Malone,LB,dead_cap,los-angeles-rams,333,2015
22978,0,333,Tyler Slavin,WR,dead_cap,los-angeles-rams,333,2015
22979,13952000,0,Trumaine Johnson,CB,active,los-angeles-rams,13952000,2016
22980,1111111,6700137,Tavon Austin,WR,active,los-angeles-rams,7811248,2016
22981,3000000,4000000,William Hayes,DE,active,los-angeles-rams,7000000,2016
22982,6146000,750000,Michael Brockers,DT,active,los-angeles-rams,6896000,2016
22983,5000000,1000000,Mark Barron,ILB,active,los-angeles-rams,6000000,2016
22984,2354918,3449836,Greg Robinson,LT,active,los-angeles-rams,5804754,2016
22985,4500000,1156250,Rodger Saffold,G,active,los-angeles-rams,5656250,2016
22986,450000,4629577,Jared Goff,QB,active,los-angeles-rams,5079577,2016
22987,3600000,1250000,Kenny Britt,WR,active,los-angeles-rams,4850000,2016
22988,3250000,1250000,Lance Kendricks,TE,active,los-angeles-rams,4500000,2016
22989,3635000,0,Case Keenum,QB,active,los-angeles-rams,3635000,2016
22990,1063326,2078306,Todd Gurley,RB,active,los-angeles-rams,3141632,2016
22991,2250000,750000,Eugene Sims,DE,active,los-angeles-rams,3000000,2016
22992,1250000,1600000,Tim Barnes,C,active,los-angeles-rams,2850000,2016
22993,1341500,1423000,Aaron Donald,DT,active,los-angeles-rams,2764500,2016
22994,2222222,151551,Johnny Hekker,P,active,los-angeles-rams,2373773,2016
22995,1019322,1217507,Alec Ogletree,ILB,active,los-angeles-rams,2236829,2016
22996,1671000,162000,T.J. McDonald,FS,active,los-angeles-rams,1833000,2016
22997,1250000,453125,Brian Quick,WR,active,los-angeles-rams,1703125,2016
22998,877289,494578,LaMarcus Joyner,FS,active,los-angeles-rams,1371867,2016
22999,750000,555555,Cody Davis,FS,active,los-angeles-rams,1305555,2016
23000,850000,400000,Greg Zuerlein,K,active,los-angeles-rams,1250000,2016
23001,615455,286822,Rob Havenstein,G,active,los-angeles-rams,902277,2016
23002,775000,100000,Jake McQuaide,LS,active,los-angeles-rams,875000,2016
23003,775000,87500,Chase Reynolds,RB,active,los-angeles-rams,862500,2016
23004,575575,188704,Jamon Brown,RT,active,los-angeles-rams,764279,2016
23005,582285,156449,Sean Mannion,QB,active,los-angeles-rams,738734,2016
23006,600000,116065,Maurice Alexander,SS,active,los-angeles-rams,716065,2016
23007,525000,124233,Andrew Donnal,RT,active,los-angeles-rams,649233,2016
23008,600000,26918,E.J. Gaines,CB,active,los-angeles-rams,626918,2016
23009,600000,11474,Demetrius Rhaney,C,active,los-angeles-rams,611474,2016
23010,600000,6668,Ethan Westbrooks,DE,active,los-angeles-rams,606668,2016
23011,760000,0,Cam Thomas,DT,active,los-angeles-rams,760000,2016
23012,600000,0,Dominique Easley,DT,active,los-angeles-rams,600000,2016
23013,450000,145215,Tyler Higbee,TE,active,los-angeles-rams,595215,2016
23014,450000,138666,Pharoh Cooper,WR,active,los-angeles-rams,588666,2016
23015,525000,22621,Cody Wichmann,G,active,los-angeles-rams,547621,2016
23016,525000,18035,Bryce Hager,ILB,active,los-angeles-rams,543035,2016
23017,525000,0,Matt Longacre,DE,active,los-angeles-rams,525000,2016
23018,450000,39896,Temarrick Hemingway,TE,active,los-angeles-rams,489896,2016
23019,450000,29017,Mike Thomas,WR,active,los-angeles-rams,479017,2016
23020,450000,5000,Cory Littleton,ILB,active,los-angeles-rams,455000,2016
23021,450000,666,Pace Murphy,T,active,los-angeles-rams,450666,2016
23022,450000,0,Malcolm Brown,RB,active,los-angeles-rams,450000,2016
23023,185290,0,Blake Countess,S,active,los-angeles-rams,185290,2016
23024,158820,0,Nicholas Grigsby,ILB,active,los-angeles-rams,158820,2016
23025,158820,0,Mike Jordan,CB,active,los-angeles-rams,158820,2016
23026,119117,0,David Arkin,G,active,los-angeles-rams,119117,2016
23027,92646,0,Troy Hill,CB,active,los-angeles-rams,92646,2016
23028,79410,0,Morgan Fox,OLB,active,los-angeles-rams,79410,2016
23029,52940,0,Aaron Green,T,active,los-angeles-rams,52940,2016
23030,52940,0,Isaiah Johnson,FS,active,los-angeles-rams,52940,2016
23031,52940,0,Paul McRoberts,WR,active,los-angeles-rams,52940,2016
23032,7777777,3379597,Robert Quinn,OLB,injured_reserve,los-angeles-rams,11157374,2016
23033,1500000,500000,Cory Harkey,FB,injured_reserve,los-angeles-rams,2000000,2016
23034,1671000,0,Benny Cunningham,RB,injured_reserve,los-angeles-rams,1671000,2016
23035,525000,2166,Bradley Marquez,WR,injured_reserve,los-angeles-rams,527166,2016
23036,450000,33580,Josh Forrest,ILB,injured_reserve,los-angeles-rams,483580,2016
23037,450000,0,Nelson Spruce,WR,injured_reserve,los-angeles-rams,450000,2016
23038,370580,0,Marqui Christian,S,injured_reserve,los-angeles-rams,370580,2016
23039,348000,2500,Darrell Williams,T,injured_reserve,los-angeles-rams,350500,2016
23040,348000,0,Louis Trinca-Pasat,DT,injured_reserve,los-angeles-rams,348000,2016
23041,333000,2500,Brian Randolph,S,injured_reserve,los-angeles-rams,335500,2016
23042,333000,0,Zach Laskey,RB,injured_reserve,los-angeles-rams,333000,2016
23043,333000,0,Marquez North,WR,injured_reserve,los-angeles-rams,333000,2016
23044,0,127972,Stedman Bailey,WR,non_fb_injury,los-angeles-rams,127972,2016
23045,0,7000000,Nick Foles,QB,dead_cap,los-angeles-rams,7000000,2016
23046,1000000,3500000,Coty Sensabaugh,CB,dead_cap,los-angeles-rams,4500000,2016
23047,0,2600882,Jared Cook,TE,dead_cap,los-angeles-rams,2600882,2016
23048,0,2500000,Chris Long,DE,dead_cap,los-angeles-rams,2500000,2016
23049,0,1400000,James Laurinaitis,ILB,dead_cap,los-angeles-rams,1400000,2016
23050,763224,0,Dwayne Gratz,CB,dead_cap,los-angeles-rams,763224,2016
23051,0,500000,Akeem Ayers,OLB,dead_cap,los-angeles-rams,500000,2016
23052,360402,0,Troy Hill,CB,dead_cap,los-angeles-rams,360402,2016
23053,117300,124125,Isaiah Battle,LT,dead_cap,los-angeles-rams,241425,2016
23054,238234,0,Steve Williams,CB,dead_cap,los-angeles-rams,238234,2016
23055,178781,0,Bryce Williams,TE,dead_cap,los-angeles-rams,178781,2016
23056,175000,0,Blake Countess,S,dead_cap,los-angeles-rams,175000,2016
23057,0,150021,Garrett Reynolds,G,dead_cap,los-angeles-rams,150021,2016
23058,127482,0,Isaiah Johnson,FS,dead_cap,los-angeles-rams,127482,2016
23059,116170,0,Morgan Fox,OLB,dead_cap,los-angeles-rams,116170,2016
23060,0,111300,Barrett Jones,G,dead_cap,los-angeles-rams,111300,2016
23061,103500,3333,Paul McRoberts,WR,dead_cap,los-angeles-rams,106833,2016
23062,103500,0,Aaron Green,T,dead_cap,los-angeles-rams,103500,2016
23063,96600,0,David Arkin,G,dead_cap,los-angeles-rams,96600,2016
23064,0,85303,Bud Sasser,WR,dead_cap,los-angeles-rams,85303,2016
23065,75900,0,Nicholas Grigsby,ILB,dead_cap,los-angeles-rams,75900,2016
23066,75900,0,Mike Jordan,CB,dead_cap,los-angeles-rams,75900,2016
23067,0,53322,Martin Ifedi,DE,dead_cap,los-angeles-rams,53322,2016
23068,48300,0,Lenny Jones,DE,dead_cap,los-angeles-rams,48300,2016
23069,48300,0,Brandon Chubb,ILB,dead_cap,los-angeles-rams,48300,2016
23070,0,47790,Brandon McGee,CB,dead_cap,los-angeles-rams,47790,2016
23071,27600,0,Randell Johnson,OLB,dead_cap,los-angeles-rams,27600,2016
23072,13800,0,Jerome Couplin,FS,dead_cap,los-angeles-rams,13800,2016
23073,13800,0,Cassanova Mckinzy,DE,dead_cap,los-angeles-rams,13800,2016
23074,13800,0,Reggie Northrup,OLB,dead_cap,los-angeles-rams,13800,2016
23075,13800,0,Kevin Short,CB,dead_cap,los-angeles-rams,13800,2016
23076,13800,0,Brandon Wegher,RB,dead_cap,los-angeles-rams,13800,2016
23077,0,10000,Louis Trinca-Pasat,DT,dead_cap,los-angeles-rams,10000,2016
23078,6900,0,Terrence Magee,RT,dead_cap,los-angeles-rams,6900,2016
23079,6900,0,Kevin Peterson,CB,dead_cap,los-angeles-rams,6900,2016
23080,6900,0,Brandon Shippen,S,dead_cap,los-angeles-rams,6900,2016
23081,0,5667,Malcolm Brown,RB,dead_cap,los-angeles-rams,5667,2016
23082,0,5000,Marcus Roberson,CB,dead_cap,los-angeles-rams,5000,2016
23083,0,3334,Alex Bayer,TE,dead_cap,los-angeles-rams,3334,2016
23084,0,3334,Imoan Claiborne,CB,dead_cap,los-angeles-rams,3334,2016
23085,0,2667,Jay Hughes,SS,dead_cap,los-angeles-rams,2667,2016
23086,0,2667,Matt Longacre,DE,dead_cap,los-angeles-rams,2667,2016
23087,0,2000,Zach Laskey,RB,dead_cap,los-angeles-rams,2000,2016
23088,0,2000,Trey Watts,RB,dead_cap,los-angeles-rams,2000,2016
23089,0,1667,Terrance Franks,RB,dead_cap,los-angeles-rams,1667,2016
23090,0,1667,Montell Garner,CB,dead_cap,los-angeles-rams,1667,2016
23091,0,667,Isiah Ferguson,WR,dead_cap,los-angeles-rams,667,2016
23092,0,667,Jacob Hagen,FS,dead_cap,los-angeles-rams,667,2016
23093,0,667,Keshaun Malone,LB,dead_cap,los-angeles-rams,667,2016
23094,0,667,Tyler Slavin,WR,dead_cap,los-angeles-rams,667,2016
23095,0,666,Cameron Lynch,OLB,dead_cap,los-angeles-rams,666,2016
23096,16742400,0,Trumaine Johnson,CB,active,los-angeles-rams,16742400,2017
23097,3500000,11477116,Tavon Austin,WR,active,los-angeles-rams,14977116,2017
23098,5000000,6000000,Mark Barron,ILB,active,los-angeles-rams,11000000,2017
23099,1250000,9750000,Michael Brockers,DT,active,los-angeles-rams,11000000,2017
23100,6161616,4588718,Robert Quinn,OLB,active,los-angeles-rams,10750334,2017
23101,7500000,1666666,Andrew Whitworth,LT,active,los-angeles-rams,9166666,2017
23102,3000000,4000000,Robert Woods,WR,active,los-angeles-rams,7000000,2017
23103,1719894,4629577,Jared Goff,QB,active,los-angeles-rams,6349471,2017
23104,4847233,1468750,Rodger Saffold,G,active,los-angeles-rams,6315983,2017
23105,3369000,2350000,Alec Ogletree,ILB,active,los-angeles-rams,5719000,2017
23106,2750000,1203125,Kayvon Webster,CB,active,los-angeles-rams,3953125,2017
23107,1691653,2078306,Todd Gurley,RB,active,los-angeles-rams,3769959,2017
23108,2000000,1500000,Connor Barwin,OLB,active,los-angeles-rams,3500000,2017
23109,1802250,1423000,Aaron Donald,DT,active,los-angeles-rams,3225250,2017
23110,1111111,650000,Cody Davis,FS,active,los-angeles-rams,1761111,2017
23111,1105934,494578,LaMarcus Joyner,FS,active,los-angeles-rams,1600512,2017
23112,1000000,476556,Lance Dunbar,RB,active,los-angeles-rams,1476556,2017
23113,775000,646551,Johnny Hekker,P,active,los-angeles-rams,1421551,2017
23114,750000,500000,Ethan Westbrooks,DE,active,los-angeles-rams,1250000,2017
23115,465000,633994,Gerald Everett,TE,active,los-angeles-rams,1098994,2017
23116,795911,286822,Rob Havenstein,G,active,los-angeles-rams,1082733,2017
23117,950000,50000,Derek Carrier,TE,active,los-angeles-rams,1000000,2017
23118,900000,99999,John Sullivan,C,active,los-angeles-rams,999999,2017
23119,730037,156449,Sean Mannion,QB,active,los-angeles-rams,886486,2017
23120,686686,188704,Jamon Brown,RT,active,los-angeles-rams,875390,2017
23121,775000,100000,Jake McQuaide,LS,active,los-angeles-rams,875000,2017
23122,465000,238690,Cooper Kupp,WR,active,los-angeles-rams,703690,2017
23123,775000,80000,Nickell Robey-Coleman,CB,active,los-angeles-rams,855000,2017
23124,690000,0,Sammy Watkins,WR,active,los-angeles-rams,690000,2017
23125,540000,145215,Tyler Higbee,TE,active,los-angeles-rams,685215,2017
23126,540000,138666,Pharoh Cooper,WR,active,los-angeles-rams,678666,2017
23127,465000,189438,John Johnson,SS,active,los-angeles-rams,654438,2017
23128,649412,0,Cornelius Lucas,RT,active,los-angeles-rams,649412,2017
23129,615000,18035,Bryce Hager,ILB,active,los-angeles-rams,633035,2017
23130,465000,162005,Josh Reynolds,WR,active,los-angeles-rams,627005,2017
23131,465000,153270,Samson Ebukam,OLB,active,los-angeles-rams,618270,2017
23132,615000,2500,Darrell Williams,T,active,los-angeles-rams,617500,2017
23133,775000,0,Tyrunn Walker,DT,active,los-angeles-rams,775000,2017
23134,540000,5000,Cory Littleton,ILB,active,los-angeles-rams,545000,2017
23135,542647,0,Troy Hill,CB,active,los-angeles-rams,542647,2017
23136,540000,0,Austin Blythe,C,active,los-angeles-rams,540000,2017
23137,540000,0,Malcolm Brown,RB,active,los-angeles-rams,540000,2017
23138,540000,0,Blake Countess,S,active,los-angeles-rams,540000,2017
23139,540000,0,Morgan Fox,OLB,active,los-angeles-rams,540000,2017
23140,465000,41195,Tanzel Smart,DT,active,los-angeles-rams,506195,2017
23141,465000,5000,Justin Davis,RB,active,los-angeles-rams,470000,2017
23142,412941,29017,Mike Thomas,WR,active,los-angeles-rams,441958,2017
23143,164118,0,Kevin Peterson,CB,active,los-angeles-rams,164118,2017
23144,158825,0,Carlos Thompson,OLB,active,los-angeles-rams,158825,2017
23145,144706,0,Cameron Lynch,OLB,active,los-angeles-rams,144706,2017
23146,108529,0,Isaiah Johnson,FS,active,los-angeles-rams,108529,2017
23147,54706,0,Sam Ficken,K,active,los-angeles-rams,54706,2017
23148,27353,0,Aaron Neary,T,active,los-angeles-rams,27353,2017
23149,27353,0,Garrett Sickels,OLB,active,los-angeles-rams,27353,2017
23150,1797000,0,Dominique Easley,DT,injured_reserve,los-angeles-rams,1797000,2017
23151,1375000,250000,Greg Zuerlein,K,injured_reserve,los-angeles-rams,1625000,2017
23152,615000,0,Matt Longacre,DE,injured_reserve,los-angeles-rams,615000,2017
23153,540000,0,Brandon Allen,QB,injured_reserve,los-angeles-rams,540000,2017
23154,540000,0,Marqui Christian,S,injured_reserve,los-angeles-rams,540000,2017
23155,363000,39896,Temarrick Hemingway,TE,injured_reserve,los-angeles-rams,402896,2017
23156,348000,833,Lenard Tillery,RB,injured_reserve,los-angeles-rams,348833,2017
23157,0,3449836,Greg Robinson,LT,dead_cap,los-angeles-rams,3449836,2017
23158,0,1000000,Nick Foles,QB,dead_cap,los-angeles-rams,1000000,2017
23159,0,1000000,Coty Sensabaugh,CB,dead_cap,los-angeles-rams,1000000,2017
23160,528529,116065,Maurice Alexander,SS,dead_cap,los-angeles-rams,644594,2017
23161,0,500000,Cory Harkey,FB,dead_cap,los-angeles-rams,500000,2017
23162,325584,124233,Andrew Donnal,RT,dead_cap,los-angeles-rams,449817,2017
23163,357036,20700,Ejuan Price,OLB,dead_cap,los-angeles-rams,377736,2017
23164,377189,0,Dominique Hatfield,CB,dead_cap,los-angeles-rams,377189,2017
23165,325584,2168,Bradley Marquez,WR,dead_cap,los-angeles-rams,327752,2017
23166,162706,0,Johnny Mundt,TE,dead_cap,los-angeles-rams,162706,2017
23167,0,159375,Tre Mason,RB,dead_cap,los-angeles-rams,159375,2017
23168,122400,35708,Sam Rogers,FB,dead_cap,los-angeles-rams,158108,2017
23169,148306,0,Aaron Neary,T,dead_cap,los-angeles-rams,148306,2017
23170,129776,0,Isaiah Johnson,FS,dead_cap,los-angeles-rams,129776,2017
23171,122400,0,Omarius Bryant,DT,dead_cap,los-angeles-rams,122400,2017
23172,115200,6667,Paul McRoberts,WR,dead_cap,los-angeles-rams,121867,2017
23173,100800,0,Fred Brown,WR,dead_cap,los-angeles-rams,100800,2017
23174,92153,0,Kevin Peterson,CB,dead_cap,los-angeles-rams,92153,2017
23175,86400,0,Carlos Thompson,OLB,dead_cap,los-angeles-rams,86400,2017
23176,0,80000,Dan Orlovsky,QB,dead_cap,los-angeles-rams,80000,2017
23177,0,80000,Tyrunn Walker,DT,dead_cap,los-angeles-rams,80000,2017
23178,79200,0,Garrett Sickels,OLB,dead_cap,los-angeles-rams,79200,2017
23179,57600,0,Jake Eldrenkamp,G,dead_cap,los-angeles-rams,57600,2017
23180,40588,0,Kasim Edebali,OLB,dead_cap,los-angeles-rams,40588,2017
23181,36000,0,Marcus Sayles,CB,dead_cap,los-angeles-rams,36000,2017
23182,0,33580,Josh Forrest,ILB,dead_cap,los-angeles-rams,33580,2017
23183,27353,0,J.J. Dielman,C,dead_cap,los-angeles-rams,27353,2017
23184,0,26918,E.J. Gaines,CB,dead_cap,los-angeles-rams,26918,2017
23185,0,22622,Cody Wichmann,G,dead_cap,los-angeles-rams,22622,2017
23186,21600,0,Travis Wilson,WR,dead_cap,los-angeles-rams,21600,2017
23187,14400,0,Quinton Jefferson,DE,dead_cap,los-angeles-rams,14400,2017
23188,14400,0,Cassanova Mckinzy,DE,dead_cap,los-angeles-rams,14400,2017
23189,14400,0,Jeremiah Poutasi,RT,dead_cap,los-angeles-rams,14400,2017
23190,0,11474,Demetrius Rhaney,C,dead_cap,los-angeles-rams,11474,2017
23191,7200,0,Michael Dunn,T,dead_cap,los-angeles-rams,7200,2017
23192,7200,0,Henry Krieger-Coble,TE,dead_cap,los-angeles-rams,7200,2017
23193,7200,0,Taurean Nixon,CB,dead_cap,los-angeles-rams,7200,2017
23194,7200,0,Louis Trinca-Pasat,DT,dead_cap,los-angeles-rams,7200,2017
23195,0,2500,Brian Randolph,S,dead_cap,los-angeles-rams,2500,2017
23196,0,668,Cameron Lynch,OLB,dead_cap,los-angeles-rams,668,2017
23197,0,666,Pace Murphy,T,dead_cap,los-angeles-rams,666,2017
23198,14000000,500000,Ndamukong Suh,DT,active,los-angeles-rams,14500000,2018
23199,11287000,0,LaMarcus Joyner,FS,active,los-angeles-rams,11287000,2018
23200,11000000,0,Aqib Talib,CB,active,los-angeles-rams,11000000,2018
23201,5250000,5750000,Michael Brockers,DE,active,los-angeles-rams,11000000,2018
23202,4500000,5166666,Mark Barron,ILB,active,los-angeles-rams,9666666,2018
23203,1015000,8159166,Andrew Whitworth,LT,active,los-angeles-rams,9174166,2018
23204,892000,8000000,Aaron Donald,DT,active,los-angeles-rams,8892000,2018
23205,999999,7125000,John Sullivan,C,active,los-angeles-rams,8124999,2018
23206,5375000,2575000,Rodger Saffold,G,active,los-angeles-rams,7950000,2018
23207,2989788,4629577,Jared Goff,QB,active,los-angeles-rams,7619365,2018
23208,950000,6278306,Todd Gurley,RB,active,los-angeles-rams,7228306,2018
23209,790000,4677523,Robert Woods,WR,active,los-angeles-rams,5467523,2018
23210,4000000,1400000,Brandin Cooks,WR,active,los-angeles-rams,5400000,2018
23211,2125000,3125000,Nickell Robey-Coleman,CB,active,los-angeles-rams,5250000,2018
23212,2050000,1500000,Greg Zuerlein,K,active,los-angeles-rams,3550000,2018
23213,790000,1888551,Johnny Hekker,P,active,los-angeles-rams,2678551,2018
23214,1250000,975000,Ethan Westbrooks,DT,active,los-angeles-rams,2225000,2018
23215,976367,1086822,Rob Havenstein,RT,active,los-angeles-rams,2063189,2018
23216,1926114,0,Dante Fowler Jr.,DE,active,los-angeles-rams,1926114,2018
23217,1741931,0,Marcus Peters,CB,active,los-angeles-rams,1741931,2018
23218,800000,898438,Matt Longacre,OLB,active,los-angeles-rams,1698438,2018
23219,739749,633994,Gerald Everett,TE,active,los-angeles-rams,1373743,2018
23220,915000,435000,Jake McQuaide,LS,active,los-angeles-rams,1350000,2018
23221,877778,156450,Sean Mannion,QB,active,los-angeles-rams,1034228,2018
23222,915000,89999,Sam Shields,CB,active,los-angeles-rams,1004999,2018
23223,630000,145215,Tyler Higbee,TE,active,los-angeles-rams,775215,2018
23224,584000,189438,John Johnson,SS,active,los-angeles-rams,773438,2018
23225,705000,45000,Ramik Wilson,ILB,active,los-angeles-rams,750000,2018
23226,705000,18036,Bryce Hager,ILB,active,los-angeles-rams,723036,2018
23227,555000,162005,Josh Reynolds,WR,active,los-angeles-rams,717005,2018
23228,555000,153270,Samson Ebukam,OLB,active,los-angeles-rams,708270,2018
23229,705000,0,Troy Hill,CB,active,los-angeles-rams,705000,2018
23230,480000,204723,Joseph Noteboom,T,active,los-angeles-rams,684723,2018
23231,480000,171734,Brian Allen,C,active,los-angeles-rams,651734,2018
23232,630000,5000,Cory Littleton,ILB,active,los-angeles-rams,635000,2018
23233,630000,0,Austin Blythe,G,active,los-angeles-rams,630000,2018
23234,630000,0,Marqui Christian,S,active,los-angeles-rams,630000,2018
23235,630000,0,Blake Countess,S,active,los-angeles-rams,630000,2018
23236,555000,41195,Tanzel Smart,DT,active,los-angeles-rams,596195,2018
23237,480000,113089,John Franklin-Myers,DE,active,los-angeles-rams,593089,2018
23238,555000,5000,Justin Davis,RB,active,los-angeles-rams,560000,2018
23239,480000,74494,Micah Kiser,ILB,active,los-angeles-rams,554494,2018
23240,480000,47072,John Kelly,RB,active,los-angeles-rams,527072,2018
23241,522353,0,Jojo Natson,WR,active,los-angeles-rams,522353,2018
23242,480000,38809,Sebastian Joseph,DT,active,los-angeles-rams,518809,2018
23243,438702,68634,Ogbonnia Okoronkwo,DE,active,los-angeles-rams,507336,2018
23244,480000,18435,Justin Lawler,DE,active,los-angeles-rams,498435,2018
23245,480000,0,Johnny Mundt,TE,active,los-angeles-rams,480000,2018
23246,423529,0,Khadarel Hodge,WR,active,los-angeles-rams,423529,2018
23247,338820,0,Darious Williams,S,active,los-angeles-rams,338820,2018
23248,92941,0,C.J. Anderson,RB,active,los-angeles-rams,92941,2018
23249,84705,6866,Trevon Young,DE,active,los-angeles-rams,91571,2018
23250,84705,0,Jamil Demby,G,active,los-angeles-rams,84705,2018
23251,640000,238690,Cooper Kupp,WR,injured_reserve,los-angeles-rams,878690,2018
23252,479353,237500,Dominique Easley,DT,injured_reserve,los-angeles-rams,716853,2018
23253,630000,29017,Mike Thomas,WR,injured_reserve,los-angeles-rams,659017,2018
23254,630000,0,Malcolm Brown,RB,injured_reserve,los-angeles-rams,630000,2018
23255,426173,0,Dominique Hatfield,CB,injured_reserve,los-angeles-rams,426173,2018
23256,393000,0,Morgan Fox,OLB,injured_reserve,los-angeles-rams,393000,2018
23257,378000,0,Kevin Peterson,CB,injured_reserve,los-angeles-rams,378000,2018
23258,363000,0,Garrett Sickels,OLB,injured_reserve,los-angeles-rams,363000,2018
23259,0,6400000,Alec Ogletree,ILB,dead_cap,los-angeles-rams,6400000,2018
23260,0,4000000,Tavon Austin,WR,dead_cap,los-angeles-rams,4000000,2018
23261,0,955354,Robert Quinn,OLB,dead_cap,los-angeles-rams,955354,2018
23262,673059,188704,Jamon Brown,RT,dead_cap,los-angeles-rams,861763,2018
23263,555885,138666,Pharoh Cooper,WR,dead_cap,los-angeles-rams,694551,2018
23264,0,500000,Kayvon Webster,CB,dead_cap,los-angeles-rams,500000,2018
23265,292115,34237,Trevon Young,DE,dead_cap,los-angeles-rams,326352,2018
23266,277588,0,Kendal Thompson,WR,dead_cap,los-angeles-rams,277588,2018
23267,189000,75000,Darrell Williams,T,dead_cap,los-angeles-rams,264000,2018
23268,259412,0,Nick Williams,WR,dead_cap,los-angeles-rams,259412,2018
23269,188118,0,Brandon Allen,QB,dead_cap,los-angeles-rams,188118,2018
23270,165883,0,Isaiah Johnson,FS,dead_cap,los-angeles-rams,165883,2018
23271,151030,0,Cairo Santos,K,dead_cap,los-angeles-rams,151030,2018
23272,129200,1666,Steven Parker,S,dead_cap,los-angeles-rams,130866,2018
23273,129200,0,Henry Krieger-Coble,TE,dead_cap,los-angeles-rams,129200,2018
23274,129200,0,Ramon Richards,SS,dead_cap,los-angeles-rams,129200,2018
23275,0,124233,Andrew Donnal,RT,dead_cap,los-angeles-rams,124233,2018
23276,114000,0,Aaron Neary,C,dead_cap,los-angeles-rams,114000,2018
23277,0,107124,Sam Rogers,FB,dead_cap,los-angeles-rams,107124,2018
23278,83600,22667,Travin Howard,OLB,dead_cap,los-angeles-rams,106267,2018
23279,92472,0,Carlos Thompson,OLB,dead_cap,los-angeles-rams,92472,2018
23280,0,90000,Cornelius Lucas,RT,dead_cap,los-angeles-rams,90000,2018
23281,76000,0,Austin Proehl,WR,dead_cap,los-angeles-rams,76000,2018
23282,0,67160,Josh Forrest,ILB,dead_cap,los-angeles-rams,67160,2018
23283,0,62102,Ejuan Price,OLB,dead_cap,los-angeles-rams,62102,2018
23284,60800,0,J.J. Dielman,C,dead_cap,los-angeles-rams,60800,2018
23285,56470,0,Sam Ficken,K,dead_cap,los-angeles-rams,56470,2018
23286,15200,39896,Temarrick Hemingway,TE,dead_cap,los-angeles-rams,55096,2018
23287,53200,0,Steven Mitchell,WR,dead_cap,los-angeles-rams,53200,2018
23288,0,45247,Cody Wichmann,G,dead_cap,los-angeles-rams,45247,2018
23289,0,39155,Jamil Demby,G,dead_cap,los-angeles-rams,39155,2018
23290,38000,0,Evan Boehm,G,dead_cap,los-angeles-rams,38000,2018
23291,38000,0,Ja'Von Rolland-Jones,DE,dead_cap,los-angeles-rams,38000,2018
23292,30400,0,Rick Leonard,T,dead_cap,los-angeles-rams,30400,2018
23293,22800,0,Donte Deayon,S,dead_cap,los-angeles-rams,22800,2018
23294,22800,0,Dominique Hatfield,CB,dead_cap,los-angeles-rams,22800,2018
23295,15200,0,Khadarel Hodge,WR,dead_cap,los-angeles-rams,15200,2018
23296,15200,0,Marcus Martin,DE,dead_cap,los-angeles-rams,15200,2018
23297,15200,0,Luis Perez,QB,dead_cap,los-angeles-rams,15200,2018
23298,15200,0,Linden Stephens,S,dead_cap,los-angeles-rams,15200,2018
23299,7600,0,Jeremiah Kolone,G,dead_cap,los-angeles-rams,7600,2018
23300,7600,0,Kyle Murphy,T,dead_cap,los-angeles-rams,7600,2018
23301,0,6666,Codey McElroy,WR,dead_cap,los-angeles-rams,6666,2018
23302,0,2500,Brian Randolph,S,dead_cap,los-angeles-rams,2500,2018
23303,0,1667,Lenard Tillery,RB,dead_cap,los-angeles-rams,1667,2018
23304,0,1666,Afolabi Laguda,S,dead_cap,los-angeles-rams,1666,2018
23305,0,1666,Chucky Williams,S,dead_cap,los-angeles-rams,1666,2018
23306,0,668,Pace Murphy,T,dead_cap,los-angeles-rams,668,2018
23307,9108000,8000000,Aaron Donald,DT,active,los-angeles-rams,17108000,2019
23308,10250000,6409168,Andrew Whitworth,LT,active,los-angeles-rams,16659168,2019
23309,1000000,17659000,Brandin Cooks,WR,active,los-angeles-rams,18659000,2019
23310,9000000,3000000,Dante Fowler Jr.,OLB,active,los-angeles-rams,12000000,2019
23311,7777777,2972223,Michael Brockers,DE,active,los-angeles-rams,10750000,2019
23312,1000000,9629577,Jared Goff,QB,active,los-angeles-rams,10629577,2019
23313,5000000,4200000,Todd Gurley,RB,active,los-angeles-rams,9200000,2019
23314,2500000,5800000,Rob Havenstein,RT,active,los-angeles-rams,8300000,2019
23315,6000000,2177504,Robert Woods,WR,active,los-angeles-rams,8177504,2019
23316,3300000,2750000,Nickell Robey-Coleman,CB,active,los-angeles-rams,6050000,2019
23317,4250524,1501001,Eric Weddle,FS,active,los-angeles-rams,5751525,2019
23318,3000000,500000,Clay Matthews,OLB,active,los-angeles-rams,3500000,2019
23319,3095000,0,Cory Littleton,ILB,active,los-angeles-rams,3095000,2019
23320,2325000,250000,Greg Zuerlein,K,active,los-angeles-rams,2575000,2019
23321,2351559,0,Jalen Ramsey,CB,active,los-angeles-rams,2351559,2019
23322,1000000,1187000,Johnny Hekker,P,active,los-angeles-rams,2187000,2019
23323,1000000,1137500,Malcolm Brown,RB,active,los-angeles-rams,2137500,2019
23324,2025000,0,Austin Blythe,G,active,los-angeles-rams,2025000,2019
23325,1000000,745215,Tyler Higbee,TE,active,los-angeles-rams,1745215,2019
23326,1025000,719275,Troy Hill,CB,active,los-angeles-rams,1744275,2019
23327,1014497,633994,Gerald Everett,TE,active,los-angeles-rams,1648491,2019
23328,930000,320000,Jake McQuaide,LS,active,los-angeles-rams,1250000,2019
23329,811000,238690,Cooper Kupp,WR,active,los-angeles-rams,1049690,2019
23330,1000000,0,Blake Bortles,QB,active,los-angeles-rams,1000000,2019
23331,495000,354762,Taylor Rapp,S,active,los-angeles-rams,849762,2019
23332,645000,162005,Josh Reynolds,WR,active,los-angeles-rams,807005,2019
23333,645000,153270,Samson Ebukam,OLB,active,los-angeles-rams,798270,2019
23334,495000,272664,Darrell Henderson,RB,active,los-angeles-rams,767664,2019
23335,720000,29019,Mike Thomas,WR,active,los-angeles-rams,749019,2019
23336,495000,243265,David Long,CB,active,los-angeles-rams,738265,2019
23337,720000,0,Marqui Christian,S,active,los-angeles-rams,720000,2019
23338,495000,205545,Bobby Evans,T,active,los-angeles-rams,700545,2019
23339,645000,41195,Tanzel Smart,DT,active,los-angeles-rams,686195,2019
23340,495000,156653,Greg Gaines,DT,active,los-angeles-rams,651653,2019
23341,645000,0,Morgan Fox,DE,active,los-angeles-rams,645000,2019
23342,570000,68634,Ogbonnia Okoronkwo,OLB,active,los-angeles-rams,638634,2019
23343,570000,38809,Sebastian Joseph,DT,active,los-angeles-rams,608809,2019
23344,570000,0,Jamil Demby,G,active,los-angeles-rams,570000,2019
23345,570000,0,Johnny Mundt,TE,active,los-angeles-rams,570000,2019
23346,570000,0,Darious Williams,CB,active,los-angeles-rams,570000,2019
23347,495000,66130,David Edwards,T,active,los-angeles-rams,561130,2019
23348,531717,0,Austin Corbett,C,active,los-angeles-rams,531717,2019
23349,495000,19332,Nick Scott,S,active,los-angeles-rams,514332,2019
23350,495000,4000,Troy Reeder,LB,active,los-angeles-rams,499000,2019
23351,495000,1666,Natrez Patrick,LB,active,los-angeles-rams,496666,2019
23352,495000,0,Travin Howard,OLB,active,los-angeles-rams,495000,2019
23353,495000,0,Coleman Shelton,C,active,los-angeles-rams,495000,2019
23354,368824,0,Kenny Young,ILB,active,los-angeles-rams,368824,2019
23355,320294,0,Jake Gervase,S,active,los-angeles-rams,320294,2019
23356,265587,0,Donte Deayon,S,active,los-angeles-rams,265587,2019
23357,203824,0,Chandler Brewer,G,active,los-angeles-rams,203824,2019
23358,203824,0,Nsimba Webster,WR,active,los-angeles-rams,203824,2019
23359,116471,0,Kendall Blanton,TE,active,los-angeles-rams,116471,2019
23360,677000,189438,John Johnson,SS,injured_reserve,los-angeles-rams,866438,2019
23361,626626,204723,Joseph Noteboom,G,injured_reserve,los-angeles-rams,831349,2019
23362,570000,171734,Brian Allen,C,injured_reserve,los-angeles-rams,741734,2019
23363,645000,0,Jojo Natson,WR,injured_reserve,los-angeles-rams,645000,2019
23364,805000,0,Bryce Hager,ILB,injured_reserve,los-angeles-rams,805000,2019
23365,393000,74494,Micah Kiser,ILB,injured_reserve,los-angeles-rams,467494,2019
23366,393000,18435,Justin Lawler,DE,injured_reserve,los-angeles-rams,411435,2019
23367,393000,0,Josh Carraway,OLB,injured_reserve,los-angeles-rams,393000,2019
23368,136000,0,Landis Durham,LB,practice_squad,los-angeles-rams,136000,2019
23369,48000,0,John Kelly,RB,practice_squad,los-angeles-rams,48000,2019
23370,3764706,0,Aqib Talib,CB,dead_cap,los-angeles-rams,3764706,2019
23371,0,3333334,Mark Barron,ILB,dead_cap,los-angeles-rams,3333334,2019
23372,3200824,0,Marcus Peters,CB,dead_cap,los-angeles-rams,3200824,2019
23373,0,1000000,John Sullivan,C,dead_cap,los-angeles-rams,1000000,2019
23374,241176,47073,John Kelly,RB,dead_cap,los-angeles-rams,288249,2019
23375,208039,0,Nsimba Webster,WR,dead_cap,los-angeles-rams,208039,2019
23376,0,138666,Pharoh Cooper,WR,dead_cap,los-angeles-rams,138666,2019
23377,136000,0,Marquise Copeland,DT,dead_cap,los-angeles-rams,136000,2019
23378,136000,0,Jeremiah Kolone,G,dead_cap,los-angeles-rams,136000,2019
23379,136000,0,John Wolford,QB,dead_cap,los-angeles-rams,136000,2019
23380,23118,109377,Trevon Young,DE,dead_cap,los-angeles-rams,132495,2019
23381,0,117466,Jamil Demby,G,dead_cap,los-angeles-rams,117466,2019
23382,0,113090,John Franklin-Myers,DE,dead_cap,los-angeles-rams,113090,2019
23383,112000,0,Jachai Polite,OLB,dead_cap,los-angeles-rams,112000,2019
23384,104000,0,Kendall Blanton,TE,dead_cap,los-angeles-rams,104000,2019
23385,64000,18644,Dakota Allen,LB,dead_cap,los-angeles-rams,82644,2019
23386,80000,0,Chandler Brewer,G,dead_cap,los-angeles-rams,80000,2019
23387,80000,0,Donte Deayon,S,dead_cap,los-angeles-rams,80000,2019
23388,0,68002,Travin Howard,OLB,dead_cap,los-angeles-rams,68002,2019
23389,56000,0,Adonis Alexander,CB,dead_cap,los-angeles-rams,56000,2019
23390,56000,0,Nate Trewyn,C,dead_cap,los-angeles-rams,56000,2019
23391,48000,0,Jake Gervase,S,dead_cap,los-angeles-rams,48000,2019
23392,0,39896,Temarrick Hemingway,TE,dead_cap,los-angeles-rams,39896,2019
23393,37941,0,Dominique Hatfield,CB,dead_cap,los-angeles-rams,37941,2019
23394,32000,0,Ethan Wolf,TE,dead_cap,los-angeles-rams,32000,2019
23395,24000,0,Greg Dortch,WR,dead_cap,los-angeles-rams,24000,2019
23396,0,13334,Codey McElroy,WR,dead_cap,los-angeles-rams,13334,2019
23397,0,5000,Justin Davis,RB,dead_cap,los-angeles-rams,5000,2019
23398,0,3334,Afolabi Laguda,S,dead_cap,los-angeles-rams,3334,2019
23399,0,3334,Steven Parker,S,dead_cap,los-angeles-rams,3334,2019
23400,0,3334,Chucky Williams,S,dead_cap,los-angeles-rams,3334,2019
23401,0,1666,Alex Bachman,WR,dead_cap,los-angeles-rams,1666,2019
23402,0,666,Johnathan Lloyd,WR,dead_cap,los-angeles-rams,666,2019
23403,10042683,26000000,Jared Goff,QB,active,los-angeles-rams,36042683,2020
23404,17000000,8000000,Aaron Donald,DT,active,los-angeles-rams,25000000,2020
23405,5500000,11750000,Todd Gurley,RB,active,los-angeles-rams,17250000,2020
23406,8000000,12200000,Brandin Cooks,WR,active,los-angeles-rams,20200000,2020
23407,13703000,0,Jalen Ramsey,CB,active,los-angeles-rams,13703000,2020
23408,5500000,3677504,Robert Woods,WR,active,los-angeles-rams,9177504,2020
23409,2000000,6625000,Tyler Higbee,TE,active,los-angeles-rams,8625000,2020
23410,3250000,4550000,Rob Havenstein,RT,active,los-angeles-rams,7800000,2020
23411,3750000,2000000,Clay Matthews,OLB,active,los-angeles-rams,5750000,2020
23412,4250524,500001,Eric Weddle,FS,active,los-angeles-rams,4750525,2020
23413,3500000,1187000,Johnny Hekker,P,active,los-angeles-rams,4687000,2020
23414,3500000,1000000,Nickell Robey-Coleman,CB,active,los-angeles-rams,4500000,2020
23415,2350000,1093750,Troy Hill,CB,active,los-angeles-rams,3443750,2020
23416,1289246,633996,Gerald Everett,TE,active,los-angeles-rams,1923242,2020
23417,961000,238690,Cooper Kupp,WR,active,los-angeles-rams,1199690,2020
23418,1163490,0,Austin Corbett,C,active,los-angeles-rams,1163490,2020
23419,1000000,137500,Malcolm Brown,RB,active,los-angeles-rams,1137500,2020
23420,707441,354762,Taylor Rapp,S,active,los-angeles-rams,1062203,2020
23421,945000,30000,Jake McQuaide,LS,active,los-angeles-rams,975000,2020
23422,775000,189438,John Johnson,SS,active,los-angeles-rams,964438,2020
23423,686916,272664,Darrell Henderson,RB,active,los-angeles-rams,959580,2020
23424,717717,204723,Joseph Noteboom,G,active,los-angeles-rams,922440,2020
23425,677776,243265,David Long,CB,active,los-angeles-rams,921041,2020
23426,735000,162006,Josh Reynolds,WR,active,los-angeles-rams,897006,2020
23427,735000,153272,Samson Ebukam,OLB,active,los-angeles-rams,888272,2020
23428,642246,205545,Bobby Evans,T,active,los-angeles-rams,847791,2020
23429,660000,171734,Brian Allen,C,active,los-angeles-rams,831734,2020
23430,735000,41198,Tanzel Smart,DT,active,los-angeles-rams,776198,2020
23431,585000,156653,Greg Gaines,DT,active,los-angeles-rams,741653,2020
23432,660000,74494,Micah Kiser,ILB,active,los-angeles-rams,734494,2020
23433,660000,68634,Ogbonnia Okoronkwo,OLB,active,los-angeles-rams,728634,2020
23434,660000,38809,Sebastian Joseph,DT,active,los-angeles-rams,698809,2020
23435,660000,18435,Justin Lawler,DE,active,los-angeles-rams,678435,2020
23436,660000,0,Jamil Demby,G,active,los-angeles-rams,660000,2020
23437,660000,0,Darious Williams,CB,active,los-angeles-rams,660000,2020
23438,660000,0,Kenny Young,ILB,active,los-angeles-rams,660000,2020
23439,585000,66130,David Edwards,T,active,los-angeles-rams,651130,2020
23440,585000,19332,Nick Scott,S,active,los-angeles-rams,604332,2020
23441,585000,4000,Troy Reeder,LB,active,los-angeles-rams,589000,2020
23442,585000,1666,Natrez Patrick,LB,active,los-angeles-rams,586666,2020
23443,585000,0,Adonis Alexander,CB,active,los-angeles-rams,585000,2020
23444,585000,0,Kendall Blanton,TE,active,los-angeles-rams,585000,2020
23445,585000,0,Chandler Brewer,G,active,los-angeles-rams,585000,2020
23446,585000,0,Greg Dortch,WR,active,los-angeles-rams,585000,2020
23447,585000,0,Jake Gervase,S,active,los-angeles-rams,585000,2020
23448,585000,0,Jeff Holland,LB,active,los-angeles-rams,585000,2020
23449,585000,0,Travin Howard,OLB,active,los-angeles-rams,585000,2020
23450,585000,0,Nate Trewyn,C,active,los-angeles-rams,585000,2020
23451,510000,75000,John Wolford,QB,active,los-angeles-rams,585000,2020
23452,510000,0,Marquise Copeland,DT,active,los-angeles-rams,510000,2020
23453,510000,0,Jeremiah Kolone,G,active,los-angeles-rams,510000,2020
23454,510000,0,Jachai Polite,OLB,active,los-angeles-rams,510000,2020
23455,510000,0,Ethan Wolf,TE,active,los-angeles-rams,510000,2020
23456,0,226180,John Franklin-Myers,DE,dead_cap,los-angeles-rams,226180,2020
23457,0,94146,John Kelly,RB,dead_cap,los-angeles-rams,94146,2020
23458,0,55932,Dakota Allen,LB,dead_cap,los-angeles-rams,55932,2020
23459,0,6667,Trevon Young,DE,dead_cap,los-angeles-rams,6667,2020
23460,0,3334,Alex Bachman,WR,dead_cap,los-angeles-rams,3334,2020
23461,0,1334,Johnathan Lloyd,WR,dead_cap,los-angeles-rams,1334,2020
23462,285000,4375000,Ted Ginn Jr.,WR,active,miami-dolphins,4660000,2007
23463,800000,2600000,Joey Porter,LB,active,miami-dolphins,3400000,2007
23464,800000,2350000,Vonnie Holliday,DT,active,miami-dolphins,3150000,2007
23465,1000000,1525000,Will Allen,S,active,miami-dolphins,2525000,2007
23466,660000,1890000,Jason Allen,CB,active,miami-dolphins,2550000,2007
23467,655000,1460000,Vernon Carey,T,active,miami-dolphins,2115000,2007
23468,1200000,400000,Justin Peelle,TE,active,miami-dolphins,1600000,2007
23469,1000000,333333,Andre' Goodman,CB,active,miami-dolphins,1333333,2007
23470,1300000,0,Yeremiah Bell,S,active,miami-dolphins,1300000,2007
23471,1300000,0,Cleo Lemon,QB,active,miami-dolphins,1300000,2007
23472,285000,100000,John Beck,QB,active,miami-dolphins,385000,2007
23473,600000,425000,Jay Feely,K,active,miami-dolphins,1025000,2007
23474,600000,425000,Jay Feely,K,active,miami-dolphins,1025000,2007
23475,850000,22500,Rex Hadnot,G,active,miami-dolphins,872500,2007
23476,435000,197000,Matt Roth,DE,active,miami-dolphins,632000,2007
23477,435000,191625,Channing Crowder,LB,active,miami-dolphins,626625,2007
23478,435000,125000,John Denney,LS,active,miami-dolphins,560000,2007
23479,435000,114500,Travis Daniels,S,active,miami-dolphins,549500,2007
23480,510000,10725,Derrick Pope,LB,active,miami-dolphins,520725,2007
23481,285000,205000,Samson Satele,C,active,miami-dolphins,490000,2007
23482,435000,52166,Anthony Alabi,T,active,miami-dolphins,487166,2007
23483,460000,0,Dominic Furio,C,active,miami-dolphins,460000,2007
23484,435000,0,Robert McCune,LB,active,miami-dolphins,435000,2007
23485,285000,117500,Paul Soliai,DT,active,miami-dolphins,402500,2007
23486,285000,109187,Joe Toledo,T,active,miami-dolphins,394187,2007
23487,285000,108750,Lorenzo Booker,RB,active,miami-dolphins,393750,2007
23488,360000,0,Rob Ninkovich,OLB,active,miami-dolphins,360000,2007
23489,285000,25437,Reagan Maui'a,RB,active,miami-dolphins,310437,2007
23490,285000,13518,Brandon Fields,P,active,miami-dolphins,298518,2007
23491,285000,12587,Rodrique Wright,DE,active,miami-dolphins,297587,2007
23492,285000,1000,Edmond Miles,LB,active,miami-dolphins,286000,2007
23493,190000,22062,Drew Mormino,CB,active,miami-dolphins,212062,2007
23494,160312,11137,Abraham Wright,DE,active,miami-dolphins,171449,2007
23495,67058,0,Mark Washington,LB,active,miami-dolphins,67058,2007
23496,984133,4897068,Ronnie Brown,RB,injured_reserve,miami-dolphins,5881201,2007
23497,210000,0,Ricky Williams,RB,injured_reserve,miami-dolphins,210000,2007
23498,0,1466668,Joey Harrington,QB,dead_cap,miami-dolphins,1466668,2007
23499,0,1400000,Daunte Culpepper,QB,dead_cap,miami-dolphins,1400000,2007
23500,912000,0,Randy McMichael,TE,dead_cap,miami-dolphins,912000,2007
23501,457500,0,Seth McKinney,G,dead_cap,miami-dolphins,457500,2007
23502,254117,0,Donovan Darius,S,dead_cap,miami-dolphins,254117,2007
23503,33768,0,Devin Aromashodu,WR,dead_cap,miami-dolphins,33768,2007
23504,14625,0,Fred Evans,DT,dead_cap,miami-dolphins,14625,2007
23505,14062,0,Kelvin Smith,LB,dead_cap,miami-dolphins,14062,2007
23506,4800000,2600000,Joey Porter,LB,active,miami-dolphins,7400000,2008
23507,3658266,4897068,Ronnie Brown,RB,active,miami-dolphins,8555334,2008
23508,295000,4705000,Jake Long,LT,active,miami-dolphins,5000000,2008
23509,1650000,2950000,Vonnie Holliday,DT,active,miami-dolphins,4600000,2008
23510,3500000,500000,Chad Pennington,QB,active,miami-dolphins,4000000,2008
23511,2500000,1125000,Will Allen,S,active,miami-dolphins,3625000,2008
23512,2570000,1460000,Vernon Carey,T,active,miami-dolphins,4030000,2008
23513,1075000,1275000,Randy Starks,DE,active,miami-dolphins,2350000,2008
23514,370000,3167499,Ted Ginn Jr.,WR,active,miami-dolphins,3537499,2008
23515,1000000,1100000,Reggie Torbor,LB,active,miami-dolphins,2100000,2008
23516,985000,1890000,Jason Allen,CB,active,miami-dolphins,2875000,2008
23517,950000,833333,Charlie Anderson,LB,active,miami-dolphins,1783333,2008
23518,520000,880000,Yeremiah Bell,S,active,miami-dolphins,1400000,2008
23519,1000000,333333,Andre' Goodman,CB,active,miami-dolphins,1333333,2008
23520,1000000,191625,Channing Crowder,LB,active,miami-dolphins,1191625,2008
23521,851000,300000,Chris Crocker,S,active,miami-dolphins,1151000,2008
23522,605000,450000,Nathan Jones,CB,active,miami-dolphins,1055000,2008
23523,520000,197000,Matt Roth,DE,active,miami-dolphins,717000,2008
23524,370000,100000,John Beck,QB,active,miami-dolphins,470000,2008
23525,445000,310000,Anthony Fasano,TE,active,miami-dolphins,755000,2008
23526,730000,0,Ricky Williams,RB,active,miami-dolphins,730000,2008
23527,295000,415000,Phillip Merling,DE,active,miami-dolphins,710000,2008
23528,520000,10000,Tab Perry,WR,active,miami-dolphins,530000,2008
23529,520000,132500,John Denney,LS,active,miami-dolphins,652500,2008
23530,370000,205000,Samson Satele,C,active,miami-dolphins,575000,2008
23531,520000,50000,Lousaka Polite,RB,active,miami-dolphins,570000,2008
23532,545000,0,Jake Grove,C,active,miami-dolphins,545000,2008
23533,520000,0,Evan Mathis,G,active,miami-dolphins,520000,2008
23534,295000,216500,Chad Henne,QB,active,miami-dolphins,511500,2008
23535,295000,215000,Kendall Langford,DE,active,miami-dolphins,510000,2008
23536,370000,117500,Paul Soliai,DT,active,miami-dolphins,487500,2008
23537,370000,108750,Lorenzo Booker,RB,active,miami-dolphins,478750,2008
23538,445000,12587,Rodrique Wright,DE,active,miami-dolphins,457587,2008
23539,445000,0,Rob Ninkovich,OLB,active,miami-dolphins,445000,2008
23540,295000,119125,Shawn Murphy,G,active,miami-dolphins,414125,2008
23541,370000,13518,Brandon Fields,P,active,miami-dolphins,383518,2008
23542,370000,0,Andy Alleman,C,active,miami-dolphins,370000,2008
23543,370000,0,Brandon Frye,T,active,miami-dolphins,370000,2008
23544,370000,0,Quentin Moses,DE,active,miami-dolphins,370000,2008
23545,295000,10070,Lionel Dotson,DE,active,miami-dolphins,305070,2008
23546,295000,3750,Dan Carpenter,K,active,miami-dolphins,298750,2008
23547,295000,3500,Davone Bess,WR,active,miami-dolphins,298500,2008
23548,295000,0,Nate Garner,RT,active,miami-dolphins,295000,2008
23549,295000,0,Jalen Parmele,RB,active,miami-dolphins,295000,2008
23550,215000,0,Kelvin Smith,LB,active,miami-dolphins,215000,2008
23551,295000,21343,Donald Thomas,G,injured_reserve,miami-dolphins,316343,2008
23552,88400,0,Lex Hilliard,RB,practice_squad,miami-dolphins,88400,2008
23553,0,4200000,Daunte Culpepper,QB,dead_cap,miami-dolphins,4200000,2008
23554,0,1250000,Josh McCown,QB,dead_cap,miami-dolphins,1250000,2008
23555,1200000,0,Jay Feely,K,dead_cap,miami-dolphins,1200000,2008
23556,114500,0,Travis Daniels,S,dead_cap,miami-dolphins,114500,2008
23557,109187,0,Joe Toledo,T,dead_cap,miami-dolphins,109187,2008
23558,42187,0,Kelvin Smith,LB,dead_cap,miami-dolphins,42187,2008
23559,29250,0,Fred Evans,DT,dead_cap,miami-dolphins,29250,2008
23560,25925,0,Jalen Parmele,RB,dead_cap,miami-dolphins,25925,2008
23561,25437,0,Reagan Maui'a,RB,dead_cap,miami-dolphins,25437,2008
23562,24200,0,Lex Hilliard,RB,dead_cap,miami-dolphins,24200,2008
23563,22062,0,Drew Mormino,CB,dead_cap,miami-dolphins,22062,2008
23564,11137,0,Abraham Wright,DE,dead_cap,miami-dolphins,11137,2008
23565,5000,0,James Grigsby,LB,dead_cap,miami-dolphins,5000,2008
23566,1000,0,Edmond Miles,LB,dead_cap,miami-dolphins,1000,2008
23567,6500000,3100000,Jake Long,LT,active,miami-dolphins,9600000,2009
23568,4800000,2600000,Joey Porter,LB,active,miami-dolphins,7400000,2009
23569,5900000,0,Jake Grove,C,active,miami-dolphins,5900000,2009
23570,3900000,1850000,Chad Pennington,QB,active,miami-dolphins,5750000,2009
23571,2550000,4350000,Yeremiah Bell,S,active,miami-dolphins,6900000,2009
23572,800000,4600000,Vernon Carey,T,active,miami-dolphins,5400000,2009
23573,3000000,1275000,Randy Starks,DE,active,miami-dolphins,4275000,2009
23574,3400000,850000,Ricky Williams,RB,active,miami-dolphins,4250000,2009
23575,1500000,1250000,Channing Crowder,LB,active,miami-dolphins,2750000,2009
23576,2500000,1100000,Reggie Torbor,LB,active,miami-dolphins,3600000,2009
23577,1700000,833333,Charlie Anderson,LB,active,miami-dolphins,2533333,2009
23578,677917,3217499,Ted Ginn Jr.,WR,active,miami-dolphins,3895416,2009
23579,1310000,1890000,Jason Allen,CB,active,miami-dolphins,3200000,2009
23580,500000,415000,Phillip Merling,DE,active,miami-dolphins,915000,2009
23581,1475000,12667,Greg Camarillo,WR,active,miami-dolphins,1487667,2009
23582,310000,940000,Vontae Davis,CB,active,miami-dolphins,1250000,2009
23583,620000,450000,Nathan Jones,CB,active,miami-dolphins,1070000,2009
23584,700000,197000,Matt Roth,DE,active,miami-dolphins,897000,2009
23585,875000,166667,Tyrone Culver,S,active,miami-dolphins,1041667,2009
23586,1000000,25000,Tony McDaniel,DT,active,miami-dolphins,1025000,2009
23587,900000,100000,Lousaka Polite,RB,active,miami-dolphins,1000000,2009
23588,310000,657250,Sean Smith,CB,active,miami-dolphins,967250,2009
23589,675000,108333,Joe Berger,G,active,miami-dolphins,783333,2009
23590,620000,132500,John Denney,LS,active,miami-dolphins,752500,2009
23591,310000,0,Pat White,QB,active,miami-dolphins,310000,2009
23592,385000,300565,Kendall Langford,DE,active,miami-dolphins,685565,2009
23593,310000,325000,Cameron Wake,DE,active,miami-dolphins,635000,2009
23594,385000,216500,Chad Henne,QB,active,miami-dolphins,601500,2009
23595,460000,117500,Paul Soliai,DT,active,miami-dolphins,577500,2009
23596,460000,108750,Lorenzo Booker,RB,active,miami-dolphins,568750,2009
23597,535000,0,Anthony Fasano,TE,active,miami-dolphins,535000,2009
23598,310000,178575,Patrick Turner,WR,active,miami-dolphins,488575,2009
23599,460000,13518,Brandon Fields,P,active,miami-dolphins,473518,2009
23600,460000,0,Ikaika Alama-Francis,DE,active,miami-dolphins,460000,2009
23601,460000,0,Quentin Moses,DE,active,miami-dolphins,460000,2009
23602,310000,126243,Brian Hartline,WR,active,miami-dolphins,436243,2009
23603,385000,10070,Lionel Dotson,DE,active,miami-dolphins,395070,2009
23604,385000,3750,Dan Carpenter,K,active,miami-dolphins,388750,2009
23605,385000,3500,Davone Bess,WR,active,miami-dolphins,388500,2009
23606,385000,0,Nate Garner,RT,active,miami-dolphins,385000,2009
23607,310000,43137,John Nalbone,TE,active,miami-dolphins,353137,2009
23608,310000,40625,Chris Clemons,FS,active,miami-dolphins,350625,2009
23609,310000,27443,Andrew Gardner,G,active,miami-dolphins,337443,2009
23610,310000,21343,Donald Thomas,G,active,miami-dolphins,331343,2009
23611,310000,0,Ryan Baker,DT,active,miami-dolphins,310000,2009
23612,310000,0,J.D. Folsom,LB,active,miami-dolphins,310000,2009
23613,310000,0,J.D. Folsom,LB,active,miami-dolphins,310000,2009
23614,310000,0,Lex Hilliard,RB,active,miami-dolphins,310000,2009
23615,218823,0,Kory Sheets,RB,active,miami-dolphins,218823,2009
23616,145882,0,Kory Sperry,TE,active,miami-dolphins,145882,2009
23617,3608399,4897068,Ronnie Brown,RB,injured_reserve,miami-dolphins,8505467,2009
23618,4000000,1625000,Will Allen,S,injured_reserve,miami-dolphins,5625000,2009
23619,88400,0,Danny Lansanah,ILB,practice_squad,miami-dolphins,88400,2009
23620,88400,0,Kory Sperry,TE,practice_squad,miami-dolphins,88400,2009
23621,2500000,0,Vonnie Holliday,DT,dead_cap,miami-dolphins,2500000,2009
23622,0,1250000,Josh McCown,QB,dead_cap,miami-dolphins,1250000,2009
23623,831764,0,Richie Incognito,G,dead_cap,miami-dolphins,831764,2009
23624,400000,0,Jay Feely,K,dead_cap,miami-dolphins,400000,2009
23625,200000,0,John Beck,QB,dead_cap,miami-dolphins,200000,2009
23626,119125,0,Shawn Murphy,G,dead_cap,miami-dolphins,119125,2009
23627,109187,0,Joe Toledo,T,dead_cap,miami-dolphins,109187,2009
23628,77775,0,Jalen Parmele,RB,dead_cap,miami-dolphins,77775,2009
23629,69411,0,Chris Hannon,WR,dead_cap,miami-dolphins,69411,2009
23630,50874,0,Reagan Maui'a,RB,dead_cap,miami-dolphins,50874,2009
23631,48400,0,Lex Hilliard,RB,dead_cap,miami-dolphins,48400,2009
23632,44124,0,Drew Mormino,CB,dead_cap,miami-dolphins,44124,2009
23633,31474,0,J.D. Folsom,LB,dead_cap,miami-dolphins,31474,2009
23634,22274,0,Abraham Wright,DE,dead_cap,miami-dolphins,22274,2009
23635,12587,0,Rodrique Wright,DE,dead_cap,miami-dolphins,12587,2009
23636,9750000,1600000,Jake Long,LT,active,miami-dolphins,11350000,2010
23637,5840000,5350000,Vernon Carey,T,active,miami-dolphins,11190000,2010
23638,4800000,1000000,Karlos Dansby,ILB,active,miami-dolphins,5800000,2010
23639,4350000,950000,Ricky Williams,RB,active,miami-dolphins,5300000,2010
23640,2100000,1250000,Channing Crowder,LB,active,miami-dolphins,3350000,2010
23641,3000000,1275000,Randy Starks,DE,active,miami-dolphins,4275000,2010
23642,3969239,0,Ronnie Brown,RB,active,miami-dolphins,3969239,2010
23643,1850000,1550000,Yeremiah Bell,S,active,miami-dolphins,3400000,2010
23644,600000,415000,Phillip Merling,DE,active,miami-dolphins,1015000,2010
23645,1276000,600000,Tim Dobbins,ILB,active,miami-dolphins,1876000,2010
23646,1176000,700000,Anthony Fasano,TE,active,miami-dolphins,1876000,2010
23647,1745883,25000,Tony McDaniel,DT,active,miami-dolphins,1770883,2010
23648,395000,2147500,Vontae Davis,CB,active,miami-dolphins,2542500,2010
23649,1150000,12667,Greg Camarillo,WR,active,miami-dolphins,1162667,2010
23650,725000,625000,Richie Incognito,G,active,miami-dolphins,1350000,2010
23651,1150000,150000,Lousaka Polite,RB,active,miami-dolphins,1300000,2010
23652,320000,961804,Jared Odrick,DE,active,miami-dolphins,1281804,2010
23653,1100000,166667,Tyrone Culver,S,active,miami-dolphins,1266667,2010
23654,470000,775600,Chad Henne,QB,active,miami-dolphins,1245600,2010
23655,470000,750000,Davone Bess,WR,active,miami-dolphins,1220000,2010
23656,1101000,0,Quentin Moses,DE,active,miami-dolphins,1101000,2010
23657,395000,0,Pat White,QB,active,miami-dolphins,395000,2010
23658,598000,307518,Brandon Fields,P,active,miami-dolphins,905518,2010
23659,635000,268750,John Denney,LS,active,miami-dolphins,903750,2010
23660,700000,133333,Joe Berger,G,active,miami-dolphins,833333,2010
23661,320000,467500,Koa Misi,OLB,active,miami-dolphins,787500,2010
23662,470000,312500,Dan Carpenter,K,active,miami-dolphins,782500,2010
23663,470000,215000,Kendall Langford,DE,active,miami-dolphins,685000,2010
23664,550000,117500,Paul Soliai,DT,active,miami-dolphins,667500,2010
23665,550000,108750,Lorenzo Booker,RB,active,miami-dolphins,658750,2010
23666,640000,0,Ikaika Alama-Francis,DE,active,miami-dolphins,640000,2010
23667,395000,236250,Sean Smith,CB,active,miami-dolphins,631250,2010
23668,395000,175000,Cameron Wake,DE,active,miami-dolphins,570000,2010
23669,320000,214625,John Jerry,G,active,miami-dolphins,534625,2010
23670,395000,126243,Brian Hartline,WR,active,miami-dolphins,521243,2010
23671,470000,0,Joey Haynos,TE,active,miami-dolphins,470000,2010
23672,320000,119250,A.J. Edds,OLB,active,miami-dolphins,439250,2010
23673,395000,40625,Chris Clemons,FS,active,miami-dolphins,435625,2010
23674,395000,27443,Andrew Gardner,G,active,miami-dolphins,422443,2010
23675,395000,0,Ryan Baker,DT,active,miami-dolphins,395000,2010
23676,395000,0,Lex Hilliard,RB,active,miami-dolphins,395000,2010
23677,395000,0,Lydon Murtha,T,active,miami-dolphins,395000,2010
23678,370000,0,Randy Thomas,G,active,miami-dolphins,370000,2010
23679,320000,47937,Nolan Carroll,CB,active,miami-dolphins,367937,2010
23680,320000,40075,Reshad Jones,SS,active,miami-dolphins,360075,2010
23681,325000,0,Chris Baker,DT,active,miami-dolphins,325000,2010
23682,320000,1666,Marlon Moore,WR,active,miami-dolphins,321666,2010
23683,320000,0,Ray Feinga,G,active,miami-dolphins,320000,2010
23684,320000,0,Julius Pruitt,WR,active,miami-dolphins,320000,2010
23685,320000,0,Mickey Shuler,TE,active,miami-dolphins,320000,2010
23686,320000,0,Roberto Wallace,WR,active,miami-dolphins,320000,2010
23687,282352,0,Jeron Mastrud,TE,active,miami-dolphins,282352,2010
23688,263529,0,Austin Spitler,ILB,active,miami-dolphins,263529,2010
23689,188235,0,Jonathon Amaya,S,active,miami-dolphins,188235,2010
23690,1830000,500000,Will Allen,S,injured_reserve,miami-dolphins,2330000,2010
23691,255000,0,Lionel Dotson,DE,injured_reserve,miami-dolphins,255000,2010
23692,255000,0,Nate Garner,RT,injured_reserve,miami-dolphins,255000,2010
23693,240000,0,Kory Sheets,RB,injured_reserve,miami-dolphins,240000,2010
23694,176800,0,Clifton Geathers,DE,practice_squad,miami-dolphins,176800,2010
23695,176800,0,Chris McCoy,OLB,practice_squad,miami-dolphins,176800,2010
23696,88400,0,Jonathon Amaya,S,practice_squad,miami-dolphins,88400,2010
23697,88400,0,Jeron Mastrud,TE,practice_squad,miami-dolphins,88400,2010
23698,88400,0,Nathan Overbay,TE,practice_squad,miami-dolphins,88400,2010
23699,88400,0,Austin Spitler,ILB,practice_squad,miami-dolphins,88400,2010
23700,5243748,0,Ted Ginn Jr.,WR,dead_cap,miami-dolphins,5243748,2010
23701,4800000,0,Joey Porter,LB,dead_cap,miami-dolphins,4800000,2010
23702,2000000,0,Reggie Torbor,LB,dead_cap,miami-dolphins,2000000,2010
23703,0,1840000,Jason Allen,CB,dead_cap,miami-dolphins,1840000,2010
23704,833334,0,Charlie Anderson,LB,dead_cap,miami-dolphins,833334,2010
23705,512718,0,Pat White,QB,dead_cap,miami-dolphins,512718,2010
23706,407647,0,Bobby Carpenter,LB,dead_cap,miami-dolphins,407647,2010
23707,238250,0,Shawn Murphy,G,dead_cap,miami-dolphins,238250,2010
23708,133235,0,Patrick Ramsey,QB,dead_cap,miami-dolphins,133235,2010
23709,94422,0,J.D. Folsom,LB,dead_cap,miami-dolphins,94422,2010
23710,27443,0,Andrew Gardner,G,dead_cap,miami-dolphins,27443,2010
23711,21343,0,Donald Thomas,G,dead_cap,miami-dolphins,21343,2010
23712,0,16287,Chris McCoy,OLB,dead_cap,miami-dolphins,16287,2010
23713,10070,0,Lionel Dotson,DE,dead_cap,miami-dolphins,10070,2010
23714,0,9118,Austin Spitler,ILB,dead_cap,miami-dolphins,9118,2010
23715,2500,0,Jonathon Amaya,S,dead_cap,miami-dolphins,2500,2010
23716,11200000,1600000,Jake Long,LT,active,miami-dolphins,12800000,2011
23717,12476000,0,Paul Soliai,DT,active,miami-dolphins,12476000,2011
23718,6500000,4300000,Brandon Marshall,WR,active,miami-dolphins,10800000,2011
23719,3700000,1550000,Yeremiah Bell,S,active,miami-dolphins,5250000,2011
23720,2700000,4050000,Karlos Dansby,ILB,active,miami-dolphins,6750000,2011
23721,2500000,1250000,Channing Crowder,LB,active,miami-dolphins,3750000,2011
23722,3625000,1275000,Randy Starks,DE,active,miami-dolphins,4900000,2011
23723,2500000,1250000,Reggie Bush,RB,active,miami-dolphins,3750000,2011
23724,2500000,750000,Matt Moore,QB,active,miami-dolphins,3250000,2011
23725,1900000,775000,Anthony Fasano,TE,active,miami-dolphins,2675000,2011
23726,2500000,0,Vernon Carey,T,active,miami-dolphins,2500000,2011
23727,1700000,600000,Tim Dobbins,ILB,active,miami-dolphins,2300000,2011
23728,700000,415000,Phillip Merling,DE,active,miami-dolphins,1115000,2011
23729,750000,1250000,Kevin Burnett,OLB,active,miami-dolphins,2000000,2011
23730,685000,1157500,Tony McDaniel,DT,active,miami-dolphins,1842500,2011
23731,1013000,800000,Davone Bess,WR,active,miami-dolphins,1813000,2011
23732,676250,2147500,Vontae Davis,CB,active,miami-dolphins,2823750,2011
23733,450000,1297500,Koa Misi,OLB,active,miami-dolphins,1747500,2011
23734,105000,1583333,Richie Incognito,G,active,miami-dolphins,1688333,2011
23735,375000,1308581,Mike Pouncey,C,active,miami-dolphins,1683581,2011
23736,405000,2149548,Jared Odrick,DE,active,miami-dolphins,2554548,2011
23737,1400000,215000,Kendall Langford,DE,active,miami-dolphins,1615000,2011
23738,1250000,166667,Tyrone Culver,S,active,miami-dolphins,1416667,2011
23739,810000,575000,Will Allen,S,active,miami-dolphins,1385000,2011
23740,1005000,337500,Dan Carpenter,K,active,miami-dolphins,1342500,2011
23741,986000,304000,Brandon Fields,P,active,miami-dolphins,1290000,2011
23742,1200000,0,Steve Slaton,RB,active,miami-dolphins,1200000,2011
23743,800000,200000,Nate Garner,RT,active,miami-dolphins,1000000,2011
23744,685000,250000,Jason Trusnik,ILB,active,miami-dolphins,935000,2011
23745,700000,153750,John Denney,LS,active,miami-dolphins,853750,2011
23746,555000,216500,Chad Henne,QB,active,miami-dolphins,771500,2011
23747,480000,236250,Sean Smith,CB,active,miami-dolphins,716250,2011
23748,525000,175000,Cameron Wake,DE,active,miami-dolphins,700000,2011
23749,525000,126243,Brian Hartline,WR,active,miami-dolphins,651243,2011
23750,640000,0,Ikaika Alama-Francis,DE,active,miami-dolphins,640000,2011
23751,405000,214625,John Jerry,G,active,miami-dolphins,619625,2011
23752,375000,213435,Daniel Thomas,RB,active,miami-dolphins,588435,2011
23753,525000,40625,Chris Clemons,FS,active,miami-dolphins,565625,2011
23754,910000,0,Igor Olshansky,DE,active,miami-dolphins,910000,2011
23755,810000,0,J.P. Losman,QB,active,miami-dolphins,810000,2011
23756,685000,50000,Ronald Fields,DT,active,miami-dolphins,735000,2011
23757,685000,0,Marvin Mitchell,OLB,active,miami-dolphins,685000,2011
23758,525000,0,Lex Hilliard,RB,active,miami-dolphins,525000,2011
23759,450000,40075,Reshad Jones,SS,active,miami-dolphins,490075,2011
23760,375000,113287,Edmond Gates,WR,active,miami-dolphins,488287,2011
23761,375000,113282,Clyde Gates,WR,active,miami-dolphins,488282,2011
23762,480000,0,Ryan Baker,DT,active,miami-dolphins,480000,2011
23763,480000,0,Lydon Murtha,T,active,miami-dolphins,480000,2011
23764,405000,47937,Nolan Carroll,CB,active,miami-dolphins,452937,2011
23765,450000,0,Jeron Mastrud,TE,active,miami-dolphins,450000,2011
23766,450000,0,Austin Spitler,ILB,active,miami-dolphins,450000,2011
23767,405000,0,Dedrick Epps,TE,active,miami-dolphins,405000,2011
23768,405000,0,Ray Feinga,G,active,miami-dolphins,405000,2011
23769,405000,0,Matt Kopa,G,active,miami-dolphins,405000,2011
23770,405000,0,Nate Ness,FS,active,miami-dolphins,405000,2011
23771,405000,0,Roberto Wallace,WR,active,miami-dolphins,405000,2011
23772,375000,28000,Charles Clay,TE,active,miami-dolphins,403000,2011
23773,375000,11475,Jimmy Wilson,SS,active,miami-dolphins,386475,2011
23774,375000,0,Will Yeatman,LT,active,miami-dolphins,375000,2011
23775,330000,0,Julius Pruitt,WR,active,miami-dolphins,330000,2011
23776,44117,0,Pat Devlin,QB,active,miami-dolphins,44117,2011
23777,273000,1666,Marlon Moore,WR,injured_reserve,miami-dolphins,274666,2011
23778,96900,0,Isaako Aaitui,DT,practice_squad,miami-dolphins,96900,2011
23779,96900,0,Brett Brackett,TE,practice_squad,miami-dolphins,96900,2011
23780,96900,0,Garrett Chisolm,LT,practice_squad,miami-dolphins,96900,2011
23781,96900,0,Pat Devlin,QB,practice_squad,miami-dolphins,96900,2011
23782,96900,0,Jonathan Freeny,OLB,practice_squad,miami-dolphins,96900,2011
23783,0,7200000,Vernon Carey,T,dead_cap,miami-dolphins,7200000,2011
23784,0,1840000,Jason Allen,CB,dead_cap,miami-dolphins,1840000,2011
23785,535725,0,Patrick Turner,WR,dead_cap,miami-dolphins,535725,2011
23786,512718,0,Pat White,QB,dead_cap,miami-dolphins,512718,2011
23787,0,119250,A.J. Edds,OLB,dead_cap,miami-dolphins,119250,2011
23788,108333,0,Joe Berger,G,dead_cap,miami-dolphins,108333,2011
23789,100000,0,Lousaka Polite,RB,dead_cap,miami-dolphins,100000,2011
23790,95294,0,Larry Johnson,RB,dead_cap,miami-dolphins,95294,2011
23791,0,48861,Chris McCoy,OLB,dead_cap,miami-dolphins,48861,2011
23792,27443,0,Andrew Gardner,G,dead_cap,miami-dolphins,27443,2011
23793,0,27356,Austin Spitler,ILB,dead_cap,miami-dolphins,27356,2011
23794,21343,0,Donald Thomas,G,dead_cap,miami-dolphins,21343,2011
23795,0,11787,Frank Kearse,DE,dead_cap,miami-dolphins,11787,2011
23796,10070,0,Lionel Dotson,DE,dead_cap,miami-dolphins,10070,2011
23797,5700,0,Chris Hogan,WR,dead_cap,miami-dolphins,5700,2011
23798,5000,0,Jonathon Amaya,S,dead_cap,miami-dolphins,5000,2011
23799,0,2000,Pat Devlin,QB,dead_cap,miami-dolphins,2000,2011
23800,1333,0,Jonathan Freeny,OLB,dead_cap,miami-dolphins,1333,2011
23801,1166,0,Brett Brackett,TE,dead_cap,miami-dolphins,1166,2011
23802,1000,0,Garrett Chisolm,LT,dead_cap,miami-dolphins,1000,2011
23803,333,0,Phillip Livas,WR,dead_cap,miami-dolphins,333,2011
23804,11200000,1600000,Jake Long,LT,active,miami-dolphins,12800000,2012
23805,8800000,4050000,Karlos Dansby,ILB,active,miami-dolphins,12850000,2012
23806,4500000,1525000,Reggie Bush,RB,active,miami-dolphins,6025000,2012
23807,3950000,1350000,Kevin Burnett,OLB,active,miami-dolphins,5300000,2012
23808,3725000,1275000,Randy Starks,DE,active,miami-dolphins,5000000,2012
23809,3300000,1583333,Richie Incognito,G,active,miami-dolphins,4883333,2012
23810,3600000,775000,Anthony Fasano,TE,active,miami-dolphins,4375000,2012
23811,3000000,1157500,Tony McDaniel,DT,active,miami-dolphins,4157500,2012
23812,2450000,1675000,Paul Soliai,DT,active,miami-dolphins,4125000,2012
23813,2750000,775000,Matt Moore,QB,active,miami-dolphins,3525000,2012
23814,2233000,800000,Davone Bess,WR,active,miami-dolphins,3033000,2012
23815,2525000,337500,Dan Carpenter,K,active,miami-dolphins,2862500,2012
23816,390000,1913364,Ryan Tannehill,QB,active,miami-dolphins,2303364,2012
23817,615000,1575000,Cameron Wake,DE,active,miami-dolphins,2190000,2012
23818,795895,1308581,Mike Pouncey,C,active,miami-dolphins,2104476,2012
23819,1927000,0,Lydon Murtha,T,active,miami-dolphins,1927000,2012
23820,568054,2149548,Jared Odrick,DE,active,miami-dolphins,2717602,2012
23821,1400000,250000,Nate Garner,RT,active,miami-dolphins,1650000,2012
23822,1308000,126243,Brian Hartline,WR,active,miami-dolphins,1434243,2012
23823,700000,699000,Brandon Fields,P,active,miami-dolphins,1399000,2012
23824,1308000,40625,Chris Clemons,FS,active,miami-dolphins,1348625,2012
23825,700000,431666,Jason Trusnik,ILB,active,miami-dolphins,1131666,2012
23826,540000,553000,Koa Misi,OLB,active,miami-dolphins,1093000,2012
23827,835000,153750,John Denney,LS,active,miami-dolphins,988750,2012
23828,390000,479867,Jonathan Martin,RT,active,miami-dolphins,869867,2012
23829,825000,0,Eric Steinbach,G,active,miami-dolphins,825000,2012
23830,565000,236250,Sean Smith,CB,active,miami-dolphins,801250,2012
23831,568000,213435,Daniel Thomas,RB,active,miami-dolphins,781435,2012
23832,540000,214625,John Jerry,G,active,miami-dolphins,754625,2012
23833,707353,0,Jabar Gaffney,WR,active,miami-dolphins,707353,2012
23834,540000,40075,Reshad Jones,SS,active,miami-dolphins,580075,2012
23835,390000,159520,Olivier Vernon,DE,active,miami-dolphins,549520,2012
23836,540000,1668,Marlon Moore,WR,active,miami-dolphins,541668,2012
23837,540000,0,Ray Feinga,G,active,miami-dolphins,540000,2012
23838,540000,0,Jeron Mastrud,TE,active,miami-dolphins,540000,2012
23839,540000,0,Austin Spitler,ILB,active,miami-dolphins,540000,2012
23840,540000,0,R.J. Stanford,CB,active,miami-dolphins,540000,2012
23841,490000,47937,Nolan Carroll,CB,active,miami-dolphins,537937,2012
23842,390000,147239,Michael Egnew,TE,active,miami-dolphins,537239,2012
23843,390000,121500,Lamar Miller,RB,active,miami-dolphins,511500,2012
23844,465000,28000,Charles Clay,TE,active,miami-dolphins,493000,2012
23845,465000,11475,Jimmy Wilson,SS,active,miami-dolphins,476475,2012
23846,465000,0,Quinten Lawrence,WR,active,miami-dolphins,465000,2012
23847,465000,0,Ryan Mahaffey,RB,active,miami-dolphins,465000,2012
23848,465000,0,Will Yeatman,LT,active,miami-dolphins,465000,2012
23849,444705,0,Jonathon Amaya,S,active,miami-dolphins,444705,2012
23850,390000,15612,Kheeston Randall,DT,active,miami-dolphins,405612,2012
23851,390000,13403,Rishard Matthews,WR,active,miami-dolphins,403403,2012
23852,390000,3333,Kelcie McCray,SS,active,miami-dolphins,393333,2012
23853,390000,3333,Derrick Shelby,DT,active,miami-dolphins,393333,2012
23854,390000,2500,Marcus Thigpen,WR,active,miami-dolphins,392500,2012
23855,390000,1500,Jonas Gray,RB,active,miami-dolphins,391500,2012
23856,390000,0,Pat Devlin,QB,active,miami-dolphins,390000,2012
23857,390000,0,Jonathan Freeny,OLB,active,miami-dolphins,390000,2012
23858,390000,0,Jorvorskie Lane,FB,active,miami-dolphins,390000,2012
23859,390000,0,Josh Samuda,C,active,miami-dolphins,390000,2012
23860,390000,0,Armon Binns,WR,active,miami-dolphins,390000,2012
23861,268125,0,Josh Kaddu,OLB,active,miami-dolphins,268125,2012
23862,390000,0,Kyle Miller,TE,active,miami-dolphins,390000,2012
23863,540000,0,Bryan McCann,CB,active,miami-dolphins,540000,2012
23864,465000,0,Ryan Durand,G,active,miami-dolphins,465000,2012
23865,170625,0,Anderson Russell,S,active,miami-dolphins,170625,2012
23866,138332,0,Chandler Burden,C,active,miami-dolphins,138332,2012
23867,137506,0,De'Andre Presley,WR,active,miami-dolphins,137506,2012
23868,700000,0,Tyrone Culver,S,active,miami-dolphins,700000,2012
23869,390000,0,Jeff Fuller,WR,active,miami-dolphins,390000,2012
23870,1500,0,Andrew McDonald,RT,active,miami-dolphins,1500,2012
23871,1562500,1216667,Richard Marshall,CB,injured_reserve,miami-dolphins,2779167,2012
23872,1200000,100000,Artis Hicks,G,injured_reserve,miami-dolphins,1300000,2012
23873,96900,0,Chas Alecxih,DT,practice_squad,miami-dolphins,96900,2012
23874,96900,0,Chandler Burden,C,practice_squad,miami-dolphins,96900,2012
23875,34200,0,Jeff Adams,G,practice_squad,miami-dolphins,34200,2012
23876,5500000,0,Brandon Marshall,WR,dead_cap,miami-dolphins,5500000,2012
23877,1850000,0,Yeremiah Bell,S,dead_cap,miami-dolphins,1850000,2012
23878,1796250,0,Vontae Davis,CB,dead_cap,miami-dolphins,1796250,2012
23879,1100000,0,David Garrard,QB,dead_cap,miami-dolphins,1100000,2012
23880,600000,0,Tim Dobbins,ILB,dead_cap,miami-dolphins,600000,2012
23881,270000,0,Anthony Armstrong,WR,dead_cap,miami-dolphins,270000,2012
23882,0,238500,A.J. Edds,OLB,dead_cap,miami-dolphins,238500,2012
23883,124750,0,Clyde Gates,WR,dead_cap,miami-dolphins,124750,2012
23884,124623,0,Mickey Shuler,TE,dead_cap,miami-dolphins,124623,2012
23885,123500,0,Matt Roth,DE,dead_cap,miami-dolphins,123500,2012
23886,0,113287,Edmond Gates,WR,dead_cap,miami-dolphins,113287,2012
23887,46685,0,Josh Kaddu,OLB,dead_cap,miami-dolphins,46685,2012
23888,45000,0,Gary Guyton,OLB,dead_cap,miami-dolphins,45000,2012
23889,0,35361,Frank Kearse,DE,dead_cap,miami-dolphins,35361,2012
23890,26550,0,B.J Cunningham,WR,dead_cap,miami-dolphins,26550,2012
23891,5700,0,Chris Hogan,WR,dead_cap,miami-dolphins,5700,2012
23892,4500,0,Terence Brown,C,dead_cap,miami-dolphins,4500,2012
23893,4500,0,Cameron Collins,ILB,dead_cap,miami-dolphins,4500,2012
23894,4500,0,Derek Dennis,G,dead_cap,miami-dolphins,4500,2012
23895,4500,0,Trenton Hughes,CB,dead_cap,miami-dolphins,4500,2012
23896,0,4000,Pat Devlin,QB,dead_cap,miami-dolphins,4000,2012
23897,3000,0,Kevyn Scott,CB,dead_cap,miami-dolphins,3000,2012
23898,2667,0,Jonathan Freeny,OLB,dead_cap,miami-dolphins,2667,2012
23899,0,2500,Jamaal Westerman,LB,dead_cap,miami-dolphins,2500,2012
23900,2500,0,Chas Alecxih,DT,dead_cap,miami-dolphins,2500,2012
23901,2500,0,Ryan Baker,DT,dead_cap,miami-dolphins,2500,2012
23902,2500,0,Jeff Fuller,WR,dead_cap,miami-dolphins,2500,2012
23903,2334,0,Brett Brackett,TE,dead_cap,miami-dolphins,2334,2012
23904,2000,0,Garrett Chisolm,LT,dead_cap,miami-dolphins,2000,2012
23905,1667,0,Derek Moye,WR,dead_cap,miami-dolphins,1667,2012
23906,1667,0,Jarrell Root,DE,dead_cap,miami-dolphins,1667,2012
23907,1667,0,Jacquies Smith,OLB,dead_cap,miami-dolphins,1667,2012
23908,1667,0,Dustin Waldron,LT,dead_cap,miami-dolphins,1667,2012
23909,1000,0,Shelly Lyons,LB,dead_cap,miami-dolphins,1000,2012
23910,833,0,Les Brown,TE,dead_cap,miami-dolphins,833,2012
23911,667,0,Phillip Livas,WR,dead_cap,miami-dolphins,667,2012
23912,167,0,Andrew McDonald,RT,dead_cap,miami-dolphins,167,2012
23913,8450000,0,Randy Starks,DE,active,miami-dolphins,8450000,2013
23914,5700000,1675000,Paul Soliai,DT,active,miami-dolphins,7375000,2013
23915,2725000,2712500,Brent Grimes,CB,active,miami-dolphins,5437500,2013
23916,3565000,1450000,Cameron Wake,DE,active,miami-dolphins,5015000,2013
23917,405000,3335420,Dion Jordan,DE,active,miami-dolphins,3740420,2013
23918,2500000,1000000,Tyson Clabo,RT,active,miami-dolphins,3500000,2013
23919,1000000,2250000,Mike Wallace,WR,active,miami-dolphins,3250000,2013
23920,480000,2399205,Ryan Tannehill,QB,active,miami-dolphins,2879205,2013
23921,2500000,250000,Chris Clemons,FS,active,miami-dolphins,2750000,2013
23922,1216790,1308581,Mike Pouncey,C,active,miami-dolphins,2525371,2013
23923,1000000,1500000,Matt Moore,QB,active,miami-dolphins,2500000,2013
23924,1000000,1425000,Dannell Ellerbe,OLB,active,miami-dolphins,2425000,2013
23925,1000000,1400000,Philip Wheeler,OLB,active,miami-dolphins,2400000,2013
23926,715000,1400000,Brian Hartline,WR,active,miami-dolphins,2115000,2013
23927,700000,2149548,Jared Odrick,DE,active,miami-dolphins,2849548,2013
23928,750000,1035000,Brandon Gibson,WR,active,miami-dolphins,1785000,2013
23929,630000,1134905,Koa Misi,OLB,active,miami-dolphins,1764905,2013
23930,630000,1040075,Reshad Jones,SS,active,miami-dolphins,1670075,2013
23931,1100000,545000,Brandon Fields,P,active,miami-dolphins,1645000,2013
23932,1323000,214625,John Jerry,G,active,miami-dolphins,1537625,2013
23933,1000000,506250,Bryant McKinnie,LT,active,miami-dolphins,1506250,2013
23934,1075000,191666,Nate Garner,RT,active,miami-dolphins,1266666,2013
23935,840000,253750,John Denney,LS,active,miami-dolphins,1093750,2013
23936,715000,216666,Jason Trusnik,ILB,active,miami-dolphins,931666,2013
23937,669217,213435,Daniel Thomas,RB,active,miami-dolphins,882652,2013
23938,630000,47937,Nolan Carroll,CB,active,miami-dolphins,677937,2013
23939,500000,169520,Olivier Vernon,DE,active,miami-dolphins,669520,2013
23940,405000,254300,Jamar Taylor,CB,active,miami-dolphins,659300,2013
23941,495000,157239,Michael Egnew,TE,active,miami-dolphins,652239,2013
23942,630000,0,R.J. Stanford,CB,active,miami-dolphins,630000,2013
23943,480000,121500,Lamar Miller,RB,active,miami-dolphins,601500,2013
23944,555000,28000,Charles Clay,TE,active,miami-dolphins,583000,2013
23945,555000,11475,Jimmy Wilson,SS,active,miami-dolphins,566475,2013
23946,405000,151594,Dallas Thomas,G,active,miami-dolphins,556594,2013
23947,555000,0,Danny Watkins,G,active,miami-dolphins,555000,2013
23948,405000,130300,Will Davis,CB,active,miami-dolphins,535300,2013
23949,405000,118172,Jelani Jenkins,OLB,active,miami-dolphins,523172,2013
23950,405000,116888,Dion Sims,TE,active,miami-dolphins,521888,2013
23951,480000,13403,Rishard Matthews,WR,active,miami-dolphins,493403,2013
23952,480000,3333,Derrick Shelby,DT,active,miami-dolphins,483333,2013
23953,480000,2500,Marcus Thigpen,WR,active,miami-dolphins,482500,2013
23954,630000,0,Austin Spitler,ILB,active,miami-dolphins,630000,2013
23955,480000,0,Pat Devlin,QB,active,miami-dolphins,480000,2013
23956,480000,0,Jonathan Freeny,OLB,active,miami-dolphins,480000,2013
23957,405000,40700,Mike Gillislee,RB,active,miami-dolphins,445700,2013
23958,405000,36140,Caleb Sturgis,K,active,miami-dolphins,441140,2013
23959,405000,11474,Don Jones,FS,active,miami-dolphins,416474,2013
23960,630000,0,Marlon Moore,WR,active,miami-dolphins,630000,2013
23961,555000,0,David Arkin,G,active,miami-dolphins,555000,2013
23962,405000,0,Sam Brenner,C,active,miami-dolphins,405000,2013
23963,405000,0,A.J. Francis,DE,active,miami-dolphins,405000,2013
23964,405000,0,Jordan Kovacs,SS,active,miami-dolphins,405000,2013
23965,1000000,0,Christopher Owens,CB,active,miami-dolphins,1000000,2013
23966,405000,0,Michael Thomas,FS,active,miami-dolphins,405000,2013
23967,630000,0,Jalil Brown,CB,active,miami-dolphins,630000,2013
23968,4500000,100000,Dimitri Patterson,CB,injured_reserve,miami-dolphins,4600000,2013
23969,3250000,1000000,Dustin Keller,TE,injured_reserve,miami-dolphins,4250000,2013
23970,555000,0,Will Yeatman,LT,injured_reserve,miami-dolphins,555000,2013
23971,303000,0,Armon Binns,WR,injured_reserve,miami-dolphins,303000,2013
23972,607466,479867,Jonathan Martin,RT,non_fb_injury,miami-dolphins,1087333,2013
23973,66000,0,Al Lapuaho,DT,practice_squad,miami-dolphins,66000,2013
23974,60000,0,Sam Brenner,C,practice_squad,miami-dolphins,60000,2013
23975,6000,0,Jasper Collins,WR,practice_squad,miami-dolphins,6000,2013
23976,6000,0,Austin Davis,QB,practice_squad,miami-dolphins,6000,2013
23977,6000,0,Devin Smith,CB,practice_squad,miami-dolphins,6000,2013
23978,2325000,0,Karlos Dansby,ILB,dead_cap,miami-dolphins,2325000,2013
23979,1796250,0,Vontae Davis,CB,dead_cap,miami-dolphins,1796250,2013
23980,1675000,0,Vaughn Martin,DE,dead_cap,miami-dolphins,1675000,2013
23981,1600000,0,Jake Long,LT,dead_cap,miami-dolphins,1600000,2013
23982,1250000,0,Kevin Burnett,OLB,dead_cap,miami-dolphins,1250000,2013
23983,1216666,0,Richard Marshall,CB,dead_cap,miami-dolphins,1216666,2013
23984,750000,0,Davone Bess,WR,dead_cap,miami-dolphins,750000,2013
23985,337702,0,Josh Kaddu,OLB,dead_cap,miami-dolphins,337702,2013
23986,337500,0,Dan Carpenter,K,dead_cap,miami-dolphins,337500,2013
23987,0,226574,Edmond Gates,WR,dead_cap,miami-dolphins,226574,2013
23988,193412,0,D.J. Campbell,S,dead_cap,miami-dolphins,193412,2013
23989,180607,0,Jordan Kovacs,SS,dead_cap,miami-dolphins,180607,2013
23990,166941,0,Isaako Aaitui,DT,dead_cap,miami-dolphins,166941,2013
23991,130588,0,Tyler Clutts,FB,dead_cap,miami-dolphins,130588,2013
23992,125000,0,Lance Louis,G,dead_cap,miami-dolphins,125000,2013
23993,98627,0,Kelcie McCray,SS,dead_cap,miami-dolphins,98627,2013
23994,84706,0,Marvin Austin,DT,dead_cap,miami-dolphins,84706,2013
23995,79650,0,B.J Cunningham,WR,dead_cap,miami-dolphins,79650,2013
23996,65294,0,Justin Rogers,CB,dead_cap,miami-dolphins,65294,2013
23997,54000,0,Nathan Palmer,WR,dead_cap,miami-dolphins,54000,2013
23998,42000,0,Brian Tyms,WR,dead_cap,miami-dolphins,42000,2013
23999,41824,0,Ryan Spadola,WR,dead_cap,miami-dolphins,41824,2013
24000,30000,0,Marvin McNutt,WR,dead_cap,miami-dolphins,30000,2013
24001,16941,0,Jeff Adams,G,dead_cap,miami-dolphins,16941,2013
24002,15612,0,Kheeston Randall,DT,dead_cap,miami-dolphins,15612,2013
24003,6000,0,Kevyn Scott,CB,dead_cap,miami-dolphins,6000,2013
24004,5000,0,Chas Alecxih,DT,dead_cap,miami-dolphins,5000,2013
24005,5000,0,Jeff Fuller,WR,dead_cap,miami-dolphins,5000,2013
24006,3334,0,Derek Moye,WR,dead_cap,miami-dolphins,3334,2013
24007,3334,0,Jarrell Root,DE,dead_cap,miami-dolphins,3334,2013
24008,3334,0,Jacquies Smith,OLB,dead_cap,miami-dolphins,3334,2013
24009,3334,0,Dustin Waldron,LT,dead_cap,miami-dolphins,3334,2013
24010,3333,0,Keelan Johnson,SS,dead_cap,miami-dolphins,3333,2013
24011,2500,0,Chad Bumphis,WR,dead_cap,miami-dolphins,2500,2013
24012,2500,0,Jasper Collins,WR,dead_cap,miami-dolphins,2500,2013
24013,2500,0,A.J. Francis,DE,dead_cap,miami-dolphins,2500,2013
24014,2500,0,Terrell Sinkfield,WR,dead_cap,miami-dolphins,2500,2013
24015,2000,0,Shelly Lyons,LB,dead_cap,miami-dolphins,2000,2013
24016,2000,0,Taylor Stockemer,WR,dead_cap,miami-dolphins,2000,2013
24017,1667,0,Les Brown,TE,dead_cap,miami-dolphins,1667,2013
24018,1666,0,Ina Liaina,FB,dead_cap,miami-dolphins,1666,2013
24019,0,1500,Jonas Gray,RB,dead_cap,miami-dolphins,1500,2013
24020,1500,0,Chris Barker,G,dead_cap,miami-dolphins,1500,2013
24021,1333,0,Emeka Onyenekwu,DE,dead_cap,miami-dolphins,1333,2013
24022,1000,0,Clay Belton,QB,dead_cap,miami-dolphins,1000,2013
24023,1000,0,Sam Brenner,C,dead_cap,miami-dolphins,1000,2013
24024,1000,0,Alonzo Highsmith,OLB,dead_cap,miami-dolphins,1000,2013
24025,1000,0,Rob McCabe,LB,dead_cap,miami-dolphins,1000,2013
24026,1000,0,Tristan Okpalaugo,DE,dead_cap,miami-dolphins,1000,2013
24027,666,0,Michael Clay,ILB,dead_cap,miami-dolphins,666,2013
24028,334,0,Andrew McDonald,RT,dead_cap,miami-dolphins,334,2013
24029,133,0,Cameron Marshall,RB,dead_cap,miami-dolphins,133,2013
24030,15000000,2250000,Mike Wallace,WR,active,miami-dolphins,17250000,2014
24031,6000000,1425000,Dannell Ellerbe,OLB,active,miami-dolphins,7425000,2014
24032,5820000,1465000,Cameron Wake,DE,active,miami-dolphins,7285000,2014
24033,5000000,1400000,Philip Wheeler,OLB,active,miami-dolphins,6400000,2014
24034,4785000,1425000,Brian Hartline,WR,active,miami-dolphins,6210000,2014
24035,4000000,1500000,Matt Moore,QB,active,miami-dolphins,5500000,2014
24036,3500000,1025000,Cortland Finnegan,CB,active,miami-dolphins,4525000,2014
24037,2500000,1725000,Branden Albert,LT,active,miami-dolphins,4225000,2014
24038,3000000,1000000,Randy Starks,DE,active,miami-dolphins,4000000,2014
24039,2475000,1525000,Brent Grimes,CB,active,miami-dolphins,4000000,2014
24040,2700000,1035000,Brandon Gibson,WR,active,miami-dolphins,3735000,2014
24041,3041116,545000,Brandon Fields,P,active,miami-dolphins,3586116,2014
24042,3000000,500000,Earl Mitchell,DT,active,miami-dolphins,3500000,2014
24043,570000,2885046,Ryan Tannehill,QB,active,miami-dolphins,3455046,2014
24044,1995882,1000000,Reshad Jones,SS,active,miami-dolphins,2995882,2014
24045,1637685,1308581,Mike Pouncey,C,active,miami-dolphins,2946266,2014
24046,1540000,2149548,Jared Odrick,DE,active,miami-dolphins,3689548,2014
24047,2250000,250000,Shelley Smith,G,active,miami-dolphins,2500000,2014
24048,1725000,603000,Koa Misi,OLB,active,miami-dolphins,2328000,2014
24049,1250000,750000,Daryn Colledge,G,active,miami-dolphins,2000000,2014
24050,1250000,609375,Samson Satele,C,active,miami-dolphins,1859375,2014
24051,1600000,191666,Nate Garner,RT,active,miami-dolphins,1791666,2014
24052,420000,1112436,Ja'Wuan James,RT,active,miami-dolphins,1532436,2014
24053,1431000,28000,Charles Clay,TE,active,miami-dolphins,1459000,2014
24054,1431000,11475,Jimmy Wilson,SS,active,miami-dolphins,1442475,2014
24055,855000,216668,Jason Trusnik,ILB,active,miami-dolphins,1071668,2014
24056,865087,110000,John Denney,LS,active,miami-dolphins,975087,2014
24057,549825,274300,Jamar Taylor,CB,active,miami-dolphins,824125,2014
24058,590000,169520,Olivier Vernon,DE,active,miami-dolphins,759520,2014
24059,570000,121500,Lamar Miller,RB,active,miami-dolphins,691500,2014
24060,520000,151594,Dallas Thomas,G,active,miami-dolphins,671594,2014
24061,730000,65000,Jason Fox,RT,active,miami-dolphins,795000,2014
24062,420000,211802,Jarvis Landry,WR,active,miami-dolphins,631802,2014
24063,500000,130300,Will Davis,CB,active,miami-dolphins,630300,2014
24064,495000,118172,Jelani Jenkins,OLB,active,miami-dolphins,613172,2014
24065,495000,116888,Dion Sims,TE,active,miami-dolphins,611888,2014
24066,645000,0,Kelvin Sheppard,ILB,active,miami-dolphins,645000,2014
24067,420000,174250,Billy Turner,G,active,miami-dolphins,594250,2014
24068,570000,13403,Rishard Matthews,WR,active,miami-dolphins,583403,2014
24069,570000,0,Jonathan Freeny,OLB,active,miami-dolphins,570000,2014
24070,645000,0,Daniel Thomas,RB,active,miami-dolphins,645000,2014
24071,495000,36140,Caleb Sturgis,K,active,miami-dolphins,531140,2014
24072,420000,103977,Walt Aikens,FS,active,miami-dolphins,523977,2014
24073,420000,40700,Jordan Tripp,ILB,active,miami-dolphins,460700,2014
24074,420000,13988,Terrence Fede,DE,active,miami-dolphins,433988,2014
24075,420000,1666,Damien Williams,RB,active,miami-dolphins,421666,2014
24076,420000,666,Anthony Johnson,DE,active,miami-dolphins,420666,2014
24077,420000,0,Chris McCain,OLB,active,miami-dolphins,420000,2014
24078,495000,0,Michael Thomas,FS,active,miami-dolphins,495000,2014
24079,318000,40700,Mike Gillislee,RB,active,miami-dolphins,358700,2014
24080,318000,0,A.J. Francis,DE,active,miami-dolphins,318000,2014
24081,316765,0,Sammy Seamster,CB,active,miami-dolphins,316765,2014
24082,303000,3333,Davonte Wallace,G,active,miami-dolphins,306333,2014
24083,570000,0,LaMichael James,RB,active,miami-dolphins,570000,2014
24084,232941,0,Jordan Kovacs,SS,active,miami-dolphins,232941,2014
24085,570000,0,R.J. Stanford,CB,active,miami-dolphins,570000,2014
24086,495000,0,Don Jones,FS,active,miami-dolphins,495000,2014
24087,570000,0,T.J. Heath,CB,active,miami-dolphins,570000,2014
24088,420000,0,Matt Hazel,WR,active,miami-dolphins,420000,2014
24089,420000,0,Gerell Robinson,WR,active,miami-dolphins,420000,2014
24090,495000,0,Sam Brenner,C,active,miami-dolphins,495000,2014
24091,420000,0,DeAndre Coleman,DT,active,miami-dolphins,420000,2014
24092,1475000,2025000,Louis Delmas,FS,injured_reserve,miami-dolphins,3500000,2014
24093,1975000,1025000,Knowshon Moreno,RB,injured_reserve,miami-dolphins,3000000,2014
24094,303000,47825,Arthur Lynch,TE,injured_reserve,miami-dolphins,350825,2014
24095,303000,666,Kamal Johnson,DT,injured_reserve,miami-dolphins,303666,2014
24096,25200,0,Lowell Rose,CB,practice_squad,miami-dolphins,25200,2014
24097,25200,0,L'Damian Washington,WR,practice_squad,miami-dolphins,25200,2014
24098,18900,0,Jake Stoneburner,TE,practice_squad,miami-dolphins,18900,2014
24099,12600,0,Mark Asper,LT,practice_squad,miami-dolphins,12600,2014
24100,12600,0,Emmanuel Dieke,DE,practice_squad,miami-dolphins,12600,2014
24101,12600,0,D'Aundre Reed,DE,practice_squad,miami-dolphins,12600,2014
24102,6300,0,Jake Knott,ILB,practice_squad,miami-dolphins,6300,2014
24103,2325000,0,Karlos Dansby,ILB,dead_cap,miami-dolphins,2325000,2014
24104,1250000,0,Kevin Burnett,OLB,dead_cap,miami-dolphins,1250000,2014
24105,1166667,0,Richard Marshall,CB,dead_cap,miami-dolphins,1166667,2014
24106,959734,0,Jonathan Martin,RT,dead_cap,miami-dolphins,959734,2014
24107,370588,166,Gator Hoskins,TE,dead_cap,miami-dolphins,370754,2014
24108,0,213435,Daniel Thomas,RB,dead_cap,miami-dolphins,213435,2014
24109,210741,0,Lowell Rose,CB,dead_cap,miami-dolphins,210741,2014
24110,0,157239,Michael Egnew,TE,dead_cap,miami-dolphins,157239,2014
24111,155524,0,DeAndre Coleman,DT,dead_cap,miami-dolphins,155524,2014
24112,155029,0,Orleans Darkwa,RB,dead_cap,miami-dolphins,155029,2014
24113,128823,30000,Damian Williams,WR,dead_cap,miami-dolphins,158823,2014
24114,125000,0,Vaughn Martin,DE,dead_cap,miami-dolphins,125000,2014
24115,94500,26450,Matt Hazel,WR,dead_cap,miami-dolphins,120950,2014
24116,102800,0,Sam Brenner,C,dead_cap,miami-dolphins,102800,2014
24117,74118,0,Bruce Gaston,DT,dead_cap,miami-dolphins,74118,2014
24118,69413,0,Brandian Ross,CB,dead_cap,miami-dolphins,69413,2014
24119,58235,0,Jake Knott,ILB,dead_cap,miami-dolphins,58235,2014
24120,50400,0,Seth Lobato,QB,dead_cap,miami-dolphins,50400,2014
24121,44100,0,Gerell Robinson,WR,dead_cap,miami-dolphins,44100,2014
24122,37941,0,Jalil Brown,CB,dead_cap,miami-dolphins,37941,2014
24123,37800,0,Mike Brewster,C,dead_cap,miami-dolphins,37800,2014
24124,37800,0,Laron Byrd,WR,dead_cap,miami-dolphins,37800,2014
24125,37800,0,Tony Hills,LT,dead_cap,miami-dolphins,37800,2014
24126,37800,0,LaMichael James,RB,dead_cap,miami-dolphins,37800,2014
24127,37800,0,Jacob Maxwell,TE,dead_cap,miami-dolphins,37800,2014
24128,31500,0,Emmanuel Dieke,DE,dead_cap,miami-dolphins,31500,2014
24129,31224,0,Kheeston Randall,DT,dead_cap,miami-dolphins,31224,2014
24130,25200,0,T.J. Heath,CB,dead_cap,miami-dolphins,25200,2014
24131,25200,0,Jake Murphy,TE,dead_cap,miami-dolphins,25200,2014
24132,25200,0,Gerald Rivers,DE,dead_cap,miami-dolphins,25200,2014
24133,25200,0,Jake Stoneburner,TE,dead_cap,miami-dolphins,25200,2014
24134,25200,0,Rod Sweeting,CB,dead_cap,miami-dolphins,25200,2014
24135,18900,2500,Marcus Thigpen,WR,dead_cap,miami-dolphins,21400,2014
24136,18900,0,Terrell Manning,ILB,dead_cap,miami-dolphins,18900,2014
24137,18900,0,Tommy Streeter,WR,dead_cap,miami-dolphins,18900,2014
24138,0,15000,David Arkin,G,dead_cap,miami-dolphins,15000,2014
24139,12600,0,Brett Brackett,TE,dead_cap,miami-dolphins,12600,2014
24140,12600,0,Rashaan Melvin,CB,dead_cap,miami-dolphins,12600,2014
24141,0,11474,Don Jones,FS,dead_cap,miami-dolphins,11474,2014
24142,5000,3666,Brock Jensen,QB,dead_cap,miami-dolphins,8666,2014
24143,6667,0,Keelan Johnson,SS,dead_cap,miami-dolphins,6667,2014
24144,6300,333,Garrison Smith,DE,dead_cap,miami-dolphins,6633,2014
24145,6300,0,Ahmad Dixon,S,dead_cap,miami-dolphins,6300,2014
24146,6300,0,David Hinds,OLB,dead_cap,miami-dolphins,6300,2014
24147,6300,0,Evan Wilson,TE,dead_cap,miami-dolphins,6300,2014
24148,5000,0,Chad Bumphis,WR,dead_cap,miami-dolphins,5000,2014
24149,5000,0,Jasper Collins,WR,dead_cap,miami-dolphins,5000,2014
24150,5000,0,A.J. Francis,DE,dead_cap,miami-dolphins,5000,2014
24151,5000,0,Michael Ola,T,dead_cap,miami-dolphins,5000,2014
24152,0,3500,Ryan Lankford,WR,dead_cap,miami-dolphins,3500,2014
24153,3334,0,Jordan Kovacs,SS,dead_cap,miami-dolphins,3334,2014
24154,3334,0,Ina Liaina,FB,dead_cap,miami-dolphins,3334,2014
24155,3334,0,Kelcie McCray,SS,dead_cap,miami-dolphins,3334,2014
24156,0,3000,Derrell Johnson,OLB,dead_cap,miami-dolphins,3000,2014
24157,3000,0,Chris Barker,G,dead_cap,miami-dolphins,3000,2014
24158,2667,0,Emeka Onyenekwu,DE,dead_cap,miami-dolphins,2667,2014
24159,0,2333,Tyler Larsen,C,dead_cap,miami-dolphins,2333,2014
24160,0,2000,Deion Belue,CB,dead_cap,miami-dolphins,2000,2014
24161,2000,0,Alonzo Highsmith,OLB,dead_cap,miami-dolphins,2000,2014
24162,2000,0,Tristan Okpalaugo,DE,dead_cap,miami-dolphins,2000,2014
24163,0,1666,Tevin Mims,DE,dead_cap,miami-dolphins,1666,2014
24164,0,1666,Marcus Thompson,OLB,dead_cap,miami-dolphins,1666,2014
24165,0,1500,Jonas Gray,RB,dead_cap,miami-dolphins,1500,2014
24166,1334,0,Michael Clay,ILB,dead_cap,miami-dolphins,1334,2014
24167,0,833,Steven Clarke,CB,dead_cap,miami-dolphins,833,2014
24168,0,666,Tariq Edwards,OLB,dead_cap,miami-dolphins,666,2014
24169,0,666,Andrew Wilson,OLB,dead_cap,miami-dolphins,666,2014
24170,0,666,Rantavious Wooten,WR,dead_cap,miami-dolphins,666,2014
24171,0,666,Demetrius Wright,S,dead_cap,miami-dolphins,666,2014
24172,334,0,Cameron Marshall,RB,dead_cap,miami-dolphins,334,2014
24173,0,333,Evan Finkenberg,RT,dead_cap,miami-dolphins,333,2014
24174,9000000,1725000,Branden Albert,LT,active,miami-dolphins,10725000,2015
24175,8475000,1525000,Brent Grimes,CB,active,miami-dolphins,10000000,2015
24176,6760000,952942,Reshad Jones,SS,active,miami-dolphins,7712942,2015
24177,6000000,1000000,Mike Pouncey,C,active,miami-dolphins,7000000,2015
24178,985000,5115000,Ndamukong Suh,DT,active,miami-dolphins,6100000,2015
24179,660000,4213364,Ryan Tannehill,QB,active,miami-dolphins,4873364,2015
24180,1000000,3562500,Jordan Cameron,TE,active,miami-dolphins,4562500,2015
24181,4000000,500000,Earl Mitchell,DT,active,miami-dolphins,4500000,2015
24182,1000000,1600000,Matt Moore,QB,active,miami-dolphins,2600000,2015
24183,900000,1600000,Greg Jennings,WR,active,miami-dolphins,2500000,2015
24184,2356000,0,Derrick Shelby,DT,active,miami-dolphins,2356000,2015
24185,1075000,925000,Kelvin Sheppard,ILB,active,miami-dolphins,2000000,2015
24186,1000000,1000000,Brice McCain,CB,active,miami-dolphins,2000000,2015
24187,435000,1542553,DeVante Parker,WR,active,miami-dolphins,1977553,2015
24188,803109,1112436,Ja'Wuan James,RT,active,miami-dolphins,1915545,2015
24189,1532000,169520,Olivier Vernon,DE,active,miami-dolphins,1701520,2015
24190,1542000,121500,Lamar Miller,RB,active,miami-dolphins,1663500,2015
24191,1060000,120000,John Denney,LS,active,miami-dolphins,1180000,2015
24192,734650,254300,Jamar Taylor,CB,active,miami-dolphins,988950,2015
24193,435000,358256,Jordan Phillips,DT,active,miami-dolphins,793256,2015
24194,577951,211802,Jarvis Landry,WR,active,miami-dolphins,789753,2015
24195,610000,151594,Dallas Thomas,G,active,miami-dolphins,761594,2015
24196,548750,174250,Billy Turner,G,active,miami-dolphins,723000,2015
24197,585000,118172,Jelani Jenkins,OLB,active,miami-dolphins,703172,2015
24198,585000,116888,Dion Sims,TE,active,miami-dolphins,701888,2015
24199,510000,103977,Walt Aikens,FS,active,miami-dolphins,613977,2015
24200,745000,0,Spencer Paysinger,ILB,active,miami-dolphins,745000,2015
24201,585000,0,Kenny Stills,WR,active,miami-dolphins,585000,2015
24202,585000,0,Michael Thomas,FS,active,miami-dolphins,585000,2015
24203,435000,129641,Jamil Douglas,C,active,miami-dolphins,564641,2015
24204,534840,0,Quinton Coples,OLB,active,miami-dolphins,534840,2015
24205,510000,13988,Terrence Fede,DE,active,miami-dolphins,523988,2015
24206,510000,1666,Damien Williams,RB,active,miami-dolphins,511666,2015
24207,435000,57072,Bobby McCain,CB,active,miami-dolphins,492072,2015
24208,435000,53690,Tony Lippett,CB,active,miami-dolphins,488690,2015
24209,480000,0,Jake Stoneburner,TE,active,miami-dolphins,480000,2015
24210,435000,3333,Zach Vigil,OLB,active,miami-dolphins,438333,2015
24211,435000,333,Matt Darr,P,active,miami-dolphins,435333,2015
24212,435000,333,Neville Hewitt,OLB,active,miami-dolphins,435333,2015
24213,379941,55203,Jay Ajayi,RB,active,miami-dolphins,435144,2015
24214,435000,0,Andrew Franks,K,active,miami-dolphins,435000,2015
24215,435000,0,Matt Hazel,WR,active,miami-dolphins,435000,2015
24216,255882,0,Ulrick John,LT,active,miami-dolphins,255882,2015
24217,153529,0,Shamiel Gary,S,active,miami-dolphins,153529,2015
24218,90000,62500,Logan Thomas,TE,active,miami-dolphins,152500,2015
24219,137647,0,Damontre Moore,DE,active,miami-dolphins,137647,2015
24220,120000,0,DeAndre Coleman,DT,active,miami-dolphins,120000,2015
24221,87647,0,Jacques McClendon,C,active,miami-dolphins,87647,2015
24222,87647,0,Shelley Smith,G,active,miami-dolphins,87647,2015
24223,77647,0,James-Michael Johnson,OLB,active,miami-dolphins,77647,2015
24224,60000,0,Tyler Patmon,CB,active,miami-dolphins,60000,2015
24225,25588,0,Mike Hull,ILB,active,miami-dolphins,25588,2015
24226,8950000,1500000,Cameron Wake,DE,injured_reserve,miami-dolphins,10450000,2015
24227,3835000,603000,Koa Misi,OLB,injured_reserve,miami-dolphins,4438000,2015
24228,438000,1859375,Louis Delmas,FS,injured_reserve,miami-dolphins,2297375,2015
24229,660000,13403,Rishard Matthews,WR,injured_reserve,miami-dolphins,673403,2015
24230,489176,0,Chris McCain,OLB,injured_reserve,miami-dolphins,489176,2015
24231,137647,0,Brandon Williams,TE,injured_reserve,miami-dolphins,137647,2015
24232,0,6600000,Mike Wallace,WR,dead_cap,miami-dolphins,6600000,2015
24233,700000,5700000,Dannell Ellerbe,OLB,dead_cap,miami-dolphins,6400000,2015
24234,0,4200000,Brian Hartline,WR,dead_cap,miami-dolphins,4200000,2015
24235,0,1400000,Philip Wheeler,OLB,dead_cap,miami-dolphins,1400000,2015
24236,970000,80000,C.J. Mosley,DT,dead_cap,miami-dolphins,1050000,2015
24237,0,1000000,Cortland Finnegan,CB,dead_cap,miami-dolphins,1000000,2015
24238,0,1000000,Brandon Gibson,WR,dead_cap,miami-dolphins,1000000,2015
24239,0,1000000,Randy Starks,DE,dead_cap,miami-dolphins,1000000,2015
24240,770000,187500,Jason Fox,RT,dead_cap,miami-dolphins,957500,2015
24241,0,870000,Brandon Fields,P,dead_cap,miami-dolphins,870000,2015
24242,745000,80000,Zackary Bowman,CB,dead_cap,miami-dolphins,825000,2015
24243,613529,50000,Jeff Linkenbach,RT,dead_cap,miami-dolphins,663529,2015
24244,447352,20000,Jordan Kovacs,SS,dead_cap,miami-dolphins,467352,2015
24245,388823,20000,LaMichael James,RB,dead_cap,miami-dolphins,408823,2015
24246,309600,0,Jonas Gray,RB,dead_cap,miami-dolphins,309600,2015
24247,270000,20000,A.J. Francis,DE,dead_cap,miami-dolphins,290000,2015
24248,276600,0,Sam Brenner,C,dead_cap,miami-dolphins,276600,2015
24249,0,275000,J.D. Walton,C,dead_cap,miami-dolphins,275000,2015
24250,0,250000,Shelley Smith,G,dead_cap,miami-dolphins,250000,2015
24251,69705,130300,Will Davis,CB,dead_cap,miami-dolphins,200005,2015
24252,112200,55132,Cedric Thompson,FS,dead_cap,miami-dolphins,167332,2015
24253,0,166668,Nate Garner,RT,dead_cap,miami-dolphins,166668,2015
24254,146976,4166,Mike Hull,ILB,dead_cap,miami-dolphins,151142,2015
24255,0,147239,Michael Egnew,TE,dead_cap,miami-dolphins,147239,2015
24256,175293,0,Jacques McClendon,C,dead_cap,miami-dolphins,175293,2015
24257,136164,0,Jordan Williams,DT,dead_cap,miami-dolphins,136164,2015
24258,127941,0,Raheem Mostert,RB,dead_cap,miami-dolphins,127941,2015
24259,99000,0,Terrell Manning,ILB,dead_cap,miami-dolphins,99000,2015
24260,88623,0,Brandon Williams,TE,dead_cap,miami-dolphins,88623,2015
24261,85800,0,Vinston Painter,RT,dead_cap,miami-dolphins,85800,2015
24262,85800,0,Logan Thomas,TE,dead_cap,miami-dolphins,85800,2015
24263,0,79350,Matt Hazel,WR,dead_cap,miami-dolphins,79350,2015
24264,66600,0,Jonathan Dowling,FS,dead_cap,miami-dolphins,66600,2015
24265,66000,0,Tim Semisch,TE,dead_cap,miami-dolphins,66000,2015
24266,66000,0,Donald Hawkins,G,dead_cap,miami-dolphins,66000,2015
24267,0,47825,Arthur Lynch,TE,dead_cap,miami-dolphins,47825,2015
24268,0,40700,Mike Gillislee,RB,dead_cap,miami-dolphins,40700,2015
24269,0,40700,Jordan Tripp,ILB,dead_cap,miami-dolphins,40700,2015
24270,39600,0,Anthony Steen,G,dead_cap,miami-dolphins,39600,2015
24271,38823,0,James-Michael Johnson,OLB,dead_cap,miami-dolphins,38823,2015
24272,0,36140,Caleb Sturgis,K,dead_cap,miami-dolphins,36140,2015
24273,33000,0,DeAndre Coleman,DT,dead_cap,miami-dolphins,33000,2015
24274,26400,0,Dax Swanson,SS,dead_cap,miami-dolphins,26400,2015
24275,25588,0,Robert Thomas,DT,dead_cap,miami-dolphins,25588,2015
24276,0,22948,Don Jones,FS,dead_cap,miami-dolphins,22948,2015
24277,19800,500,Damarr Aultman,WR,dead_cap,miami-dolphins,20300,2015
24278,0,20000,Josh Freeman,QB,dead_cap,miami-dolphins,20000,2015
24279,19800,0,Emmanuel Dieke,DE,dead_cap,miami-dolphins,19800,2015
24280,19800,0,Shamiel Gary,S,dead_cap,miami-dolphins,19800,2015
24281,19800,0,Julius Warmsley,DE,dead_cap,miami-dolphins,19800,2015
24282,13200,0,Jahwan Edwards,RB,dead_cap,miami-dolphins,13200,2015
24283,0,7334,Brock Jensen,QB,dead_cap,miami-dolphins,7334,2015
24284,6600,333,Michael Liedtke,G,dead_cap,miami-dolphins,6933,2015
24285,0,6667,Davonte Wallace,G,dead_cap,miami-dolphins,6667,2015
24286,6600,0,Bronson Hill,RB,dead_cap,miami-dolphins,6600,2015
24287,6600,0,Deon Long,WR,dead_cap,miami-dolphins,6600,2015
24288,6600,0,Marcus Lucas,TE,dead_cap,miami-dolphins,6600,2015
24289,6600,0,Chris Martin,RT,dead_cap,miami-dolphins,6600,2015
24290,6600,0,Uzoma Nwachukwu,WR,dead_cap,miami-dolphins,6600,2015
24291,6600,0,Tyler Patmon,CB,dead_cap,miami-dolphins,6600,2015
24292,6600,0,Trovon Reed,CB,dead_cap,miami-dolphins,6600,2015
24293,6600,0,Jake Stoneburner,TE,dead_cap,miami-dolphins,6600,2015
24294,6600,0,Trey Williams,RB,dead_cap,miami-dolphins,6600,2015
24295,0,6000,Derrell Johnson,OLB,dead_cap,miami-dolphins,6000,2015
24296,0,4667,Tyler Larsen,C,dead_cap,miami-dolphins,4667,2015
24297,0,3666,Aundrey Walker,G,dead_cap,miami-dolphins,3666,2015
24298,0,3334,Tevin Mims,DE,dead_cap,miami-dolphins,3334,2015
24299,0,3334,Marcus Thompson,OLB,dead_cap,miami-dolphins,3334,2015
24300,0,2166,Christion Jones,WR,dead_cap,miami-dolphins,2166,2015
24301,0,2166,Jeff Luc,ILB,dead_cap,miami-dolphins,2166,2015
24302,0,1667,Steven Clarke,CB,dead_cap,miami-dolphins,1667,2015
24303,0,1666,Ray Drew,DE,dead_cap,miami-dolphins,1666,2015
24304,0,1666,Ellis McCarthy,DT,dead_cap,miami-dolphins,1666,2015
24305,0,1334,Tariq Edwards,OLB,dead_cap,miami-dolphins,1334,2015
24306,0,1334,Andrew Wilson,OLB,dead_cap,miami-dolphins,1334,2015
24307,0,1334,Rantavious Wooten,WR,dead_cap,miami-dolphins,1334,2015
24308,0,1334,Demetrius Wright,S,dead_cap,miami-dolphins,1334,2015
24309,0,1000,Nigel King,WR,dead_cap,miami-dolphins,1000,2015
24310,0,667,Evan Finkenberg,RT,dead_cap,miami-dolphins,667,2015
24311,0,667,Garrison Smith,DE,dead_cap,miami-dolphins,667,2015
24312,0,666,Mickey Baucus,T,dead_cap,miami-dolphins,666,2015
24313,0,666,Kamal Johnson,DT,dead_cap,miami-dolphins,666,2015
24314,0,666,Anthony Johnson,DE,dead_cap,miami-dolphins,666,2015
24315,0,334,Gator Hoskins,TE,dead_cap,miami-dolphins,334,2015
24316,3485000,9115000,Ndamukong Suh,DT,active,miami-dolphins,12600000,2016
24317,9340000,2300000,Ryan Tannehill,QB,active,miami-dolphins,11640000,2016
24318,8425000,1725000,Branden Albert,LT,active,miami-dolphins,10150000,2016
24319,7000000,1525000,Cameron Wake,DE,active,miami-dolphins,8525000,2016
24320,8500000,0,Byron Maxwell,CB,active,miami-dolphins,8500000,2016
24321,4485000,2015000,Mario Williams,DE,active,miami-dolphins,6500000,2016
24322,2975000,525000,Earl Mitchell,DT,active,miami-dolphins,3500000,2016
24323,2500000,203125,Andre Branch,DE,active,miami-dolphins,2703125,2016
24324,929389,1542553,DeVante Parker,WR,active,miami-dolphins,2471942,2016
24325,1186218,1112436,Ja'Wuan James,RT,active,miami-dolphins,2298654,2016
24326,450000,1815027,Laremy Tunsil,LT,active,miami-dolphins,2265027,2016
24327,1671000,118172,Jelani Jenkins,OLB,active,miami-dolphins,1789172,2016
24328,1671000,116888,Dion Sims,TE,active,miami-dolphins,1787888,2016
24329,1671000,0,Kenny Stills,WR,active,miami-dolphins,1671000,2016
24330,885000,552500,Jermon Bushrod,G,active,miami-dolphins,1437500,2016
24331,1000000,400000,Matt Moore,QB,active,miami-dolphins,1400000,2016
24332,1095000,120000,John Denney,LS,active,miami-dolphins,1215000,2016
24333,975000,150000,Kraig Urbik,G,active,miami-dolphins,1125000,2016
24334,450000,664189,Xavien Howard,CB,active,miami-dolphins,1114189,2016
24335,633314,358256,Jordan Phillips,DT,active,miami-dolphins,991570,2016
24336,941418,50000,Kiko Alonso,OLB,active,miami-dolphins,991418,2016
24337,735901,211802,Jarvis Landry,WR,active,miami-dolphins,947703,2016
24338,600000,103977,Walt Aikens,FS,active,miami-dolphins,703977,2016
24339,760000,80000,Spencer Paysinger,ILB,active,miami-dolphins,840000,2016
24340,675000,0,Michael Thomas,FS,active,miami-dolphins,675000,2016
24341,450000,205315,Kenyan Drake,RB,active,miami-dolphins,655315,2016
24342,536470,100000,Sam Young,LT,active,miami-dolphins,636470,2016
24343,450000,175097,Leonte Carroo,WR,active,miami-dolphins,625097,2016
24344,600000,13988,Terrence Fede,DE,active,miami-dolphins,613988,2016
24345,600000,1668,Damien Williams,RB,active,miami-dolphins,601668,2016
24346,525000,57072,Bobby McCain,CB,active,miami-dolphins,582072,2016
24347,525000,55203,Jay Ajayi,RB,active,miami-dolphins,580203,2016
24348,525000,53691,Tony Lippett,CB,active,miami-dolphins,578691,2016
24349,760000,0,Donald Butler,ILB,active,miami-dolphins,760000,2016
24350,525000,333,Matt Darr,P,active,miami-dolphins,525333,2016
24351,525000,333,Neville Hewitt,OLB,active,miami-dolphins,525333,2016
24352,525000,0,Andrew Franks,K,active,miami-dolphins,525000,2016
24353,525000,0,Mike Hull,ILB,active,miami-dolphins,525000,2016
24354,525000,0,Anthony Steen,G,active,miami-dolphins,525000,2016
24355,516178,0,Dominique Jones,TE,active,miami-dolphins,516178,2016
24356,450000,35095,Jakeem Grant,WR,active,miami-dolphins,485095,2016
24357,397058,0,Bacarri Rambo,SS,active,miami-dolphins,397058,2016
24358,388234,0,Nick Williams,DE,active,miami-dolphins,388234,2016
24359,238230,0,Thomas Duarte,TE,active,miami-dolphins,238230,2016
24360,211760,0,Lafayette Pitts,CB,active,miami-dolphins,211760,2016
24361,185290,0,Jake Brendel,C,active,miami-dolphins,185290,2016
24362,134117,0,T.J. Yates,QB,active,miami-dolphins,134117,2016
24363,132350,0,Rashawn Scott,WR,active,miami-dolphins,132350,2016
24364,70588,0,Trevor Reilly,OLB,active,miami-dolphins,70588,2016
24365,26470,0,A.J. Hendy,S,active,miami-dolphins,26470,2016
24366,9000000,1025000,Mike Pouncey,C,injured_reserve,miami-dolphins,10025000,2016
24367,7225000,977942,Reshad Jones,SS,injured_reserve,miami-dolphins,8202942,2016
24368,6000000,2000000,Jordan Cameron,TE,injured_reserve,miami-dolphins,8000000,2016
24369,760000,2360500,Koa Misi,OLB,injured_reserve,miami-dolphins,3120500,2016
24370,1725000,858333,Isa Abdul-Quddus,FS,injured_reserve,miami-dolphins,2583333,2016
24371,333000,0,Ifo Ekpre-Olomu,CB,injured_reserve,miami-dolphins,333000,2016
24372,600000,4759132,Dion Jordan,DE,non_fb_injury,miami-dolphins,5359132,2016
24373,0,3000000,Brent Grimes,CB,dead_cap,miami-dolphins,3000000,2016
24374,0,2800000,Philip Wheeler,OLB,dead_cap,miami-dolphins,2800000,2016
24375,0,1500000,Greg Jennings,WR,dead_cap,miami-dolphins,1500000,2016
24376,780882,617188,Jason Jones,DE,dead_cap,miami-dolphins,1398070,2016
24377,0,1000000,Brice McCain,CB,dead_cap,miami-dolphins,1000000,2016
24378,798117,75000,Chris Culliver,CB,dead_cap,miami-dolphins,873117,2016
24379,364411,453750,Arian Foster,RB,dead_cap,miami-dolphins,818161,2016
24380,0,770000,Brandon Fields,P,dead_cap,miami-dolphins,770000,2016
24381,491470,151594,Dallas Thomas,G,dead_cap,miami-dolphins,643064,2016
24382,379941,0,Zach Vigil,OLB,dead_cap,miami-dolphins,379941,2016
24383,201985,174250,Billy Turner,G,dead_cap,miami-dolphins,376235,2016
24384,320942,0,Bene Benwikere,CB,dead_cap,miami-dolphins,320942,2016
24385,317647,0,Chris Jones,DT,dead_cap,miami-dolphins,317647,2016
24386,0,254300,Jamar Taylor,CB,dead_cap,miami-dolphins,254300,2016
24387,247390,0,Julius Warmsley,DE,dead_cap,miami-dolphins,247390,2016
24388,236876,0,Leon Orr,DT,dead_cap,miami-dolphins,236876,2016
24389,163340,43940,Brandon Doughty,QB,dead_cap,miami-dolphins,207280,2016
24390,0,165396,Cedric Thompson,FS,dead_cap,miami-dolphins,165396,2016
24391,0,162500,Jason Fox,RT,dead_cap,miami-dolphins,162500,2016
24392,20700,129641,Jamil Douglas,C,dead_cap,miami-dolphins,150341,2016
24393,0,150000,Sam Young,LT,dead_cap,miami-dolphins,150000,2016
24394,178823,0,Chimdi Chekwa,CB,dead_cap,miami-dolphins,178823,2016
24395,0,130300,Will Davis,CB,dead_cap,miami-dolphins,130300,2016
24396,119117,0,Justin Hunter,WR,dead_cap,miami-dolphins,119117,2016
24397,117300,0,Brandon Watts,OLB,dead_cap,miami-dolphins,117300,2016
24398,110400,0,A.J. Hendy,S,dead_cap,miami-dolphins,110400,2016
24399,92800,3333,Rashawn Scott,WR,dead_cap,miami-dolphins,96133,2016
24400,0,95650,Arthur Lynch,TE,dead_cap,miami-dolphins,95650,2016
24401,89411,0,Bryce Harris,RT,dead_cap,miami-dolphins,89411,2016
24402,82800,0,Senorise Perry,RB,dead_cap,miami-dolphins,82800,2016
24403,82800,0,Terry Poole,G,dead_cap,miami-dolphins,82800,2016
24404,0,81400,Jordan Tripp,ILB,dead_cap,miami-dolphins,81400,2016
24405,55200,19712,Thomas Duarte,TE,dead_cap,miami-dolphins,74912,2016
24406,0,62500,Logan Thomas,TE,dead_cap,miami-dolphins,62500,2016
24407,62100,0,Lafayette Pitts,CB,dead_cap,miami-dolphins,62100,2016
24408,55200,0,Storm Johnson,RB,dead_cap,miami-dolphins,55200,2016
24409,55200,0,Cleyon Laing,DE,dead_cap,miami-dolphins,55200,2016
24410,41400,0,Jesse Davis,T,dead_cap,miami-dolphins,41400,2016
24411,0,40700,Mike Gillislee,RB,dead_cap,miami-dolphins,40700,2016
24412,0,36140,Caleb Sturgis,K,dead_cap,miami-dolphins,36140,2016
24413,34500,0,Jake Brendel,C,dead_cap,miami-dolphins,34500,2016
24414,34500,0,Da'Ron Brown,WR,dead_cap,miami-dolphins,34500,2016
24415,34500,0,Ulrick John,LT,dead_cap,miami-dolphins,34500,2016
24416,13800,0,James Burgess,ILB,dead_cap,miami-dolphins,13800,2016
24417,13800,0,Jordan Williams,DT,dead_cap,miami-dolphins,13800,2016
24418,0,8334,Mike Hull,ILB,dead_cap,miami-dolphins,8334,2016
24419,0,7334,Aundrey Walker,G,dead_cap,miami-dolphins,7334,2016
24420,6900,0,Lamin Barrow,ILB,dead_cap,miami-dolphins,6900,2016
24421,0,4334,Christion Jones,WR,dead_cap,miami-dolphins,4334,2016
24422,0,4334,Jeff Luc,ILB,dead_cap,miami-dolphins,4334,2016
24423,0,3334,Ray Drew,DE,dead_cap,miami-dolphins,3334,2016
24424,0,3334,Ellis McCarthy,DT,dead_cap,miami-dolphins,3334,2016
24425,0,2000,Nigel King,WR,dead_cap,miami-dolphins,2000,2016
24426,0,1334,Mickey Baucus,T,dead_cap,miami-dolphins,1334,2016
24427,0,1000,Damarr Aultman,WR,dead_cap,miami-dolphins,1000,2016
24428,0,668,Anthony Johnson,DE,dead_cap,miami-dolphins,668,2016
24429,0,667,Kamal Johnson,DT,dead_cap,miami-dolphins,667,2016
24430,0,667,Michael Liedtke,G,dead_cap,miami-dolphins,667,2016
24431,9985000,9115000,Ndamukong Suh,DT,active,miami-dolphins,19100000,2017
24432,5000000,5000000,Jay Cutler,QB,active,miami-dolphins,10000000,2017
24433,7950000,1025000,Mike Pouncey,C,active,miami-dolphins,8975000,2017
24434,6875000,625000,Cameron Wake,DE,active,miami-dolphins,7500000,2017
24435,2900000,2100000,Andre Branch,DE,active,miami-dolphins,5000000,2017
24436,1975000,1775000,Kenny Stills,WR,active,miami-dolphins,3750000,2017
24437,950000,2792938,Reshad Jones,SS,active,miami-dolphins,3742938,2017
24438,941176,2775000,Lawrence Timmons,ILB,active,miami-dolphins,3716176,2017
24439,1423776,1542554,DeVante Parker,WR,active,miami-dolphins,2966330,2017
24440,1075000,1787500,Kiko Alonso,OLB,active,miami-dolphins,2862500,2017
24441,1016257,1815027,Laremy Tunsil,LT,active,miami-dolphins,2831284,2017
24442,1500000,1250000,Anthony Fasano,TE,active,miami-dolphins,2750000,2017
24443,944445,1352000,T.J. McDonald,FS,active,miami-dolphins,2296445,2017
24444,1750000,400000,Matt Moore,QB,active,miami-dolphins,2150000,2017
24445,465000,1506589,Charles Harris,DE,active,miami-dolphins,1971589,2017
24446,1797000,0,Damien Williams,RB,active,miami-dolphins,1797000,2017
24447,975000,441666,Ted Larsen,G,active,miami-dolphins,1416666,2017
24448,728547,664189,Xavien Howard,CB,active,miami-dolphins,1392736,2017
24449,831628,358256,Jordan Phillips,DT,active,miami-dolphins,1189884,2017
24450,893852,211802,Jarvis Landry,WR,active,miami-dolphins,1105654,2017
24451,1004015,0,Stephone Anthony,OLB,active,miami-dolphins,1004015,2017
24452,775000,150000,MarQueis Gray,TE,active,miami-dolphins,925000,2017
24453,900000,0,Sam Young,LT,active,miami-dolphins,900000,2017
24454,595000,205315,Kenyan Drake,RB,active,miami-dolphins,800315,2017
24455,690000,103977,Walt Aikens,FS,active,miami-dolphins,793977,2017
24456,690000,13988,Terrence Fede,DE,active,miami-dolphins,703988,2017
24457,900000,80000,John Denney,LS,active,miami-dolphins,980000,2017
24458,900000,80000,Alterraun Verner,CB,active,miami-dolphins,980000,2017
24459,690000,0,Cody Parkey,K,active,miami-dolphins,690000,2017
24460,615000,57072,Bobby McCain,CB,active,miami-dolphins,672072,2017
24461,465000,176572,Cordrea Tankersley,CB,active,miami-dolphins,641572,2017
24462,615000,0,Mike Hull,ILB,active,miami-dolphins,615000,2017
24463,540000,35095,Jakeem Grant,WR,active,miami-dolphins,575095,2017
24464,540000,0,Jake Brendel,C,active,miami-dolphins,540000,2017
24465,540000,0,Senorise Perry,RB,active,miami-dolphins,540000,2017
24466,465000,65198,Isaac Asiata,G,active,miami-dolphins,530198,2017
24467,465000,50484,Davon Godchaux,DT,active,miami-dolphins,515484,2017
24468,465000,3333,Chase Allen,OLB,active,miami-dolphins,468333,2017
24469,465000,2500,Torry McTyer,CB,active,miami-dolphins,467500,2017
24470,465000,1333,Matt Haack,P,active,miami-dolphins,466333,2017
24471,465000,0,Jesse Davis,T,active,miami-dolphins,465000,2017
24472,421941,0,Jordan Lucas,S,active,miami-dolphins,421941,2017
24473,405880,0,David Fales,QB,active,miami-dolphins,405880,2017
24474,389288,3333,Eric Smith,T,active,miami-dolphins,392621,2017
24475,218824,0,Zach Sterup,T,active,miami-dolphins,218824,2017
24476,217059,0,Neville Hewitt,OLB,active,miami-dolphins,217059,2017
24477,180880,0,A.J. Derby,TE,active,miami-dolphins,180880,2017
24478,136765,0,Cameron Malveaux,DE,active,miami-dolphins,136765,2017
24479,136765,0,De'Veon Smith,RB,active,miami-dolphins,136765,2017
24480,54706,0,Thomas Duarte,TE,active,miami-dolphins,54706,2017
24481,31765,0,Rashawn Scott,WR,active,miami-dolphins,31765,2017
24482,31765,0,Gabe Wright,DT,active,miami-dolphins,31765,2017
24483,27353,0,Trae Elston,S,active,miami-dolphins,27353,2017
24484,17975000,2325000,Ryan Tannehill,QB,injured_reserve,miami-dolphins,20300000,2017
24485,5500000,100000,Julius Thomas,TE,injured_reserve,miami-dolphins,5600000,2017
24486,2750000,2000000,William Hayes,DE,injured_reserve,miami-dolphins,4750000,2017
24487,1125000,2426125,Koa Misi,OLB,injured_reserve,miami-dolphins,3551125,2017
24488,1400000,2000000,Nate Allen,FS,injured_reserve,miami-dolphins,3400000,2017
24489,1475000,1525000,Jermon Bushrod,G,injured_reserve,miami-dolphins,3000000,2017
24490,1569327,1112436,Ja'Wuan James,RT,injured_reserve,miami-dolphins,2681763,2017
24491,1797000,0,Michael Thomas,FS,injured_reserve,miami-dolphins,1797000,2017
24492,348000,389098,Raekwon McMillan,OLB,injured_reserve,miami-dolphins,737098,2017
24493,615000,53691,Tony Lippett,CB,injured_reserve,miami-dolphins,668691,2017
24494,465000,38603,Vincent Taylor,DT,injured_reserve,miami-dolphins,503603,2017
24495,489526,0,Anthony Steen,G,injured_reserve,miami-dolphins,489526,2017
24496,378000,0,Lamin Barrow,ILB,injured_reserve,miami-dolphins,378000,2017
24497,348000,19575,Isaiah Ford,WR,injured_reserve,miami-dolphins,367575,2017
24498,560000,175097,Leonte Carroo,WR,non_fb_injury,miami-dolphins,735097,2017
24499,465000,2833,Maurice Smith,S,non_fb_injury,miami-dolphins,467833,2017
24500,8500000,0,Byron Maxwell,CB,dead_cap,miami-dolphins,8500000,2017
24501,0,3400000,Branden Albert,LT,dead_cap,miami-dolphins,3400000,2017
24502,0,2000000,Mario Williams,DE,dead_cap,miami-dolphins,2000000,2017
24503,0,1666667,Isa Abdul-Quddus,FS,dead_cap,miami-dolphins,1666667,2017
24504,900000,80000,Rey Maualuga,ILB,dead_cap,miami-dolphins,980000,2017
24505,0,500000,Earl Mitchell,DT,dead_cap,miami-dolphins,500000,2017
24506,289412,55203,Jay Ajayi,RB,dead_cap,miami-dolphins,344615,2017
24507,202400,131822,Brandon Doughty,QB,dead_cap,miami-dolphins,334222,2017
24508,282920,6667,Rashawn Scott,WR,dead_cap,miami-dolphins,289587,2017
24509,125000,150000,Sam Young,LT,dead_cap,miami-dolphins,275000,2017
24510,0,259282,Jamil Douglas,C,dead_cap,miami-dolphins,259282,2017
24511,0,174250,Billy Turner,G,dead_cap,miami-dolphins,174250,2017
24512,108000,59139,Thomas Duarte,TE,dead_cap,miami-dolphins,167139,2017
24513,0,150000,Kraig Urbik,G,dead_cap,miami-dolphins,150000,2017
24514,0,150000,Nick Williams,DE,dead_cap,miami-dolphins,150000,2017
24515,122400,0,Sean Hickey,T,dead_cap,miami-dolphins,122400,2017
24516,122400,0,Malcolm Lewis,WR,dead_cap,miami-dolphins,122400,2017
24517,122400,0,Drew Morgan,WR,dead_cap,miami-dolphins,122400,2017
24518,115200,0,Gabe Wright,DT,dead_cap,miami-dolphins,115200,2017
24519,106553,0,De'Veon Smith,RB,dead_cap,miami-dolphins,106553,2017
24520,95294,0,Justin March,ILB,dead_cap,miami-dolphins,95294,2017
24521,86400,0,Cameron Malveaux,DE,dead_cap,miami-dolphins,86400,2017
24522,0,66666,Deon Lacey,OLB,dead_cap,miami-dolphins,66666,2017
24523,64800,0,Kolby Listenbee,WR,dead_cap,miami-dolphins,64800,2017
24524,28800,29991,Jordan Lucas,S,dead_cap,miami-dolphins,58791,2017
24525,43200,334,Neville Hewitt,OLB,dead_cap,miami-dolphins,43534,2017
24526,36000,0,Brandon Radcliff,RB,dead_cap,miami-dolphins,36000,2017
24527,36000,0,Trevor Reilly,OLB,dead_cap,miami-dolphins,36000,2017
24528,28800,0,Jonathan Woodard,DE,dead_cap,miami-dolphins,28800,2017
24529,14400,0,Tracy Howard,CB,dead_cap,miami-dolphins,14400,2017
24530,14400,0,David Rivers III,CB,dead_cap,miami-dolphins,14400,2017
24531,0,3334,Zach Vigil,OLB,dead_cap,miami-dolphins,3334,2017
24532,0,2500,Lawrence Okoye,DT,dead_cap,miami-dolphins,2500,2017
24533,0,334,Matt Darr,P,dead_cap,miami-dolphins,334,2017
24534,10333301,1111111,Robert Quinn,DE,active,miami-dolphins,11444412,2018
24535,7900000,2100000,Andre Branch,DE,active,miami-dolphins,10000000,2018
24536,7975000,1775000,Kenny Stills,WR,active,miami-dolphins,9750000,2018
24537,7875000,1787500,Kiko Alonso,OLB,active,miami-dolphins,9662500,2018
24538,8000000,1625000,Cameron Wake,DE,active,miami-dolphins,9625000,2018
24539,9341000,0,Ja'Wuan James,RT,active,miami-dolphins,9341000,2018
24540,790000,7886666,Ryan Tannehill,QB,active,miami-dolphins,8676666,2018
24541,2950000,3050000,Danny Amendola,WR,active,miami-dolphins,6000000,2018
24542,915000,4045000,Reshad Jones,SS,active,miami-dolphins,4960000,2018
24543,1918165,1542553,DeVante Parker,WR,active,miami-dolphins,3460718,2018
24544,1582514,1815027,Laremy Tunsil,LT,active,miami-dolphins,3397541,2018
24545,480000,2510504,Minkah Fitzpatrick,S,active,miami-dolphins,2990504,2018
24546,2575000,350000,Akeem Spence,DT,active,miami-dolphins,2925000,2018
24547,1500000,1002000,T.J. McDonald,FS,active,miami-dolphins,2502000,2018
24548,957897,1506589,Charles Harris,DE,active,miami-dolphins,2464486,2018
24549,1500000,441666,Ted Larsen,G,active,miami-dolphins,1941666,2018
24550,1007094,664189,Xavien Howard,CB,active,miami-dolphins,1671283,2018
24551,705000,797072,Bobby McCain,CB,active,miami-dolphins,1502072,2018
24552,1087150,402176,Stephone Anthony,OLB,active,miami-dolphins,1489326,2018
24553,800000,500000,Walt Aikens,SS,active,miami-dolphins,1300000,2018
24554,480000,722168,Mike Gesicki,TE,active,miami-dolphins,1202168,2018
24555,678524,389098,Raekwon McMillan,ILB,active,miami-dolphins,1067622,2018
24556,705000,205315,Kenyan Drake,RB,active,miami-dolphins,910315,2018
24557,850000,0,Brandon Bolden,RB,active,miami-dolphins,850000,2018
24558,705000,100000,Nick O'Leary,TE,active,miami-dolphins,805000,2018
24559,800000,0,Travis Swanson,C,active,miami-dolphins,800000,2018
24560,480000,243800,Jerome Baker,OLB,active,miami-dolphins,723800,2018
24561,790000,90000,David Fales,QB,active,miami-dolphins,880000,2018
24562,790000,90000,Brock Osweiler,QB,active,miami-dolphins,880000,2018
24563,705000,0,Mike Hull,ILB,active,miami-dolphins,705000,2018
24564,480000,158058,Durham Smythe,TE,active,miami-dolphins,638058,2018
24565,1015000,0,John Denney,LS,active,miami-dolphins,1015000,2018
24566,630000,0,Senorise Perry,RB,active,miami-dolphins,630000,2018
24567,480000,147295,Kalen Ballage,RB,active,miami-dolphins,627295,2018
24568,555000,50484,Davon Godchaux,DT,active,miami-dolphins,605484,2018
24569,592059,0,Sam Young,LT,active,miami-dolphins,592059,2018
24570,555000,2500,Torry McTyer,CB,active,miami-dolphins,557500,2018
24571,555000,1333,Matt Haack,P,active,miami-dolphins,556333,2018
24572,555000,0,Jesse Davis,G,active,miami-dolphins,555000,2018
24573,555000,0,Zach Sterup,T,active,miami-dolphins,555000,2018
24574,480000,29602,Cornell Armstrong,CB,active,miami-dolphins,509602,2018
24575,480000,22800,Jason Sanders,K,active,miami-dolphins,502800,2018
24576,604118,0,Wesley Johnson,C,active,miami-dolphins,604118,2018
24577,457058,0,Jonathan Woodard,DE,active,miami-dolphins,457058,2018
24578,370588,0,Leonte Carroo,WR,active,miami-dolphins,370588,2018
24579,537353,0,Evander Hood,DE,active,miami-dolphins,537353,2018
24580,418235,0,Sylvester Williams,DT,active,miami-dolphins,418235,2018
24581,325294,0,Brice Butler,WR,active,miami-dolphins,325294,2018
24582,261176,0,Isaac Asiata,G,active,miami-dolphins,261176,2018
24583,141175,0,Isaiah Ford,WR,active,miami-dolphins,141175,2018
24584,112940,0,Jalen Davis,CB,active,miami-dolphins,112940,2018
24585,65294,0,Maurice Smith,S,active,miami-dolphins,65294,2018
24586,56470,0,Kendrick Norton,DT,active,miami-dolphins,56470,2018
24587,1015000,5485000,Josh Sitton,G,injured_reserve,miami-dolphins,6500000,2018
24588,2525000,2475000,Daniel Kilgore,C,injured_reserve,miami-dolphins,5000000,2018
24589,790000,4043333,Albert Wilson,WR,injured_reserve,miami-dolphins,4833333,2018
24590,4000000,50000,William Hayes,DE,injured_reserve,miami-dolphins,4050000,2018
24591,1015000,90000,Frank Gore,RB,injured_reserve,miami-dolphins,1105000,2018
24592,925000,150000,MarQueis Gray,TE,injured_reserve,miami-dolphins,1075000,2018
24593,583000,176572,Cordrea Tankersley,CB,injured_reserve,miami-dolphins,759572,2018
24594,705000,0,A.J. Derby,TE,injured_reserve,miami-dolphins,705000,2018
24595,630000,35095,Jakeem Grant,WR,injured_reserve,miami-dolphins,665095,2018
24596,630000,0,Jake Brendel,C,injured_reserve,miami-dolphins,630000,2018
24597,461294,38603,Vincent Taylor,DT,injured_reserve,miami-dolphins,499897,2018
24598,441754,3333,Chase Allen,OLB,injured_reserve,miami-dolphins,445087,2018
24599,390516,0,Luke Falk,QB,injured_reserve,miami-dolphins,390516,2018
24600,91200,0,Travis Rudolph,WR,injured_reserve,miami-dolphins,91200,2018
24601,0,9100000,Ndamukong Suh,DT,dead_cap,miami-dolphins,9100000,2018
24602,0,2750000,Lawrence Timmons,ILB,dead_cap,miami-dolphins,2750000,2018
24603,0,2000000,Mike Pouncey,C,dead_cap,miami-dolphins,2000000,2018
24604,1000000,0,Julius Thomas,TE,dead_cap,miami-dolphins,1000000,2018
24605,322941,400000,Sam Young,LT,dead_cap,miami-dolphins,722941,2018
24606,630000,0,Gavin Escobar,TE,dead_cap,miami-dolphins,630000,2018
24607,242339,358256,Jordan Phillips,DT,dead_cap,miami-dolphins,600595,2018
24608,410070,2833,Maurice Smith,S,dead_cap,miami-dolphins,412903,2018
24609,259412,0,Martrell Spaight,ILB,dead_cap,miami-dolphins,259412,2018
24610,53200,175097,Leonte Carroo,WR,dead_cap,miami-dolphins,228297,2018
24611,226282,0,Cameron Malveaux,DE,dead_cap,miami-dolphins,226282,2018
24612,191105,0,Jamiyus Pittman,DT,dead_cap,miami-dolphins,191105,2018
24613,129200,23420,Quentin Poling,ILB,dead_cap,miami-dolphins,152620,2018
24614,68400,65198,Isaac Asiata,G,dead_cap,miami-dolphins,133598,2018
24615,0,133334,Deon Lacey,OLB,dead_cap,miami-dolphins,133334,2018
24616,123800,6666,Jalen Davis,CB,dead_cap,miami-dolphins,130466,2018
24617,129200,0,Connor Hilland,G,dead_cap,miami-dolphins,129200,2018
24618,124412,0,Bryce Petty,QB,dead_cap,miami-dolphins,124412,2018
24619,111177,0,Tanner McEvoy,WR,dead_cap,miami-dolphins,111177,2018
24620,91200,19575,Isaiah Ford,WR,dead_cap,miami-dolphins,110775,2018
24621,106400,0,Jeremiah Valoaga,DE,dead_cap,miami-dolphins,106400,2018
24622,98800,0,Garrison Smith,DE,dead_cap,miami-dolphins,98800,2018
24623,91200,0,Malcolm Lewis,WR,dead_cap,miami-dolphins,91200,2018
24624,91200,0,Travis Rudolph,WR,dead_cap,miami-dolphins,91200,2018
24625,0,90000,Terence Garvin,ILB,dead_cap,miami-dolphins,90000,2018
24626,0,59982,Jordan Lucas,S,dead_cap,miami-dolphins,59982,2018
24627,0,55204,Jay Ajayi,RB,dead_cap,miami-dolphins,55204,2018
24628,0,53691,Tony Lippett,CB,dead_cap,miami-dolphins,53691,2018
24629,53200,0,DeShawn Williams,DT,dead_cap,miami-dolphins,53200,2018
24630,38000,0,Chris Lammons,CB,dead_cap,miami-dolphins,38000,2018
24631,38000,0,Chris Owusu,WR,dead_cap,miami-dolphins,38000,2018
24632,37059,0,Hroniss Grasu,C,dead_cap,miami-dolphins,37059,2018
24633,30400,0,James Burgess,ILB,dead_cap,miami-dolphins,30400,2018
24634,22800,0,Dee Delaney,CB,dead_cap,miami-dolphins,22800,2018
24635,22800,0,Jonathan Woodard,DE,dead_cap,miami-dolphins,22800,2018
24636,12000,3333,Mike McCray,LB,dead_cap,miami-dolphins,15333,2018
24637,15200,0,Lucas Gravelle,LS,dead_cap,miami-dolphins,15200,2018
24638,15200,0,Nick O'Leary,TE,dead_cap,miami-dolphins,15200,2018
24639,7600,0,Jeremy Langford,RB,dead_cap,miami-dolphins,7600,2018
24640,0,3333,Eric Smith,T,dead_cap,miami-dolphins,3333,2018
24641,0,2500,Lawrence Okoye,DT,dead_cap,miami-dolphins,2500,2018
24642,6975000,1358333,Albert Wilson,WR,active,miami-dolphins,8333333,2019
24643,3500000,3400000,DeVante Parker,WR,active,miami-dolphins,6900000,2019
24644,1500000,4000000,Ryan Fitzpatrick,QB,active,miami-dolphins,5500000,2019
24645,1375000,2650000,Eric Rowe,CB,active,miami-dolphins,4025000,2019
24646,1450794,1506589,Charles Harris,DE,active,miami-dolphins,2957383,2019
24647,1750000,1183333,Allen Hurns,WR,active,miami-dolphins,2933333,2019
24648,495000,2312109,Christian Wilkins,DT,active,miami-dolphins,2807109,2019
24649,2225000,456250,Daniel Kilgore,C,active,miami-dolphins,2681250,2019
24650,2025000,0,Evan Boehm,G,active,miami-dolphins,2025000,2019
24651,645000,1000000,Jesse Davis,T,active,miami-dolphins,1645000,2019
24652,780542,722168,Mike Gesicki,TE,active,miami-dolphins,1502710,2019
24653,1400000,0,Walt Aikens,FS,active,miami-dolphins,1400000,2019
24654,570000,709898,Josh Rosen,QB,active,miami-dolphins,1279898,2019
24655,1214711,0,Taco Charlton,DE,active,miami-dolphins,1214711,2019
24656,654000,243800,Jerome Baker,OLB,active,miami-dolphins,897800,2019
24657,495000,246312,Michael Deiter,G,active,miami-dolphins,741312,2019
24658,570000,158058,Durham Smythe,TE,active,miami-dolphins,728058,2019
24659,645000,50484,Davon Godchaux,DT,active,miami-dolphins,695484,2019
24660,645000,1334,Matt Haack,P,active,miami-dolphins,646334,2019
24661,930000,0,J'Marcus Webb,RT,active,miami-dolphins,930000,2019
24662,805000,0,John Jenkins,DT,active,miami-dolphins,805000,2019
24663,645000,0,Vince Biegel,OLB,active,miami-dolphins,645000,2019
24664,645000,0,Julie'n Davenport,LT,active,miami-dolphins,645000,2019
24665,645000,0,Deon Lacey,OLB,active,miami-dolphins,645000,2019
24666,570000,22800,Jason Sanders,K,active,miami-dolphins,592800,2019
24667,570000,0,Avery Moss,DE,active,miami-dolphins,570000,2019
24668,570000,0,Taybor Pepper,LS,active,miami-dolphins,570000,2019
24669,495000,22641,Chandler Cox,FB,active,miami-dolphins,517641,2019
24670,495000,3333,Deion Calhoun,G,active,miami-dolphins,498333,2019
24671,495000,3000,Patrick Laird,RB,active,miami-dolphins,498000,2019
24672,419291,77695,Andrew Van Ginkel,LB,active,miami-dolphins,496986,2019
24673,495000,0,Sam Eguavoen,LB,active,miami-dolphins,495000,2019
24674,495000,0,Trent Harris,DE,active,miami-dolphins,495000,2019
24675,495000,0,Steven Parker,S,active,miami-dolphins,495000,2019
24676,495000,0,Jomal Wiltz,CB,active,miami-dolphins,495000,2019
24677,407647,0,Keaton Sutherland,T,active,miami-dolphins,407647,2019
24678,381176,0,Clive Walford,TE,active,miami-dolphins,381176,2019
24679,349412,0,Nik Needham,CB,active,miami-dolphins,349412,2019
24680,268235,0,De’Lance Turner,RB,active,miami-dolphins,268235,2019
24681,201176,0,Adrian Colbert,FS,active,miami-dolphins,201176,2019
24682,169412,0,Trevor Davis,WR,active,miami-dolphins,169412,2019
24683,167647,0,Isaiah Ford,WR,active,miami-dolphins,167647,2019
24684,151764,0,Mack Hollins,WR,active,miami-dolphins,151764,2019
24685,134116,0,Zach Sieler,DE,active,miami-dolphins,134116,2019
24686,116471,0,Evan Brown,C,active,miami-dolphins,116471,2019
24687,116471,0,Linden Stephens,S,active,miami-dolphins,116471,2019
24688,100587,0,Adam Pankey,T,active,miami-dolphins,100587,2019
24689,87353,0,Nate Brooks,CB,active,miami-dolphins,87353,2019
24690,87353,0,Jamal Davis,OLB,active,miami-dolphins,87353,2019
24691,87353,0,Montre Hartage,CB,active,miami-dolphins,87353,2019
24692,87353,0,Tae Hayes,CB,active,miami-dolphins,87353,2019
24693,58236,0,Calvin Munson,ILB,active,miami-dolphins,58236,2019
24694,37941,0,Samaje Perine,RB,active,miami-dolphins,37941,2019
24695,0,0,Marcus Sherels,CB,active,miami-dolphins,0,2019
24696,13015000,4176250,Reshad Jones,SS,injured_reserve,miami-dolphins,17191250,2019
24697,1285641,9064189,Xavien Howard,CB,injured_reserve,miami-dolphins,10349830,2019
24698,5600000,740000,Bobby McCain,FS,injured_reserve,miami-dolphins,6340000,2019
24699,4235294,0,Aqib Talib,CB,injured_reserve,miami-dolphins,4235294,2019
24700,720000,635096,Jakeem Grant,WR,injured_reserve,miami-dolphins,1355096,2019
24701,892049,389098,Raekwon McMillan,OLB,injured_reserve,miami-dolphins,1281147,2019
24702,528353,147295,Kalen Ballage,RB,injured_reserve,miami-dolphins,675648,2019
24703,645000,3334,Chase Allen,OLB,injured_reserve,miami-dolphins,648334,2019
24704,645000,0,Danny Isidora,G,injured_reserve,miami-dolphins,645000,2019
24705,495000,21694,Myles Gaskin,RB,injured_reserve,miami-dolphins,516694,2019
24706,474353,0,Ken Webster,CB,injured_reserve,miami-dolphins,474353,2019
24707,439941,3333,Preston Williams,WR,injured_reserve,miami-dolphins,443274,2019
24708,424234,0,James Crawford,LB,injured_reserve,miami-dolphins,424234,2019
24709,408000,0,Ricardo Louis,WR,injured_reserve,miami-dolphins,408000,2019
24710,384882,5000,Jonathan Ledbetter,DE,injured_reserve,miami-dolphins,389882,2019
24711,368824,0,Ryan Lewis,CB,injured_reserve,miami-dolphins,368824,2019
24712,191647,0,Gary Jennings,WR,injured_reserve,miami-dolphins,191647,2019
24713,154059,0,Gerald Willis,DT,injured_reserve,miami-dolphins,154059,2019
24714,136000,0,Jamiyus Pittman,DT,injured_reserve,miami-dolphins,136000,2019
24715,16000,0,Jonathan Bonner,DE,practice_squad,miami-dolphins,16000,2019
24716,136000,0,Durval Neto,DT,practice_squad,miami-dolphins,136000,2019
24717,0,18423332,Ryan Tannehill,QB,dead_cap,miami-dolphins,18423332,2019
24718,0,13100000,Ndamukong Suh,DT,dead_cap,miami-dolphins,13100000,2019
24719,3640000,1002000,T.J. McDonald,FS,dead_cap,miami-dolphins,4642000,2019
24720,1350000,1787500,Kiko Alonso,OLB,dead_cap,miami-dolphins,3137500,2019
24721,144427,2510504,Minkah Fitzpatrick,S,dead_cap,miami-dolphins,2654931,2019
24722,2500000,93750,Johnson Bademosi,CB,dead_cap,miami-dolphins,2593750,2019
24723,0,2000000,Andre Branch,DE,dead_cap,miami-dolphins,2000000,2019
24724,0,2000000,Josh Sitton,G,dead_cap,miami-dolphins,2000000,2019
24725,0,1815028,Laremy Tunsil,LT,dead_cap,miami-dolphins,1815028,2019
24726,0,1775000,Kenny Stills,WR,dead_cap,miami-dolphins,1775000,2019
24727,500000,1000000,Jordan Mills,RT,dead_cap,miami-dolphins,1500000,2019
24728,0,1350000,Dwayne Allen,TE,dead_cap,miami-dolphins,1350000,2019
24729,764704,550000,Chris Reed,C,dead_cap,miami-dolphins,1314704,2019
24730,952941,205315,Kenyan Drake,RB,dead_cap,miami-dolphins,1158256,2019
24731,0,1121211,Robert Quinn,DE,dead_cap,miami-dolphins,1121211,2019
24732,1000000,100000,Nick O'Leary,TE,dead_cap,miami-dolphins,1100000,2019
24733,833824,0,Ken Crawley,CB,dead_cap,miami-dolphins,833824,2019
24734,607056,0,Jonathan Woodard,DE,dead_cap,miami-dolphins,607056,2019
24735,0,416668,Ted Larsen,G,dead_cap,miami-dolphins,416668,2019
24736,378529,37436,Isaiah Prince,T,dead_cap,miami-dolphins,415965,2019
24737,382941,0,Marcus Sherels,CB,dead_cap,miami-dolphins,382941,2019
24738,378824,0,Andrew Donnal,G,dead_cap,miami-dolphins,378824,2019
24739,378534,0,Chris Lammons,CB,dead_cap,miami-dolphins,378534,2019
24740,340000,0,Jake Rudock,QB,dead_cap,miami-dolphins,340000,2019
24741,223647,39150,Isaiah Ford,WR,dead_cap,miami-dolphins,262797,2019
24742,262059,0,Mark Walton,RB,dead_cap,miami-dolphins,262059,2019
24743,253176,0,Robert Nkemdiche,DE,dead_cap,miami-dolphins,253176,2019
24744,0,175097,Leonte Carroo,WR,dead_cap,miami-dolphins,175097,2019
24745,170589,0,Cornellius Carradine,DE,dead_cap,miami-dolphins,170589,2019
24746,169412,0,Bryan Witzmann,G,dead_cap,miami-dolphins,169412,2019
24747,167765,0,Doug Middleton,FS,dead_cap,miami-dolphins,167765,2019
24748,136000,0,Terrill Hanks,LB,dead_cap,miami-dolphins,136000,2019
24749,136000,0,Chris Myarick,TE,dead_cap,miami-dolphins,136000,2019
24750,133118,0,Montre Hartage,CB,dead_cap,miami-dolphins,133118,2019
24751,131765,0,Clive Walford,TE,dead_cap,miami-dolphins,131765,2019
24752,0,130396,Isaac Asiata,G,dead_cap,miami-dolphins,130396,2019
24753,128000,0,Chidi Okeke,T,dead_cap,miami-dolphins,128000,2019
24754,128000,0,Todd Rahming,WR,dead_cap,miami-dolphins,128000,2019
24755,116471,0,Xavier Crawford,CB,dead_cap,miami-dolphins,116471,2019
24756,0,100000,Akeem Spence,DT,dead_cap,miami-dolphins,100000,2019
24757,0,90000,John Denney,LS,dead_cap,miami-dolphins,90000,2019
24758,88000,0,Andy Jones,WR,dead_cap,miami-dolphins,88000,2019
24759,25000,50000,Jayrone Elliott,OLB,dead_cap,miami-dolphins,75000,2019
24760,0,70260,Quentin Poling,ILB,dead_cap,miami-dolphins,70260,2019
24761,64000,0,Gerald Willis,DT,dead_cap,miami-dolphins,64000,2019
24762,56000,0,Jake Carlock,CB,dead_cap,miami-dolphins,56000,2019
24763,56000,0,Frank Herron,DT,dead_cap,miami-dolphins,56000,2019
24764,47353,0,Zach Zenner,RB,dead_cap,miami-dolphins,47353,2019
24765,35000,5000,Tyrone Holmes,DE,dead_cap,miami-dolphins,40000,2019
24766,40000,0,Dewayne Hendrix,DE,dead_cap,miami-dolphins,40000,2019
24767,40000,0,Nik Needham,CB,dead_cap,miami-dolphins,40000,2019
24768,40000,0,Terry Wright,WR,dead_cap,miami-dolphins,40000,2019
24769,0,38603,Vincent Taylor,DT,dead_cap,miami-dolphins,38603,2019
24770,0,29602,Cornell Armstrong,CB,dead_cap,miami-dolphins,29602,2019
24771,24000,0,Rashard Causey,CB,dead_cap,miami-dolphins,24000,2019
24772,16000,0,Antonio Garcia,T,dead_cap,miami-dolphins,16000,2019
24773,16000,0,Jayson Stanley,WR,dead_cap,miami-dolphins,16000,2019
24774,0,13334,Jalen Davis,CB,dead_cap,miami-dolphins,13334,2019
24775,8000,0,Christian Sam,ILB,dead_cap,miami-dolphins,8000,2019
24776,8000,0,Zach Sterup,T,dead_cap,miami-dolphins,8000,2019
24777,0,6667,Mike McCray,LB,dead_cap,miami-dolphins,6667,2019
24778,0,3334,Eric Smith,T,dead_cap,miami-dolphins,3334,2019
24779,0,2834,Maurice Smith,S,dead_cap,miami-dolphins,2834,2019
24780,0,2500,Torry McTyer,CB,dead_cap,miami-dolphins,2500,2019
24781,11485000,4076250,Reshad Jones,SS,active,miami-dolphins,15561250,2020
24782,11900000,1425000,Xavien Howard,CB,active,miami-dolphins,13325000,2020
24783,9475000,1358334,Albert Wilson,WR,active,miami-dolphins,10833334,2020
24784,8000000,0,Ryan Fitzpatrick,QB,active,miami-dolphins,8000000,2020
24785,5500000,740000,Bobby McCain,FS,active,miami-dolphins,6240000,2020
24786,3855000,1000000,Jesse Davis,T,active,miami-dolphins,4855000,2020
24787,1300000,4100000,DeVante Parker,WR,active,miami-dolphins,5400000,2020
24788,3780000,600000,Jakeem Grant,WR,active,miami-dolphins,4380000,2020
24789,2175000,1925000,Eric Rowe,CB,active,miami-dolphins,4100000,2020
24790,3080000,456250,Daniel Kilgore,C,active,miami-dolphins,3536250,2020
24791,1196777,2312109,Christian Wilkins,DT,active,miami-dolphins,3508886,2020
24792,1943692,1506589,Charles Harris,DE,active,miami-dolphins,3450281,2020
24793,1875000,958333,Allen Hurns,WR,active,miami-dolphins,2833333,2020
24794,660000,1419796,Josh Rosen,QB,active,miami-dolphins,2079796,2020
24795,1832507,0,Taco Charlton,DE,active,miami-dolphins,1832507,2020
24796,1081084,722168,Mike Gesicki,TE,active,miami-dolphins,1803252,2020
24797,1105573,389098,Raekwon McMillan,OLB,active,miami-dolphins,1494671,2020
24798,810000,243800,Jerome Baker,OLB,active,miami-dolphins,1053800,2020
24799,680328,246312,Michael Deiter,G,active,miami-dolphins,926640,2020
24800,749000,176572,Cordrea Tankersley,CB,active,miami-dolphins,925572,2020
24801,660000,158058,Durham Smythe,TE,active,miami-dolphins,818058,2020
24802,660000,147295,Kalen Ballage,RB,active,miami-dolphins,807295,2020
24803,735000,50485,Davon Godchaux,DT,active,miami-dolphins,785485,2020
24804,735000,0,Julie'n Davenport,LT,active,miami-dolphins,735000,2020
24805,735000,0,Mack Hollins,WR,active,miami-dolphins,735000,2020
24806,735000,0,Danny Isidora,G,active,miami-dolphins,735000,2020
24807,735000,0,Adam Pankey,T,active,miami-dolphins,735000,2020
24808,660000,22800,Jason Sanders,K,active,miami-dolphins,682800,2020
24809,585000,77695,Andrew Van Ginkel,LB,active,miami-dolphins,662695,2020
24810,660000,0,James Crawford,LB,active,miami-dolphins,660000,2020
24811,660000,0,Ryan Lewis,CB,active,miami-dolphins,660000,2020
24812,660000,0,Avery Moss,DE,active,miami-dolphins,660000,2020
24813,660000,0,Zach Sieler,DE,active,miami-dolphins,660000,2020
24814,660000,0,De’Lance Turner,RB,active,miami-dolphins,660000,2020
24815,585000,22641,Chandler Cox,FB,active,miami-dolphins,607641,2020
24816,585000,21694,Myles Gaskin,RB,active,miami-dolphins,606694,2020
24817,585000,3333,Deion Calhoun,G,active,miami-dolphins,588333,2020
24818,585000,3333,Preston Williams,WR,active,miami-dolphins,588333,2020
24819,585000,3000,Patrick Laird,RB,active,miami-dolphins,588000,2020
24820,585000,0,Nate Brooks,CB,active,miami-dolphins,585000,2020
24821,585000,0,Jamal Davis,OLB,active,miami-dolphins,585000,2020
24822,585000,0,Sam Eguavoen,LB,active,miami-dolphins,585000,2020
24823,585000,0,Montre Hartage,CB,active,miami-dolphins,585000,2020
24824,585000,0,Tae Hayes,CB,active,miami-dolphins,585000,2020
24825,585000,0,Gary Jennings,WR,active,miami-dolphins,585000,2020
24826,585000,0,Calvin Munson,ILB,active,miami-dolphins,585000,2020
24827,585000,0,Nik Needham,CB,active,miami-dolphins,585000,2020
24828,585000,0,Steven Parker,S,active,miami-dolphins,585000,2020
24829,585000,0,Linden Stephens,S,active,miami-dolphins,585000,2020
24830,585000,0,Keaton Sutherland,T,active,miami-dolphins,585000,2020
24831,585000,0,Ken Webster,CB,active,miami-dolphins,585000,2020
24832,585000,0,Gerald Willis,DT,active,miami-dolphins,585000,2020
24833,585000,0,Jomal Wiltz,CB,active,miami-dolphins,585000,2020
24834,510000,5000,Jonathan Ledbetter,DE,active,miami-dolphins,515000,2020
24835,0,0,Jake Carlock,CB,active,miami-dolphins,0,2020
24836,0,0,Rashard Causey,CB,active,miami-dolphins,0,2020
24837,0,0,Terrill Hanks,LB,active,miami-dolphins,0,2020
24838,0,0,Andy Jones,WR,active,miami-dolphins,0,2020
24839,0,0,Chris Myarick,TE,active,miami-dolphins,0,2020
24840,0,0,Chidi Okeke,T,active,miami-dolphins,0,2020
24841,0,0,Durval Queiroz,DT,active,miami-dolphins,0,2020
24842,0,0,Todd Rahming,WR,active,miami-dolphins,0,2020
24843,0,0,Jake Rudock,QB,active,miami-dolphins,0,2020
24844,0,0,Terry Wright,WR,active,miami-dolphins,0,2020
24845,0,5021008,Minkah Fitzpatrick,S,dead_cap,miami-dolphins,5021008,2020
24846,0,1904000,T.J. McDonald,FS,dead_cap,miami-dolphins,1904000,2020
24847,0,1762500,Kiko Alonso,OLB,dead_cap,miami-dolphins,1762500,2020
24848,0,1750000,Kenny Stills,WR,dead_cap,miami-dolphins,1750000,2020
24849,0,112308,Isaiah Prince,T,dead_cap,miami-dolphins,112308,2020
24850,0,59204,Cornell Armstrong,CB,dead_cap,miami-dolphins,59204,2020
24851,0,50485,Danny Isidora,G,dead_cap,miami-dolphins,50485,2020
24852,0,38605,Vincent Taylor,DT,dead_cap,miami-dolphins,38605,2020
24853,0,10000,Tyrone Holmes,DE,dead_cap,miami-dolphins,10000,2020
24854,2650000,1604168,Pat Williams,DT,active,minnesota-vikings,4254168,2007
24855,2035000,2000000,Steve Hutchinson,G,active,minnesota-vikings,4035000,2007
24856,3000000,4621426,Kevin Williams,DT,active,minnesota-vikings,7621426,2007
24857,5320000,1066668,Matt Birk,C,active,minnesota-vikings,6386668,2007
24858,850000,6606668,Bryant McKinnie,LT,active,minnesota-vikings,7456668,2007
24859,4900000,0,Antoine Winfield,CB,active,minnesota-vikings,4900000,2007
24860,2900000,250000,Darren Sharper,S,active,minnesota-vikings,3150000,2007
24861,285000,4205000,Adrian Peterson,RB,active,minnesota-vikings,4490000,2007
24862,1100000,1000000,Visanthe Shiancoe,TE,active,minnesota-vikings,2100000,2007
24863,2400000,750000,Chester Taylor,RB,active,minnesota-vikings,3150000,2007
24864,1000000,1000000,E.J. Henderson,LB,active,minnesota-vikings,2000000,2007
24865,435000,4244000,Troy Williamson,WR,active,minnesota-vikings,4679000,2007
24866,375000,2555000,Chad Greenway,OLB,active,minnesota-vikings,2930000,2007
24867,649750,1523000,Kenechi Udeze,DE,active,minnesota-vikings,2172750,2007
24868,1485000,0,Kelly Holcomb,QB,active,minnesota-vikings,1485000,2007
24869,820000,600000,Ryan Longwell,K,active,minnesota-vikings,1420000,2007
24870,360000,606385,Ryan Cook,C,active,minnesota-vikings,966385,2007
24871,435000,283333,Chris Kluwe,P,active,minnesota-vikings,718333,2007
24872,850000,0,Spencer Johnson,DT,active,minnesota-vikings,850000,2007
24873,850000,0,Darrion Scott,DT,active,minnesota-vikings,850000,2007
24874,435000,305000,Marcus Johnson,T,active,minnesota-vikings,740000,2007
24875,525000,140000,Jeff Dugan,TE,active,minnesota-vikings,665000,2007
24876,360000,325000,Cedric Griffin,CB,active,minnesota-vikings,685000,2007
24877,525000,120000,Cullen Loeffler,LS,active,minnesota-vikings,645000,2007
24878,285000,329000,Sidney Rice,WR,active,minnesota-vikings,614000,2007
24879,510000,98500,Mewelde Moore,RB,active,minnesota-vikings,608500,2007
24880,360000,205000,Tarvaris Jackson,QB,active,minnesota-vikings,565000,2007
24881,285000,196500,Marcus McCauley,CB,active,minnesota-vikings,481500,2007
24882,360000,98250,Ray Edwards,DE,active,minnesota-vikings,458250,2007
24883,435000,0,Heath Farwell,ILB,active,minnesota-vikings,435000,2007
24884,285000,121000,Brian Robison,DE,active,minnesota-vikings,406000,2007
24885,360000,0,Fred Evans,DT,active,minnesota-vikings,360000,2007
24886,360000,0,Garrett Mills,TE,active,minnesota-vikings,360000,2007
24887,285000,44875,Aundrae Allison,WR,active,minnesota-vikings,329875,2007
24888,285000,28187,Rufus Alexander,LB,active,minnesota-vikings,313187,2007
24889,387500,2240000,Erasmus James,DE,injured_reserve,minnesota-vikings,2627500,2007
24890,2700000,0,Fred Smoot,CB,dead_cap,minnesota-vikings,2700000,2007
24891,0,600000,Brad Johnson,QB,dead_cap,minnesota-vikings,600000,2007
24892,181167,0,Dustin Fox,CB,dead_cap,minnesota-vikings,181167,2007
24893,114000,0,Ciatrick Fason,RB,dead_cap,minnesota-vikings,114000,2007
24894,46000,0,C.J. Mosley,DT,dead_cap,minnesota-vikings,46000,2007
24895,42500,0,Greg Blue,CB,dead_cap,minnesota-vikings,42500,2007
24896,11437,0,Chandler Williams,WR,dead_cap,minnesota-vikings,11437,2007
24897,605000,8933333,Bernard Berrian,WR,active,minnesota-vikings,9538333,2008
24898,4000000,937500,Pat Williams,DT,active,minnesota-vikings,4937500,2008
24899,3250000,6606668,Bryant McKinnie,LT,active,minnesota-vikings,9856668,2008
24900,750000,7250011,Jared Allen,DE,active,minnesota-vikings,8000011,2008
24901,4450000,2000000,Steve Hutchinson,G,active,minnesota-vikings,6450000,2008
24902,5320000,400000,Matt Birk,C,active,minnesota-vikings,5720000,2008
24903,5600000,0,Antoine Winfield,CB,active,minnesota-vikings,5600000,2008
24904,605000,666667,Madieu Williams,S,active,minnesota-vikings,1271667,2008
24905,1000000,4621426,Kevin Williams,DT,active,minnesota-vikings,5621426,2008
24906,3900000,250000,Darren Sharper,S,active,minnesota-vikings,4150000,2008
24907,3000000,750000,Chester Taylor,RB,active,minnesota-vikings,3750000,2008
24908,2100000,1000000,Visanthe Shiancoe,TE,active,minnesota-vikings,3100000,2008
24909,617000,283333,Chris Kluwe,P,active,minnesota-vikings,900333,2008
24910,370000,3610000,Adrian Peterson,RB,active,minnesota-vikings,3980000,2008
24911,1620000,600000,Ryan Longwell,K,active,minnesota-vikings,2220000,2008
24912,675000,2555000,Chad Greenway,OLB,active,minnesota-vikings,3230000,2008
24913,1417000,0,Heath Farwell,ILB,active,minnesota-vikings,1417000,2008
24914,520000,305000,Marcus Johnson,T,active,minnesota-vikings,825000,2008
24915,625000,140000,Jeff Dugan,TE,active,minnesota-vikings,765000,2008
24916,445000,325000,Cedric Griffin,CB,active,minnesota-vikings,770000,2008
24917,625000,120000,Cullen Loeffler,LS,active,minnesota-vikings,745000,2008
24918,445000,300000,Ryan Cook,C,active,minnesota-vikings,745000,2008
24919,370000,329000,Sidney Rice,WR,active,minnesota-vikings,699000,2008
24920,295000,367500,Tyrell Johnson,S,active,minnesota-vikings,662500,2008
24921,445000,205000,Tarvaris Jackson,QB,active,minnesota-vikings,650000,2008
24922,370000,196500,Marcus McCauley,CB,active,minnesota-vikings,566500,2008
24923,445000,98250,Ray Edwards,DE,active,minnesota-vikings,543250,2008
24924,370000,121000,Brian Robison,DE,active,minnesota-vikings,491000,2008
24925,445000,0,Fred Evans,DT,active,minnesota-vikings,445000,2008
24926,445000,0,Garrett Mills,TE,active,minnesota-vikings,445000,2008
24927,370000,44875,Aundrae Allison,WR,active,minnesota-vikings,414875,2008
24928,295000,51500,John David Booty,QB,active,minnesota-vikings,346500,2008
24929,295000,44175,Letroy Guion,DE,active,minnesota-vikings,339175,2008
24930,295000,24050,John Sullivan,C,active,minnesota-vikings,319050,2008
24931,295000,6666,Erin Henderson,ILB,active,minnesota-vikings,301666,2008
24932,295000,3333,Husain Abdullah,FS,active,minnesota-vikings,298333,2008
24933,295000,2666,Leger Douzable,DT,active,minnesota-vikings,297666,2008
24934,295000,0,Darius Reynaud,RB,active,minnesota-vikings,295000,2008
24935,2500000,910000,E.J. Henderson,LB,injured_reserve,minnesota-vikings,3410000,2008
24936,295000,7668,Drew Radovich,T,injured_reserve,minnesota-vikings,302668,2008
24937,88400,0,Jaymar Johnson,WR,practice_squad,minnesota-vikings,88400,2008
24938,88400,0,Marcus Walker,CB,practice_squad,minnesota-vikings,88400,2008
24939,0,13272000,Troy Williamson,WR,dead_cap,minnesota-vikings,13272000,2008
24940,0,6996000,Erasmus James,DE,dead_cap,minnesota-vikings,6996000,2008
24941,807500,1523000,Kenechi Udeze,DE,dead_cap,minnesota-vikings,2330500,2008
24942,85000,0,Greg Blue,CB,dead_cap,minnesota-vikings,85000,2008
24943,57000,0,Tyler Thigpen,QB,dead_cap,minnesota-vikings,57000,2008
24944,34311,0,Chandler Williams,WR,dead_cap,minnesota-vikings,34311,2008
24945,28187,0,Rufus Alexander,LB,dead_cap,minnesota-vikings,28187,2008
24946,0,333,Steven Hauschka,K,dead_cap,minnesota-vikings,333,2008
24947,11950000,2583344,Jared Allen,DE,active,minnesota-vikings,14533344,2009
24948,12000000,0,Brett Favre,QB,active,minnesota-vikings,12000000,2009
24949,6100000,0,Antoine Winfield,CB,active,minnesota-vikings,6100000,2009
24950,5450000,2000000,Steve Hutchinson,G,active,minnesota-vikings,7450000,2009
24951,2395000,3933333,Bernard Berrian,WR,active,minnesota-vikings,6328333,2009
24952,2900000,3050000,Bryant McKinnie,LT,active,minnesota-vikings,5950000,2009
24953,3750000,937500,Pat Williams,DT,active,minnesota-vikings,4687500,2009
24954,620000,666667,Madieu Williams,S,active,minnesota-vikings,1286667,2009
24955,1000000,4621430,Kevin Williams,DT,active,minnesota-vikings,5621430,2009
24956,1250000,3350000,Heath Farwell,ILB,active,minnesota-vikings,4600000,2009
24957,2535000,1325000,Cedric Griffin,CB,active,minnesota-vikings,3860000,2009
24958,3000000,750000,Chester Taylor,RB,active,minnesota-vikings,3750000,2009
24959,2100000,1000000,Visanthe Shiancoe,TE,active,minnesota-vikings,3100000,2009
24960,755000,3610000,Adrian Peterson,RB,active,minnesota-vikings,4365000,2009
24961,2000000,466667,Sage Rosenfels,QB,active,minnesota-vikings,2466667,2009
24962,1850000,600000,Ryan Longwell,K,active,minnesota-vikings,2450000,2009
24963,1000000,2555000,Chad Greenway,OLB,active,minnesota-vikings,3555000,2009
24964,1545000,0,Fred Evans,DT,active,minnesota-vikings,1545000,2009
24965,1545000,0,Fred Evans,DT,active,minnesota-vikings,1545000,2009
24966,460000,329000,Sidney Rice,WR,active,minnesota-vikings,789000,2009
24967,1040000,196300,Percy Harvin,WR,active,minnesota-vikings,1236300,2009
24968,850000,283333,Chris Kluwe,P,active,minnesota-vikings,1133333,2009
24969,1010000,92469,Ray Edwards,DE,active,minnesota-vikings,1102469,2009
24970,310000,725000,Phillip Loadholt,RT,active,minnesota-vikings,1035000,2009
24971,620000,380000,Jimmy Kennedy,DT,active,minnesota-vikings,1000000,2009
24972,675000,140000,Jeff Dugan,TE,active,minnesota-vikings,815000,2009
24973,535000,300000,Ryan Cook,C,active,minnesota-vikings,835000,2009
24974,675000,120000,Cullen Loeffler,LS,active,minnesota-vikings,795000,2009
24975,385000,367500,Tyrell Johnson,S,active,minnesota-vikings,752500,2009
24976,535000,205000,Tarvaris Jackson,QB,active,minnesota-vikings,740000,2009
24977,460000,121000,Brian Robison,DE,active,minnesota-vikings,581000,2009
24978,535000,0,Garrett Mills,TE,active,minnesota-vikings,535000,2009
24979,310000,181375,Asher Allen,CB,active,minnesota-vikings,491375,2009
24980,385000,44175,Letroy Guion,DE,active,minnesota-vikings,429175,2009
24981,385000,24050,John Sullivan,C,active,minnesota-vikings,409050,2009
24982,385000,6666,Erin Henderson,ILB,active,minnesota-vikings,391666,2009
24983,385000,3333,Husain Abdullah,FS,active,minnesota-vikings,388333,2009
24984,385000,2666,Leger Douzable,DT,active,minnesota-vikings,387666,2009
24985,385000,0,Kory Lichtensteiger,C,active,minnesota-vikings,385000,2009
24986,385000,0,Darius Reynaud,RB,active,minnesota-vikings,385000,2009
24987,310000,46500,Jasper Brinkley,ILB,active,minnesota-vikings,356500,2009
24988,310000,12318,Jamarca Sanford,SS,active,minnesota-vikings,322318,2009
24989,88400,0,John David Booty,QB,active,minnesota-vikings,88400,2009
24990,3200000,910000,E.J. Henderson,LB,injured_reserve,minnesota-vikings,4110000,2009
24991,88400,0,Colt Anderson,SS,practice_squad,minnesota-vikings,88400,2009
24992,88400,0,Patrick Brown,G,practice_squad,minnesota-vikings,88400,2009
24993,0,1523000,Kenechi Udeze,DE,dead_cap,minnesota-vikings,1523000,2009
24994,305000,0,Marcus Johnson,T,dead_cap,minnesota-vikings,305000,2009
24995,196500,0,Marcus McCauley,CB,dead_cap,minnesota-vikings,196500,2009
24996,96506,0,Drew Radovich,T,dead_cap,minnesota-vikings,96506,2009
24997,56374,0,Rufus Alexander,LB,dead_cap,minnesota-vikings,56374,2009
24998,51500,0,John David Booty,QB,dead_cap,minnesota-vikings,51500,2009
24999,44875,0,Aundrae Allison,WR,dead_cap,minnesota-vikings,44875,2009
25000,22750,0,Jaymar Johnson,WR,dead_cap,minnesota-vikings,22750,2009
25001,6666,0,Colt Anderson,SS,dead_cap,minnesota-vikings,6666,2009
25002,0,667,Steven Hauschka,K,dead_cap,minnesota-vikings,667,2009
25003,11600000,4400000,Brett Favre,QB,active,minnesota-vikings,16000000,2010
25004,6380000,6583344,Jared Allen,DE,active,minnesota-vikings,12963344,2010
25005,6550000,2000000,Steve Hutchinson,G,active,minnesota-vikings,8550000,2010
25006,4600000,2950000,Bryant McKinnie,LT,active,minnesota-vikings,7550000,2010
25007,6500000,0,Antoine Winfield,CB,active,minnesota-vikings,6500000,2010
25008,4250000,937500,Pat Williams,DT,active,minnesota-vikings,5187500,2010
25009,4100000,910000,E.J. Henderson,LB,active,minnesota-vikings,5010000,2010
25010,3640000,3610000,Adrian Peterson,RB,active,minnesota-vikings,7250000,2010
25011,2274000,2716666,Kevin Williams,DT,active,minnesota-vikings,4990666,2010
25012,4894117,0,Randy Moss,WR,active,minnesota-vikings,4894117,2010
25013,2974000,666667,Madieu Williams,S,active,minnesota-vikings,3640667,2010
25014,3700000,933333,Bernard Berrian,WR,active,minnesota-vikings,4633333,2010
25015,3170000,2555000,Chad Greenway,OLB,active,minnesota-vikings,5725000,2010
25016,3000000,1000000,Cedric Griffin,CB,active,minnesota-vikings,4000000,2010
25017,2100000,1000000,Visanthe Shiancoe,TE,active,minnesota-vikings,3100000,2010
25018,395000,4192300,Percy Harvin,WR,active,minnesota-vikings,4587300,2010
25019,1500000,1100000,Ryan Longwell,K,active,minnesota-vikings,2600000,2010
25020,2521000,0,Ray Edwards,DE,active,minnesota-vikings,2521000,2010
25021,1500000,1000000,Jimmy Kennedy,DT,active,minnesota-vikings,2500000,2010
25022,1500000,750000,Heath Farwell,ILB,active,minnesota-vikings,2250000,2010
25023,1759000,0,Fred Evans,DT,active,minnesota-vikings,1759000,2010
25024,1000000,283333,Chris Kluwe,P,active,minnesota-vikings,1283333,2010
25025,1176000,0,Ryan Cook,C,active,minnesota-vikings,1176000,2010
25026,1176000,0,Tarvaris Jackson,QB,active,minnesota-vikings,1176000,2010
25027,1101000,0,Eric Frampton,S,active,minnesota-vikings,1101000,2010
25028,725000,140000,Jeff Dugan,TE,active,minnesota-vikings,865000,2010
25029,320000,575000,Chris Cook,CB,active,minnesota-vikings,895000,2010
25030,550000,329000,Sidney Rice,WR,active,minnesota-vikings,879000,2010
25031,725000,120000,Cullen Loeffler,LS,active,minnesota-vikings,845000,2010
25032,470000,367500,Tyrell Johnson,S,active,minnesota-vikings,837500,2010
25033,395000,302500,Phillip Loadholt,RT,active,minnesota-vikings,697500,2010
25034,320000,371000,Toby Gerhart,RB,active,minnesota-vikings,691000,2010
25035,550000,121000,Brian Robison,DE,active,minnesota-vikings,671000,2010
25036,395000,181375,Asher Allen,CB,active,minnesota-vikings,576375,2010
25037,470000,44175,Letroy Guion,DE,active,minnesota-vikings,514175,2010
25038,470000,24050,John Sullivan,C,active,minnesota-vikings,494050,2010
25039,475000,6666,Erin Henderson,ILB,active,minnesota-vikings,481666,2010
25040,475000,3334,Husain Abdullah,FS,active,minnesota-vikings,478334,2010
25041,475000,2668,Leger Douzable,DT,active,minnesota-vikings,477668,2010
25042,470000,0,Xavier Adibi,LB,active,minnesota-vikings,470000,2010
25043,470000,0,Lorenzo Booker,RB,active,minnesota-vikings,470000,2010
25044,320000,135000,Everson Griffen,DE,active,minnesota-vikings,455000,2010
25045,395000,46500,Jasper Brinkley,ILB,active,minnesota-vikings,441500,2010
25046,395000,12318,Jamarca Sanford,SS,active,minnesota-vikings,407318,2010
25047,320000,23128,Joe Webb,QB,active,minnesota-vikings,343128,2010
25048,320000,0,Rhett Bomar,QB,active,minnesota-vikings,320000,2010
25049,320000,0,Chris Clark,LT,active,minnesota-vikings,320000,2010
25050,56470,0,R.J. Archer,QB,active,minnesota-vikings,56470,2010
25051,37647,0,Marcus Sherels,CB,active,minnesota-vikings,37647,2010
25052,176800,0,Marcus Sherels,CB,practice_squad,minnesota-vikings,176800,2010
25053,119000,0,Patrick Brown,G,practice_squad,minnesota-vikings,119000,2010
25054,119000,0,Seth Olsen,G,practice_squad,minnesota-vikings,119000,2010
25055,88400,0,Colt Anderson,SS,practice_squad,minnesota-vikings,88400,2010
25056,88400,0,Cary Harris,CB,practice_squad,minnesota-vikings,88400,2010
25057,88400,0,Logan Payne,WR,practice_squad,minnesota-vikings,88400,2010
25058,196500,0,Marcus McCauley,CB,dead_cap,minnesota-vikings,196500,2010
25059,177647,0,Patrick Ramsey,QB,dead_cap,minnesota-vikings,177647,2010
25060,103000,0,John David Booty,QB,dead_cap,minnesota-vikings,103000,2010
25061,68250,0,Jaymar Johnson,WR,dead_cap,minnesota-vikings,68250,2010
25062,44875,0,Aundrae Allison,WR,dead_cap,minnesota-vikings,44875,2010
25063,0,38053,Nathan Triplett,LB,dead_cap,minnesota-vikings,38053,2010
25064,0,15000,Mickey Shuler,TE,dead_cap,minnesota-vikings,15000,2010
25065,13333,0,Colt Anderson,SS,dead_cap,minnesota-vikings,13333,2010
25066,0,11787,Ryan D'Imperio,LB,dead_cap,minnesota-vikings,11787,2010
25067,7666,0,Drew Radovich,T,dead_cap,minnesota-vikings,7666,2010
25068,0,3333,R.J. Archer,QB,dead_cap,minnesota-vikings,3333,2010
25069,8250000,6260000,Adrian Peterson,RB,active,minnesota-vikings,14510000,2011
25070,8979438,2783344,Jared Allen,DE,active,minnesota-vikings,11762782,2011
25071,6000000,1416666,Kevin Williams,DT,active,minnesota-vikings,7416666,2011
25072,5500000,1700000,Chad Greenway,OLB,active,minnesota-vikings,7200000,2011
25073,6750000,0,Antoine Winfield,CB,active,minnesota-vikings,6750000,2011
25074,6680000,0,Steve Hutchinson,G,active,minnesota-vikings,6680000,2011
25075,4700000,0,E.J. Henderson,LB,active,minnesota-vikings,4700000,2011
25076,5050000,0,Donovan McNabb,QB,active,minnesota-vikings,5050000,2011
25077,3350000,1000000,Cedric Griffin,CB,active,minnesota-vikings,4350000,2011
25078,3100000,1000000,Visanthe Shiancoe,TE,active,minnesota-vikings,4100000,2011
25079,1750000,1183333,Remi Ayodele,DT,active,minnesota-vikings,2933333,2011
25080,688000,2166667,Brian Robison,DE,active,minnesota-vikings,2854667,2011
25081,1500000,875000,Ryan Longwell,K,active,minnesota-vikings,2375000,2011
25082,375000,1472036,Christian Ponder,QB,active,minnesota-vikings,1847036,2011
25083,655000,2033800,Percy Harvin,WR,active,minnesota-vikings,2688800,2011
25084,600000,1024050,John Sullivan,C,active,minnesota-vikings,1624050,2011
25085,1000000,600000,Charlie Johnson,G,active,minnesota-vikings,1600000,2011
25086,1180000,283333,Chris Kluwe,P,active,minnesota-vikings,1463333,2011
25087,1200000,0,Erin Henderson,ILB,active,minnesota-vikings,1200000,2011
25088,1000000,100000,Fred Evans,DT,active,minnesota-vikings,1100000,2011
25089,700000,333333,Eric Frampton,S,active,minnesota-vikings,1033333,2011
25090,450000,575000,Chris Cook,CB,active,minnesota-vikings,1025000,2011
25091,875000,62500,Ryan Cook,C,active,minnesota-vikings,937500,2011
25092,900000,25000,Greg Camarillo,WR,active,minnesota-vikings,925000,2011
25093,555000,367500,Tyrell Johnson,S,active,minnesota-vikings,922500,2011
25094,375000,466791,Kyle Rudolph,TE,active,minnesota-vikings,841791,2011
25095,525000,302500,Phillip Loadholt,RT,active,minnesota-vikings,827500,2011
25096,450000,371000,Toby Gerhart,RB,active,minnesota-vikings,821000,2011
25097,727812,62500,Joe Berger,G,active,minnesota-vikings,790312,2011
25098,525000,181375,Asher Allen,CB,active,minnesota-vikings,706375,2011
25099,600000,44175,Letroy Guion,DE,active,minnesota-vikings,644175,2011
25100,525000,46500,Jasper Brinkley,ILB,active,minnesota-vikings,571500,2011
25101,555000,0,Lorenzo Booker,RB,active,minnesota-vikings,555000,2011
25102,405000,135000,Everson Griffen,DE,active,minnesota-vikings,540000,2011
25103,685000,0,Devin Aromashodu,WR,active,minnesota-vikings,685000,2011
25104,480000,12318,Jamarca Sanford,SS,active,minnesota-vikings,492318,2011
25105,375000,101888,Christian Ballard,DT,active,minnesota-vikings,476888,2011
25106,450000,23128,Joe Webb,QB,active,minnesota-vikings,473128,2011
25107,450000,0,Patrick Brown,G,active,minnesota-vikings,450000,2011
25108,450000,0,Andrew Sendejo,SS,active,minnesota-vikings,450000,2011
25109,375000,42250,Brandon Burton,CB,active,minnesota-vikings,417250,2011
25110,405000,0,Mickey Shuler,TE,active,minnesota-vikings,405000,2011
25111,375000,25775,DeMarcus Love,LT,active,minnesota-vikings,400775,2011
25112,375000,24483,Mistral Raymond,S,active,minnesota-vikings,399483,2011
25113,375000,23556,Brandon Fusco,G,active,minnesota-vikings,398556,2011
25114,375000,12563,D'Aundre Reed,DE,active,minnesota-vikings,387563,2011
25115,375000,0,Emmanuel Arceneaux,WR,active,minnesota-vikings,375000,2011
25116,375000,0,Ryan D'Imperio,LB,active,minnesota-vikings,375000,2011
25117,375000,0,Larry Dean,OLB,active,minnesota-vikings,375000,2011
25118,375000,0,Daniel Hardy,TE,active,minnesota-vikings,375000,2011
25119,375000,0,Caleb King,RB,active,minnesota-vikings,375000,2011
25120,375000,0,Marcus Sherels,CB,active,minnesota-vikings,375000,2011
25121,330000,0,Rhett Bomar,QB,active,minnesota-vikings,330000,2011
25122,330000,0,Ryan Perrilloux,QB,active,minnesota-vikings,330000,2011
25123,258000,0,Stephen Burton,WR,active,minnesota-vikings,258000,2011
25124,198529,2500,Allen Reisner,TE,active,minnesota-vikings,201029,2011
25125,22058,0,Jordan Todman,RB,active,minnesota-vikings,22058,2011
25126,1835000,0,Husain Abdullah,FS,injured_reserve,minnesota-vikings,1835000,2011
25127,1000000,666666,Michael Jenkins,WR,injured_reserve,minnesota-vikings,1666666,2011
25128,775000,125000,Cullen Loeffler,LS,injured_reserve,minnesota-vikings,900000,2011
25129,378000,0,Scott Kooistra,T,injured_reserve,minnesota-vikings,378000,2011
25130,193800,0,Allen Reisner,TE,practice_squad,minnesota-vikings,193800,2011
25131,96900,0,Stephen Burton,WR,practice_squad,minnesota-vikings,96900,2011
25132,96900,0,Kerry Taylor,WR,practice_squad,minnesota-vikings,96900,2011
25133,1117647,833333,Bernard Berrian,WR,dead_cap,minnesota-vikings,1950980,2011
25134,666667,0,Madieu Williams,S,dead_cap,minnesota-vikings,666667,2011
25135,0,45000,Mickey Shuler,TE,dead_cap,minnesota-vikings,45000,2011
25136,0,41200,Chris DeGeare,LT,dead_cap,minnesota-vikings,41200,2011
25137,0,38053,Nathan Triplett,LB,dead_cap,minnesota-vikings,38053,2011
25138,0,35361,Ryan D'Imperio,LB,dead_cap,minnesota-vikings,35361,2011
25139,0,16420,Ross Homan,LB,dead_cap,minnesota-vikings,16420,2011
25140,12667,0,Greg Camarillo,WR,dead_cap,minnesota-vikings,12667,2011
25141,0,8975,Stephen Burton,WR,dead_cap,minnesota-vikings,8975,2011
25142,0,6667,R.J. Archer,QB,dead_cap,minnesota-vikings,6667,2011
25143,11619850,2783344,Jared Allen,DE,active,minnesota-vikings,14403194,2012
25144,8000000,6260000,Adrian Peterson,RB,active,minnesota-vikings,14260000,2012
25145,7000000,1416666,Kevin Williams,DT,active,minnesota-vikings,8416666,2012
25146,5900000,1800000,Chad Greenway,OLB,active,minnesota-vikings,7700000,2012
25147,3000000,1000000,John Sullivan,C,active,minnesota-vikings,4000000,2012
25148,2900000,1100000,John Carlson,TE,active,minnesota-vikings,4000000,2012
25149,1712000,2266667,Brian Robison,DE,active,minnesota-vikings,3978667,2012
25150,2950000,650000,Charlie Johnson,G,active,minnesota-vikings,3600000,2012
25151,390000,3204655,Matt Kalil,LT,active,minnesota-vikings,3594655,2012
25152,3000000,0,Antoine Winfield,CB,active,minnesota-vikings,3000000,2012
25153,836759,1472036,Christian Ponder,QB,active,minnesota-vikings,2308795,2012
25154,915000,2033800,Percy Harvin,WR,active,minnesota-vikings,2948800,2012
25155,1000000,887500,Joe Berger,G,active,minnesota-vikings,1887500,2012
25156,658823,1200000,Jerome Simpson,WR,active,minnesota-vikings,1858823,2012
25157,1300000,283333,Chris Kluwe,P,active,minnesota-vikings,1583333,2012
25158,825000,666666,Michael Jenkins,WR,active,minnesota-vikings,1491666,2012
25159,1450000,0,Erin Henderson,ILB,active,minnesota-vikings,1450000,2012
25160,540000,838500,Toby Gerhart,RB,active,minnesota-vikings,1378500,2012
25161,950000,350000,Letroy Guion,DE,active,minnesota-vikings,1300000,2012
25162,390000,907918,Harrison Smith,FS,active,minnesota-vikings,1297918,2012
25163,700000,550000,Fred Evans,DT,active,minnesota-vikings,1250000,2012
25164,540000,575000,Chris Cook,CB,active,minnesota-vikings,1115000,2012
25165,585448,466791,Kyle Rudolph,TE,active,minnesota-vikings,1052239,2012
25166,840000,135000,Cullen Loeffler,LS,active,minnesota-vikings,975000,2012
25167,615000,302500,Phillip Loadholt,RT,active,minnesota-vikings,917500,2012
25168,550000,350000,Geoff Schwartz,G,active,minnesota-vikings,900000,2012
25169,700000,50000,Jerome Felton,FB,active,minnesota-vikings,750000,2012
25170,700000,25000,Marvin Mitchell,OLB,active,minnesota-vikings,725000,2012
25171,540000,135000,Everson Griffen,DE,active,minnesota-vikings,675000,2012
25172,615000,12318,Jamarca Sanford,SS,active,minnesota-vikings,627318,2012
25173,565000,46500,Jasper Brinkley,ILB,active,minnesota-vikings,611500,2012
25174,390000,184250,Josh Robinson,CB,active,minnesota-vikings,574250,2012
25175,465000,101888,Christian Ballard,DT,active,minnesota-vikings,566888,2012
25176,540000,23128,Joe Webb,QB,active,minnesota-vikings,563128,2012
25177,700000,0,Devin Aromashodu,WR,active,minnesota-vikings,700000,2012
25178,540000,0,A.J. Jefferson,CB,active,minnesota-vikings,540000,2012
25179,540000,0,George Johnson,DE,active,minnesota-vikings,540000,2012
25180,540000,0,Troy Kropog,RT,active,minnesota-vikings,540000,2012
25181,540000,0,Andrew Sendejo,SS,active,minnesota-vikings,540000,2012
25182,465000,42250,Brandon Burton,CB,active,minnesota-vikings,507250,2012
25183,465000,34354,Mistral Raymond,S,active,minnesota-vikings,499354,2012
25184,465000,33195,Brandon Fusco,G,active,minnesota-vikings,498195,2012
25185,390000,105027,Jarius Wright,WR,active,minnesota-vikings,495027,2012
25186,465000,19454,D'Aundre Reed,DE,active,minnesota-vikings,484454,2012
25187,465000,5994,Stephen Burton,WR,active,minnesota-vikings,470994,2012
25188,390000,75146,Rhett Ellison,TE,active,minnesota-vikings,465146,2012
25189,465000,0,Larry Dean,OLB,active,minnesota-vikings,465000,2012
25190,465000,0,Tyrone McKenzie,OLB,active,minnesota-vikings,465000,2012
25191,465000,0,Marcus Sherels,CB,active,minnesota-vikings,465000,2012
25192,390000,52763,Robert Blanton,SS,active,minnesota-vikings,442763,2012
25193,390000,29483,Blair Walsh,K,active,minnesota-vikings,419483,2012
25194,390000,16875,Audie Cole,ILB,active,minnesota-vikings,406875,2012
25195,390000,2500,McLeod Bethel-Thompson,QB,active,minnesota-vikings,392500,2012
25196,390000,0,Matt Asiata,RB,active,minnesota-vikings,390000,2012
25197,288000,40619,DeMarcus Love,LT,active,minnesota-vikings,328619,2012
25198,300882,0,Allen Reisner,TE,active,minnesota-vikings,300882,2012
25199,273000,0,Nick Taylor,CB,active,minnesota-vikings,273000,2012
25200,170000,0,Jordan Todman,RB,active,minnesota-vikings,170000,2012
25201,32118,0,Kamar Jorden,WR,active,minnesota-vikings,32118,2012
25202,390000,75146,Greg Childs,WR,injured_reserve,minnesota-vikings,465146,2012
25203,96900,0,Chase Baker,DT,practice_squad,minnesota-vikings,96900,2012
25204,96900,0,Joe Banyard,RB,practice_squad,minnesota-vikings,96900,2012
25205,96900,0,Bobby Felder,CB,practice_squad,minnesota-vikings,96900,2012
25206,96900,0,Chase Ford,TE,practice_squad,minnesota-vikings,96900,2012
25207,96900,0,Kevin Murphy,LT,practice_squad,minnesota-vikings,96900,2012
25208,96900,0,Allen Reisner,TE,practice_squad,minnesota-vikings,96900,2012
25209,0,2625000,Ryan Longwell,K,dead_cap,minnesota-vikings,2625000,2012
25210,2366666,0,Remi Ayodele,DT,dead_cap,minnesota-vikings,2366666,2012
25211,2000000,0,Cedric Griffin,CB,dead_cap,minnesota-vikings,2000000,2012
25212,0,1666667,Bernard Berrian,WR,dead_cap,minnesota-vikings,1666667,2012
25213,1333334,0,Madieu Williams,S,dead_cap,minnesota-vikings,1333334,2012
25214,550000,0,Sage Rosenfels,QB,dead_cap,minnesota-vikings,550000,2012
25215,181375,0,Asher Allen,CB,dead_cap,minnesota-vikings,181375,2012
25216,100000,0,Anthony Herrera,G,dead_cap,minnesota-vikings,100000,2012
25217,0,82400,Chris DeGeare,LT,dead_cap,minnesota-vikings,82400,2012
25218,62500,0,Ryan Cook,C,dead_cap,minnesota-vikings,62500,2012
25219,0,49260,Ross Homan,LB,dead_cap,minnesota-vikings,49260,2012
25220,0,26925,Stephen Burton,WR,dead_cap,minnesota-vikings,26925,2012
25221,23574,0,Ryan D'Imperio,LB,dead_cap,minnesota-vikings,23574,2012
25222,0,22596,Trevor Guyton,DE,dead_cap,minnesota-vikings,22596,2012
25223,7500,0,Tyler Nielsen,LB,dead_cap,minnesota-vikings,7500,2012
25224,5000,0,Corey Paredes,LB,dead_cap,minnesota-vikings,5000,2012
25225,5000,0,Tydreke Powell,DT,dead_cap,minnesota-vikings,5000,2012
25226,5000,0,Quentin Saulsberry,G,dead_cap,minnesota-vikings,5000,2012
25227,3333,0,Chase Baker,DT,dead_cap,minnesota-vikings,3333,2012
25228,2500,0,Bobby Felder,CB,dead_cap,minnesota-vikings,2500,2012
25229,1666,0,Derrick Coleman,FB,dead_cap,minnesota-vikings,1666,2012
25230,833,0,Kamar Jorden,WR,dead_cap,minnesota-vikings,833,2012
25231,666,0,Austin Pasztor,T,dead_cap,minnesota-vikings,666,2012
25232,14280612,2783344,Jared Allen,DE,active,minnesota-vikings,17063956,2013
25233,11250000,2650000,Adrian Peterson,RB,active,minnesota-vikings,13900000,2013
25234,6900000,1800000,Chad Greenway,OLB,active,minnesota-vikings,8700000,2013
25235,3400000,3266667,Brian Robison,DE,active,minnesota-vikings,6666667,2013
25236,4900000,100000,Kevin Williams,DT,active,minnesota-vikings,5000000,2013
25237,2900000,2100000,Greg Jennings,WR,active,minnesota-vikings,5000000,2013
25238,2900000,1850000,Phillip Loadholt,RT,active,minnesota-vikings,4750000,2013
25239,1288663,3204655,Matt Kalil,LT,active,minnesota-vikings,4493318,2013
25240,3150000,1100000,John Sullivan,C,active,minnesota-vikings,4250000,2013
25241,2450000,1400000,Charlie Johnson,G,active,minnesota-vikings,3850000,2013
25242,1650000,2050000,Matt Cassel,QB,active,minnesota-vikings,3700000,2013
25243,2450000,350000,Letroy Guion,DE,active,minnesota-vikings,2800000,2013
25244,1298518,1472036,Christian Ponder,QB,active,minnesota-vikings,2770554,2013
25245,850000,1463726,Jerome Felton,FB,active,minnesota-vikings,2313726,2013
25246,1500000,750000,Jamarca Sanford,SS,active,minnesota-vikings,2250000,2013
25247,1350000,750000,Jerome Simpson,WR,active,minnesota-vikings,2100000,2013
25248,2833334,0,Josh Freeman,QB,active,minnesota-vikings,2833334,2013
25249,1450000,300000,Fred Evans,DT,active,minnesota-vikings,1750000,2013
25250,714479,907918,Harrison Smith,FS,active,minnesota-vikings,1622397,2013
25251,405000,1063400,Sharrif Floyd,DT,active,minnesota-vikings,1468400,2013
25252,405000,1014364,Xavier Rhodes,CB,active,minnesota-vikings,1419364,2013
25253,405000,907918,Cordarrelle Patterson,WR,active,minnesota-vikings,1312918,2013
25254,630000,675000,Chris Cook,CB,active,minnesota-vikings,1305000,2013
25255,745896,516791,Kyle Rudolph,TE,active,minnesota-vikings,1262687,2013
25256,950000,300000,Erin Henderson,ILB,active,minnesota-vikings,1250000,2013
25257,915000,135000,Cullen Loeffler,LS,active,minnesota-vikings,1050000,2013
25258,630000,383500,Toby Gerhart,RB,active,minnesota-vikings,1013500,2013
25259,630000,135000,Everson Griffen,DE,active,minnesota-vikings,765000,2013
25260,630000,66666,Andrew Sendejo,SS,active,minnesota-vikings,696666,2013
25261,505000,184250,Josh Robinson,CB,active,minnesota-vikings,689250,2013
25262,555000,101888,Christian Ballard,DT,active,minnesota-vikings,656888,2013
25263,630000,23129,Joe Webb,QB,active,minnesota-vikings,653129,2013
25264,630000,0,Marcus Sherels,CB,active,minnesota-vikings,630000,2013
25265,630000,0,J'Marcus Webb,RT,active,minnesota-vikings,630000,2013
25266,840000,65000,Joe Berger,G,active,minnesota-vikings,905000,2013
25267,765000,50000,Marvin Mitchell,OLB,active,minnesota-vikings,815000,2013
25268,555000,34612,Mistral Raymond,S,active,minnesota-vikings,589612,2013
25269,555000,33917,Brandon Fusco,G,active,minnesota-vikings,588917,2013
25270,480000,105027,Jarius Wright,WR,active,minnesota-vikings,585027,2013
25271,480000,75146,Rhett Ellison,TE,active,minnesota-vikings,555146,2013
25272,555000,0,Larry Dean,OLB,active,minnesota-vikings,555000,2013
25273,480000,52763,Robert Blanton,SS,active,minnesota-vikings,532763,2013
25274,405000,105027,Gerald Hodges,OLB,active,minnesota-vikings,510027,2013
25275,480000,29483,Blair Walsh,K,active,minnesota-vikings,509483,2013
25276,480000,0,Matt Asiata,RB,active,minnesota-vikings,480000,2013
25277,405000,46048,Jeff Locke,P,active,minnesota-vikings,451048,2013
25278,405000,24150,Jeff Baca,G,active,minnesota-vikings,429150,2013
25279,405000,15682,Michael Mauti,OLB,active,minnesota-vikings,420682,2013
25280,405000,2666,Zach Line,FB,active,minnesota-vikings,407666,2013
25281,405000,0,Chase Baker,DT,active,minnesota-vikings,405000,2013
25282,405000,0,Shaun Prater,CB,active,minnesota-vikings,405000,2013
25283,262059,0,Rodney Smith,WR,active,minnesota-vikings,262059,2013
25284,405000,0,Chase Ford,TE,active,minnesota-vikings,405000,2013
25285,480000,0,Audie Cole,ILB,active,minnesota-vikings,480000,2013
25286,56471,0,Justin Trattou,DE,active,minnesota-vikings,56471,2013
25287,405000,0,Joe Banyard,RB,active,minnesota-vikings,405000,2013
25288,405000,0,Mike Remmers,RT,active,minnesota-vikings,405000,2013
25289,23823,0,Robert Steeples,CB,active,minnesota-vikings,23823,2013
25290,1500000,1050000,John Carlson,TE,injured_reserve,minnesota-vikings,2550000,2013
25291,750000,100000,Desmond Bishop,OLB,injured_reserve,minnesota-vikings,850000,2013
25292,630000,40000,Seth Olsen,G,injured_reserve,minnesota-vikings,670000,2013
25293,54000,0,Everett Dawkins,DT,practice_squad,minnesota-vikings,54000,2013
25294,36000,0,Rodney Smith,WR,practice_squad,minnesota-vikings,36000,2013
25295,35756,0,D'Aundre Reed,DE,practice_squad,minnesota-vikings,35756,2013
25296,24000,0,Spencer Nealy,DT,practice_squad,minnesota-vikings,24000,2013
25297,1101300,0,Percy Harvin,WR,dead_cap,minnesota-vikings,1101300,2013
25298,933882,0,A.J. Jefferson,CB,dead_cap,minnesota-vikings,933882,2013
25299,0,666667,Michael Jenkins,WR,dead_cap,minnesota-vikings,666667,2013
25300,333334,0,Eric Frampton,S,dead_cap,minnesota-vikings,333334,2013
25301,299218,0,Audie Cole,ILB,dead_cap,minnesota-vikings,299218,2013
25302,222353,0,George Johnson,DE,dead_cap,minnesota-vikings,222353,2013
25303,148941,0,Justin Trattou,DE,dead_cap,minnesota-vikings,148941,2013
25304,143675,0,McLeod Bethel-Thompson,QB,dead_cap,minnesota-vikings,143675,2013
25305,140529,0,Bobby Felder,CB,dead_cap,minnesota-vikings,140529,2013
25306,125647,0,Robert Steeples,CB,dead_cap,minnesota-vikings,125647,2013
25307,101824,0,Joe Banyard,RB,dead_cap,minnesota-vikings,101824,2013
25308,89780,0,Jacob Lacey,CB,dead_cap,minnesota-vikings,89780,2013
25309,77824,0,Kevin Murphy,LT,dead_cap,minnesota-vikings,77824,2013
25310,75612,0,Travis Bond,G,dead_cap,minnesota-vikings,75612,2013
25311,71471,0,Mike Remmers,RT,dead_cap,minnesota-vikings,71471,2013
25312,65824,0,Chase Ford,TE,dead_cap,minnesota-vikings,65824,2013
25313,0,65000,Lawrence Jackson,DE,dead_cap,minnesota-vikings,65000,2013
25314,0,45192,Trevor Guyton,DE,dead_cap,minnesota-vikings,45192,2013
25315,0,42250,Brandon Burton,CB,dead_cap,minnesota-vikings,42250,2013
25316,33882,2333,Nathan Williams,DE,dead_cap,minnesota-vikings,36215,2013
25317,0,25775,DeMarcus Love,LT,dead_cap,minnesota-vikings,25775,2013
25318,20000,0,Seth Olsen,G,dead_cap,minnesota-vikings,20000,2013
25319,12563,0,D'Aundre Reed,DE,dead_cap,minnesota-vikings,12563,2013
25320,12588,0,Everett Dawkins,DT,dead_cap,minnesota-vikings,12588,2013
25321,12000,0,Jamaal Johnson-Webb,LT,dead_cap,minnesota-vikings,12000,2013
25322,7000,0,Nicholas Edwards,WR,dead_cap,minnesota-vikings,7000,2013
25323,6667,0,Chase Baker,DT,dead_cap,minnesota-vikings,6667,2013
25324,3334,0,Derrick Coleman,FB,dead_cap,minnesota-vikings,3334,2013
25325,3000,0,Mark Jackson,T,dead_cap,minnesota-vikings,3000,2013
25326,2333,0,Rodney Smith,WR,dead_cap,minnesota-vikings,2333,2013
25327,1667,0,Kamar Jorden,WR,dead_cap,minnesota-vikings,1667,2013
25328,1666,0,Marquis Jackson,DE,dead_cap,minnesota-vikings,1666,2013
25329,1666,0,Collins Ukwu,DE,dead_cap,minnesota-vikings,1666,2013
25330,1666,0,James Vandenberg,QB,dead_cap,minnesota-vikings,1666,2013
25331,1334,0,Austin Pasztor,T,dead_cap,minnesota-vikings,1334,2013
25332,1333,0,Jeroldis Williams,RB,dead_cap,minnesota-vikings,1333,2013
25333,1000,0,Brandon Bishop,S,dead_cap,minnesota-vikings,1000,2013
25334,1000,0,Darius Eubanks,S,dead_cap,minnesota-vikings,1000,2013
25335,1000,0,Anthony McCloud,DT,dead_cap,minnesota-vikings,1000,2013
25336,833,0,Erik Highsmith,WR,dead_cap,minnesota-vikings,833,2013
25337,833,0,Bradley Randle,RB,dead_cap,minnesota-vikings,833,2013
25338,500,0,Colin Anderson,TE,dead_cap,minnesota-vikings,500,2013
25339,6900000,1300000,Everson Griffen,DE,active,minnesota-vikings,8200000,2014
25340,5500000,1700000,Chad Greenway,OLB,active,minnesota-vikings,7200000,2014
25341,4900000,2100000,Greg Jennings,WR,active,minnesota-vikings,7000000,2014
25342,3500000,3100000,Linval Joseph,DT,active,minnesota-vikings,6600000,2014
25343,2650000,3100000,Matt Cassel,QB,active,minnesota-vikings,5750000,2014
25344,4000000,1700000,Brian Robison,DE,active,minnesota-vikings,5700000,2014
25345,2187326,3204655,Matt Kalil,LT,active,minnesota-vikings,5391981,2014
25346,3650000,1100000,John Sullivan,C,active,minnesota-vikings,4750000,2014
25347,950000,2383333,Captain Munnerlyn,CB,active,minnesota-vikings,3333333,2014
25348,1760277,1472036,Christian Ponder,QB,active,minnesota-vikings,3232313,2014
25349,956343,1816791,Kyle Rudolph,TE,active,minnesota-vikings,2773134,2014
25350,950000,1550000,Charlie Johnson,G,active,minnesota-vikings,2500000,2014
25351,420000,1897000,Anthony Barr,OLB,active,minnesota-vikings,2317000,2014
25352,1431000,823556,Brandon Fusco,G,active,minnesota-vikings,2254556,2014
25353,1450000,677452,Jerome Felton,FB,active,minnesota-vikings,2127452,2014
25354,1038958,907918,Harrison Smith,FS,active,minnesota-vikings,1946876,2014
25355,772100,1063400,Sharrif Floyd,DT,active,minnesota-vikings,1835500,2014
25356,759841,1014364,Xavier Rhodes,CB,active,minnesota-vikings,1774205,2014
25357,1000000,700000,Corey Wootton,DT,active,minnesota-vikings,1700000,2014
25358,733230,907918,Cordarrelle Patterson,WR,active,minnesota-vikings,1641148,2014
25359,1135000,135000,Cullen Loeffler,LS,active,minnesota-vikings,1270000,2014
25360,420000,825364,Teddy Bridgewater,QB,active,minnesota-vikings,1245364,2014
25361,750000,250000,Marcus Sherels,CB,active,minnesota-vikings,1000000,2014
25362,750000,116666,Andrew Sendejo,SS,active,minnesota-vikings,866666,2014
25363,645000,200000,Tom Johnson,DT,active,minnesota-vikings,845000,2014
25364,730000,100000,Jasper Brinkley,ILB,active,minnesota-vikings,830000,2014
25365,627000,184250,Josh Robinson,CB,active,minnesota-vikings,811250,2014
25366,645000,101888,Christian Ballard,DT,active,minnesota-vikings,746888,2014
25367,570000,105027,Jarius Wright,WR,active,minnesota-vikings,675027,2014
25368,570000,75146,Rhett Ellison,TE,active,minnesota-vikings,645146,2014
25369,855000,65000,Joe Berger,G,active,minnesota-vikings,920000,2014
25370,730000,65000,Vladimir Ducasse,G,active,minnesota-vikings,795000,2014
25371,570000,52763,Robert Blanton,SS,active,minnesota-vikings,622763,2014
25372,495000,105027,Gerald Hodges,OLB,active,minnesota-vikings,600027,2014
25373,570000,29483,Blair Walsh,K,active,minnesota-vikings,599483,2014
25374,420000,164081,Scott Crichton,DE,active,minnesota-vikings,584081,2014
25375,570000,0,Matt Asiata,RB,active,minnesota-vikings,570000,2014
25376,570000,0,Audie Cole,ILB,active,minnesota-vikings,570000,2014
25377,570000,0,Mike Harris,G,active,minnesota-vikings,570000,2014
25378,570000,0,Shaun Prater,CB,active,minnesota-vikings,570000,2014
25379,495000,46048,Jeff Locke,P,active,minnesota-vikings,541048,2014
25380,420000,128750,Jerick McKinnon,RB,active,minnesota-vikings,548750,2014
25381,495000,15682,Michael Mauti,OLB,active,minnesota-vikings,510682,2014
25382,420000,51725,David Yankey,G,active,minnesota-vikings,471725,2014
25383,495000,0,Joe Banyard,RB,active,minnesota-vikings,495000,2014
25384,420000,28947,Antone Exum,FS,active,minnesota-vikings,448947,2014
25385,420000,16287,Shamar Stephen,DT,active,minnesota-vikings,436287,2014
25386,420000,15612,Brandon Watts,OLB,active,minnesota-vikings,435612,2014
25387,420000,15455,Jabari Price,CB,active,minnesota-vikings,435455,2014
25388,420000,0,Adam Thielen,WR,active,minnesota-vikings,420000,2014
25389,495000,0,Chase Ford,TE,active,minnesota-vikings,495000,2014
25390,420000,0,Charles Johnson,WR,active,minnesota-vikings,420000,2014
25391,495000,0,Zach Line,FB,active,minnesota-vikings,495000,2014
25392,420000,0,Austin Wentworth,RT,active,minnesota-vikings,420000,2014
25393,570000,0,Justin Trattou,DE,active,minnesota-vikings,570000,2014
25394,420000,0,Carter Bykowski,LT,active,minnesota-vikings,420000,2014
25395,420000,0,Ahmad Dixon,S,active,minnesota-vikings,420000,2014
25396,570000,0,Josh Kaddu,OLB,active,minnesota-vikings,570000,2014
25397,420000,0,Henry Josey,RB,active,minnesota-vikings,420000,2014
25398,3400000,2350000,Phillip Loadholt,RT,injured_reserve,minnesota-vikings,5750000,2014
25399,570000,0,Dom DeCicco,ILB,injured_reserve,minnesota-vikings,570000,2014
25400,318000,0,Josh Samuda,C,injured_reserve,minnesota-vikings,318000,2014
25401,303000,0,Antonio Richardson,RT,injured_reserve,minnesota-vikings,303000,2014
25402,107100,0,Kain Colter,WR,practice_squad,minnesota-vikings,107100,2014
25403,107100,0,Isame Faciane III,DE,practice_squad,minnesota-vikings,107100,2014
25404,107100,0,Zac Kerin,C,practice_squad,minnesota-vikings,107100,2014
25405,75600,0,Donte Foster,WR,practice_squad,minnesota-vikings,75600,2014
25406,50400,0,Pat Devlin,QB,practice_squad,minnesota-vikings,50400,2014
25407,44100,0,Ryan Otten,TE,practice_squad,minnesota-vikings,44100,2014
25408,37800,0,Dominique Williams,RB,practice_squad,minnesota-vikings,37800,2014
25409,12600,0,Jordan McCray,G,practice_squad,minnesota-vikings,12600,2014
25410,6300,0,Justin Anderson,ILB,practice_squad,minnesota-vikings,6300,2014
25411,3000000,0,John Carlson,TE,dead_cap,minnesota-vikings,3000000,2014
25412,1200000,0,Charlie Johnson,G,dead_cap,minnesota-vikings,1200000,2014
25413,700000,300000,Jamarca Sanford,SS,dead_cap,minnesota-vikings,1000000,2014
25414,587316,0,Ben Tate,RB,dead_cap,minnesota-vikings,587316,2014
25415,200000,150000,Larry Dean,OLB,dead_cap,minnesota-vikings,350000,2014
25416,320294,0,MarQueis Gray,TE,dead_cap,minnesota-vikings,320294,2014
25417,300000,0,Letroy Guion,DE,dead_cap,minnesota-vikings,300000,2014
25418,250000,0,Erin Henderson,ILB,dead_cap,minnesota-vikings,250000,2014
25419,190106,24483,Mistral Raymond,S,dead_cap,minnesota-vikings,214589,2014
25420,150292,0,Greg Childs,WR,dead_cap,minnesota-vikings,150292,2014
25421,128824,0,J'Marcus Webb,RT,dead_cap,minnesota-vikings,128824,2014
25422,116471,4667,Rodney Smith,WR,dead_cap,minnesota-vikings,121138,2014
25423,0,100000,Fred Evans,DT,dead_cap,minnesota-vikings,100000,2014
25424,94500,0,Chris Greenwood,CB,dead_cap,minnesota-vikings,94500,2014
25425,94500,0,Josh Kaddu,OLB,dead_cap,minnesota-vikings,94500,2014
25426,92117,0,Chandler Harnish,QB,dead_cap,minnesota-vikings,92117,2014
25427,88235,2666,Zach Line,FB,dead_cap,minnesota-vikings,90901,2014
25428,88200,0,Justin Trattou,DE,dead_cap,minnesota-vikings,88200,2014
25429,0,50000,Derek Cox,CB,dead_cap,minnesota-vikings,50000,2014
25430,0,50000,Jerome Simpson,WR,dead_cap,minnesota-vikings,50000,2014
25431,46836,0,Travis Bond,G,dead_cap,minnesota-vikings,46836,2014
25432,37800,0,Ryan Otten,TE,dead_cap,minnesota-vikings,37800,2014
25433,37800,0,Pierre Warren,FS,dead_cap,minnesota-vikings,37800,2014
25434,37764,0,Everett Dawkins,DT,dead_cap,minnesota-vikings,37764,2014
25435,34500,0,Ahmad Dixon,S,dead_cap,minnesota-vikings,34500,2014
25436,33750,0,Audie Cole,ILB,dead_cap,minnesota-vikings,33750,2014
25437,0,28363,Kendall James,CB,dead_cap,minnesota-vikings,28363,2014
25438,0,25775,DeMarcus Love,LT,dead_cap,minnesota-vikings,25775,2014
25439,25200,333,Donte Foster,WR,dead_cap,minnesota-vikings,25533,2014
25440,0,24150,Jeff Baca,G,dead_cap,minnesota-vikings,24150,2014
25441,18900,666,Austin Wentworth,RT,dead_cap,minnesota-vikings,19566,2014
25442,18900,0,Chase Ford,TE,dead_cap,minnesota-vikings,18900,2014
25443,12600,0,McLeod Bethel-Thompson,QB,dead_cap,minnesota-vikings,12600,2014
25444,12563,0,D'Aundre Reed,DE,dead_cap,minnesota-vikings,12563,2014
25445,0,10000,Lestar Jean,WR,dead_cap,minnesota-vikings,10000,2014
25446,10000,0,Simoni Lawrence,ILB,dead_cap,minnesota-vikings,10000,2014
25447,6300,0,Rashaun Allen,TE,dead_cap,minnesota-vikings,6300,2014
25448,6300,0,Joe Banyard,RB,dead_cap,minnesota-vikings,6300,2014
25449,6300,0,Allen Reisner,TE,dead_cap,minnesota-vikings,6300,2014
25450,4667,0,Nathan Williams,DE,dead_cap,minnesota-vikings,4667,2014
25451,0,4000,Conor Bofeli,G,dead_cap,minnesota-vikings,4000,2014
25452,3334,0,Marquis Jackson,DE,dead_cap,minnesota-vikings,3334,2014
25453,3334,0,Collins Ukwu,DE,dead_cap,minnesota-vikings,3334,2014
25454,3334,0,James Vandenberg,QB,dead_cap,minnesota-vikings,3334,2014
25455,0,3333,Zac Kerin,C,dead_cap,minnesota-vikings,3333,2014
25456,0,3333,Antonio Richardson,RT,dead_cap,minnesota-vikings,3333,2014
25457,2667,0,Jeroldis Williams,RB,dead_cap,minnesota-vikings,2667,2014
25458,0,2666,Kain Colter,WR,dead_cap,minnesota-vikings,2666,2014
25459,2000,0,Brandon Bishop,S,dead_cap,minnesota-vikings,2000,2014
25460,2000,0,Darius Eubanks,S,dead_cap,minnesota-vikings,2000,2014
25461,2000,0,Anthony McCloud,DT,dead_cap,minnesota-vikings,2000,2014
25462,1667,0,Erik Highsmith,WR,dead_cap,minnesota-vikings,1667,2014
25463,1667,0,Bradley Randle,RB,dead_cap,minnesota-vikings,1667,2014
25464,0,1333,Isame Faciane III,DE,dead_cap,minnesota-vikings,1333,2014
25465,0,1166,Pierce Burton,RT,dead_cap,minnesota-vikings,1166,2014
25466,0,1000,Rakim Cox,DE,dead_cap,minnesota-vikings,1000,2014
25467,0,1000,Travis Partridge,QB,dead_cap,minnesota-vikings,1000,2014
25468,1000,0,Colin Anderson,TE,dead_cap,minnesota-vikings,1000,2014
25469,0,833,A.C. Leonard,TE,dead_cap,minnesota-vikings,833,2014
25470,0,833,Tyler Scott,DE,dead_cap,minnesota-vikings,833,2014
25471,0,833,Jake Snyder,DE,dead_cap,minnesota-vikings,833,2014
25472,0,500,Matt Hall,RT,dead_cap,minnesota-vikings,500,2014
25473,0,500,Erik Lora,WR,dead_cap,minnesota-vikings,500,2014
25474,0,333,Dominique Williams,RB,dead_cap,minnesota-vikings,333,2014
25475,11000000,4400000,Adrian Peterson,RB,active,minnesota-vikings,15400000,2015
25476,9850000,50000,Mike Wallace,WR,active,minnesota-vikings,9900000,2015
25477,6900000,1300000,Everson Griffen,DE,active,minnesota-vikings,8200000,2015
25478,5900000,1433333,John Sullivan,C,active,minnesota-vikings,7333333,2015
25479,4900000,1540625,Kyle Rudolph,TE,active,minnesota-vikings,6440625,2015
25480,3085989,3204655,Matt Kalil,LT,active,minnesota-vikings,6290644,2015
25481,4150000,1500000,Brian Robison,DE,active,minnesota-vikings,5650000,2015
25482,3400000,2175000,Chad Greenway,OLB,active,minnesota-vikings,5575000,2015
25483,3900000,700000,Linval Joseph,DT,active,minnesota-vikings,4600000,2015
25484,3450000,883333,Captain Munnerlyn,CB,active,minnesota-vikings,4333333,2015
25485,2620000,865000,Brandon Fusco,G,active,minnesota-vikings,3485000,2015
25486,2200000,1050000,Shaun Hill,QB,active,minnesota-vikings,3250000,2015
25487,999250,1897000,Anthony Barr,OLB,active,minnesota-vikings,2896250,2015
25488,1542000,1165027,Jarius Wright,WR,active,minnesota-vikings,2707027,2015
25489,1400000,1053125,Terence Newman,CB,active,minnesota-vikings,2453125,2015
25490,435000,1918520,Trae Waynes,CB,active,minnesota-vikings,2353520,2015
25491,750000,1550000,Tom Johnson,DT,active,minnesota-vikings,2300000,2015
25492,1363437,907918,Harrison Smith,FS,active,minnesota-vikings,2271355,2015
25493,660000,1579483,Blair Walsh,K,active,minnesota-vikings,2239483,2015
25494,1139200,1063400,Sharrif Floyd,DT,active,minnesota-vikings,2202600,2015
25495,1114682,1014364,Xavier Rhodes,CB,active,minnesota-vikings,2129046,2015
25496,1061459,907918,Cordarrelle Patterson,WR,active,minnesota-vikings,1969377,2015
25497,1532000,184250,Josh Robinson,CB,active,minnesota-vikings,1716250,2015
25498,1542000,52763,Robert Blanton,SS,active,minnesota-vikings,1594763,2015
25499,731341,825364,Teddy Bridgewater,QB,active,minnesota-vikings,1556705,2015
25500,1542000,0,Mike Harris,G,active,minnesota-vikings,1542000,2015
25501,1050000,200000,Marcus Sherels,CB,active,minnesota-vikings,1250000,2015
25502,970000,150000,Joe Berger,G,active,minnesota-vikings,1120000,2015
25503,950000,116668,Andrew Sendejo,SS,active,minnesota-vikings,1066668,2015
25504,435000,502440,Eric Kendricks,ILB,active,minnesota-vikings,937440,2015
25505,725000,75000,Matt Asiata,RB,active,minnesota-vikings,800000,2015
25506,520000,128750,Jerick McKinnon,RB,active,minnesota-vikings,648750,2015
25507,585000,46048,Jeff Locke,P,active,minnesota-vikings,631048,2015
25508,435000,156805,Danielle Hunter,DE,active,minnesota-vikings,591805,2015
25509,585000,0,Zach Line,FB,active,minnesota-vikings,585000,2015
25510,585000,0,Kevin McDermott,LS,active,minnesota-vikings,585000,2015
25511,435000,131238,T.J. Clemmings,RT,active,minnesota-vikings,566238,2015
25512,510000,0,Charles Johnson,WR,active,minnesota-vikings,510000,2015
25513,510000,0,Jeremiah Sirles,G,active,minnesota-vikings,510000,2015
25514,510000,0,Adam Thielen,WR,active,minnesota-vikings,510000,2015
25515,435000,57647,MyCole Pruitt,TE,active,minnesota-vikings,492647,2015
25516,435000,56928,Stefon Diggs,WR,active,minnesota-vikings,491928,2015
25517,435000,17423,Austin Shepherd,RT,active,minnesota-vikings,452423,2015
25518,435000,17078,Edmond Robinson,OLB,active,minnesota-vikings,452078,2015
25519,435000,3333,Taylor Heinicke,QB,active,minnesota-vikings,438333,2015
25520,435000,0,Chigbo Anunoby,DT,active,minnesota-vikings,435000,2015
25521,435000,0,Zac Kerin,C,active,minnesota-vikings,435000,2015
25522,348000,80000,Casey Matthews,ILB,active,minnesota-vikings,428000,2015
25523,482058,0,Kenrick Ellis,DT,active,minnesota-vikings,482058,2015
25524,333000,0,Carter Bykowski,LT,active,minnesota-vikings,333000,2015
25525,332647,0,Nick Easton,C,active,minnesota-vikings,332647,2015
25526,300000,0,Brandon Watts,OLB,active,minnesota-vikings,300000,2015
25527,409411,0,Jason Trusnik,ILB,active,minnesota-vikings,409411,2015
25528,116470,0,Justin Trattou,DE,active,minnesota-vikings,116470,2015
25529,102352,0,Anthony Harris,SS,active,minnesota-vikings,102352,2015
25530,90000,0,Zach Moore,DE,active,minnesota-vikings,90000,2015
25531,4400000,2350000,Phillip Loadholt,RT,injured_reserve,minnesota-vikings,6750000,2015
25532,1542000,75146,Rhett Ellison,TE,injured_reserve,minnesota-vikings,1617146,2015
25533,541426,164081,Scott Crichton,DE,injured_reserve,minnesota-vikings,705507,2015
25534,660000,0,Audie Cole,ILB,injured_reserve,minnesota-vikings,660000,2015
25535,468352,28947,Antone Exum,FS,injured_reserve,minnesota-vikings,497299,2015
25536,450000,15455,Jabari Price,CB,injured_reserve,minnesota-vikings,465455,2015
25537,395470,16287,Shamar Stephen,DT,injured_reserve,minnesota-vikings,411757,2015
25538,510000,0,Austin Wentworth,RT,non_fb_injury,minnesota-vikings,510000,2015
25539,0,6000000,Greg Jennings,WR,dead_cap,minnesota-vikings,6000000,2015
25540,504705,0,Justin Trattou,DE,dead_cap,minnesota-vikings,504705,2015
25541,362505,0,Chase Ford,TE,dead_cap,minnesota-vikings,362505,2015
25542,220000,80000,Cullen Loeffler,LS,dead_cap,minnesota-vikings,300000,2015
25543,137647,105027,Gerald Hodges,OLB,dead_cap,minnesota-vikings,242674,2015
25544,112200,51725,David Yankey,G,dead_cap,minnesota-vikings,163925,2015
25545,112200,29965,B.J. Dubose,DE,dead_cap,minnesota-vikings,142165,2015
25546,112200,2667,Isame Faciane III,DE,dead_cap,minnesota-vikings,114867,2015
25547,112200,667,Dominique Williams,RB,dead_cap,minnesota-vikings,112867,2015
25548,112200,0,Isaac Fruechte,WR,dead_cap,minnesota-vikings,112200,2015
25549,0,100000,Larry Dean,OLB,dead_cap,minnesota-vikings,100000,2015
25550,95800,3333,Anthony Harris,SS,dead_cap,minnesota-vikings,99133,2015
25551,92400,0,Zach Moore,DE,dead_cap,minnesota-vikings,92400,2015
25552,85800,500,Blake Renaud,LB,dead_cap,minnesota-vikings,86300,2015
25553,0,85089,Kendall James,CB,dead_cap,minnesota-vikings,85089,2015
25554,46200,15612,Brandon Watts,OLB,dead_cap,minnesota-vikings,61812,2015
25555,59400,0,Terrance Plummer,ILB,dead_cap,minnesota-vikings,59400,2015
25556,56117,2500,Gavin Lutman,WR,dead_cap,minnesota-vikings,58617,2015
25557,18705,32201,Tyrus Thompson,T,dead_cap,minnesota-vikings,50906,2015
25558,0,48300,Jeff Baca,G,dead_cap,minnesota-vikings,48300,2015
25559,46200,0,Dominique Jones,TE,dead_cap,minnesota-vikings,46200,2015
25560,39600,0,Brock Vereen,FS,dead_cap,minnesota-vikings,39600,2015
25561,38823,0,Shaun Prater,CB,dead_cap,minnesota-vikings,38823,2015
25562,33000,0,John Lowdermilk,SS,dead_cap,minnesota-vikings,33000,2015
25563,26400,667,Donte Foster,WR,dead_cap,minnesota-vikings,27067,2015
25564,0,25000,Taylor Mays,SS,dead_cap,minnesota-vikings,25000,2015
25565,22823,0,Mike Kafka,QB,dead_cap,minnesota-vikings,22823,2015
25566,19800,0,Brian Peters,ILB,dead_cap,minnesota-vikings,19800,2015
25567,0,15682,Michael Mauti,OLB,dead_cap,minnesota-vikings,15682,2015
25568,13200,0,Alex Singleton,LB,dead_cap,minnesota-vikings,13200,2015
25569,0,10000,DeMarcus Van Dyke,CB,dead_cap,minnesota-vikings,10000,2015
25570,5000,5000,Justin Coleman,CB,dead_cap,minnesota-vikings,10000,2015
25571,0,7500,Jalil Carter,CB,dead_cap,minnesota-vikings,7500,2015
25572,0,6667,Zac Kerin,C,dead_cap,minnesota-vikings,6667,2015
25573,0,6667,Antonio Richardson,RT,dead_cap,minnesota-vikings,6667,2015
25574,0,5334,Kain Colter,WR,dead_cap,minnesota-vikings,5334,2015
25575,0,3333,DaVaris Daniels,WR,dead_cap,minnesota-vikings,3333,2015
25576,0,2667,Zach Line,FB,dead_cap,minnesota-vikings,2667,2015
25577,0,2666,Jordan Leslie,WR,dead_cap,minnesota-vikings,2666,2015
25578,0,2334,Pierce Burton,RT,dead_cap,minnesota-vikings,2334,2015
25579,0,2000,Rakim Cox,DE,dead_cap,minnesota-vikings,2000,2015
25580,0,2000,Travis Partridge,QB,dead_cap,minnesota-vikings,2000,2015
25581,0,1667,A.C. Leonard,TE,dead_cap,minnesota-vikings,1667,2015
25582,0,1667,Tyler Scott,DE,dead_cap,minnesota-vikings,1667,2015
25583,0,1667,Jake Snyder,DE,dead_cap,minnesota-vikings,1667,2015
25584,0,1334,Austin Wentworth,RT,dead_cap,minnesota-vikings,1334,2015
25585,0,1000,Matt Hall,RT,dead_cap,minnesota-vikings,1000,2015
25586,0,1000,Erik Lora,WR,dead_cap,minnesota-vikings,1000,2015
25587,0,1000,Jesse Somsel,G,dead_cap,minnesota-vikings,1000,2015
25588,0,666,Bobby Vardaro,G,dead_cap,minnesota-vikings,666,2015
25589,7750000,4250000,Adrian Peterson,RB,active,minnesota-vikings,12000000,2016
25590,6900000,1300000,Everson Griffen,DE,active,minnesota-vikings,8200000,2016
25591,5650000,1650000,Kyle Rudolph,TE,active,minnesota-vikings,7300000,2016
25592,5278000,2000000,Harrison Smith,FS,active,minnesota-vikings,7278000,2016
25593,7000000,0,Sam Bradford,QB,active,minnesota-vikings,7000000,2016
25594,1600000,5100000,Alex Boone,G,active,minnesota-vikings,6700000,2016
25595,5650000,700000,Linval Joseph,DT,active,minnesota-vikings,6350000,2016
25596,3750000,1500000,Brian Robison,DE,active,minnesota-vikings,5250000,2016
25597,4200000,383334,Captain Munnerlyn,CB,active,minnesota-vikings,4583334,2016
25598,3120000,930000,Brandon Fusco,G,active,minnesota-vikings,4050000,2016
25599,1578500,1897000,Anthony Barr,OLB,active,minnesota-vikings,3475500,2016
25600,3200000,50000,Shaun Hill,QB,active,minnesota-vikings,3250000,2016
25601,1900000,1160000,Jarius Wright,WR,active,minnesota-vikings,3060000,2016
25602,1650000,1350000,Terence Newman,CB,active,minnesota-vikings,3000000,2016
25603,1023381,1918520,Trae Waynes,CB,active,minnesota-vikings,2941901,2016
25604,2300000,450000,Chad Greenway,OLB,active,minnesota-vikings,2750000,2016
25605,1450000,1300000,Emmanuel Lamur,OLB,active,minnesota-vikings,2750000,2016
25606,979523,1504364,Xavier Rhodes,CB,active,minnesota-vikings,2483887,2016
25607,1009689,1287918,Cordarrelle Patterson,WR,active,minnesota-vikings,2297607,2016
25608,1450000,550000,Marcus Sherels,CB,active,minnesota-vikings,2000000,2016
25609,760000,1090625,Rhett Ellison,TE,active,minnesota-vikings,1850625,2016
25610,450000,1356359,Laquon Treadwell,WR,active,minnesota-vikings,1806359,2016
25611,1671000,0,Zach Line,FB,active,minnesota-vikings,1671000,2016
25612,985000,625000,Joe Berger,G,active,minnesota-vikings,1610000,2016
25613,669360,502440,Eric Kendricks,ILB,active,minnesota-vikings,1171800,2016
25614,760000,80000,Matt Asiata,RB,active,minnesota-vikings,840000,2016
25615,675000,100000,Kevin McDermott,LS,active,minnesota-vikings,775000,2016
25616,610000,128750,Jerick McKinnon,RB,active,minnesota-vikings,738750,2016
25617,675000,46048,Jeff Locke,P,active,minnesota-vikings,721048,2016
25618,536000,156805,Danielle Hunter,DE,active,minnesota-vikings,692805,2016
25619,760000,80000,Audie Cole,ILB,active,minnesota-vikings,840000,2016
25620,525000,131238,T.J. Clemmings,RT,active,minnesota-vikings,656238,2016
25621,760000,50000,Justin Trattou,DE,active,minnesota-vikings,810000,2016
25622,600000,16287,Shamar Stephen,DT,active,minnesota-vikings,616287,2016
25623,600000,0,Charles Johnson,WR,active,minnesota-vikings,600000,2016
25624,600000,0,Jeremiah Sirles,G,active,minnesota-vikings,600000,2016
25625,600000,0,Adam Thielen,WR,active,minnesota-vikings,600000,2016
25626,525000,56928,Stefon Diggs,WR,active,minnesota-vikings,581928,2016
25627,525000,17078,Edmond Robinson,OLB,active,minnesota-vikings,542078,2016
25628,525000,0,Nick Easton,C,active,minnesota-vikings,525000,2016
25629,525000,0,Anthony Harris,SS,active,minnesota-vikings,525000,2016
25630,525000,0,Zac Kerin,C,active,minnesota-vikings,525000,2016
25631,450000,58170,Kentrell Brothers,OLB,active,minnesota-vikings,508170,2016
25632,450000,33864,David Morgan,TE,active,minnesota-vikings,483864,2016
25633,450000,16056,Jayron Kearse,S,active,minnesota-vikings,466056,2016
25634,462529,3333,Taylor Heinicke,QB,active,minnesota-vikings,465862,2016
25635,450000,0,Rashod Hill,T,active,minnesota-vikings,450000,2016
25636,450000,0,Terrell Sinkfield,WR,active,minnesota-vikings,450000,2016
25637,312941,0,Kai Forbath,K,active,minnesota-vikings,312941,2016
25638,158820,0,Stephen Weatherly,DE,active,minnesota-vikings,158820,2016
25639,52940,0,C.J. Ham,RB,active,minnesota-vikings,52940,2016
25640,52940,0,Toby Johnson,DT,active,minnesota-vikings,52940,2016
25641,26470,0,Isaac Fruechte,WR,active,minnesota-vikings,26470,2016
25642,11096000,0,Matt Kalil,LT,injured_reserve,minnesota-vikings,11096000,2016
25643,950000,3050000,Andrew Sendejo,SS,injured_reserve,minnesota-vikings,4000000,2016
25644,2500000,968750,Andre Smith,G,injured_reserve,minnesota-vikings,3468750,2016
25645,941300,1628400,Sharrif Floyd,DT,injured_reserve,minnesota-vikings,2569700,2016
25646,2300000,50000,Tom Johnson,DT,injured_reserve,minnesota-vikings,2350000,2016
25647,1042682,825364,Teddy Bridgewater,QB,injured_reserve,minnesota-vikings,1868046,2016
25648,633750,164081,Scott Crichton,DE,injured_reserve,minnesota-vikings,797831,2016
25649,450000,334783,Mackensie Alexander,CB,injured_reserve,minnesota-vikings,784783,2016
25650,600000,28947,Antone Exum,FS,injured_reserve,minnesota-vikings,628947,2016
25651,600000,15455,Jabari Price,CB,injured_reserve,minnesota-vikings,615455,2016
25652,624705,0,Jake Long,LT,injured_reserve,minnesota-vikings,624705,2016
25653,333000,0,B.J. Dubose,DE,injured_reserve,minnesota-vikings,333000,2016
25654,500000,1100000,Mike Harris,G,non_fb_injury,minnesota-vikings,1600000,2016
25655,1150000,650000,Blair Walsh,K,dead_cap,minnesota-vikings,1800000,2016
25656,0,1750000,Phillip Loadholt,RT,dead_cap,minnesota-vikings,1750000,2016
25657,500000,350000,Michael Griffin,FS,dead_cap,minnesota-vikings,850000,2016
25658,0,433333,John Sullivan,C,dead_cap,minnesota-vikings,433333,2016
25659,402352,0,Ronnie Hillman,RB,dead_cap,minnesota-vikings,402352,2016
25660,312441,57647,MyCole Pruitt,TE,dead_cap,minnesota-vikings,370088,2016
25661,45000,133961,Willie Beavers,T,dead_cap,minnesota-vikings,178961,2016
25662,117300,37605,Moritz Boehringer,WR,dead_cap,minnesota-vikings,154905,2016
25663,131100,0,Kyle Carter,TE,dead_cap,minnesota-vikings,131100,2016
25664,0,105027,Gerald Hodges,OLB,dead_cap,minnesota-vikings,105027,2016
25665,103500,0,C.J. Ham,RB,dead_cap,minnesota-vikings,103500,2016
25666,103500,0,Tre Roberson,CB,dead_cap,minnesota-vikings,103500,2016
25667,0,103450,David Yankey,G,dead_cap,minnesota-vikings,103450,2016
25668,0,96605,Tyrus Thompson,T,dead_cap,minnesota-vikings,96605,2016
25669,96600,0,Toby Johnson,DT,dead_cap,minnesota-vikings,96600,2016
25670,75900,20322,Stephen Weatherly,DE,dead_cap,minnesota-vikings,96222,2016
25671,0,89895,B.J. Dubose,DE,dead_cap,minnesota-vikings,89895,2016
25672,89700,0,Isaac Fruechte,WR,dead_cap,minnesota-vikings,89700,2016
25673,69000,17423,Austin Shepherd,RT,dead_cap,minnesota-vikings,86423,2016
25674,69000,0,Sterling Bailey,DE,dead_cap,minnesota-vikings,69000,2016
25675,55200,0,Cedric Thompson,FS,dead_cap,minnesota-vikings,55200,2016
25676,0,50000,Travis Lewis,ILB,dead_cap,minnesota-vikings,50000,2016
25677,48300,0,Sean Hickey,T,dead_cap,minnesota-vikings,48300,2016
25678,41400,0,Bishop Sankey,RB,dead_cap,minnesota-vikings,41400,2016
25679,41400,0,Joel Stave,QB,dead_cap,minnesota-vikings,41400,2016
25680,0,31224,Brandon Watts,OLB,dead_cap,minnesota-vikings,31224,2016
25681,20700,0,Isame Faciane III,DE,dead_cap,minnesota-vikings,20700,2016
25682,20700,0,Brian Leonhardt,TE,dead_cap,minnesota-vikings,20700,2016
25683,20700,0,Marquis Lucas,T,dead_cap,minnesota-vikings,20700,2016
25684,0,15682,Michael Mauti,OLB,dead_cap,minnesota-vikings,15682,2016
25685,13800,0,Julian Wilson,CB,dead_cap,minnesota-vikings,13800,2016
25686,0,10000,Justin Coleman,CB,dead_cap,minnesota-vikings,10000,2016
25687,0,7500,Jalil Carter,CB,dead_cap,minnesota-vikings,7500,2016
25688,6900,0,Carter Bykowski,LT,dead_cap,minnesota-vikings,6900,2016
25689,6900,0,Shamiel Gary,S,dead_cap,minnesota-vikings,6900,2016
25690,6900,0,Cayleb Jones,WR,dead_cap,minnesota-vikings,6900,2016
25691,0,6667,DaVaris Daniels,WR,dead_cap,minnesota-vikings,6667,2016
25692,0,6667,Anthony Harris,SS,dead_cap,minnesota-vikings,6667,2016
25693,0,5334,Jordan Leslie,WR,dead_cap,minnesota-vikings,5334,2016
25694,0,5000,Gavin Lutman,WR,dead_cap,minnesota-vikings,5000,2016
25695,0,3000,Brandon Ross,RB,dead_cap,minnesota-vikings,3000,2016
25696,0,1666,Keith Baxter,DE,dead_cap,minnesota-vikings,1666,2016
25697,0,1334,Bobby Vardaro,G,dead_cap,minnesota-vikings,1334,2016
25698,0,1000,Blake Renaud,LB,dead_cap,minnesota-vikings,1000,2016
25699,14000000,4000000,Sam Bradford,QB,active,minnesota-vikings,18000000,2017
25700,8026000,2400000,Xavier Rhodes,CB,active,minnesota-vikings,10426000,2017
25701,1900000,6700000,Everson Griffen,DE,active,minnesota-vikings,8600000,2017
25702,6200000,2300000,Riley Reiff,LT,active,minnesota-vikings,8500000,2017
25703,5150000,2350000,Harrison Smith,FS,active,minnesota-vikings,7500000,2017
25704,1150000,5900000,Linval Joseph,DT,active,minnesota-vikings,7050000,2017
25705,5150000,1650000,Kyle Rudolph,TE,active,minnesota-vikings,6800000,2017
25706,1400000,3700000,Mike Remmers,RT,active,minnesota-vikings,5100000,2017
25707,3900000,1100000,Brian Robison,DE,active,minnesota-vikings,5000000,2017
25708,2157750,1897000,Anthony Barr,OLB,active,minnesota-vikings,4054750,2017
25709,2746000,1000000,Adam Thielen,WR,active,minnesota-vikings,3746000,2017
25710,2400000,1184375,Terence Newman,CB,active,minnesota-vikings,3584375,2017
25711,1611761,1918520,Trae Waynes,CB,active,minnesota-vikings,3530281,2017
25712,1050000,2003750,Jarius Wright,WR,active,minnesota-vikings,3053750,2017
25713,900000,2056250,Latavius Murray,RB,active,minnesota-vikings,2956250,2017
25714,2776471,50000,Andrew Sendejo,SS,active,minnesota-vikings,2826471,2017
25715,2450000,300000,Emmanuel Lamur,OLB,active,minnesota-vikings,2750000,2017
25716,2300000,50000,Tom Johnson,DT,active,minnesota-vikings,2350000,2017
25717,901590,1356359,Laquon Treadwell,WR,active,minnesota-vikings,2257949,2017
25718,1354023,825364,Teddy Bridgewater,QB,active,minnesota-vikings,2179387,2017
25719,1950000,50000,Marcus Sherels,CB,active,minnesota-vikings,2000000,2017
25720,950000,956250,Case Keenum,QB,active,minnesota-vikings,1906250,2017
25721,1000000,882500,Joe Berger,G,active,minnesota-vikings,1882500,2017
25722,1797000,16287,Shamar Stephen,DT,active,minnesota-vikings,1813287,2017
25723,903720,502440,Eric Kendricks,ILB,active,minnesota-vikings,1406160,2017
25724,887058,250000,Michael Floyd,WR,active,minnesota-vikings,1137058,2017
25725,646196,334783,Mackensie Alexander,CB,active,minnesota-vikings,980979,2017
25726,700000,128750,Jerick McKinnon,RB,active,minnesota-vikings,828750,2017
25727,636000,156805,Danielle Hunter,DE,active,minnesota-vikings,792805,2017
25728,775000,0,Kai Forbath,K,active,minnesota-vikings,775000,2017
25729,775000,0,Ryan Quigley,P,active,minnesota-vikings,775000,2017
25730,465000,234210,Pat Elflein,C,active,minnesota-vikings,699210,2017
25731,900000,80000,Tramaine Brock,CB,active,minnesota-vikings,980000,2017
25732,690000,0,Jeremiah Sirles,G,active,minnesota-vikings,690000,2017
25733,615000,56928,Stefon Diggs,WR,active,minnesota-vikings,671928,2017
25734,465000,169588,Jaleel Johnson,DT,active,minnesota-vikings,634588,2017
25735,465000,158286,Ben Gedeon,ILB,active,minnesota-vikings,623286,2017
25736,615000,0,Anthony Harris,SS,active,minnesota-vikings,615000,2017
25737,540000,58170,Kentrell Brothers,OLB,active,minnesota-vikings,598170,2017
25738,540000,33864,David Morgan,TE,active,minnesota-vikings,573864,2017
25739,540000,16056,Jayron Kearse,S,active,minnesota-vikings,556056,2017
25740,540000,0,Rashod Hill,T,active,minnesota-vikings,540000,2017
25741,540000,0,Stephen Weatherly,DE,active,minnesota-vikings,540000,2017
25742,465000,50484,Danny Isidora,G,active,minnesota-vikings,515484,2017
25743,465000,24170,Stacy Coley,WR,active,minnesota-vikings,489170,2017
25744,465000,5000,Tashawn Bower,DE,active,minnesota-vikings,470000,2017
25745,465000,5000,Aviante Collins,T,active,minnesota-vikings,470000,2017
25746,465000,3333,Eric Wilson,OLB,active,minnesota-vikings,468333,2017
25747,465000,0,C.J. Ham,RB,active,minnesota-vikings,465000,2017
25748,437647,0,Kyle Sloter,QB,active,minnesota-vikings,437647,2017
25749,285880,0,Mack Brown,RB,active,minnesota-vikings,285880,2017
25750,82059,0,Kyle Carter,TE,active,minnesota-vikings,82059,2017
25751,31765,0,Cornelius Edison,C,active,minnesota-vikings,31765,2017
25752,27353,0,Jeff Overbaugh,LS,active,minnesota-vikings,27353,2017
25753,375530,690151,Dalvin Cook,RB,injured_reserve,minnesota-vikings,1065681,2017
25754,775000,135000,Kevin McDermott,LS,injured_reserve,minnesota-vikings,910000,2017
25755,615000,0,Blake Bell,TE,injured_reserve,minnesota-vikings,615000,2017
25756,615000,0,Nick Easton,C,injured_reserve,minnesota-vikings,615000,2017
25757,418000,0,Bishop Sankey,RB,injured_reserve,minnesota-vikings,418000,2017
25758,348000,1666,Shaan Washington,ILB,injured_reserve,minnesota-vikings,349666,2017
25759,2006000,6450,Sharrif Floyd,DT,non_fb_injury,minnesota-vikings,2012450,2017
25760,3400000,100000,Alex Boone,G,dead_cap,minnesota-vikings,3500000,2017
25761,0,1750000,Datone Jones,DE,dead_cap,minnesota-vikings,1750000,2017
25762,0,1650000,Blair Walsh,K,dead_cap,minnesota-vikings,1650000,2017
25763,0,1600000,Brandon Fusco,G,dead_cap,minnesota-vikings,1600000,2017
25764,7200,401884,Willie Beavers,T,dead_cap,minnesota-vikings,409084,2017
25765,283624,61626,Rodney Adams,WR,dead_cap,minnesota-vikings,345250,2017
25766,0,333334,John Sullivan,C,dead_cap,minnesota-vikings,333334,2017
25767,184230,1666,R.J. Shelton,WR,dead_cap,minnesota-vikings,185896,2017
25768,0,164081,Scott Crichton,DE,dead_cap,minnesota-vikings,164081,2017
25769,147400,5000,Dylan Bradley,DT,dead_cap,minnesota-vikings,152400,2017
25770,122400,24095,Ifeadi Odenigbo,DE,dead_cap,minnesota-vikings,146495,2017
25771,137400,2500,Horace Richardson,CB,dead_cap,minnesota-vikings,139900,2017
25772,139764,0,Cornelius Edison,C,dead_cap,minnesota-vikings,139764,2017
25773,0,131238,T.J. Clemmings,RT,dead_cap,minnesota-vikings,131238,2017
25774,122400,0,Cayleb Jones,WR,dead_cap,minnesota-vikings,122400,2017
25775,122400,0,Cedrick Lang,TE,dead_cap,minnesota-vikings,122400,2017
25776,0,115294,MyCole Pruitt,TE,dead_cap,minnesota-vikings,115294,2017
25777,115200,0,Antwione Williams,OLB,dead_cap,minnesota-vikings,115200,2017
25778,0,112816,Moritz Boehringer,WR,dead_cap,minnesota-vikings,112816,2017
25779,81176,28947,Antone Exum,FS,dead_cap,minnesota-vikings,110123,2017
25780,86400,17010,Jack Tocho,CB,dead_cap,minnesota-vikings,103410,2017
25781,100800,0,Kyle Carter,TE,dead_cap,minnesota-vikings,100800,2017
25782,64800,0,Bronson Hill,RB,dead_cap,minnesota-vikings,64800,2017
25783,0,60968,Stephen Weatherly,DE,dead_cap,minnesota-vikings,60968,2017
25784,20470,36412,Bucky Hodges,TE,dead_cap,minnesota-vikings,56882,2017
25785,45588,0,Stevan Ridley,RB,dead_cap,minnesota-vikings,45588,2017
25786,0,34846,Austin Shepherd,RT,dead_cap,minnesota-vikings,34846,2017
25787,7200,20786,Elijah Lee,OLB,dead_cap,minnesota-vikings,27986,2017
25788,21600,0,Storm Norton,T,dead_cap,minnesota-vikings,21600,2017
25789,20000,0,Kyle Sloter,QB,dead_cap,minnesota-vikings,20000,2017
25790,0,17078,Edmond Robinson,OLB,dead_cap,minnesota-vikings,17078,2017
25791,0,15455,Jabari Price,CB,dead_cap,minnesota-vikings,15455,2017
25792,0,10000,Nick Truesdell,TE,dead_cap,minnesota-vikings,10000,2017
25793,7500,833,Caleb Kidder,DE,dead_cap,minnesota-vikings,8333,2017
25794,0,3334,Keith Baxter,DE,dead_cap,minnesota-vikings,3334,2017
25795,0,3334,Taylor Heinicke,QB,dead_cap,minnesota-vikings,3334,2017
25796,0,1666,Wes Lunt,QB,dead_cap,minnesota-vikings,1666,2017
25797,0,1666,Josiah Price,TE,dead_cap,minnesota-vikings,1666,2017
25798,0,833,Terrell Newby,RB,dead_cap,minnesota-vikings,833,2017
25799,22500000,1500000,Kirk Cousins,QB,active,minnesota-vikings,24000000,2018
25800,10400000,2937500,Xavier Rhodes,CB,active,minnesota-vikings,13337500,2018
25801,12306000,0,Anthony Barr,OLB,active,minnesota-vikings,12306000,2018
25802,3900000,7700000,Everson Griffen,DE,active,minnesota-vikings,11600000,2018
25803,9100000,2300000,Riley Reiff,LT,active,minnesota-vikings,11400000,2018
25804,7650000,2350000,Harrison Smith,FS,active,minnesota-vikings,10000000,2018
25805,1150000,6900000,Linval Joseph,DT,active,minnesota-vikings,8050000,2018
25806,5800000,2200000,Sheldon Richardson,DT,active,minnesota-vikings,8000000,2018
25807,6025000,1650000,Kyle Rudolph,TE,active,minnesota-vikings,7675000,2018
25808,3850000,2500000,Adam Thielen,WR,active,minnesota-vikings,6350000,2018
25809,1907000,3656806,Danielle Hunter,DE,active,minnesota-vikings,5563806,2018
25810,3650000,1550000,Latavius Murray,RB,active,minnesota-vikings,5200000,2018
25811,1907000,3056929,Stefon Diggs,WR,active,minnesota-vikings,4963929,2018
25812,3900000,700000,Mike Remmers,G,active,minnesota-vikings,4600000,2018
25813,2200142,1918521,Trae Waynes,CB,active,minnesota-vikings,4118663,2018
25814,1138080,2602440,Eric Kendricks,ILB,active,minnesota-vikings,3740520,2018
25815,2914000,0,Brett Jones,C,active,minnesota-vikings,2914000,2018
25816,1353180,1356359,Laquon Treadwell,WR,active,minnesota-vikings,2709539,2018
25817,1907000,0,Trevor Siemian,QB,active,minnesota-vikings,1907000,2018
25818,1750000,0,Dan Bailey,K,active,minnesota-vikings,1750000,2018
25819,753788,690151,Dalvin Cook,RB,active,minnesota-vikings,1443939,2018
25820,1050000,350000,Marcus Sherels,CB,active,minnesota-vikings,1400000,2018
25821,842391,334783,Mackensie Alexander,CB,active,minnesota-vikings,1177174,2018
25822,790000,135000,Kevin McDermott,LS,active,minnesota-vikings,925000,2018
25823,800000,100000,Tom Compton,G,active,minnesota-vikings,900000,2018
25824,882353,0,Tom Johnson,DT,active,minnesota-vikings,882353,2018
25825,790000,90000,George Iloka,FS,active,minnesota-vikings,880000,2018
25826,637000,234210,Pat Elflein,C,active,minnesota-vikings,871210,2018
25827,480000,321207,Brian O'Neill,T,active,minnesota-vikings,801207,2018
25828,555000,169588,Jaleel Johnson,DT,active,minnesota-vikings,724588,2018
25829,555000,158286,Ben Gedeon,OLB,active,minnesota-vikings,713286,2018
25830,705000,0,Anthony Harris,SS,active,minnesota-vikings,705000,2018
25831,697059,0,Aldrick Robinson,WR,active,minnesota-vikings,697059,2018
25832,630000,33864,David Morgan,TE,active,minnesota-vikings,663864,2018
25833,480000,182849,Jalyn Holmes,DE,active,minnesota-vikings,662849,2018
25834,630000,16056,Jayron Kearse,S,active,minnesota-vikings,646056,2018
25835,630000,0,Rashod Hill,RT,active,minnesota-vikings,630000,2018
25836,630000,0,Stephen Weatherly,DE,active,minnesota-vikings,630000,2018
25837,555000,50484,Danny Isidora,G,active,minnesota-vikings,605484,2018
25838,555000,5000,Tashawn Bower,DE,active,minnesota-vikings,560000,2018
25839,555000,3333,Eric Wilson,OLB,active,minnesota-vikings,558333,2018
25840,555000,0,C.J. Ham,RB,active,minnesota-vikings,555000,2018
25841,555000,0,Kyle Sloter,QB,active,minnesota-vikings,555000,2018
25842,555000,0,Matt Wile,P,active,minnesota-vikings,555000,2018
25843,480000,70257,Tyler Conklin,TE,active,minnesota-vikings,550257,2018
25844,630000,44483,Kentrell Brothers,OLB,active,minnesota-vikings,674483,2018
25845,480000,23600,Devante Downs,ILB,active,minnesota-vikings,503600,2018
25846,480000,5000,Holton Hill,CB,active,minnesota-vikings,485000,2018
25847,480000,2500,Mike Boone,RB,active,minnesota-vikings,482500,2018
25848,412586,0,Ameer Abdullah,RB,active,minnesota-vikings,412586,2018
25849,254115,0,Chad Beebe,WR,active,minnesota-vikings,254115,2018
25850,141175,0,Craig James,CB,active,minnesota-vikings,141175,2018
25851,3450000,50000,Andrew Sendejo,SS,injured_reserve,minnesota-vikings,3500000,2018
25852,2914000,0,Nick Easton,C,injured_reserve,minnesota-vikings,2914000,2018
25853,480000,1314088,Mike Hughes,CB,injured_reserve,minnesota-vikings,1794088,2018
25854,388412,5000,Aviante Collins,T,injured_reserve,minnesota-vikings,393412,2018
25855,363000,29602,Ade Aruna,DE,injured_reserve,minnesota-vikings,392602,2018
25856,363000,10000,Cedrick Lang,TE,injured_reserve,minnesota-vikings,373000,2018
25857,363000,1333,Hercules Mata'afa,LB,injured_reserve,minnesota-vikings,364333,2018
25858,363000,0,Josiah Price,TE,injured_reserve,minnesota-vikings,363000,2018
25859,363000,0,Johnny Stanton,FB,injured_reserve,minnesota-vikings,363000,2018
25860,0,2120000,Jarius Wright,WR,dead_cap,minnesota-vikings,2120000,2018
25861,300000,200000,Kendall Wright,WR,dead_cap,minnesota-vikings,500000,2018
25862,343153,3333,Roc Thomas,RB,dead_cap,minnesota-vikings,346486,2018
25863,340000,0,Cole Hikutini,TE,dead_cap,minnesota-vikings,340000,2018
25864,254115,72285,Ifeadi Odenigbo,DE,dead_cap,minnesota-vikings,326400,2018
25865,185294,90000,Tavarres King,WR,dead_cap,minnesota-vikings,275294,2018
25866,238871,0,Storm Norton,T,dead_cap,minnesota-vikings,238871,2018
25867,0,210000,Kai Forbath,K,dead_cap,minnesota-vikings,210000,2018
25868,185294,0,David Parry,DT,dead_cap,minnesota-vikings,185294,2018
25869,0,184878,Rodney Adams,WR,dead_cap,minnesota-vikings,184878,2018
25870,115098,51033,Jack Tocho,CB,dead_cap,minnesota-vikings,166131,2018
25871,148235,0,Bryan Witzmann,G,dead_cap,minnesota-vikings,148235,2018
25872,139200,4000,Jeff Badet,WR,dead_cap,minnesota-vikings,143200,2018
25873,0,131238,T.J. Clemmings,RT,dead_cap,minnesota-vikings,131238,2018
25874,129200,0,Reshard Cliett,OLB,dead_cap,minnesota-vikings,129200,2018
25875,129200,0,Cornelius Edison,C,dead_cap,minnesota-vikings,129200,2018
25876,128142,0,Craig James,CB,dead_cap,minnesota-vikings,128142,2018
25877,56471,62003,Daniel Carlson,K,dead_cap,minnesota-vikings,118474,2018
25878,105099,5000,Horace Richardson,CB,dead_cap,minnesota-vikings,110099,2018
25879,0,109238,Bucky Hodges,TE,dead_cap,minnesota-vikings,109238,2018
25880,60800,29602,Colby Gossett,G,dead_cap,minnesota-vikings,90402,2018
25881,0,90000,Terence Newman,CB,dead_cap,minnesota-vikings,90000,2018
25882,0,90000,Brian Robison,DE,dead_cap,minnesota-vikings,90000,2018
25883,65294,24170,Stacy Coley,WR,dead_cap,minnesota-vikings,89464,2018
25884,76000,0,Adam Bisnowaty,T,dead_cap,minnesota-vikings,76000,2018
25885,76000,0,Jalen Myrick,CB,dead_cap,minnesota-vikings,76000,2018
25886,68200,3333,Curtis Cothran,DT,dead_cap,minnesota-vikings,71533,2018
25887,60400,3666,Garret Dooley,LB,dead_cap,minnesota-vikings,64066,2018
25888,0,62500,Antwione Williams,OLB,dead_cap,minnesota-vikings,62500,2018
25889,0,62359,Elijah Lee,OLB,dead_cap,minnesota-vikings,62359,2018
25890,60800,0,Chad Beebe,WR,dead_cap,minnesota-vikings,60800,2018
25891,60800,0,Jonathan Wynn,DE,dead_cap,minnesota-vikings,60800,2018
25892,0,50000,Josh Andrews,C,dead_cap,minnesota-vikings,50000,2018
25893,35000,5000,Korey Robertson,WR,dead_cap,minnesota-vikings,40000,2018
25894,25000,0,Tray Matthews,S,dead_cap,minnesota-vikings,25000,2018
25895,0,17078,Edmond Robinson,OLB,dead_cap,minnesota-vikings,17078,2018
25896,0,10000,Dylan Bradley,DT,dead_cap,minnesota-vikings,10000,2018
25897,7600,0,Landon Turner,G,dead_cap,minnesota-vikings,7600,2018
25898,5000,1666,Peter Pujals,QB,dead_cap,minnesota-vikings,6666,2018
25899,0,3334,Wes Lunt,QB,dead_cap,minnesota-vikings,3334,2018
25900,0,3334,Josiah Price,TE,dead_cap,minnesota-vikings,3334,2018
25901,0,3334,R.J. Shelton,WR,dead_cap,minnesota-vikings,3334,2018
25902,0,3334,Shaan Washington,ILB,dead_cap,minnesota-vikings,3334,2018
25903,0,2000,Tyler Hoppes,TE,dead_cap,minnesota-vikings,2000,2018
25904,0,1667,Caleb Kidder,DE,dead_cap,minnesota-vikings,1667,2018
25905,0,1667,Terrell Newby,RB,dead_cap,minnesota-vikings,1667,2018
25906,0,833,Chris Gonzalez,G,dead_cap,minnesota-vikings,833,2018
25907,27500000,1500000,Kirk Cousins,QB,active,minnesota-vikings,29000000,2019
25908,9400000,4100000,Danielle Hunter,DE,active,minnesota-vikings,13500000,2019
25909,10400000,3000000,Xavier Rhodes,CB,active,minnesota-vikings,13400000,2019
25910,8900000,3600000,Stefon Diggs,WR,active,minnesota-vikings,12500000,2019
25911,9400000,2300000,Riley Reiff,LT,active,minnesota-vikings,11700000,2019
25912,8350000,2400000,Harrison Smith,FS,active,minnesota-vikings,10750000,2019
25913,8900000,1737500,Linval Joseph,DT,active,minnesota-vikings,10637500,2019
25914,9069000,0,Trae Waynes,CB,active,minnesota-vikings,9069000,2019
25915,805000,7268750,Adam Thielen,WR,active,minnesota-vikings,8073750,2019
25916,6400000,1468750,Everson Griffen,DE,active,minnesota-vikings,7868750,2019
25917,2900000,2700000,Anthony Barr,OLB,active,minnesota-vikings,5600000,2019
25918,2000000,2864375,Eric Kendricks,ILB,active,minnesota-vikings,4864375,2019
25919,1750000,1800000,Kyle Rudolph,TE,active,minnesota-vikings,3550000,2019
25920,3095000,0,Anthony Harris,SS,active,minnesota-vikings,3095000,2019
25921,1450000,1586458,Josh Kline,G,active,minnesota-vikings,3036458,2019
25922,495000,1847340,Garrett Bradbury,C,active,minnesota-vikings,2342340,2019
25923,900000,1433333,Shamar Stephen,DT,active,minnesota-vikings,2333333,2019
25924,2025000,0,Rashod Hill,G,active,minnesota-vikings,2025000,2019
25925,1000000,1000000,Dan Bailey,K,active,minnesota-vikings,2000000,2019
25926,1042576,690151,Dalvin Cook,RB,active,minnesota-vikings,1732727,2019
25927,1038587,334783,Mackensie Alexander,CB,active,minnesota-vikings,1373370,2019
25928,495000,559260,Irv Smith,TE,active,minnesota-vikings,1054260,2019
25929,809500,234210,Pat Elflein,G,active,minnesota-vikings,1043710,2019
25930,680302,321207,Brian O'Neill,RT,active,minnesota-vikings,1001509,2019
25931,645000,169588,Jaleel Johnson,DT,active,minnesota-vikings,814588,2019
25932,720000,58170,Kentrell Brothers,OLB,active,minnesota-vikings,778170,2019
25933,570000,182849,Jalyn Holmes,DT,active,minnesota-vikings,752849,2019
25934,720000,16056,Jayron Kearse,S,active,minnesota-vikings,736056,2019
25935,805000,90000,Dakota Dozier,LT,active,minnesota-vikings,895000,2019
25936,805000,90000,Sean Mannion,QB,active,minnesota-vikings,895000,2019
25937,720000,90000,Ameer Abdullah,RB,active,minnesota-vikings,810000,2019
25938,720000,0,Stephen Weatherly,DE,active,minnesota-vikings,720000,2019
25939,495000,205543,Alexander Mattison,RB,active,minnesota-vikings,700543,2019
25940,495000,184279,Dru Samia,G,active,minnesota-vikings,679279,2019
25941,645000,3334,Eric Wilson,OLB,active,minnesota-vikings,648334,2019
25942,930000,0,Britton Colquitt,P,active,minnesota-vikings,930000,2019
25943,645000,0,C.J. Ham,FB,active,minnesota-vikings,645000,2019
25944,570000,70257,Tyler Conklin,TE,active,minnesota-vikings,640257,2019
25945,592941,0,Laquon Treadwell,WR,active,minnesota-vikings,592941,2019
25946,570000,2500,Mike Boone,RB,active,minnesota-vikings,572500,2019
25947,570000,0,Ifeadi Odenigbo,DE,active,minnesota-vikings,570000,2019
25948,495000,41741,Oli Udoh,T,active,minnesota-vikings,536741,2019
25949,495000,27314,Kris Boyd,CB,active,minnesota-vikings,522314,2019
25950,495000,18644,Austin Cutting,LS,active,minnesota-vikings,513644,2019
25951,495000,18572,Olabisi Johnson,WR,active,minnesota-vikings,513572,2019
25952,495000,1333,Hercules Mata'afa,LB,active,minnesota-vikings,496333,2019
25953,437647,0,Andrew Sendejo,SS,active,minnesota-vikings,437647,2019
25954,300586,3824,Holton Hill,CB,active,minnesota-vikings,304410,2019
25955,265588,0,Aviante Collins,T,active,minnesota-vikings,265588,2019
25956,145588,0,Cameron Smith,LB,active,minnesota-vikings,145588,2019
25957,116471,0,Alexander Hollins,WR,active,minnesota-vikings,116471,2019
25958,928522,1314088,Mike Hughes,CB,injured_reserve,minnesota-vikings,2242610,2019
25959,645000,158286,Ben Gedeon,ILB,injured_reserve,minnesota-vikings,803286,2019
25960,677647,0,Brett Jones,C,injured_reserve,minnesota-vikings,677647,2019
25961,495000,42113,Armon Watts,DT,injured_reserve,minnesota-vikings,537113,2019
25962,424234,0,Chad Beebe,WR,injured_reserve,minnesota-vikings,424234,2019
25963,255000,0,Stacy Keely,DE,practice_squad,minnesota-vikings,255000,2019
25964,104000,0,Nate Meadors,CB,practice_squad,minnesota-vikings,104000,2019
25965,56000,0,John Keenoy,C,practice_squad,minnesota-vikings,56000,2019
25966,32000,0,Reshard Cliett,OLB,practice_squad,minnesota-vikings,32000,2019
25967,557059,1356362,Laquon Treadwell,WR,dead_cap,minnesota-vikings,1913421,2019
25968,0,1800000,Mike Remmers,RT,dead_cap,minnesota-vikings,1800000,2019
25969,465882,0,Josh Doctson,WR,dead_cap,minnesota-vikings,465882,2019
25970,310706,3333,Davion Davis,WR,dead_cap,minnesota-vikings,314039,2019
25971,262056,42029,Marcus Epps,S,dead_cap,minnesota-vikings,304085,2019
25972,295000,5000,Jake Browning,QB,dead_cap,minnesota-vikings,300000,2019
25973,286266,3333,Khari Blasingame,FB,dead_cap,minnesota-vikings,289599,2019
25974,227646,5000,Tashawn Bower,DE,dead_cap,minnesota-vikings,232646,2019
25975,151353,73506,Cameron Smith,LB,dead_cap,minnesota-vikings,224859,2019
25976,189118,3333,Brandon Dillon,TE,dead_cap,minnesota-vikings,192451,2019
25977,0,186010,Daniel Carlson,K,dead_cap,minnesota-vikings,186010,2019
25978,136000,20003,Dillon Mitchell,WR,dead_cap,minnesota-vikings,156003,2019
25979,150000,5000,Aviante Collins,T,dead_cap,minnesota-vikings,155000,2019
25980,218824,0,Marcus Sherels,CB,dead_cap,minnesota-vikings,218824,2019
25981,149118,0,Mark Fields,CB,dead_cap,minnesota-vikings,149118,2019
25982,125353,3333,Nate Meadors,CB,dead_cap,minnesota-vikings,128686,2019
25983,0,110000,Kevin McDermott,LS,dead_cap,minnesota-vikings,110000,2019
25984,75059,23600,Devante Downs,ILB,dead_cap,minnesota-vikings,98659,2019
25985,96000,0,Alexander Hollins,WR,dead_cap,minnesota-vikings,96000,2019
25986,0,90000,Brett Jones,C,dead_cap,minnesota-vikings,90000,2019
25987,88940,0,Isaiah Wharton,CB,dead_cap,minnesota-vikings,88940,2019
25988,0,88806,Colby Gossett,G,dead_cap,minnesota-vikings,88806,2019
25989,0,62500,Antwione Williams,OLB,dead_cap,minnesota-vikings,62500,2019
25990,50000,5000,Anree Saint-Amour,DE,dead_cap,minnesota-vikings,55000,2019
25991,22235,29602,Ade Aruna,DE,dead_cap,minnesota-vikings,51837,2019
25992,0,50485,Danny Isidora,G,dead_cap,minnesota-vikings,50485,2019
25993,0,48340,Stacy Coley,WR,dead_cap,minnesota-vikings,48340,2019
25994,0,33000,Jeff Badet,WR,dead_cap,minnesota-vikings,33000,2019
25995,25000,3333,Micah Abernathy,S,dead_cap,minnesota-vikings,28333,2019
25996,24000,0,Tony Brooks-James,RB,dead_cap,minnesota-vikings,24000,2019
25997,16000,0,Johnny Stanton,FB,dead_cap,minnesota-vikings,16000,2019
25998,0,10000,Korey Robertson,WR,dead_cap,minnesota-vikings,10000,2019
25999,8000,0,Chase McLaughlin,K,dead_cap,minnesota-vikings,8000,2019
26000,0,7334,Garret Dooley,LB,dead_cap,minnesota-vikings,7334,2019
26001,0,6667,Curtis Cothran,DT,dead_cap,minnesota-vikings,6667,2019
26002,0,6667,Roc Thomas,RB,dead_cap,minnesota-vikings,6667,2019
26003,0,5000,Derron Smith,SS,dead_cap,minnesota-vikings,5000,2019
26004,0,4000,Tyler Hoppes,TE,dead_cap,minnesota-vikings,4000,2019
26005,0,3334,Peter Pujals,QB,dead_cap,minnesota-vikings,3334,2019
26006,0,2500,Karter Schult,DE,dead_cap,minnesota-vikings,2500,2019
26007,0,2500,Duke Thomas,S,dead_cap,minnesota-vikings,2500,2019
26008,0,1667,Chris Gonzalez,G,dead_cap,minnesota-vikings,1667,2019
26009,0,833,John Keenoy,C,dead_cap,minnesota-vikings,833,2019
26010,0,833,Tito Odenigbo,DT,dead_cap,minnesota-vikings,833,2019
26011,29500000,1500000,Kirk Cousins,QB,active,minnesota-vikings,31000000,2020
26012,10900000,3600000,Stefon Diggs,WR,active,minnesota-vikings,14500000,2020
26013,10900000,3600000,Danielle Hunter,DE,active,minnesota-vikings,14500000,2020
26014,12900000,968750,Everson Griffen,DE,active,minnesota-vikings,13868750,2020
26015,10900000,2300000,Riley Reiff,LT,active,minnesota-vikings,13200000,2020
26016,9900000,3000000,Xavier Rhodes,CB,active,minnesota-vikings,12900000,2020
26017,11150000,1737500,Linval Joseph,DT,active,minnesota-vikings,12887500,2020
26018,4800000,7968750,Adam Thielen,WR,active,minnesota-vikings,12768750,2020
26019,10000000,2700000,Anthony Barr,OLB,active,minnesota-vikings,12700000,2020
26020,8350000,2400000,Harrison Smith,FS,active,minnesota-vikings,10750000,2020
26021,7150000,2864375,Eric Kendricks,ILB,active,minnesota-vikings,10014375,2020
26022,7025000,2425000,Kyle Rudolph,TE,active,minnesota-vikings,9450000,2020
26023,4450000,1586458,Josh Kline,G,active,minnesota-vikings,6036458,2020
26024,3600000,1433333,Shamar Stephen,DT,active,minnesota-vikings,5033333,2020
26025,1080585,1847340,Garrett Bradbury,C,active,minnesota-vikings,2927925,2020
26026,1377044,1314088,Mike Hughes,CB,active,minnesota-vikings,2691132,2020
26027,1331364,690154,Dalvin Cook,RB,active,minnesota-vikings,2021518,2020
26028,758566,559260,Irv Smith,TE,active,minnesota-vikings,1317826,2020
26029,880603,321207,Brian O'Neill,RT,active,minnesota-vikings,1201810,2020
26030,899500,234210,Pat Elflein,G,active,minnesota-vikings,1133710,2020
26031,735000,169591,Jaleel Johnson,DT,active,minnesota-vikings,904591,2020
26032,735000,158289,Ben Gedeon,ILB,active,minnesota-vikings,893289,2020
26033,660000,182849,Jalyn Holmes,DT,active,minnesota-vikings,842849,2020
26034,624500,205543,Alexander Mattison,RB,active,minnesota-vikings,830043,2020
26035,585000,184279,Dru Samia,G,active,minnesota-vikings,769279,2020
26036,660000,70257,Tyler Conklin,TE,active,minnesota-vikings,730257,2020
26037,660000,4608,Holton Hill,CB,active,minnesota-vikings,664608,2020
26038,660000,2500,Mike Boone,RB,active,minnesota-vikings,662500,2020
26039,660000,1334,Hercules Mata'afa,LB,active,minnesota-vikings,661334,2020
26040,660000,0,Chad Beebe,WR,active,minnesota-vikings,660000,2020
26041,660000,0,Aviante Collins,T,active,minnesota-vikings,660000,2020
26042,660000,0,Ifeadi Odenigbo,DE,active,minnesota-vikings,660000,2020
26043,585000,42113,Armon Watts,DT,active,minnesota-vikings,627113,2020
26044,585000,41741,Oli Udoh,T,active,minnesota-vikings,626741,2020
26045,585000,27314,Kris Boyd,CB,active,minnesota-vikings,612314,2020
26046,585000,18644,Austin Cutting,LS,active,minnesota-vikings,603644,2020
26047,585000,18572,Olabisi Johnson,WR,active,minnesota-vikings,603572,2020
26048,585000,0,Alexander Hollins,WR,active,minnesota-vikings,585000,2020
26049,585000,0,Cameron Smith,LB,active,minnesota-vikings,585000,2020
26050,0,0,Bralon Addison,WR,active,minnesota-vikings,0,2020
26051,0,0,Tony Brooks-James,RB,active,minnesota-vikings,0,2020
26052,0,0,Jake Browning,QB,active,minnesota-vikings,0,2020
26053,0,0,Davion Davis,WR,active,minnesota-vikings,0,2020
26054,0,0,Brandon Dillon,TE,active,minnesota-vikings,0,2020
26055,0,0,Mark Fields,CB,active,minnesota-vikings,0,2020
26056,0,0,Kemon Hall,CB,active,minnesota-vikings,0,2020
26057,0,0,Dillon Mitchell,WR,active,minnesota-vikings,0,2020
26058,0,0,Marcus Sayles,CB,active,minnesota-vikings,0,2020
26059,0,220519,Cameron Smith,LB,dead_cap,minnesota-vikings,220519,2020
26060,0,126087,Marcus Epps,S,dead_cap,minnesota-vikings,126087,2020
26061,0,100000,Kevin McDermott,LS,dead_cap,minnesota-vikings,100000,2020
26062,0,60009,Dillon Mitchell,WR,dead_cap,minnesota-vikings,60009,2020
26063,0,59204,Ade Aruna,DE,dead_cap,minnesota-vikings,59204,2020
26064,0,50000,Jeff Badet,WR,dead_cap,minnesota-vikings,50000,2020
26065,0,47201,Devante Downs,ILB,dead_cap,minnesota-vikings,47201,2020
26066,0,10000,Jake Browning,QB,dead_cap,minnesota-vikings,10000,2020
26067,0,10000,Anree Saint-Amour,DE,dead_cap,minnesota-vikings,10000,2020
26068,0,6667,Micah Abernathy,S,dead_cap,minnesota-vikings,6667,2020
26069,0,6667,Khari Blasingame,FB,dead_cap,minnesota-vikings,6667,2020
26070,0,6667,Davion Davis,WR,dead_cap,minnesota-vikings,6667,2020
26071,0,6667,Brandon Dillon,TE,dead_cap,minnesota-vikings,6667,2020
26072,0,6667,Nate Meadors,CB,dead_cap,minnesota-vikings,6667,2020
26073,0,1667,John Keenoy,C,dead_cap,minnesota-vikings,1667,2020
26074,0,1667,Tito Odenigbo,DT,dead_cap,minnesota-vikings,1667,2020
26075,7790000,0,Asante Samuel,CB,active,new-england-patriots,7790000,2007
26076,720000,9025160,Tom Brady,QB,active,new-england-patriots,9745160,2007
26077,600000,10765000,Richard Seymour,DT,active,new-england-patriots,11365000,2007
26078,3500000,416666,Matt Light,T,active,new-england-patriots,3916666,2007
26079,700000,4466667,Donte Stallworth,WR,active,new-england-patriots,5166667,2007
26080,2000000,2315096,Rodney Harrison,S,active,new-england-patriots,4315096,2007
26081,1075000,2316666,Ty Warren,DT,active,new-england-patriots,3391666,2007
26082,2500000,500000,Randy Moss,WR,active,new-england-patriots,3000000,2007
26083,900000,1600000,Dan Koppen,C,active,new-england-patriots,2500000,2007
26084,900000,1225000,Sammy Morris,RB,active,new-england-patriots,2125000,2007
26085,550000,1150000,Wes Welker,WR,active,new-england-patriots,1700000,2007
26086,600000,1500000,Vince Wilfork,DT,active,new-england-patriots,2100000,2007
26087,360000,2155000,Laurence Maroney,RB,active,new-england-patriots,2515000,2007
26088,500000,1150000,Logan Mankins,G,active,new-england-patriots,1650000,2007
26089,560000,970000,Benjamin Watson,TE,active,new-england-patriots,1530000,2007
26090,285000,855000,Brandon Meriweather,SS,active,new-england-patriots,1140000,2007
26091,1000000,100000,Junior Seau,LB,active,new-england-patriots,1100000,2007
26092,600000,133333,Russ Hochstein,G,active,new-england-patriots,733333,2007
26093,360000,1098332,Chad Jackson,WR,active,new-england-patriots,1458332,2007
26094,720000,61000,Lonie Paxton,LS,active,new-england-patriots,781000,2007
26095,595000,0,Jabar Gaffney,WR,active,new-england-patriots,595000,2007
26096,435000,165000,Ellis Hobbs,CB,active,new-england-patriots,600000,2007
26097,435000,132000,Nick Kaczur,T,active,new-england-patriots,567000,2007
26098,435000,95000,James Sanders,S,active,new-england-patriots,530000,2007
26099,360000,106250,Stephen Gostkowski,K,active,new-england-patriots,466250,2007
26100,435000,13500,Matt Cassel,QB,active,new-england-patriots,448500,2007
26101,360000,47625,Ryan O'Callaghan,T,active,new-england-patriots,407625,2007
26102,360000,17750,Le Kevin Smith,DT,active,new-england-patriots,377750,2007
26103,360000,16018,David Thomas,TE,active,new-england-patriots,376018,2007
26104,360000,11625,Willie Andrews,CB,active,new-england-patriots,371625,2007
26105,360000,3750,Pierre Woods,LB,active,new-england-patriots,363750,2007
26106,285000,0,Mike Elgin,C,active,new-england-patriots,285000,2007
26107,285000,0,Corey Hilliard,RT,active,new-england-patriots,285000,2007
26108,190000,21500,Mike Richardson,CB,active,new-england-patriots,211500,2007
26109,190000,15750,Oscar Lua,LB,active,new-england-patriots,205750,2007
26110,190000,15750,Oscar Lua,LB,active,new-england-patriots,205750,2007
26111,215900,0,Dan Connolly,G,practice_squad,new-england-patriots,215900,2007
26112,79900,0,Jason Rader,TE,practice_squad,new-england-patriots,79900,2007
26113,79900,0,Pat Ross,C,practice_squad,new-england-patriots,79900,2007
26114,0,2672500,Corey Dillon,RB,dead_cap,new-england-patriots,2672500,2007
26115,0,150000,Tebucky Jones,S,dead_cap,new-england-patriots,150000,2007
26116,115625,0,Garrett Mills,TE,dead_cap,new-england-patriots,115625,2007
26117,102375,0,Kareem Brown,DT,dead_cap,new-england-patriots,102375,2007
26118,71000,0,Ryan Claridge,LB,dead_cap,new-england-patriots,71000,2007
26119,54000,0,Dan Stevenson,G,dead_cap,new-england-patriots,54000,2007
26120,35312,0,Clint Oldenburg,T,dead_cap,new-england-patriots,35312,2007
26121,20875,0,Justin Rogers,LB,dead_cap,new-england-patriots,20875,2007
26122,18500,0,Justise Hairston,RB,dead_cap,new-england-patriots,18500,2007
26123,18350,0,Corey Hilliard,RT,dead_cap,new-england-patriots,18350,2007
26124,5000000,12021320,Tom Brady,QB,active,new-england-patriots,17021320,2008
26125,730000,10765000,Richard Seymour,DT,active,new-england-patriots,11495000,2008
26126,1900000,4100000,Randy Moss,WR,active,new-england-patriots,6000000,2008
26127,3750000,416666,Matt Light,T,active,new-england-patriots,4166666,2008
26128,1450000,3483332,Ty Warren,DT,active,new-england-patriots,4933332,2008
26129,1400000,3200000,Wes Welker,WR,active,new-england-patriots,4600000,2008
26130,1400000,1600000,Dan Koppen,C,active,new-england-patriots,3000000,2008
26131,1400000,1500000,Vince Wilfork,DT,active,new-england-patriots,2900000,2008
26132,900000,1225000,Sammy Morris,RB,active,new-england-patriots,2125000,2008
26133,295000,1505000,Jerod Mayo,ILB,active,new-england-patriots,1800000,2008
26134,1460000,165000,Ellis Hobbs,CB,active,new-england-patriots,1625000,2008
26135,785000,970000,Benjamin Watson,TE,active,new-england-patriots,1755000,2008
26136,600000,1150000,Logan Mankins,G,active,new-england-patriots,1750000,2008
26137,370000,1960000,Brandon Meriweather,SS,active,new-england-patriots,2330000,2008
26138,1260000,132000,Nick Kaczur,T,active,new-england-patriots,1392000,2008
26139,700000,500000,Jabar Gaffney,WR,active,new-england-patriots,1200000,2008
26140,730000,133333,Russ Hochstein,G,active,new-england-patriots,863333,2008
26141,1062500,0,Junior Seau,LB,active,new-england-patriots,1062500,2008
26142,927000,95000,James Sanders,S,active,new-england-patriots,1022000,2008
26143,1000000,0,Deltha O'Neal,CB,active,new-england-patriots,1000000,2008
26144,730000,150000,Lonie Paxton,LS,active,new-england-patriots,880000,2008
26145,445000,106250,Stephen Gostkowski,K,active,new-england-patriots,551250,2008
26146,520000,13500,Matt Cassel,QB,active,new-england-patriots,533500,2008
26147,295000,222500,Terrence Wheatley,CB,active,new-england-patriots,517500,2008
26148,445000,47625,Ryan O'Callaghan,T,active,new-england-patriots,492625,2008
26149,295000,190125,Kevin O'Connell,QB,active,new-england-patriots,485125,2008
26150,445000,17750,Le Kevin Smith,DT,active,new-england-patriots,462750,2008
26151,445000,16018,David Thomas,TE,active,new-england-patriots,461018,2008
26152,295000,101250,Jonathan Wilhite,CB,active,new-england-patriots,396250,2008
26153,200000,190125,Shawn Crable,LB,active,new-england-patriots,390125,2008
26154,370000,0,Mike Elgin,C,active,new-england-patriots,370000,2008
26155,370000,0,Raymond Ventrone,S,active,new-england-patriots,370000,2008
26156,367647,0,Dan Connolly,G,active,new-england-patriots,367647,2008
26157,295000,51870,Matthew Slater,WR,active,new-england-patriots,346870,2008
26158,295000,7280,BenJarvus Green-Ellis,RB,active,new-england-patriots,302280,2008
26159,295000,6000,Gary Guyton,OLB,active,new-england-patriots,301000,2008
26160,295000,0,Mike Richardson,CB,active,new-england-patriots,295000,2008
26161,200000,21225,Bo Ruud,LB,active,new-england-patriots,221225,2008
26162,88400,0,Angelo Craig,DE,active,new-england-patriots,88400,2008
26163,34705,0,Maurice Price,WR,active,new-england-patriots,34705,2008
26164,3000000,2315100,Rodney Harrison,S,injured_reserve,new-england-patriots,5315100,2008
26165,207812,2230000,Laurence Maroney,RB,injured_reserve,new-england-patriots,2437812,2008
26166,445000,0,Pierre Woods,LB,injured_reserve,new-england-patriots,445000,2008
26167,88400,0,Maurice Price,WR,practice_squad,new-england-patriots,88400,2008
26168,88400,0,Ryan Wendell,C,practice_squad,new-england-patriots,88400,2008
26169,0,5345000,Corey Dillon,RB,dead_cap,new-england-patriots,5345000,2008
26170,0,833334,Donte Stallworth,WR,dead_cap,new-england-patriots,833334,2008
26171,549166,0,Chad Jackson,WR,dead_cap,new-england-patriots,549166,2008
26172,307125,0,Kareem Brown,DT,dead_cap,new-england-patriots,307125,2008
26173,231250,0,Garrett Mills,TE,dead_cap,new-england-patriots,231250,2008
26174,105639,0,Clint Oldenburg,T,dead_cap,new-england-patriots,105639,2008
26175,62625,0,Justin Rogers,LB,dead_cap,new-england-patriots,62625,2008
26176,37000,0,Justise Hairston,RB,dead_cap,new-england-patriots,37000,2008
26177,36700,0,Corey Hilliard,RT,dead_cap,new-england-patriots,36700,2008
26178,31500,0,Oscar Lua,LB,dead_cap,new-england-patriots,31500,2008
26179,21500,0,Mike Richardson,CB,dead_cap,new-england-patriots,21500,2008
26180,11625,0,Willie Andrews,CB,dead_cap,new-england-patriots,11625,2008
26181,5000000,12020000,Tom Brady,QB,active,new-england-patriots,17020000,2009
26182,4900000,5600000,Randy Moss,WR,active,new-england-patriots,10500000,2009
26183,4250000,416666,Matt Light,T,active,new-england-patriots,4666666,2009
26184,1225000,3083332,Ty Warren,DT,active,new-england-patriots,4308332,2009
26185,2400000,1600000,Dan Koppen,C,active,new-england-patriots,4000000,2009
26186,2200000,1500000,Vince Wilfork,DT,active,new-england-patriots,3700000,2009
26187,2000000,132000,Nick Kaczur,T,active,new-england-patriots,2132000,2009
26188,500000,2275000,Jerod Mayo,ILB,active,new-england-patriots,2775000,2009
26189,620000,1880000,James Sanders,S,active,new-england-patriots,2500000,2009
26190,1550000,725000,Fred Taylor,RB,active,new-england-patriots,2275000,2009
26191,1400000,1150000,Logan Mankins,G,active,new-england-patriots,2550000,2009
26192,1600000,300000,Chris Baker,TE,active,new-england-patriots,1900000,2009
26193,600000,2245000,Laurence Maroney,RB,active,new-england-patriots,2845000,2009
26194,460000,2110000,Brandon Meriweather,SS,active,new-england-patriots,2570000,2009
26195,910000,970000,Benjamin Watson,TE,active,new-england-patriots,1880000,2009
26196,1550000,0,Alex Smith,TE,active,new-england-patriots,1550000,2009
26197,1545000,0,Pierre Woods,LB,active,new-england-patriots,1545000,2009
26198,900000,475000,Sammy Morris,RB,active,new-england-patriots,1375000,2009
26199,1145000,0,Junior Seau,LB,active,new-england-patriots,1145000,2009
26200,1010000,106250,Stephen Gostkowski,K,active,new-england-patriots,1116250,2009
26201,310000,575000,Patrick Chung,SS,active,new-england-patriots,885000,2009
26202,310000,0,Ron Brace,DT,active,new-england-patriots,310000,2009
26203,310000,440000,Darius Butler,FS,active,new-england-patriots,750000,2009
26204,620000,50000,Brandon Lloyd,WR,active,new-england-patriots,670000,2009
26205,535000,116667,Rob Ninkovich,OLB,active,new-england-patriots,651667,2009
26206,510000,108333,Dan Connolly,G,active,new-england-patriots,618333,2009
26207,385000,222500,Terrence Wheatley,CB,active,new-england-patriots,607500,2009
26208,385000,190125,Shawn Crable,LB,active,new-england-patriots,575125,2009
26209,385000,190125,Kevin O'Connell,QB,active,new-england-patriots,575125,2009
26210,310000,250000,Sebastian Vollmer,RT,active,new-england-patriots,560000,2009
26211,310000,188750,Brandon Tate,WR,active,new-england-patriots,498750,2009
26212,385000,101250,Jonathan Wilhite,CB,active,new-england-patriots,486250,2009
26213,310000,157750,Tyrone McKenzie,OLB,active,new-england-patriots,467750,2009
26214,460000,0,Prescott Burgess,LB,active,new-england-patriots,460000,2009
26215,460000,0,Mike Elgin,C,active,new-england-patriots,460000,2009
26216,460000,0,Jeff Rowe,QB,active,new-england-patriots,460000,2009
26217,460000,0,Isaiah Stanback,TE,active,new-england-patriots,460000,2009
26218,385000,51870,Matthew Slater,WR,active,new-england-patriots,436870,2009
26219,310000,112750,Rich Ohrnberger,C,active,new-england-patriots,422750,2009
26220,164117,230000,Kyle Arrington,CB,active,new-england-patriots,394117,2009
26221,385000,7280,BenJarvus Green-Ellis,RB,active,new-england-patriots,392280,2009
26222,385000,6000,Gary Guyton,OLB,active,new-england-patriots,391000,2009
26223,310000,37958,George Bussey,T,active,new-england-patriots,347958,2009
26224,310000,19750,Myron Pryor,DT,active,new-england-patriots,329750,2009
26225,310000,17500,Jake Ingram,DE,active,new-england-patriots,327500,2009
26226,310000,12175,Julian Edelman,WR,active,new-england-patriots,322175,2009
26227,310000,4166,Brian Hoyer,QB,active,new-england-patriots,314166,2009
26228,36740,0,Ryan Wendell,C,active,new-england-patriots,36740,2009
26229,1650000,3200000,Wes Welker,WR,injured_reserve,new-england-patriots,4850000,2009
26230,88400,0,Robert Agnone,TE,practice_squad,new-england-patriots,88400,2009
26231,88400,0,Kyle Arrington,CB,practice_squad,new-england-patriots,88400,2009
26232,88400,0,Ryan Wendell,C,practice_squad,new-england-patriots,88400,2009
26233,0,10665000,Richard Seymour,DT,dead_cap,new-england-patriots,10665000,2009
26234,549166,0,Chad Jackson,WR,dead_cap,new-england-patriots,549166,2009
26235,385098,0,Kendall Simmons,G,dead_cap,new-england-patriots,385098,2009
26236,165000,0,Ellis Hobbs,CB,dead_cap,new-england-patriots,165000,2009
26237,63000,0,Oscar Lua,LB,dead_cap,new-england-patriots,63000,2009
26238,47625,0,Ryan O'Callaghan,T,dead_cap,new-england-patriots,47625,2009
26239,43000,0,Mike Richardson,CB,dead_cap,new-england-patriots,43000,2009
26240,23912,0,Darryl Richard,DT,dead_cap,new-england-patriots,23912,2009
26241,21225,0,Bo Ruud,LB,dead_cap,new-england-patriots,21225,2009
26242,17750,0,Le Kevin Smith,DT,dead_cap,new-england-patriots,17750,2009
26243,11625,0,Willie Andrews,CB,dead_cap,new-england-patriots,11625,2009
26244,2000,0,Eric Kettani,FB,dead_cap,new-england-patriots,2000,2009
26245,7500000,15220000,Tom Brady,QB,active,new-england-patriots,22720000,2010
26246,1505882,5600000,Randy Moss,WR,active,new-england-patriots,7105882,2010
26247,5470000,0,Deion Branch,WR,active,new-england-patriots,5470000,2010
26248,2900000,2100000,Dan Koppen,C,active,new-england-patriots,5000000,2010
26249,470000,4455000,Jerod Mayo,ILB,active,new-england-patriots,4925000,2010
26250,4500000,0,Matt Light,T,active,new-england-patriots,4500000,2010
26251,750000,3850000,Vince Wilfork,DT,active,new-england-patriots,4600000,2010
26252,1900000,3200000,Wes Welker,WR,active,new-england-patriots,5100000,2010
26253,2700000,0,Nick Kaczur,T,active,new-england-patriots,2700000,2010
26254,2300000,700000,James Sanders,S,active,new-england-patriots,3000000,2010
26255,2000000,725000,Fred Taylor,RB,active,new-england-patriots,2725000,2010
26256,480000,1425000,Patrick Chung,SS,active,new-england-patriots,1905000,2010
26257,1100000,800000,Stephen Gostkowski,K,active,new-england-patriots,1900000,2010
26258,1759000,0,Jarrad Page,S,active,new-england-patriots,1759000,2010
26259,550000,2110000,Brandon Meriweather,SS,active,new-england-patriots,2660000,2010
26260,900000,475000,Sammy Morris,RB,active,new-england-patriots,1375000,2010
26261,320000,980000,Devin McCourty,FS,active,new-england-patriots,1300000,2010
26262,1106823,0,Quinn Ojinnaka,T,active,new-england-patriots,1106823,2010
26263,545000,1085000,Darius Butler,FS,active,new-england-patriots,1630000,2010
26264,600000,458333,Dan Connolly,G,active,new-england-patriots,1058333,2010
26265,650000,341667,Rob Ninkovich,OLB,active,new-england-patriots,991667,2010
26266,395000,0,Ron Brace,DT,active,new-england-patriots,395000,2010
26267,505000,325000,Gary Guyton,OLB,active,new-england-patriots,830000,2010
26268,320000,440000,Rob Gronkowski,TE,active,new-england-patriots,760000,2010
26269,755000,0,Shayne Graham,K,active,new-england-patriots,755000,2010
26270,755000,0,Tracy White,LB,active,new-england-patriots,755000,2010
26271,420000,610000,Sebastian Vollmer,RT,active,new-england-patriots,1030000,2010
26272,724708,0,Logan Mankins,G,active,new-england-patriots,724708,2010
26273,470000,222500,Terrence Wheatley,CB,active,new-england-patriots,692500,2010
26274,320000,309375,Jermaine Cunningham,DE,active,new-england-patriots,629375,2010
26275,470000,101250,Jonathan Wilhite,CB,active,new-england-patriots,571250,2010
26276,470000,51870,Matthew Slater,WR,active,new-england-patriots,521870,2010
26277,320000,196870,Brandon Tate,WR,active,new-england-patriots,516870,2010
26278,320000,176150,Taylor Price,WR,active,new-england-patriots,496150,2010
26279,244705,240000,Brandon Spikes,ILB,active,new-england-patriots,484705,2010
26280,470000,7280,BenJarvus Green-Ellis,RB,active,new-england-patriots,477280,2010
26281,320000,126000,Aaron Hernandez,TE,active,new-england-patriots,446000,2010
26282,395000,50000,Kyle Arrington,CB,active,new-england-patriots,445000,2010
26283,395000,19750,Myron Pryor,DT,active,new-england-patriots,414750,2010
26284,395000,17500,Jake Ingram,DE,active,new-england-patriots,412500,2010
26285,395000,15000,Rich Ohrnberger,C,active,new-england-patriots,410000,2010
26286,395000,12175,Julian Edelman,WR,active,new-england-patriots,407175,2010
26287,395000,4166,Brian Hoyer,QB,active,new-england-patriots,399166,2010
26288,395000,1000,Thomas Clayton,RB,active,new-england-patriots,396000,2010
26289,395000,0,Ryan Wendell,C,active,new-england-patriots,395000,2010
26290,371764,0,Danny Woodhead,RB,active,new-england-patriots,371764,2010
26291,320000,46812,Zoltan Mesko,P,active,new-england-patriots,366812,2010
26292,320000,37958,George Bussey,T,active,new-england-patriots,357958,2010
26293,320000,10075,Brandon Deaderick,DT,active,new-england-patriots,330075,2010
26294,320000,10000,Kade Weston,DT,active,new-england-patriots,330000,2010
26295,320000,9711,Sergio Brown,FS,active,new-england-patriots,329711,2010
26296,320000,2500,Kyle Love,DT,active,new-england-patriots,322500,2010
26297,320000,0,Steve Maneri,TE,active,new-england-patriots,320000,2010
26298,235000,3333,Dane Fletcher,ILB,active,new-england-patriots,238333,2010
26299,216471,0,Matt Katula,C,active,new-england-patriots,216471,2010
26300,75294,0,Thomas Welch,RT,active,new-england-patriots,75294,2010
26301,333,0,Terrence Johnson,CB,active,new-england-patriots,333,2010
26302,2900000,3083332,Ty Warren,DT,injured_reserve,new-england-patriots,5983332,2010
26303,470000,0,Josh Barrett,S,injured_reserve,new-england-patriots,470000,2010
26304,88400,0,Ross Ventrone,SS,practice_squad,new-england-patriots,88400,2010
26305,48530,2255000,Laurence Maroney,RB,dead_cap,new-england-patriots,2303530,2010
26306,670000,0,Pierre Woods,LB,dead_cap,new-england-patriots,670000,2010
26307,300000,0,Chris Baker,TE,dead_cap,new-england-patriots,300000,2010
26308,190125,0,Shawn Crable,LB,dead_cap,new-england-patriots,190125,2010
26309,186666,0,Kendall Simmons,G,dead_cap,new-england-patriots,186666,2010
26310,112750,0,Rich Ohrnberger,C,dead_cap,new-england-patriots,112750,2010
26311,71736,0,Darryl Richard,DT,dead_cap,new-england-patriots,71736,2010
26312,0,50000,Torry Holt,WR,dead_cap,new-england-patriots,50000,2010
26313,42450,0,Bo Ruud,LB,dead_cap,new-england-patriots,42450,2010
26314,37958,0,George Bussey,T,dead_cap,new-england-patriots,37958,2010
26315,0,20075,Ted Larsen,G,dead_cap,new-england-patriots,20075,2010
26316,17500,0,Jake Ingram,DE,dead_cap,new-england-patriots,17500,2010
26317,0,11520,Thomas Welch,RT,dead_cap,new-england-patriots,11520,2010
26318,0,9500,Zac Robinson,QB,dead_cap,new-england-patriots,9500,2010
26319,0,4166,Sergio Brown,FS,dead_cap,new-england-patriots,4166,2010
26320,5750000,7200000,Tom Brady,QB,active,new-england-patriots,12950000,2011
26321,600000,5475000,Jerod Mayo,ILB,active,new-england-patriots,6075000,2011
26322,3500000,2312500,Brian Waters,G,active,new-england-patriots,5812500,2011
26323,1500000,4000000,Logan Mankins,G,active,new-england-patriots,5500000,2011
26324,810000,3835000,Vince Wilfork,DT,active,new-england-patriots,4645000,2011
26325,2150000,3200000,Wes Welker,WR,active,new-england-patriots,5350000,2011
26326,1500000,2500000,Shaun Ellis,DE,active,new-england-patriots,4000000,2011
26327,1000000,3000000,Matt Light,T,active,new-england-patriots,4000000,2011
26328,2900000,600000,Dan Koppen,C,active,new-england-patriots,3500000,2011
26329,450000,3530000,Devin McCourty,FS,active,new-england-patriots,3980000,2011
26330,1700000,900000,Stephen Gostkowski,K,active,new-england-patriots,2600000,2011
26331,1000000,1583333,Chad Johnson,WR,active,new-england-patriots,2583333,2011
26332,2200000,0,Deion Branch,WR,active,new-england-patriots,2200000,2011
26333,1835000,0,BenJarvus Green-Ellis,RB,active,new-england-patriots,1835000,2011
26334,450000,1270000,Rob Gronkowski,TE,active,new-england-patriots,1720000,2011
26335,1200000,75000,Marcus Stroud,DT,active,new-england-patriots,1275000,2011
26336,375000,1177817,Nate Solder,LT,active,new-england-patriots,1552817,2011
26337,1500000,0,Albert Haynesworth,DT,active,new-england-patriots,1500000,2011
26338,1025000,458334,Dan Connolly,G,active,new-england-patriots,1483334,2011
26339,1000000,325000,Gary Guyton,OLB,active,new-england-patriots,1325000,2011
26340,1000000,375000,Mark Anderson,DE,active,new-england-patriots,1375000,2011
26341,1200000,101250,Jonathan Wilhite,CB,active,new-england-patriots,1301250,2011
26342,450000,834375,Jermaine Cunningham,DE,active,new-england-patriots,1284375,2011
26343,586000,0,Ron Brace,DT,active,new-england-patriots,586000,2011
26344,685000,416667,Rob Ninkovich,OLB,active,new-england-patriots,1101667,2011
26345,525000,550000,Patrick Chung,SS,active,new-england-patriots,1075000,2011
26346,375000,589382,Ras-I Dowling,CB,active,new-england-patriots,964382,2011
26347,550000,366666,Danny Woodhead,RB,active,new-england-patriots,916666,2011
26348,525000,635000,Sebastian Vollmer,RT,active,new-england-patriots,1160000,2011
26349,525000,200000,Kyle Arrington,CB,active,new-england-patriots,725000,2011
26350,540000,160000,Aaron Hernandez,TE,active,new-england-patriots,700000,2011
26351,450000,240000,Brandon Spikes,ILB,active,new-england-patriots,690000,2011
26352,480000,196870,Brandon Tate,WR,active,new-england-patriots,676870,2011
26353,525000,150000,Ryan Wendell,C,active,new-england-patriots,675000,2011
26354,600000,51870,Matthew Slater,WR,active,new-england-patriots,651870,2011
26355,640000,0,Matt Katula,C,active,new-england-patriots,640000,2011
26356,600000,8120,Landon Cohen,DT,active,new-england-patriots,608120,2011
26357,600000,0,James Ihedigbo,SS,active,new-england-patriots,600000,2011
26358,555000,0,Antwaun Molden,CB,active,new-england-patriots,555000,2011
26359,525000,19750,Myron Pryor,DT,active,new-england-patriots,544750,2011
26360,525000,15000,Rich Ohrnberger,C,active,new-england-patriots,540000,2011
26361,525000,12175,Julian Edelman,WR,active,new-england-patriots,537175,2011
26362,375000,162000,Stevan Ridley,RB,active,new-england-patriots,537000,2011
26363,375000,160969,Ryan Mallett,QB,active,new-england-patriots,535969,2011
26364,525000,4166,Brian Hoyer,QB,active,new-england-patriots,529166,2011
26365,810000,0,Nathan Jones,CB,active,new-england-patriots,810000,2011
26366,810000,0,Niko Koutouvides,ILB,active,new-england-patriots,810000,2011
26367,810000,50000,Tracy White,LB,active,new-england-patriots,860000,2011
26368,525000,0,Donald Thomas,G,active,new-england-patriots,525000,2011
26369,450000,46812,Zoltan Mesko,P,active,new-england-patriots,496812,2011
26370,480000,8120,Tony Carter,CB,active,new-england-patriots,488120,2011
26371,480000,0,George Bussey,T,active,new-england-patriots,480000,2011
26372,450000,3333,Dane Fletcher,ILB,active,new-england-patriots,453333,2011
26373,450000,2500,Kyle Love,DT,active,new-england-patriots,452500,2011
26374,423530,10075,Brandon Deaderick,DT,active,new-england-patriots,433605,2011
26375,375000,50125,Marcus Cannon,RT,active,new-england-patriots,425125,2011
26376,405000,9711,Sergio Brown,FS,active,new-england-patriots,414711,2011
26377,405000,0,Bret Lockett,S,active,new-england-patriots,405000,2011
26378,375000,3000,Kyle Hix,T,active,new-england-patriots,378000,2011
26379,375000,0,Danny Aiken,LS,active,new-england-patriots,375000,2011
26380,375000,0,Lee Smith,TE,active,new-england-patriots,375000,2011
26381,317647,0,Phillip Adams,CB,active,new-england-patriots,317647,2011
26382,308823,5000,Ross Ventrone,SS,active,new-england-patriots,313823,2011
26383,258000,0,Jeff Tarpinian,OLB,active,new-england-patriots,258000,2011
26384,132352,0,Nick McDonald,C,active,new-england-patriots,132352,2011
26385,667,0,Terrence Johnson,CB,active,new-england-patriots,667,2011
26386,725000,150000,Josh Barrett,S,injured_reserve,new-england-patriots,875000,2011
26387,207194,0,Eric Kettani,FB,practice_squad,new-england-patriots,207194,2011
26388,193800,0,Nick McDonald,C,practice_squad,new-england-patriots,193800,2011
26389,149940,0,Alex Silvestro,TE,practice_squad,new-england-patriots,149940,2011
26390,149940,0,Ross Ventrone,SS,practice_squad,new-england-patriots,149940,2011
26391,96900,0,Alex Silvestro,TE,practice_squad,new-england-patriots,96900,2011
26392,96900,0,Kerry Taylor,WR,practice_squad,new-england-patriots,96900,2011
26393,15000,0,Steve Maneri,TE,practice_squad,new-england-patriots,15000,2011
26394,0,1960000,Brandon Meriweather,SS,dead_cap,new-england-patriots,1960000,2011
26395,900000,0,Chris Baker,TE,dead_cap,new-england-patriots,900000,2011
26396,875000,0,Nick Kaczur,T,dead_cap,new-england-patriots,875000,2011
26397,600000,0,James Sanders,S,dead_cap,new-england-patriots,600000,2011
26398,542500,0,Darius Butler,FS,dead_cap,new-england-patriots,542500,2011
26399,225500,0,Rich Ohrnberger,C,dead_cap,new-england-patriots,225500,2011
26400,222500,0,Terrence Wheatley,CB,dead_cap,new-england-patriots,222500,2011
26401,190125,0,Shawn Crable,LB,dead_cap,new-england-patriots,190125,2011
26402,0,176150,Taylor Price,WR,dead_cap,new-england-patriots,176150,2011
26403,75000,0,Marcus Stroud,DT,dead_cap,new-england-patriots,75000,2011
26404,0,60225,Ted Larsen,G,dead_cap,new-england-patriots,60225,2011
26405,0,57160,Lee Smith,TE,dead_cap,new-england-patriots,57160,2011
26406,0,50000,Sammy Morris,RB,dead_cap,new-england-patriots,50000,2011
26407,37958,0,George Bussey,T,dead_cap,new-england-patriots,37958,2011
26408,0,28500,Zac Robinson,QB,dead_cap,new-england-patriots,28500,2011
26409,0,23513,Markell Carter,DE,dead_cap,new-england-patriots,23513,2011
26410,0,23040,Thomas Welch,RT,dead_cap,new-england-patriots,23040,2011
26411,17500,0,Jake Ingram,DE,dead_cap,new-england-patriots,17500,2011
26412,15000,0,Steve Maneri,TE,dead_cap,new-england-patriots,15000,2011
26413,9000,333,Jeremy Ross,WR,dead_cap,new-england-patriots,9333,2011
26414,0,8334,Sergio Brown,FS,dead_cap,new-england-patriots,8334,2011
26415,0,6000,Malcolm Williams,CB,dead_cap,new-england-patriots,6000,2011
26416,5000,0,Thomas Austin,C,dead_cap,new-england-patriots,5000,2011
26417,4000,0,Corey Woods,T,dead_cap,new-england-patriots,4000,2011
26418,3000,0,Jeff Tarpinian,OLB,dead_cap,new-england-patriots,3000,2011
26419,2667,0,Mike Berry,G,dead_cap,new-england-patriots,2667,2011
26420,2333,0,Will Yeatman,LT,dead_cap,new-england-patriots,2333,2011
26421,1667,0,Clay Nurse,DT,dead_cap,new-england-patriots,1667,2011
26422,1250,0,Ryan Coulson,LB,dead_cap,new-england-patriots,1250,2011
26423,1166,0,Alex Silvestro,TE,dead_cap,new-england-patriots,1166,2011
26424,1000,0,Thomas Clayton,RB,dead_cap,new-england-patriots,1000,2011
26425,9515000,0,Wes Welker,WR,active,new-england-patriots,9515000,2012
26426,1250000,10275000,Jerod Mayo,ILB,active,new-england-patriots,11525000,2012
26427,4500000,4100000,Vince Wilfork,DT,active,new-england-patriots,8600000,2012
26428,950000,7050000,Tom Brady,QB,active,new-england-patriots,8000000,2012
26429,2750000,4250000,Logan Mankins,G,active,new-england-patriots,7000000,2012
26430,540000,2750000,Aaron Hernandez,TE,active,new-england-patriots,3290000,2012
26431,1500000,1750000,Brian Waters,G,active,new-england-patriots,3250000,2012
26432,2100000,900000,Stephen Gostkowski,K,active,new-england-patriots,3000000,2012
26433,540000,2120000,Rob Gronkowski,TE,active,new-england-patriots,2660000,2012
26434,1250000,1083333,Dan Connolly,G,active,new-england-patriots,2333333,2012
26435,1852500,300000,Aqib Talib,CB,active,new-england-patriots,2152500,2012
26436,1850000,300000,Kyle Arrington,CB,active,new-england-patriots,2150000,2012
26437,900000,1100000,Brandon Lloyd,WR,active,new-england-patriots,2000000,2012
26438,763204,1177817,Nate Solder,LT,active,new-england-patriots,1941021,2012
26439,540000,2040000,Devin McCourty,FS,active,new-england-patriots,2580000,2012
26440,750000,833333,Steve Gregory,S,active,new-england-patriots,1583333,2012
26441,900000,766666,Rob Ninkovich,OLB,active,new-england-patriots,1666666,2012
26442,390000,1096091,Chandler Jones,OLB,active,new-england-patriots,1486091,2012
26443,700000,766666,Matthew Slater,WR,active,new-england-patriots,1466666,2012
26444,390000,1014364,Dont'a Hightower,OLB,active,new-england-patriots,1404364,2012
26445,777000,0,Ron Brace,DT,active,new-england-patriots,777000,2012
26446,1000000,333333,Daniel Fells,TE,active,new-england-patriots,1333333,2012
26447,616095,589382,Ras-I Dowling,CB,active,new-england-patriots,1205477,2012
26448,615000,550000,Patrick Chung,SS,active,new-england-patriots,1165000,2012
26449,900000,250000,Trevor Scott,DE,active,new-england-patriots,1150000,2012
26450,825000,65000,Tracy White,LB,active,new-england-patriots,890000,2012
26451,650000,635000,Sebastian Vollmer,RT,active,new-england-patriots,1285000,2012
26452,750000,200000,Ryan Wendell,C,active,new-england-patriots,950000,2012
26453,700000,191668,Danny Woodhead,RB,active,new-england-patriots,891668,2012
26454,540000,309375,Jermaine Cunningham,DE,active,new-england-patriots,849375,2012
26455,540000,250000,Kyle Love,DT,active,new-england-patriots,790000,2012
26456,465000,321625,Shane Vereen,RB,active,new-england-patriots,786625,2012
26457,540000,240000,Brandon Spikes,ILB,active,new-england-patriots,780000,2012
26458,390000,376891,Tavon Wilson,SS,active,new-england-patriots,766891,2012
26459,700000,50000,Donald Thomas,G,active,new-england-patriots,750000,2012
26460,509250,162000,Stevan Ridley,RB,active,new-england-patriots,671250,2012
26461,508992,160969,Ryan Mallett,QB,active,new-england-patriots,669961,2012
26462,615000,25000,Marquice Cole,CB,active,new-england-patriots,640000,2012
26463,615000,12175,Julian Edelman,WR,active,new-england-patriots,627175,2012
26464,615000,0,Marcus Harrison,DT,active,new-england-patriots,615000,2012
26465,1200000,0,Visanthe Shiancoe,TE,active,new-england-patriots,1200000,2012
26466,540000,46812,Zoltan Mesko,P,active,new-england-patriots,586812,2012
26467,540000,10075,Brandon Deaderick,DT,active,new-england-patriots,550075,2012
26468,540000,3334,Dane Fletcher,ILB,active,new-england-patriots,543334,2012
26469,825000,0,Niko Koutouvides,ILB,active,new-england-patriots,825000,2012
26470,825000,50000,Donte Stallworth,WR,active,new-england-patriots,875000,2012
26471,700000,0,Derrick Martin,CB,active,new-england-patriots,700000,2012
26472,540000,0,Michael Hoomanawanui,TE,active,new-england-patriots,540000,2012
26473,540000,0,Nick McDonald,C,active,new-england-patriots,540000,2012
26474,481281,50125,Marcus Cannon,RT,active,new-england-patriots,531406,2012
26475,390000,134950,Jake Bequette,DE,active,new-england-patriots,524950,2012
26476,465000,0,Danny Aiken,LS,active,new-england-patriots,465000,2012
26477,465000,0,Kamar Aiken,WR,active,new-england-patriots,465000,2012
26478,465000,0,James Develin,FB,active,new-england-patriots,465000,2012
26479,390000,24150,Nate Ebner,FS,active,new-england-patriots,414150,2012
26480,390000,14462,Alfonzo Dennard,CB,active,new-england-patriots,404462,2012
26481,390000,4584,Brandon Bolden,RB,active,new-england-patriots,394584,2012
26482,390000,4333,Markus Zusevics,RT,active,new-england-patriots,394333,2012
26483,390000,2333,Justin Francis,DE,active,new-england-patriots,392333,2012
26484,390000,0,Marcus Forston,DT,active,new-england-patriots,390000,2012
26485,390000,0,Mike Hartline,QB,active,new-england-patriots,390000,2012
26486,465000,0,Jeff Tarpinian,OLB,active,new-england-patriots,465000,2012
26487,390000,0,Malcolm Williams,CB,active,new-england-patriots,390000,2012
26488,390000,0,Mike Rivera,OLB,active,new-england-patriots,390000,2012
26489,925000,0,Deion Branch,WR,active,new-england-patriots,925000,2012
26490,775000,225000,Josh Barrett,S,injured_reserve,new-england-patriots,1000000,2012
26491,925000,25000,Will Allen,S,injured_reserve,new-england-patriots,950000,2012
26492,825000,0,Donte Stallworth,WR,injured_reserve,new-england-patriots,825000,2012
26493,700000,125000,Spencer Larsen,RB,injured_reserve,new-england-patriots,825000,2012
26494,700000,0,Jamey Richard,G,injured_reserve,new-england-patriots,700000,2012
26495,390000,3000,Kyle Hix,T,injured_reserve,new-england-patriots,393000,2012
26496,390000,833,Brad Herman,TE,injured_reserve,new-england-patriots,390833,2012
26497,64000,0,Nick McDonald,C,practice_squad,new-england-patriots,64000,2012
26498,3000000,0,Leigh Bodden,CB,dead_cap,new-england-patriots,3000000,2012
26499,3000000,0,Matt Light,T,dead_cap,new-england-patriots,3000000,2012
26500,2750012,0,Ty Warren,DT,dead_cap,new-england-patriots,2750012,2012
26501,2000000,0,Tully Banta-Cain,LB,dead_cap,new-england-patriots,2000000,2012
26502,1583333,0,Chad Johnson,WR,dead_cap,new-england-patriots,1583333,2012
26503,1383333,0,Jonathan Fanene,DE,dead_cap,new-england-patriots,1383333,2012
26504,875000,0,Nick Kaczur,T,dead_cap,new-england-patriots,875000,2012
26505,542500,0,Darius Butler,FS,dead_cap,new-england-patriots,542500,2012
26506,0,500000,Robert Gallery,T,dead_cap,new-england-patriots,500000,2012
26507,450000,0,Mike Wright,DT,dead_cap,new-england-patriots,450000,2012
26508,400000,0,Deion Branch,WR,dead_cap,new-england-patriots,400000,2012
26509,0,352290,Taylor Price,WR,dead_cap,new-england-patriots,352290,2012
26510,325000,0,Dan Koppen,C,dead_cap,new-england-patriots,325000,2012
26511,188750,0,Brandon Tate,WR,dead_cap,new-england-patriots,188750,2012
26512,150000,0,Jabar Gaffney,WR,dead_cap,new-england-patriots,150000,2012
26513,0,125000,Joseph Addai,RB,dead_cap,new-england-patriots,125000,2012
26514,0,114320,Lee Smith,TE,dead_cap,new-england-patriots,114320,2012
26515,97059,0,Kellen Winslow,TE,dead_cap,new-england-patriots,97059,2012
26516,25000,50000,Bobby Carpenter,LB,dead_cap,new-england-patriots,75000,2012
26517,75000,0,Marcus Stroud,DT,dead_cap,new-england-patriots,75000,2012
26518,72353,0,Lex Hilliard,RB,dead_cap,new-england-patriots,72353,2012
26519,0,70539,Markell Carter,DE,dead_cap,new-england-patriots,70539,2012
26520,65000,0,Niko Koutouvides,ILB,dead_cap,new-england-patriots,65000,2012
26521,60000,0,Gerard Warren,DT,dead_cap,new-england-patriots,60000,2012
26522,54706,0,Greg Salas,WR,dead_cap,new-england-patriots,54706,2012
26523,50000,0,Donte Stallworth,WR,dead_cap,new-england-patriots,50000,2012
26524,45882,0,Mike Rivera,OLB,dead_cap,new-england-patriots,45882,2012
26525,27353,0,Terrell McClain,DE,dead_cap,new-england-patriots,27353,2012
26526,25000,0,James Ihedigbo,SS,dead_cap,new-england-patriots,25000,2012
26527,19850,0,Kade Weston,DT,dead_cap,new-england-patriots,19850,2012
26528,0,18000,Malcolm Williams,CB,dead_cap,new-england-patriots,18000,2012
26529,17100,0,Chyl Quarles,S,dead_cap,new-england-patriots,17100,2012
26530,16068,0,Alex Silvestro,TE,dead_cap,new-england-patriots,16068,2012
26531,16000,0,Jeremiah Warren,C,dead_cap,new-england-patriots,16000,2012
26532,15000,0,Steve Maneri,TE,dead_cap,new-england-patriots,15000,2012
26533,15000,0,Rich Ohrnberger,C,dead_cap,new-england-patriots,15000,2012
26534,0,12050,Jeremy Ebert,WR,dead_cap,new-england-patriots,12050,2012
26535,12000,0,Aaron Lavarias,DT,dead_cap,new-england-patriots,12000,2012
26536,11400,0,Kerry Taylor,WR,dead_cap,new-england-patriots,11400,2012
26537,11000,0,Jeff Demps,RB,dead_cap,new-england-patriots,11000,2012
26538,9711,0,Sergio Brown,FS,dead_cap,new-england-patriots,9711,2012
26539,8000,0,Corey Woods,T,dead_cap,new-england-patriots,8000,2012
26540,6000,0,Jeff Tarpinian,OLB,dead_cap,new-england-patriots,6000,2012
26541,5334,0,Mike Berry,G,dead_cap,new-england-patriots,5334,2012
26542,5000,0,Thomas Austin,C,dead_cap,new-england-patriots,5000,2012
26543,4667,0,Will Yeatman,LT,dead_cap,new-england-patriots,4667,2012
26544,3334,0,Clay Nurse,DT,dead_cap,new-england-patriots,3334,2012
26545,3333,0,Marcus Forston,DT,dead_cap,new-england-patriots,3333,2012
26546,667,667,Jeremy Ross,WR,dead_cap,new-england-patriots,1334,2012
26547,1250,0,Ryan Coulson,LB,dead_cap,new-england-patriots,1250,2012
26548,833,0,Matt Roark,WR,dead_cap,new-england-patriots,833,2012
26549,1000000,12800000,Tom Brady,QB,active,new-england-patriots,13800000,2013
26550,6500000,4100000,Vince Wilfork,DT,active,new-england-patriots,10600000,2013
26551,5750000,4250000,Logan Mankins,G,active,new-england-patriots,10000000,2013
26552,1575000,3307813,Aqib Talib,CB,active,new-england-patriots,4882813,2013
26553,1400000,2916668,Rob Ninkovich,OLB,active,new-england-patriots,4316668,2013
26554,2000000,1575000,Danny Amendola,WR,active,new-england-patriots,3575000,2013
26555,2500000,900000,Stephen Gostkowski,K,active,new-england-patriots,3400000,2013
26556,2250000,1083333,Dan Connolly,G,active,new-england-patriots,3333333,2013
26557,1250000,1750000,Sebastian Vollmer,RT,active,new-england-patriots,3000000,2013
26558,630000,2120000,Rob Gronkowski,TE,active,new-england-patriots,2750000,2013
26559,1000000,1625000,Kyle Arrington,CB,active,new-england-patriots,2625000,2013
26560,1151408,1177817,Nate Solder,LT,active,new-england-patriots,2329225,2013
26561,1200000,1066666,Matthew Slater,WR,active,new-england-patriots,2266666,2013
26562,1250000,833333,Steve Gregory,S,active,new-england-patriots,2083333,2013
26563,761522,1096091,Chandler Jones,OLB,active,new-england-patriots,1857613,2013
26564,650000,2040000,Devin McCourty,FS,active,new-england-patriots,2690000,2013
26565,741091,1014364,Dont'a Hightower,OLB,active,new-england-patriots,1755455,2013
26566,815000,200000,Ryan Wendell,C,active,new-england-patriots,1015000,2013
26567,715000,285000,Will Svitek,LT,active,new-england-patriots,1000000,2013
26568,581772,376891,Tavon Wilson,SS,active,new-england-patriots,958663,2013
26569,589650,354300,Shane Vereen,RB,active,new-england-patriots,943950,2013
26570,630000,240000,Brandon Spikes,ILB,active,new-england-patriots,870000,2013
26571,643500,162000,Stevan Ridley,RB,active,new-england-patriots,805500,2013
26572,642984,160969,Ryan Mallett,QB,active,new-england-patriots,803953,2013
26573,715000,50000,Julian Edelman,WR,active,new-england-patriots,765000,2013
26574,405000,278818,Jamie Collins,OLB,active,new-england-patriots,683818,2013
26575,630000,50000,LeGarrette Blount,RB,active,new-england-patriots,680000,2013
26576,715000,0,Matthew Mulligan,TE,active,new-england-patriots,715000,2013
26577,587562,50125,Marcus Cannon,RT,active,new-england-patriots,637687,2013
26578,630000,0,Michael Hoomanawanui,TE,active,new-england-patriots,630000,2013
26579,405000,218340,Aaron Dobson,WR,active,new-england-patriots,623340,2013
26580,555000,65000,Dane Fletcher,ILB,active,new-england-patriots,620000,2013
26581,480000,134950,Jake Bequette,DE,active,new-england-patriots,614950,2013
26582,555000,0,Danny Aiken,LS,active,new-england-patriots,555000,2013
26583,555000,0,Chris White,ILB,active,new-england-patriots,555000,2013
26584,405000,140813,Logan Ryan,CB,active,new-england-patriots,545813,2013
26585,405000,133400,Duron Harmon,SS,active,new-england-patriots,538400,2013
26586,529411,0,Isaac Sopoaga,DT,active,new-england-patriots,529411,2013
26587,405000,119250,Josh Boyce,WR,active,new-england-patriots,524250,2013
26588,480000,24150,Nate Ebner,FS,active,new-england-patriots,504150,2013
26589,480000,14462,Alfonzo Dennard,CB,active,new-england-patriots,494462,2013
26590,480000,4584,Brandon Bolden,RB,active,new-england-patriots,484584,2013
26591,480000,0,James Develin,FB,active,new-england-patriots,480000,2013
26592,405000,13403,Michael Buchanan,DE,active,new-england-patriots,418403,2013
26593,405000,11898,Steve Beauharnais,ILB,active,new-england-patriots,416898,2013
26594,405000,833,Kenbrell Thompkins,WR,active,new-england-patriots,405833,2013
26595,405000,500,Ryan Allen,P,active,new-england-patriots,405500,2013
26596,405000,0,Chris Barker,G,active,new-england-patriots,405000,2013
26597,405000,0,Chris Jones,DT,active,new-england-patriots,405000,2013
26598,405000,0,Joe Vellano,DT,active,new-england-patriots,405000,2013
26599,326470,0,Andre Carter,DE,active,new-england-patriots,326470,2013
26600,405000,0,Josh Kline,G,active,new-england-patriots,405000,2013
26601,480000,0,Sealver Siliga,DT,active,new-england-patriots,480000,2013
26602,555000,0,D.J. Williams,TE,active,new-england-patriots,555000,2013
26603,405000,0,Kanorris Davis,S,active,new-england-patriots,405000,2013
26604,1250000,7050000,Jerod Mayo,ILB,injured_reserve,new-england-patriots,8300000,2013
26605,950000,1050000,Tommy Kelly,DT,injured_reserve,new-england-patriots,2000000,2013
26606,1000000,333333,Adrian Wilson,S,injured_reserve,new-england-patriots,1333333,2013
26607,303000,4333,Markus Zusevics,RT,injured_reserve,new-england-patriots,307333,2013
26608,288000,2666,T.J. Moe,WR,injured_reserve,new-england-patriots,290666,2013
26609,288000,1333,Cory Grissom,DT,injured_reserve,new-england-patriots,289333,2013
26610,288000,0,Brice Schwab,RT,injured_reserve,new-england-patriots,288000,2013
26611,405000,1000,Mark Harrison,WR,non_fb_injury,new-england-patriots,406000,2013
26612,405000,0,Armond Armstead,DT,non_fb_injury,new-england-patriots,405000,2013
26613,66000,0,A.J. Francis,DE,practice_squad,new-england-patriots,66000,2013
26614,30000,0,Sealver Siliga,DT,practice_squad,new-england-patriots,30000,2013
26615,12000,0,R.J. Dill,RT,practice_squad,new-england-patriots,12000,2013
26616,12000,0,Travis Howard,CB,practice_squad,new-england-patriots,12000,2013
26617,6000,0,Patrick Ford,G,practice_squad,new-england-patriots,6000,2013
26618,1500000,2000000,Brandon Lloyd,WR,dead_cap,new-england-patriots,3500000,2013
26619,2566666,0,Jonathan Fanene,DE,dead_cap,new-england-patriots,2566666,2013
26620,0,2550000,Aaron Hernandez,TE,dead_cap,new-england-patriots,2550000,2013
26621,1583333,0,Chad Johnson,WR,dead_cap,new-england-patriots,1583333,2013
26622,1200000,0,Leon Washington,RB,dead_cap,new-england-patriots,1200000,2013
26623,940759,0,Ras-I Dowling,CB,dead_cap,new-england-patriots,940759,2013
26624,617059,0,Marquice Cole,CB,dead_cap,new-england-patriots,617059,2013
26625,424411,0,Austin Collie,WR,dead_cap,new-england-patriots,424411,2013
26626,346434,0,Jermaine Cunningham,DE,dead_cap,new-england-patriots,346434,2013
26627,333333,0,Daniel Fells,TE,dead_cap,new-england-patriots,333333,2013
26628,250000,0,Kyle Love,DT,dead_cap,new-england-patriots,250000,2013
26629,234314,0,Marcus Forston,DT,dead_cap,new-england-patriots,234314,2013
26630,175000,0,Dan Koppen,C,dead_cap,new-england-patriots,175000,2013
26631,169411,0,Anthony Rashad White,DT,dead_cap,new-england-patriots,169411,2013
26632,168471,0,Tyronne Green,G,dead_cap,new-england-patriots,168471,2013
26633,143824,0,Justin Green,CB,dead_cap,new-england-patriots,143824,2013
26634,141647,0,Kanorris Davis,S,dead_cap,new-england-patriots,141647,2013
26635,125000,0,Jabar Gaffney,WR,dead_cap,new-england-patriots,125000,2013
26636,125000,0,Spencer Larsen,RB,dead_cap,new-england-patriots,125000,2013
26637,101647,0,Brandon Ford,TE,dead_cap,new-england-patriots,101647,2013
26638,100980,0,Josh Kline,G,dead_cap,new-england-patriots,100980,2013
26639,99294,0,Zach Sudfeld,TE,dead_cap,new-england-patriots,99294,2013
26640,75000,0,Lavelle Hawkins,WR,dead_cap,new-england-patriots,75000,2013
26641,74118,0,Andre Neblett,DT,dead_cap,new-england-patriots,74118,2013
26642,69431,0,Chris McDonald,FB,dead_cap,new-england-patriots,69431,2013
26643,67765,0,R.J. Mattes,RT,dead_cap,new-england-patriots,67765,2013
26644,65294,0,LaQuan Williams,WR,dead_cap,new-england-patriots,65294,2013
26645,65294,0,D.J. Williams,TE,dead_cap,new-england-patriots,65294,2013
26646,52235,0,Ja'Gared Davis,ILB,dead_cap,new-england-patriots,52235,2013
26647,48000,0,Cierre Wood,RB,dead_cap,new-england-patriots,48000,2013
26648,46814,0,Zoltan Mesko,P,dead_cap,new-england-patriots,46814,2013
26649,40813,0,Justin Francis,DE,dead_cap,new-england-patriots,40813,2013
26650,0,36150,Jeremy Ebert,WR,dead_cap,new-england-patriots,36150,2013
26651,35648,0,Kamar Aiken,WR,dead_cap,new-england-patriots,35648,2013
26652,26668,0,Nick McDonald,C,dead_cap,new-england-patriots,26668,2013
26653,25000,0,Niko Koutouvides,ILB,dead_cap,new-england-patriots,25000,2013
26654,15000,0,Michael Jenkins,WR,dead_cap,new-england-patriots,15000,2013
26655,12000,0,Jeremiah Warren,C,dead_cap,new-england-patriots,12000,2013
26656,10075,0,Brandon Deaderick,DT,dead_cap,new-england-patriots,10075,2013
26657,7500,2500,Elvis Fisher,T,dead_cap,new-england-patriots,10000,2013
26658,9711,0,Sergio Brown,FS,dead_cap,new-england-patriots,9711,2013
26659,3333,0,Ben Bartholomew,FB,dead_cap,new-england-patriots,3333,2013
26660,3333,0,Matt Stankiewitch,C,dead_cap,new-england-patriots,3333,2013
26661,3000,0,Kyle Hix,T,dead_cap,new-england-patriots,3000,2013
26662,1667,0,Brad Herman,TE,dead_cap,new-england-patriots,1667,2013
26663,1666,0,Matt Roark,WR,dead_cap,new-england-patriots,1666,2013
26664,1166,0,Brandon Jones,CB,dead_cap,new-england-patriots,1166,2013
26665,833,0,Stephen Morris,CB,dead_cap,new-england-patriots,833,2013
26666,666,0,Mike Zupancic,LS,dead_cap,new-england-patriots,666,2013
26667,333,0,Dewayne Cherrington,DT,dead_cap,new-england-patriots,333,2013
26668,333,0,Quenton Hines,RB,dead_cap,new-england-patriots,333,2013
26669,2000000,12800000,Tom Brady,QB,active,new-england-patriots,14800000,2014
26670,1300000,6258333,Vince Wilfork,DT,active,new-england-patriots,7558333,2014
26671,1500000,5500000,Darrelle Revis,CB,active,new-england-patriots,7000000,2014
26672,3750000,1650000,Rob Gronkowski,TE,active,new-england-patriots,5400000,2014
26673,3920000,2040000,Devin McCourty,FS,active,new-england-patriots,5960000,2014
26674,3000000,1700000,Danny Amendola,WR,active,new-england-patriots,4700000,2014
26675,3000000,1083333,Dan Connolly,G,active,new-england-patriots,4083333,2014
26676,2000000,2416666,Sebastian Vollmer,RT,active,new-england-patriots,4416666,2014
26677,2900000,900000,Stephen Gostkowski,K,active,new-england-patriots,3800000,2014
26678,2000000,1625000,Kyle Arrington,CB,active,new-england-patriots,3625000,2014
26679,1200000,1733334,Matthew Slater,WR,active,new-england-patriots,2933334,2014
26680,1000000,1850000,Rob Ninkovich,OLB,active,new-england-patriots,2850000,2014
26681,1000000,1750000,Julian Edelman,WR,active,new-england-patriots,2750000,2014
26682,769806,1947623,Nate Solder,LT,active,new-england-patriots,2717429,2014
26683,1000000,1950000,Brandon Browner,CB,active,new-england-patriots,2950000,2014
26684,1133045,1096091,Chandler Jones,OLB,active,new-england-patriots,2229136,2014
26685,1092182,1014364,Dont'a Hightower,OLB,active,new-england-patriots,2106546,2014
26686,800000,1200000,Brandon LaFell,WR,active,new-england-patriots,2000000,2014
26687,693843,1116791,Marcus Cannon,RT,active,new-england-patriots,1810634,2014
26688,1000000,625000,Ryan Wendell,C,active,new-england-patriots,1625000,2014
26689,740000,667500,Michael Hoomanawanui,TE,active,new-england-patriots,1407500,2014
26690,420000,907918,Dominique Easley,DT,active,new-england-patriots,1327918,2014
26691,773444,376891,Tavon Wilson,SS,active,new-england-patriots,1150335,2014
26692,746975,354300,Shane Vereen,RB,active,new-england-patriots,1101275,2014
26693,740000,330000,Patrick Chung,SS,active,new-england-patriots,1070000,2014
26694,777750,162000,Stevan Ridley,RB,active,new-england-patriots,939750,2014
26695,575955,278818,Jamie Collins,OLB,active,new-england-patriots,854773,2014
26696,560835,218340,Aaron Dobson,WR,active,new-england-patriots,779175,2014
26697,495000,160813,Logan Ryan,CB,active,new-england-patriots,655813,2014
26698,645000,0,Danny Aiken,LS,active,new-england-patriots,645000,2014
26699,645000,0,Chris White,ILB,active,new-england-patriots,645000,2014
26700,495000,138900,Duron Harmon,SS,active,new-england-patriots,633900,2014
26701,420000,213436,Jimmy Garoppolo,QB,active,new-england-patriots,633436,2014
26702,615762,0,Akeem Ayers,OLB,active,new-england-patriots,615762,2014
26703,570000,24150,Nate Ebner,FS,active,new-england-patriots,594150,2014
26704,570000,14462,Alfonzo Dennard,CB,active,new-england-patriots,584462,2014
26705,582352,0,Jonathan Casillas,OLB,active,new-england-patriots,582352,2014
26706,570000,4584,Brandon Bolden,RB,active,new-england-patriots,574584,2014
26707,570000,0,James Develin,FB,active,new-england-patriots,570000,2014
26708,420000,119250,Bryan Stork,C,active,new-england-patriots,539250,2014
26709,420000,99272,James White,RB,active,new-england-patriots,519272,2014
26710,495000,500,Ryan Allen,P,active,new-england-patriots,495500,2014
26711,420000,75146,Cameron Fleming,T,active,new-england-patriots,495146,2014
26712,495000,0,Chris Jones,DT,active,new-england-patriots,495000,2014
26713,495000,0,Josh Kline,G,active,new-england-patriots,495000,2014
26714,495000,0,Joe Vellano,DT,active,new-england-patriots,495000,2014
26715,495000,0,Tim Wright,TE,active,new-england-patriots,495000,2014
26716,420000,25550,Zach Moore,DE,active,new-england-patriots,445550,2014
26717,420000,0,Malcolm Butler,CB,active,new-england-patriots,420000,2014
26718,420000,0,Jordan Devey,G,active,new-england-patriots,420000,2014
26719,378529,0,Brian Tyms,WR,active,new-england-patriots,378529,2014
26720,570000,0,Sealver Siliga,DT,active,new-england-patriots,570000,2014
26721,303000,0,Tyler Gaffney,RB,active,new-england-patriots,303000,2014
26722,303000,0,James Morris,ILB,active,new-england-patriots,303000,2014
26723,855000,0,Alan Branch,DT,active,new-england-patriots,855000,2014
26724,420000,0,Jonas Gray,RB,active,new-england-patriots,420000,2014
26725,257647,0,LeGarrette Blount,RB,active,new-england-patriots,257647,2014
26726,495000,0,Darius Fleming,OLB,active,new-england-patriots,495000,2014
26727,420000,0,Josh Boyce,WR,active,new-england-patriots,420000,2014
26728,3250000,6437500,Jerod Mayo,ILB,injured_reserve,new-england-patriots,9687500,2014
26729,495000,13403,Michael Buchanan,DE,injured_reserve,new-england-patriots,508403,2014
26730,303000,5000,Cameron Gordon,OLB,injured_reserve,new-england-patriots,308000,2014
26731,303000,0,Greg Orton,WR,injured_reserve,new-england-patriots,303000,2014
26732,107100,0,Jake Bequette,DE,practice_squad,new-england-patriots,107100,2014
26733,107100,0,Kanorris Davis,S,practice_squad,new-england-patriots,107100,2014
26734,69300,0,Caylin Hauptmann,G,practice_squad,new-england-patriots,69300,2014
26735,56700,0,Chris Barker,G,practice_squad,new-england-patriots,56700,2014
26736,50400,0,Jonathan Krause,WR,practice_squad,new-england-patriots,50400,2014
26737,25200,0,Justin Green,CB,practice_squad,new-england-patriots,25200,2014
26738,25200,0,Deontae Skinner,OLB,practice_squad,new-england-patriots,25200,2014
26739,12600,0,Garrett Gilbert,QB,practice_squad,new-england-patriots,12600,2014
26740,6300,0,Dax Swanson,SS,practice_squad,new-england-patriots,6300,2014
26741,0,7500000,Aaron Hernandez,TE,dead_cap,new-england-patriots,7500000,2014
26742,0,4250000,Logan Mankins,G,dead_cap,new-england-patriots,4250000,2014
26743,1000000,0,Isaac Sopoaga,DT,dead_cap,new-england-patriots,1000000,2014
26744,833334,0,Steve Gregory,S,dead_cap,new-england-patriots,833334,2014
26745,666667,0,Adrian Wilson,S,dead_cap,new-england-patriots,666667,2014
26746,0,600000,Tommy Kelly,DT,dead_cap,new-england-patriots,600000,2014
26747,589382,0,Ras-I Dowling,CB,dead_cap,new-england-patriots,589382,2014
26748,349412,0,Don Jones,FS,dead_cap,new-england-patriots,349412,2014
26749,333334,0,Daniel Fells,TE,dead_cap,new-england-patriots,333334,2014
26750,267553,0,Casey Walker,DT,dead_cap,new-england-patriots,267553,2014
26751,227847,0,Deontae Skinner,OLB,dead_cap,new-england-patriots,227847,2014
26752,221188,0,Joe Vellano,DT,dead_cap,new-england-patriots,221188,2014
26753,100800,119250,Josh Boyce,WR,dead_cap,new-england-patriots,220050,2014
26754,0,160969,Ryan Mallett,QB,dead_cap,new-england-patriots,160969,2014
26755,149224,0,Ja'Gared Davis,ILB,dead_cap,new-england-patriots,149224,2014
26756,145588,833,Kenbrell Thompkins,WR,dead_cap,new-england-patriots,146421,2014
26757,0,139950,Jake Bequette,DE,dead_cap,new-england-patriots,139950,2014
26758,121235,0,Darius Fleming,OLB,dead_cap,new-england-patriots,121235,2014
26759,96035,0,Chris Barker,G,dead_cap,new-england-patriots,96035,2014
26760,94500,0,Dax Swanson,SS,dead_cap,new-england-patriots,94500,2014
26761,0,80000,Danny Aiken,LS,dead_cap,new-england-patriots,80000,2014
26762,75000,0,Lavelle Hawkins,WR,dead_cap,new-england-patriots,75000,2014
26763,49412,23128,Jemea Thomas,CB,dead_cap,new-england-patriots,72540,2014
26764,50400,0,Kona Schwenke,DT,dead_cap,new-england-patriots,50400,2014
26765,37800,0,Ben Bass,DT,dead_cap,new-england-patriots,37800,2014
26766,37800,0,Jonas Gray,RB,dead_cap,new-england-patriots,37800,2014
26767,31500,0,Chris Martin,RT,dead_cap,new-england-patriots,31500,2014
26768,0,30775,Jon Halapio,G,dead_cap,new-england-patriots,30775,2014
26769,25200,0,Caylin Hauptmann,G,dead_cap,new-england-patriots,25200,2014
26770,17000,1000,Asa Watson,TE,dead_cap,new-england-patriots,18000,2014
26771,15000,2500,Stephen Houston,RB,dead_cap,new-england-patriots,17500,2014
26772,0,15000,James Anderson,OLB,dead_cap,new-england-patriots,15000,2014
26773,15000,0,Will Smith,OLB,dead_cap,new-england-patriots,15000,2014
26774,12600,0,Kelcy Quarles,DT,dead_cap,new-england-patriots,12600,2014
26775,12600,0,Cam Henderson,DE,dead_cap,new-england-patriots,12600,2014
26776,12600,0,Charley Hughlett,LS,dead_cap,new-england-patriots,12600,2014
26777,0,12000,Tyler Ott,LS,dead_cap,new-england-patriots,12000,2014
26778,0,11898,Steve Beauharnais,ILB,dead_cap,new-england-patriots,11898,2014
26779,0,11898,Jeremy Gallon,WR,dead_cap,new-england-patriots,11898,2014
26780,10000,1666,Justin Jones,TE,dead_cap,new-england-patriots,11666,2014
26781,8000,0,Zach Sudfeld,TE,dead_cap,new-england-patriots,8000,2014
26782,6667,0,Ben Bartholomew,FB,dead_cap,new-england-patriots,6667,2014
26783,5000,1666,Roy Finch,RB,dead_cap,new-england-patriots,6666,2014
26784,5000,1666,Shamiel Gary,S,dead_cap,new-england-patriots,6666,2014
26785,5000,1666,Travis Hawkins,CB,dead_cap,new-england-patriots,6666,2014
26786,6300,0,McLeod Bethel-Thompson,QB,dead_cap,new-england-patriots,6300,2014
26787,6300,0,Xavier Grimble,TE,dead_cap,new-england-patriots,6300,2014
26788,6300,0,Jonathan Krause,WR,dead_cap,new-england-patriots,6300,2014
26789,6300,0,Allen Reisner,TE,dead_cap,new-england-patriots,6300,2014
26790,5333,0,T.J. Moe,WR,dead_cap,new-england-patriots,5333,2014
26791,0,5000,Jeremy Deering,S,dead_cap,new-england-patriots,5000,2014
26792,5000,0,Elvis Fisher,T,dead_cap,new-england-patriots,5000,2014
26793,4333,0,Markus Zusevics,RT,dead_cap,new-england-patriots,4333,2014
26794,3334,0,Kanorris Davis,S,dead_cap,new-england-patriots,3334,2014
26795,3334,0,Chris McDonald,FB,dead_cap,new-england-patriots,3334,2014
26796,2667,0,Cory Grissom,DT,dead_cap,new-england-patriots,2667,2014
26797,2667,0,Josh Kline,G,dead_cap,new-england-patriots,2667,2014
26798,2334,0,Justin Francis,DE,dead_cap,new-england-patriots,2334,2014
26799,2334,0,Brandon Jones,CB,dead_cap,new-england-patriots,2334,2014
26800,2000,0,Brandon Ford,TE,dead_cap,new-england-patriots,2000,2014
26801,1667,0,Stephen Morris,CB,dead_cap,new-england-patriots,1667,2014
26802,1667,0,Matt Stankiewitch,C,dead_cap,new-england-patriots,1667,2014
26803,1500,0,Tyler Beck,TE,dead_cap,new-england-patriots,1500,2014
26804,1334,0,Mike Zupancic,LS,dead_cap,new-england-patriots,1334,2014
26805,0,1000,Mark Harrison,WR,dead_cap,new-england-patriots,1000,2014
26806,667,0,Dewayne Cherrington,DT,dead_cap,new-england-patriots,667,2014
26807,667,0,Quenton Hines,RB,dead_cap,new-england-patriots,667,2014
26808,8000000,6000000,Tom Brady,QB,active,new-england-patriots,14000000,2015
26809,4750000,5900000,Rob Gronkowski,TE,active,new-england-patriots,10650000,2015
26810,2250000,5104166,Sebastian Vollmer,RT,active,new-england-patriots,7354166,2015
26811,2500000,3500000,Devin McCourty,FS,active,new-england-patriots,6000000,2015
26812,1500000,3250000,Rob Ninkovich,OLB,active,new-england-patriots,4750000,2015
26813,2250000,2406250,Julian Edelman,WR,active,new-england-patriots,4656250,2015
26814,1000000,3000000,Jabaal Sheard,OLB,active,new-england-patriots,4000000,2015
26815,1800000,1800000,Stephen Gostkowski,K,active,new-england-patriots,3600000,2015
26816,1800000,1700000,Brandon LaFell,WR,active,new-england-patriots,3500000,2015
26817,1250000,1866666,Danny Amendola,WR,active,new-england-patriots,3116666,2015
26818,1200000,1416666,Marcus Cannon,RT,active,new-england-patriots,2616666,2015
26819,1504568,1096091,Chandler Jones,OLB,active,new-england-patriots,2600659,2015
26820,1443273,1014364,Dont'a Hightower,OLB,active,new-england-patriots,2457637,2015
26821,1200000,1050000,Scott Chandler,TE,active,new-england-patriots,2250000,2015
26822,1200000,950000,Alan Branch,DT,active,new-england-patriots,2150000,2015
26823,1000000,1000000,Patrick Chung,SS,active,new-england-patriots,2000000,2015
26824,1000000,766666,Matthew Slater,WR,active,new-england-patriots,1766666,2015
26825,435000,949223,Malcom Brown,DT,active,new-england-patriots,1384223,2015
26826,965166,376891,Tavon Wilson,SS,active,new-england-patriots,1342057,2015
26827,1259588,0,Akiem Hicks,DE,active,new-england-patriots,1259588,2015
26828,850000,400000,Jonathan Freeny,OLB,active,new-england-patriots,1250000,2015
26829,585000,500500,Ryan Allen,P,active,new-england-patriots,1085500,2015
26830,660000,375000,Brandon Bolden,RB,active,new-england-patriots,1035000,2015
26831,746909,278818,Jamie Collins,OLB,active,new-england-patriots,1025727,2015
26832,585000,250000,Josh Kline,G,active,new-england-patriots,835000,2015
26833,578359,213436,Jimmy Garoppolo,QB,active,new-england-patriots,791795,2015
26834,585000,160813,Logan Ryan,CB,active,new-england-patriots,745813,2015
26835,585000,139400,Duron Harmon,SS,active,new-england-patriots,724400,2015
26836,660000,24150,Nate Ebner,FS,active,new-england-patriots,684150,2015
26837,435000,239827,Jordan Richards,SS,active,new-england-patriots,674827,2015
26838,745000,80000,Brandon Gibson,WR,active,new-england-patriots,825000,2015
26839,660000,0,James Develin,FB,active,new-england-patriots,660000,2015
26840,660000,0,Sealver Siliga,DT,active,new-england-patriots,660000,2015
26841,535544,119250,Bryan Stork,C,active,new-england-patriots,654794,2015
26842,621176,0,Keshawn Martin,WR,active,new-england-patriots,621176,2015
26843,510000,99272,James White,RB,active,new-england-patriots,609272,2015
26844,435000,145488,Geno Grissom,DE,active,new-england-patriots,580488,2015
26845,435000,130935,Tre' Jackson,G,active,new-england-patriots,565935,2015
26846,546209,0,Jon Bostic,ILB,active,new-england-patriots,546209,2015
26847,435000,110881,Shaq Mason,G,active,new-england-patriots,545881,2015
26848,510000,0,Malcolm Butler,CB,active,new-england-patriots,510000,2015
26849,435000,42500,Joe Cardona,LS,active,new-england-patriots,477500,2015
26850,435000,5000,David Andrews,C,active,new-england-patriots,440000,2015
26851,435000,0,Justin Coleman,CB,active,new-england-patriots,435000,2015
26852,435000,0,Michael Williams,TE,active,new-england-patriots,435000,2015
26853,360000,0,Cameron Fleming,T,active,new-england-patriots,360000,2015
26854,318000,28013,A.J. Derby,TE,active,new-england-patriots,346013,2015
26855,332647,0,Brandon King,FS,active,new-england-patriots,332647,2015
26856,318000,13555,Darryl Roberts,CB,active,new-england-patriots,331555,2015
26857,318000,0,Tyler Gaffney,RB,active,new-england-patriots,318000,2015
26858,206470,0,Darius Fleming,OLB,active,new-england-patriots,206470,2015
26859,155294,0,Leonard Johnson,CB,active,new-england-patriots,155294,2015
26860,103235,0,LaAdrian Waddle,RT,active,new-england-patriots,103235,2015
26861,114117,0,Steven Jackson,RB,active,new-england-patriots,114117,2015
26862,51176,0,Chris Harper,WR,active,new-england-patriots,51176,2015
26863,43823,0,Dekoda Watson,OLB,active,new-england-patriots,43823,2015
26864,38823,0,Ishmaa'ily Kitchen,DT,active,new-england-patriots,38823,2015
26865,1500000,7000000,Jerod Mayo,ILB,injured_reserve,new-england-patriots,8500000,2015
26866,1438000,4166666,Nate Solder,LT,injured_reserve,new-england-patriots,5604666,2015
26867,1000000,1400000,Ryan Wendell,C,injured_reserve,new-england-patriots,2400000,2015
26868,1000000,1000000,Tarell Brown,CB,injured_reserve,new-england-patriots,2000000,2015
26869,751980,907918,Dominique Easley,DT,injured_reserve,new-england-patriots,1659898,2015
26870,705882,243750,LeGarrette Blount,RB,injured_reserve,new-england-patriots,949632,2015
26871,716670,218340,Aaron Dobson,WR,injured_reserve,new-england-patriots,935010,2015
26872,585000,200000,Dion Lewis,RB,injured_reserve,new-england-patriots,785000,2015
26873,400588,139733,Trey Flowers,DE,injured_reserve,new-england-patriots,540321,2015
26874,348000,15000,Brian Tyms,WR,injured_reserve,new-england-patriots,363000,2015
26875,137647,0,Eric Martin,ILB,injured_reserve,new-england-patriots,137647,2015
26876,435000,0,Rufus Johnson,OLB,non_fb_injury,new-england-patriots,435000,2015
26877,19800,0,Montee Ball,RB,practice_squad,new-england-patriots,19800,2015
26878,0,5000000,Darrelle Revis,CB,dead_cap,new-england-patriots,5000000,2015
26879,0,4000000,Logan Mankins,G,dead_cap,new-england-patriots,4000000,2015
26880,0,3250000,Kyle Arrington,CB,dead_cap,new-england-patriots,3250000,2015
26881,800000,475000,Bradley Fletcher,CB,dead_cap,new-england-patriots,1275000,2015
26882,0,866668,Vince Wilfork,DT,dead_cap,new-england-patriots,866668,2015
26883,141176,498750,Michael Hoomanawanui,TE,dead_cap,new-england-patriots,639926,2015
26884,0,450000,Reggie Wayne,WR,dead_cap,new-england-patriots,450000,2015
26885,150000,200000,Robert McClain,CB,dead_cap,new-england-patriots,350000,2015
26886,301694,0,Rashaan Melvin,CB,dead_cap,new-england-patriots,301694,2015
26887,0,253500,Josh Boyce,WR,dead_cap,new-england-patriots,253500,2015
26888,116470,82500,Travaris Cadet,RB,dead_cap,new-england-patriots,198970,2015
26889,182600,0,Asante Cleveland,TE,dead_cap,new-england-patriots,182600,2015
26890,177964,0,Khyri Thornton,DT,dead_cap,new-england-patriots,177964,2015
26891,162634,10000,Eric Martin,ILB,dead_cap,new-england-patriots,172634,2015
26892,155964,5000,Chris Harper,WR,dead_cap,new-england-patriots,160964,2015
26893,143222,0,Armond Armstead,DT,dead_cap,new-england-patriots,143222,2015
26894,0,134950,Jake Bequette,DE,dead_cap,new-england-patriots,134950,2015
26895,122400,0,Chris Barker,G,dead_cap,new-england-patriots,122400,2015
26896,39600,75146,Cameron Fleming,T,dead_cap,new-england-patriots,114746,2015
26897,110576,0,Joey Iosefa,FB,dead_cap,new-england-patriots,110576,2015
26898,0,92325,Jon Halapio,G,dead_cap,new-england-patriots,92325,2015
26899,77647,0,Damaris Johnson,WR,dead_cap,new-england-patriots,77647,2015
26900,72600,0,Darius Fleming,OLB,dead_cap,new-england-patriots,72600,2015
26901,0,69384,Jemea Thomas,CB,dead_cap,new-england-patriots,69384,2015
26902,87647,0,Dekoda Watson,OLB,dead_cap,new-england-patriots,87647,2015
26903,66600,0,Dewey McDonald,OLB,dead_cap,new-england-patriots,66600,2015
26904,66000,0,Blaine Clausell,T,dead_cap,new-england-patriots,66000,2015
26905,58764,0,Ryan Groy,G,dead_cap,new-england-patriots,58764,2015
26906,52800,0,Keavon Milton,T,dead_cap,new-england-patriots,52800,2015
26907,52800,0,Torrian Wilson,T,dead_cap,new-england-patriots,52800,2015
26908,52800,0,Austin Hill,WR,dead_cap,new-england-patriots,52800,2015
26909,0,50000,Chimdi Chekwa,CB,dead_cap,new-england-patriots,50000,2015
26910,0,50000,Chris White,ILB,dead_cap,new-england-patriots,50000,2015
26911,46200,0,Brock Vereen,FS,dead_cap,new-england-patriots,46200,2015
26912,44411,0,Leonard Hankerson,WR,dead_cap,new-england-patriots,44411,2015
26913,38823,0,Ishmaa'ily Kitchen,DT,dead_cap,new-england-patriots,38823,2015
26914,0,35973,Matthew Wells,LB,dead_cap,new-england-patriots,35973,2015
26915,0,35694,Jeremy Gallon,WR,dead_cap,new-england-patriots,35694,2015
26916,33000,1000,Brandon King,FS,dead_cap,new-england-patriots,34000,2015
26917,0,26806,Michael Buchanan,DE,dead_cap,new-england-patriots,26806,2015
26918,26400,0,Brandon Dixon,CB,dead_cap,new-england-patriots,26400,2015
26919,25588,0,Troy Hill,CB,dead_cap,new-england-patriots,25588,2015
26920,0,25550,Zach Moore,DE,dead_cap,new-england-patriots,25550,2015
26921,0,25000,Brandon Spikes,ILB,dead_cap,new-england-patriots,25000,2015
26922,0,23796,Steve Beauharnais,ILB,dead_cap,new-england-patriots,23796,2015
26923,19800,834,Kenbrell Thompkins,WR,dead_cap,new-england-patriots,20634,2015
26924,0,20000,Matt Flynn,QB,dead_cap,new-england-patriots,20000,2015
26925,19800,0,Deandre Carter,WR,dead_cap,new-england-patriots,19800,2015
26926,19800,0,Joseph Fauria,TE,dead_cap,new-england-patriots,19800,2015
26927,19800,0,Chris Greenwood,CB,dead_cap,new-england-patriots,19800,2015
26928,19800,0,Kevin Snyder,ILB,dead_cap,new-england-patriots,19800,2015
26929,19800,0,Robert Thomas,DT,dead_cap,new-england-patriots,19800,2015
26930,19800,0,Ross Ventrone,SS,dead_cap,new-england-patriots,19800,2015
26931,0,15000,Devin Gardner,QB,dead_cap,new-england-patriots,15000,2015
26932,0,14462,Alfonzo Dennard,CB,dead_cap,new-england-patriots,14462,2015
26933,13200,0,Nathan Palmer,WR,dead_cap,new-england-patriots,13200,2015
26934,13200,0,Kelcy Quarles,DT,dead_cap,new-england-patriots,13200,2015
26935,13200,0,Floyd Raven,SS,dead_cap,new-england-patriots,13200,2015
26936,13200,0,Alex Singleton,LB,dead_cap,new-england-patriots,13200,2015
26937,13200,0,Jimmy Staten,DT,dead_cap,new-england-patriots,13200,2015
26938,13200,0,Dax Swanson,SS,dead_cap,new-england-patriots,13200,2015
26939,0,13195,Xzavier Dickson,OLB,dead_cap,new-england-patriots,13195,2015
26940,0,10000,Cameron Gordon,OLB,dead_cap,new-england-patriots,10000,2015
26941,0,10000,Jonathan Krause,WR,dead_cap,new-england-patriots,10000,2015
26942,0,10000,Antonio Johnson,DT,dead_cap,new-england-patriots,10000,2015
26943,5000,1666,Jimmy Jean,CB,dead_cap,new-england-patriots,6666,2015
26944,6600,0,Sean Hickey,T,dead_cap,new-england-patriots,6600,2015
26945,6600,0,Joe Vellano,DT,dead_cap,new-england-patriots,6600,2015
26946,6600,0,Brennan Williams,RT,dead_cap,new-england-patriots,6600,2015
26947,0,5000,Stephen Houston,RB,dead_cap,new-england-patriots,5000,2015
26948,0,3334,Roy Finch,RB,dead_cap,new-england-patriots,3334,2015
26949,0,3334,Shamiel Gary,S,dead_cap,new-england-patriots,3334,2015
26950,0,3334,Travis Hawkins,CB,dead_cap,new-england-patriots,3334,2015
26951,0,3334,Justin Jones,TE,dead_cap,new-england-patriots,3334,2015
26952,0,2000,Asa Watson,TE,dead_cap,new-england-patriots,2000,2015
26953,0,1000,Mark Harrison,WR,dead_cap,new-england-patriots,1000,2015
26954,0,833,Vince Taylor,DT,dead_cap,new-england-patriots,833,2015
26955,764705,13000000,Tom Brady,QB,active,new-england-patriots,13764705,2016
26956,6000000,4322666,Nate Solder,LT,active,new-england-patriots,10322666,2016
26957,7751000,0,Dont'a Hightower,OLB,active,new-england-patriots,7751000,2016
26958,4000000,2812500,Jabaal Sheard,OLB,active,new-england-patriots,6812500,2016
26959,3400000,2754168,Marcus Cannon,RT,active,new-england-patriots,6154168,2016
26960,1000000,4500000,Chris Hogan,WR,active,new-england-patriots,5500000,2016
26961,5085000,100000,Martellus Bennett,TE,active,new-england-patriots,5185000,2016
26962,760000,4372500,Devin McCourty,FS,active,new-england-patriots,5132500,2016
26963,2500000,1921875,Julian Edelman,WR,active,new-england-patriots,4421875,2016
26964,2300000,1800000,Stephen Gostkowski,K,active,new-england-patriots,4100000,2016
26965,764705,3250000,Rob Ninkovich,OLB,active,new-england-patriots,4014705,2016
26966,1400000,1787500,Patrick Chung,SS,active,new-england-patriots,3187500,2016
26967,1250000,1635416,Danny Amendola,WR,active,new-england-patriots,2885416,2016
26968,1200000,1550000,Alan Branch,DT,active,new-england-patriots,2750000,2016
26969,1250000,1125000,Chris Long,DE,active,new-england-patriots,2375000,2016
26970,1000000,1233333,Shea McClellin,OLB,active,new-england-patriots,2233333,2016
26971,1000000,1072908,Matthew Slater,WR,active,new-england-patriots,2072908,2016
26972,1661000,150813,Logan Ryan,CB,active,new-england-patriots,1811813,2016
26973,1665000,139400,Duron Harmon,SS,active,new-england-patriots,1804400,2016
26974,781056,949223,Malcom Brown,DT,active,new-england-patriots,1730279,2016
26975,1000000,700000,Ryan Allen,P,active,new-england-patriots,1700000,2016
26976,1291764,0,Michael Floyd,WR,active,new-england-patriots,1291764,2016
26977,760000,512500,Brandon Bolden,RB,active,new-england-patriots,1272500,2016
26978,825000,375000,Nate Ebner,FS,active,new-england-patriots,1200000,2016
26979,800000,287500,Dion Lewis,RB,active,new-england-patriots,1087500,2016
26980,700000,387500,LaAdrian Waddle,RT,active,new-england-patriots,1087500,2016
26981,760000,265000,LeGarrette Blount,RB,active,new-england-patriots,1025000,2016
26982,686718,263436,Jimmy Garoppolo,QB,active,new-england-patriots,950154,2016
26983,603707,239827,Jordan Richards,SS,active,new-england-patriots,843534,2016
26984,675000,75000,James Develin,FB,active,new-england-patriots,750000,2016
26985,450000,278491,Cyrus Jones,CB,active,new-england-patriots,728491,2016
26986,600000,99272,James White,RB,active,new-england-patriots,699272,2016
26987,675000,0,Barkevious Mingo,OLB,active,new-england-patriots,675000,2016
26988,525000,139733,Trey Flowers,DE,active,new-england-patriots,664733,2016
26989,656811,0,Eric Rowe,CB,active,new-england-patriots,656811,2016
26990,450000,193357,Joe Thuney,G,active,new-england-patriots,643357,2016
26991,525000,110881,Shaq Mason,G,active,new-england-patriots,635881,2016
26992,450000,161355,Vincent Valentine,DT,active,new-england-patriots,611355,2016
26993,600000,0,Malcolm Butler,CB,active,new-england-patriots,600000,2016
26994,600000,0,Cameron Fleming,T,active,new-england-patriots,600000,2016
26995,450000,144498,Malcolm Mitchell,WR,active,new-england-patriots,594498,2016
26996,525000,62500,Joe Cardona,LS,active,new-england-patriots,587500,2016
26997,360524,170151,Jacoby Brissett,QB,active,new-england-patriots,530675,2016
26998,525000,5000,David Andrews,C,active,new-england-patriots,530000,2016
26999,525000,0,Justin Coleman,CB,active,new-england-patriots,525000,2016
27000,525000,0,Brandon King,FS,active,new-england-patriots,525000,2016
27001,450000,25089,Ted Karras,G,active,new-england-patriots,475089,2016
27002,450000,25089,Elandon Roberts,ILB,active,new-england-patriots,475089,2016
27003,450000,3333,Jonathan Jones,CB,active,new-england-patriots,453333,2016
27004,446370,0,Kyle Van Noy,ILB,active,new-england-patriots,446370,2016
27005,370588,0,Geno Grissom,DE,active,new-england-patriots,370588,2016
27006,238230,0,Matt Lengel,TE,active,new-england-patriots,238230,2016
27007,132350,0,D.J. Foster,WR,active,new-england-patriots,132350,2016
27008,2250000,6368750,Rob Gronkowski,TE,injured_reserve,new-england-patriots,8618750,2016
27009,740000,1177073,Jonathan Freeny,OLB,injured_reserve,new-england-patriots,1917073,2016
27010,555882,0,Greg Scruggs,DE,injured_reserve,new-england-patriots,555882,2016
27011,0,6800000,Jerod Mayo,ILB,dead_cap,new-england-patriots,6800000,2016
27012,483959,1815836,Dominique Easley,DT,dead_cap,new-england-patriots,2299795,2016
27013,158823,1713955,Jonathan Cooper,G,dead_cap,new-england-patriots,1872778,2016
27014,900000,387500,Clay Harbor,TE,dead_cap,new-england-patriots,1287500,2016
27015,0,1000000,Scott Chandler,TE,dead_cap,new-england-patriots,1000000,2016
27016,0,1000000,Brandon LaFell,WR,dead_cap,new-england-patriots,1000000,2016
27017,431936,278818,Jamie Collins,OLB,dead_cap,new-england-patriots,710754,2016
27018,0,350000,Terrance Knighton,DT,dead_cap,new-england-patriots,350000,2016
27019,332570,0,Woodrow Hamilton,DT,dead_cap,new-england-patriots,332570,2016
27020,317640,0,D.J. Foster,WR,dead_cap,new-england-patriots,317640,2016
27021,220000,80000,Donald Brown,RB,dead_cap,new-england-patriots,300000,2016
27022,0,250000,Josh Kline,G,dead_cap,new-england-patriots,250000,2016
27023,0,218340,Aaron Dobson,WR,dead_cap,new-england-patriots,218340,2016
27024,185294,28013,A.J. Derby,TE,dead_cap,new-england-patriots,213307,2016
27025,50000,155488,Geno Grissom,DE,dead_cap,new-england-patriots,205488,2016
27026,0,200000,Keshawn Martin,WR,dead_cap,new-england-patriots,200000,2016
27027,174410,0,Anthony Johnson,DE,dead_cap,new-england-patriots,174410,2016
27028,170000,0,Chris Barker,G,dead_cap,new-england-patriots,170000,2016
27029,0,150292,Cameron Fleming,T,dead_cap,new-england-patriots,150292,2016
27030,144000,0,Trevor Bates,ILB,dead_cap,new-england-patriots,144000,2016
27031,0,140000,Markus Kuhn,DT,dead_cap,new-england-patriots,140000,2016
27032,117300,21353,Devin Lucien,WR,dead_cap,new-england-patriots,138653,2016
27033,123529,0,Darius Kilgo,DT,dead_cap,new-england-patriots,123529,2016
27034,0,119250,Bryan Stork,C,dead_cap,new-england-patriots,119250,2016
27035,110400,0,DeAndre White,WR,dead_cap,new-england-patriots,110400,2016
27036,108140,0,Tyler Gaffney,RB,dead_cap,new-england-patriots,108140,2016
27037,0,107919,Matthew Wells,LB,dead_cap,new-england-patriots,107919,2016
27038,82800,0,Chase Farris,T,dead_cap,new-england-patriots,82800,2016
27039,82800,0,Glenn Gronkowski,FB,dead_cap,new-england-patriots,82800,2016
27040,0,80000,Nate Washington,WR,dead_cap,new-england-patriots,80000,2016
27041,80000,0,Bishop Sankey,RB,dead_cap,new-england-patriots,80000,2016
27042,75900,0,Jamil Douglas,C,dead_cap,new-england-patriots,75900,2016
27043,62100,0,Trevor Reilly,OLB,dead_cap,new-england-patriots,62100,2016
27044,0,60000,Frank Kearse,DE,dead_cap,new-england-patriots,60000,2016
27045,0,55000,E.J. Biggers,CB,dead_cap,new-england-patriots,55000,2016
27046,0,51100,Zach Moore,DE,dead_cap,new-england-patriots,51100,2016
27047,48300,0,Vinnie Sunseri,SS,dead_cap,new-england-patriots,48300,2016
27048,44705,0,John Hughes,DE,dead_cap,new-england-patriots,44705,2016
27049,39705,0,Griff Whalen,WR,dead_cap,new-england-patriots,39705,2016
27050,0,39585,Xzavier Dickson,OLB,dead_cap,new-england-patriots,39585,2016
27051,0,32500,Travaris Cadet,RB,dead_cap,new-england-patriots,32500,2016
27052,27600,0,Shamiel Gary,S,dead_cap,new-england-patriots,27600,2016
27053,27600,0,Quentin Gause,ILB,dead_cap,new-england-patriots,27600,2016
27054,0,25089,Kamu Grugier-Hill,OLB,dead_cap,new-england-patriots,25089,2016
27055,0,25000,Ramon Humber,OLB,dead_cap,new-england-patriots,25000,2016
27056,20700,0,Ian Silberman,G,dead_cap,new-england-patriots,20700,2016
27057,13800,0,Clay DeBord,T,dead_cap,new-england-patriots,13800,2016
27058,13800,0,Devin Street,WR,dead_cap,new-england-patriots,13800,2016
27059,0,13556,Darryl Roberts,CB,dead_cap,new-england-patriots,13556,2016
27060,7500,3333,V'Angelo Bentley,CB,dead_cap,new-england-patriots,10833,2016
27061,7500,3333,Crevon LeBlanc,CB,dead_cap,new-england-patriots,10833,2016
27062,0,10000,Chris Harper,WR,dead_cap,new-england-patriots,10000,2016
27063,10000,0,C.J. Johnson,DT,dead_cap,new-england-patriots,10000,2016
27064,6900,0,Kennard Backman,TE,dead_cap,new-england-patriots,6900,2016
27065,6900,0,Shaquelle Evans,WR,dead_cap,new-england-patriots,6900,2016
27066,6900,0,Mike Hilton,CB,dead_cap,new-england-patriots,6900,2016
27067,6900,0,Rufus Johnson,OLB,dead_cap,new-england-patriots,6900,2016
27068,6900,0,Austin Traylor,TE,dead_cap,new-england-patriots,6900,2016
27069,0,3334,Jimmy Jean,CB,dead_cap,new-england-patriots,3334,2016
27070,0,2000,Brandon King,FS,dead_cap,new-england-patriots,2000,2016
27071,0,1667,Vince Taylor,DT,dead_cap,new-england-patriots,1667,2016
27072,1000000,13000000,Tom Brady,QB,active,new-england-patriots,14000000,2017
27073,6500000,4666418,Nate Solder,LT,active,new-england-patriots,11166418,2017
27074,6500000,4435000,Devin McCourty,FS,active,new-england-patriots,10935000,2017
27075,4500000,4068750,Stephon Gilmore,CB,active,new-england-patriots,8568750,2017
27076,4000000,4500000,Rob Gronkowski,TE,active,new-england-patriots,8500000,2017
27077,2500000,3700000,Patrick Chung,SS,active,new-england-patriots,6200000,2017
27078,2500000,2437500,Dwayne Allen,TE,active,new-england-patriots,4937500,2017
27079,1700000,2925000,Alan Branch,DT,active,new-england-patriots,4625000,2017
27080,2700000,1800000,Stephen Gostkowski,K,active,new-england-patriots,4500000,2017
27081,1500000,2468750,Mike Gillislee,RB,active,new-england-patriots,3968750,2017
27082,3910000,0,Malcolm Butler,CB,active,new-england-patriots,3910000,2017
27083,1500000,2000000,Duron Harmon,SS,active,new-england-patriots,3500000,2017
27084,1800000,1350000,Rex Burkhead,RB,active,new-england-patriots,3150000,2017
27085,1250000,1791668,Danny Amendola,WR,active,new-england-patriots,3041668,2017
27086,2500000,468750,Chris Hogan,WR,active,new-england-patriots,2968750,2017
27087,1000000,1843750,David Harris,ILB,active,new-england-patriots,2843750,2017
27088,900000,1700000,Lawrence Guy,DE,active,new-england-patriots,2600000,2017
27089,990741,1291666,Kyle Van Noy,ILB,active,new-england-patriots,2282407,2017
27090,1127112,949223,Malcom Brown,DT,active,new-england-patriots,2076335,2017
27091,1200000,700000,Ryan Allen,P,active,new-england-patriots,1900000,2017
27092,1797000,0,Cameron Fleming,T,active,new-england-patriots,1797000,2017
27093,690000,1099272,James White,RB,active,new-england-patriots,1789272,2017
27094,900000,743750,Matthew Slater,WR,active,new-england-patriots,1643750,2017
27095,781599,781599,Brandin Cooks,WR,active,new-england-patriots,1563198,2017
27096,1200000,287500,Dion Lewis,RB,active,new-england-patriots,1487500,2017
27097,800000,575000,James Develin,FB,active,new-england-patriots,1375000,2017
27098,615000,705000,David Andrews,C,active,new-england-patriots,1320000,2017
27099,1300000,0,Johnson Bademosi,CB,active,new-england-patriots,1300000,2017
27100,1174583,0,Phillip Dorsett,WR,active,new-england-patriots,1174583,2017
27101,800000,325000,LaAdrian Waddle,RT,active,new-england-patriots,1125000,2017
27102,772413,239827,Jordan Richards,SS,active,new-england-patriots,1012240,2017
27103,878623,0,Eric Rowe,CB,active,new-england-patriots,878623,2017
27104,540000,228357,Joe Thuney,G,active,new-england-patriots,768357,2017
27105,615000,139733,Trey Flowers,DE,active,new-england-patriots,754733,2017
27106,615000,110881,Shaq Mason,G,active,new-england-patriots,725881,2017
27107,690000,0,Marquis Flowers,OLB,active,new-england-patriots,690000,2017
27108,615000,70000,Joe Cardona,LS,active,new-england-patriots,685000,2017
27109,775000,0,Brandon Bolden,RB,active,new-england-patriots,775000,2017
27110,615000,0,Brandon King,FS,active,new-england-patriots,615000,2017
27111,465000,145140,Deatrich Wise,DE,active,new-england-patriots,610140,2017
27112,540000,25089,Elandon Roberts,ILB,active,new-england-patriots,565089,2017
27113,540000,0,Ted Karras,G,active,new-england-patriots,540000,2017
27114,476471,0,Brian Hoyer,QB,active,new-england-patriots,476471,2017
27115,465000,3333,Jacob Hollister,TE,active,new-england-patriots,468333,2017
27116,465000,2000,Cole Croston,T,active,new-england-patriots,467000,2017
27117,465000,1666,Adam Butler,DT,active,new-england-patriots,466666,2017
27118,180882,0,Geno Grissom,DE,active,new-england-patriots,180882,2017
27119,164118,0,Eric Lee,DE,active,new-england-patriots,164118,2017
27120,158824,0,Kenny Britt,WR,active,new-england-patriots,158824,2017
27121,158824,0,Nicholas Grigsby,ILB,active,new-england-patriots,158824,2017
27122,158824,0,Ricky Jean Francois,DT,active,new-england-patriots,158824,2017
27123,58824,0,James Harrison,OLB,active,new-england-patriots,58824,2017
27124,3000000,4416666,Julian Edelman,WR,injured_reserve,new-england-patriots,7416666,2017
27125,1250000,4085931,Dont'a Hightower,OLB,injured_reserve,new-england-patriots,5335931,2017
27126,1350000,2018750,Marcus Cannon,RT,injured_reserve,new-england-patriots,3368750,2017
27127,1900000,1295833,Shea McClellin,OLB,injured_reserve,new-england-patriots,3195833,2017
27128,825000,375000,Nate Ebner,FS,injured_reserve,new-england-patriots,1200000,2017
27129,632123,278491,Cyrus Jones,CB,injured_reserve,new-england-patriots,910614,2017
27130,476471,262500,Martellus Bennett,TE,injured_reserve,new-england-patriots,738971,2017
27131,383824,176355,Vincent Valentine,DT,injured_reserve,new-england-patriots,560179,2017
27132,348000,200724,Derek Rivers,OLB,injured_reserve,new-england-patriots,548724,2017
27133,540000,3333,Jonathan Jones,CB,injured_reserve,new-england-patriots,543333,2017
27134,363000,144498,Malcolm Mitchell,WR,injured_reserve,new-england-patriots,507498,2017
27135,348000,0,Caleb Kidder,DE,injured_reserve,new-england-patriots,348000,2017
27136,348000,196538,Antonio Garcia,T,non_fb_injury,new-england-patriots,544538,2017
27137,396171,5000,Harvey Langi,ILB,non_fb_injury,new-england-patriots,401171,2017
27138,348000,0,Keionta Davis,DE,non_fb_injury,new-england-patriots,348000,2017
27139,348000,0,Andrew Jelks,T,non_fb_injury,new-england-patriots,348000,2017
27140,7200,0,Bernard Reedy,WR,practice_squad,new-england-patriots,7200,2017
27141,0,1050000,Rob Ninkovich,OLB,dead_cap,new-england-patriots,1050000,2017
27142,45588,673333,Jonathan Freeny,OLB,dead_cap,new-england-patriots,718921,2017
27143,385919,288436,Jimmy Garoppolo,QB,dead_cap,new-england-patriots,674355,2017
27144,347188,300976,Geno Grissom,DE,dead_cap,new-england-patriots,648164,2017
27145,446468,0,Cassius Marsh,OLB,dead_cap,new-england-patriots,446468,2017
27146,339984,0,Trevor Reilly,OLB,dead_cap,new-england-patriots,339984,2017
27147,0,261870,Tre' Jackson,G,dead_cap,new-england-patriots,261870,2017
27148,0,250000,Josh Kline,G,dead_cap,new-england-patriots,250000,2017
27149,0,200000,Clay Harbor,TE,dead_cap,new-england-patriots,200000,2017
27150,0,200000,Keshawn Martin,WR,dead_cap,new-england-patriots,200000,2017
27151,0,195151,Jacoby Brissett,QB,dead_cap,new-england-patriots,195151,2017
27152,158824,0,Ricky Jean Francois,DT,dead_cap,new-england-patriots,158824,2017
27153,132400,3333,Cody Hollister,WR,dead_cap,new-england-patriots,135733,2017
27154,127400,833,David Jones,CB,dead_cap,new-england-patriots,128233,2017
27155,122400,0,James Ferentz,C,dead_cap,new-england-patriots,122400,2017
27156,122400,0,Damarius Travis,CB,dead_cap,new-england-patriots,122400,2017
27157,0,119250,Bryan Stork,C,dead_cap,new-england-patriots,119250,2017
27158,115200,0,Ryan Lewis,CB,dead_cap,new-england-patriots,115200,2017
27159,115200,0,Jomal Wiltz,CB,dead_cap,new-england-patriots,115200,2017
27160,100800,0,Riley McCarron,WR,dead_cap,new-england-patriots,100800,2017
27161,0,100000,Kony Ealy,DE,dead_cap,new-england-patriots,100000,2017
27162,95295,0,Matt Lengel,TE,dead_cap,new-england-patriots,95295,2017
27163,86400,0,Will Tye,TE,dead_cap,new-england-patriots,86400,2017
27164,0,80000,Andrew Hawkins,WR,dead_cap,new-england-patriots,80000,2017
27165,0,80000,Brandon Bolden,RB,dead_cap,new-england-patriots,80000,2017
27166,0,75267,Kamu Grugier-Hill,OLB,dead_cap,new-england-patriots,75267,2017
27167,69106,0,Bernard Reedy,WR,dead_cap,new-england-patriots,69106,2017
27168,0,64059,Devin Lucien,WR,dead_cap,new-england-patriots,64059,2017
27169,57600,0,Angelo Blackson,DE,dead_cap,new-england-patriots,57600,2017
27170,0,56028,A.J. Derby,TE,dead_cap,new-england-patriots,56028,2017
27171,50400,0,Jason King,T,dead_cap,new-england-patriots,50400,2017
27172,42706,3666,D.J. Killings,CB,dead_cap,new-england-patriots,46372,2017
27173,0,33754,Conor McDermott,T,dead_cap,new-england-patriots,33754,2017
27174,28800,0,Mike Purcell,DT,dead_cap,new-england-patriots,28800,2017
27175,0,27112,Darryl Roberts,CB,dead_cap,new-england-patriots,27112,2017
27176,0,25089,Ted Karras,G,dead_cap,new-england-patriots,25089,2017
27177,21600,0,Marcus Hardison,DT,dead_cap,new-england-patriots,21600,2017
27178,14400,0,Demarcus Ayers,WR,dead_cap,new-england-patriots,14400,2017
27179,14400,0,Willie Beavers,T,dead_cap,new-england-patriots,14400,2017
27180,14400,0,Taylor Heinicke,QB,dead_cap,new-england-patriots,14400,2017
27181,14400,0,Jake Kumerow,WR,dead_cap,new-england-patriots,14400,2017
27182,10000,833,Corey Vereen,DT,dead_cap,new-england-patriots,10833,2017
27183,0,9000,James O'Shaughnessy,TE,dead_cap,new-england-patriots,9000,2017
27184,7200,0,Trevor Bates,ILB,dead_cap,new-england-patriots,7200,2017
27185,7200,0,D.J. Foster,WR,dead_cap,new-england-patriots,7200,2017
27186,7200,0,Robert Nelson,CB,dead_cap,new-england-patriots,7200,2017
27187,7200,0,Cole Toner,G,dead_cap,new-england-patriots,7200,2017
27188,0,6667,V'Angelo Bentley,CB,dead_cap,new-england-patriots,6667,2017
27189,0,6667,Crevon LeBlanc,CB,dead_cap,new-england-patriots,6667,2017
27190,2500,333,Jason Thompson,OLB,dead_cap,new-england-patriots,2833,2017
27191,0,2500,Austin Carr,WR,dead_cap,new-england-patriots,2500,2017
27192,1500,333,Josh Augusta,DT,dead_cap,new-england-patriots,1833,2017
27193,4000000,18000000,Tom Brady,QB,active,new-england-patriots,22000000,2018
27194,7500000,4435000,Devin McCourty,FS,active,new-england-patriots,11935000,2018
27195,8000000,4859375,Rob Gronkowski,TE,active,new-england-patriots,12859375,2018
27196,5750000,3945305,Dont'a Hightower,ILB,active,new-england-patriots,9695305,2018
27197,3550000,5337500,Stephon Gilmore,CB,active,new-england-patriots,8887500,2018
27198,4000000,1956250,Marcus Cannon,RT,active,new-england-patriots,5956250,2018
27199,3200000,1800000,Stephen Gostkowski,K,active,new-england-patriots,5000000,2018
27200,1529412,2410949,Julian Edelman,WR,active,new-england-patriots,3940361,2018
27201,1500000,2437500,Adrian Clayborn,DE,active,new-england-patriots,3937500,2018
27202,3380000,500000,Dwayne Allen,TE,active,new-england-patriots,3880000,2018
27203,915000,2885000,Patrick Chung,SS,active,new-england-patriots,3800000,2018
27204,1500000,2250000,Duron Harmon,SS,active,new-england-patriots,3750000,2018
27205,2000000,1666666,Kyle Van Noy,ILB,active,new-england-patriots,3666666,2018
27206,1400000,2266666,Lawrence Guy,DT,active,new-england-patriots,3666666,2018
27207,3000000,500000,Chris Hogan,WR,active,new-england-patriots,3500000,2018
27208,907000,2510882,Shaq Mason,G,active,new-england-patriots,3417882,2018
27209,1600000,1782000,Jason McCourty,CB,active,new-england-patriots,3382000,2018
27210,3000000,250000,Cordarrelle Patterson,WR,active,new-england-patriots,3250000,2018
27211,1000000,2000000,James White,RB,active,new-england-patriots,3000000,2018
27212,1473167,949225,Malcom Brown,DT,active,new-england-patriots,2422392,2018
27213,900000,1500000,David Andrews,C,active,new-england-patriots,2400000,2018
27214,1000000,1250000,Rex Burkhead,RB,active,new-england-patriots,2250000,2018
27215,1200000,975000,Nate Ebner,FS,active,new-england-patriots,2175000,2018
27216,1907000,139733,Trey Flowers,DE,active,new-england-patriots,2046733,2018
27217,2030954,0,Danny Shelton,DT,active,new-england-patriots,2030954,2018
27218,1200000,825000,Matthew Slater,WR,active,new-england-patriots,2025000,2018
27219,1300000,700000,Ryan Allen,P,active,new-england-patriots,2000000,2018
27220,1907000,0,Trenton Brown,RT,active,new-england-patriots,1907000,2018
27221,480000,1270308,Sony Michel,RB,active,new-england-patriots,1750308,2018
27222,800000,950000,LaAdrian Waddle,RT,active,new-england-patriots,1750000,2018
27223,800000,875000,James Develin,FB,active,new-england-patriots,1675000,2018
27224,1094373,300000,Phillip Dorsett,WR,active,new-england-patriots,1394373,2018
27225,775000,434375,Brandon King,FS,active,new-england-patriots,1209375,2018
27226,658824,446875,John Simon,DE,active,new-england-patriots,1105699,2018
27227,915000,0,Brian Hoyer,QB,active,new-england-patriots,915000,2018
27228,480000,382704,Duke Dawson,CB,active,new-england-patriots,862704,2018
27229,705000,155000,Joe Cardona,LS,active,new-england-patriots,860000,2018
27230,630000,228357,Joe Thuney,G,active,new-england-patriots,858357,2018
27231,555000,228724,Derek Rivers,OLB,active,new-england-patriots,783724,2018
27232,555000,145140,Deatrich Wise,DE,active,new-england-patriots,700140,2018
27233,630000,25089,Elandon Roberts,OLB,active,new-england-patriots,655089,2018
27234,630000,3334,Jonathan Jones,CB,active,new-england-patriots,633334,2018
27235,630000,0,Ted Karras,G,active,new-england-patriots,630000,2018
27236,555000,1666,Adam Butler,DT,active,new-england-patriots,556666,2018
27237,480000,18598,Keion Crossen,CB,active,new-england-patriots,498598,2018
27238,480000,3333,J.C. Jackson,CB,active,new-england-patriots,483333,2018
27239,480000,0,Keionta Davis,DE,active,new-england-patriots,480000,2018
27240,333531,0,James Ferentz,C,active,new-england-patriots,333531,2018
27241,371765,0,Albert McClellan,OLB,active,new-england-patriots,371765,2018
27242,261176,0,Obi Melifonwu,S,active,new-england-patriots,261176,2018
27243,376765,0,Ramon Humber,OLB,active,new-england-patriots,376765,2018
27244,74118,0,Ufomba Kamalu,DE,active,new-england-patriots,74118,2018
27245,480000,1600346,Isaiah Wynn,T,injured_reserve,new-england-patriots,2080346,2018
27246,1000000,218750,Jeremy Hill,RB,injured_reserve,new-england-patriots,1218750,2018
27247,1100435,0,Eric Rowe,CB,injured_reserve,new-england-patriots,1100435,2018
27248,790000,0,Brian Schwenke,C,injured_reserve,new-england-patriots,790000,2018
27249,555000,3333,Jacob Hollister,TE,injured_reserve,new-england-patriots,558333,2018
27250,433000,40000,Ulrick John,LT,injured_reserve,new-england-patriots,473000,2018
27251,383647,75988,Ja'whaun Bentley,ILB,injured_reserve,new-england-patriots,459635,2018
27252,363000,45373,Christian Sam,ILB,injured_reserve,new-england-patriots,408373,2018
27253,363000,29602,Braxton Berrios,WR,injured_reserve,new-england-patriots,392602,2018
27254,363000,17267,Ryan Izzo,TE,injured_reserve,new-england-patriots,380267,2018
27255,121600,0,Riley McCarron,WR,injured_reserve,new-england-patriots,121600,2018
27256,363000,1666,Darren Andrews,WR,non_fb_injury,new-england-patriots,364666,2018
27257,363000,0,Cody Hollister,WR,non_fb_injury,new-england-patriots,363000,2018
27258,1075000,833334,Shea McClellin,OLB,dead_cap,new-england-patriots,1908334,2018
27259,0,1000000,Alan Branch,DT,dead_cap,new-england-patriots,1000000,2018
27260,0,625000,David Harris,ILB,dead_cap,new-england-patriots,625000,2018
27261,0,589614,Antonio Garcia,T,dead_cap,new-england-patriots,589614,2018
27262,0,433334,Jonathan Freeny,OLB,dead_cap,new-england-patriots,433334,2018
27263,414706,15000,Geno Grissom,DE,dead_cap,new-england-patriots,429706,2018
27264,143647,278491,Cyrus Jones,CB,dead_cap,new-england-patriots,422138,2018
27265,252000,144498,Malcolm Mitchell,WR,dead_cap,new-england-patriots,396498,2018
27266,370590,15000,Nicholas Grigsby,ILB,dead_cap,new-england-patriots,385590,2018
27267,346988,2000,Cole Croston,T,dead_cap,new-england-patriots,348988,2018
27268,0,340302,Jacoby Brissett,QB,dead_cap,new-england-patriots,340302,2018
27269,333528,0,Kenjon Barner,RB,dead_cap,new-england-patriots,333528,2018
27270,90000,210000,Jordan Matthews,WR,dead_cap,new-england-patriots,300000,2018
27271,300000,0,Eric Smith,T,dead_cap,new-england-patriots,300000,2018
27272,0,250000,Marquis Flowers,OLB,dead_cap,new-england-patriots,250000,2018
27273,100000,150000,Troy Niklas,TE,dead_cap,new-england-patriots,250000,2018
27274,0,239827,Jordan Richards,SS,dead_cap,new-england-patriots,239827,2018
27275,38000,176355,Vincent Valentine,DT,dead_cap,new-england-patriots,214355,2018
27276,110000,90000,Brandon Bolden,RB,dead_cap,new-england-patriots,200000,2018
27277,150000,50000,Kenny Britt,WR,dead_cap,new-england-patriots,200000,2018
27278,139412,25000,Matt Tobin,G,dead_cap,new-england-patriots,164412,2018
27279,129200,26006,Danny Etling,QB,dead_cap,new-england-patriots,155206,2018
27280,149835,0,Riley McCarron,WR,dead_cap,new-england-patriots,149835,2018
27281,129200,0,Stephen Anderson,TE,dead_cap,new-england-patriots,129200,2018
27282,129200,0,Trent Harris,DT,dead_cap,new-england-patriots,129200,2018
27283,129200,0,Jomal Wiltz,CB,dead_cap,new-england-patriots,129200,2018
27284,0,101264,Conor McDermott,T,dead_cap,new-england-patriots,101264,2018
27285,88000,6666,Ralph Webb,RB,dead_cap,new-england-patriots,94666,2018
27286,91200,0,Frank Herron,DT,dead_cap,new-england-patriots,91200,2018
27287,91200,0,Calvin Munson,ILB,dead_cap,new-england-patriots,91200,2018
27288,0,75000,Eric Decker,WR,dead_cap,new-england-patriots,75000,2018
27289,60800,0,James Ferentz,C,dead_cap,new-england-patriots,60800,2018
27290,60800,0,Damoun Patterson,WR,dead_cap,new-england-patriots,60800,2018
27291,0,50178,Ted Karras,G,dead_cap,new-england-patriots,50178,2018
27292,45600,1667,David Jones,CB,dead_cap,new-england-patriots,47267,2018
27293,45600,0,Ufomba Kamalu,DE,dead_cap,new-england-patriots,45600,2018
27294,0,45000,Luke Bowanko,C,dead_cap,new-england-patriots,45000,2018
27295,44659,0,Corey Coleman,WR,dead_cap,new-england-patriots,44659,2018
27296,38000,0,Kenneth Farrow,RB,dead_cap,new-england-patriots,38000,2018
27297,32647,0,Chad Hansen,WR,dead_cap,new-england-patriots,32647,2018
27298,22800,0,Jace Billingsley,WR,dead_cap,new-england-patriots,22800,2018
27299,15200,0,Tony Adams,T,dead_cap,new-england-patriots,15200,2018
27300,0,15000,Eric Lee,DE,dead_cap,new-england-patriots,15000,2018
27301,7600,0,Toby Weathersby,T,dead_cap,new-england-patriots,7600,2018
27302,0,7334,D.J. Killings,CB,dead_cap,new-england-patriots,7334,2018
27303,0,6667,Cody Hollister,WR,dead_cap,new-england-patriots,6667,2018
27304,0,5000,Austin Carr,WR,dead_cap,new-england-patriots,5000,2018
27305,0,5000,Harvey Langi,ILB,dead_cap,new-england-patriots,5000,2018
27306,0,1667,Corey Vereen,DT,dead_cap,new-england-patriots,1667,2018
27307,0,1000,Jason King,G,dead_cap,new-england-patriots,1000,2018
27308,0,667,Josh Augusta,DT,dead_cap,new-england-patriots,667,2018
27309,0,667,Jason Thompson,OLB,dead_cap,new-england-patriots,667,2018
27310,1750000,19750000,Tom Brady,QB,active,new-england-patriots,21500000,2019
27311,9000000,4435000,Devin McCourty,FS,active,new-england-patriots,13435000,2019
27312,7000000,4445305,Dont'a Hightower,ILB,active,new-england-patriots,11445305,2019
27313,1000000,8170833,Stephon Gilmore,CB,active,new-england-patriots,9170833,2019
27314,1000000,6202616,Julian Edelman,WR,active,new-england-patriots,7202616,2019
27315,4250000,2010418,Kyle Van Noy,ILB,active,new-england-patriots,6260418,2019
27316,2250000,3687500,Shaq Mason,G,active,new-england-patriots,5937500,2019
27317,1000000,4122917,Marcus Cannon,RT,active,new-england-patriots,5122917,2019
27318,2500000,2250000,Duron Harmon,SS,active,new-england-patriots,4750000,2019
27319,2500000,2093750,James White,RB,active,new-england-patriots,4593750,2019
27320,2400000,2066666,Lawrence Guy,DT,active,new-england-patriots,4466666,2019
27321,1100000,3242708,Patrick Chung,SS,active,new-england-patriots,4342708,2019
27322,2000000,2137500,Jason McCourty,CB,active,new-england-patriots,4137500,2019
27323,3529412,250000,Mohamed Sanu,WR,active,new-england-patriots,3779412,2019
27324,1750000,1406250,Rex Burkhead,RB,active,new-england-patriots,3156250,2019
27325,1600000,1400000,Matthew Slater,WR,active,new-england-patriots,3000000,2019
27326,900000,2100000,Jamie Collins,OLB,active,new-england-patriots,3000000,2019
27327,2000000,818750,Nate Ebner,FS,active,new-england-patriots,2818750,2019
27328,720000,2018750,Jonathan Jones,CB,active,new-england-patriots,2738750,2019
27329,1000087,1600346,Isaiah Wynn,LT,active,new-england-patriots,2600433,2019
27330,1500000,1037500,Phillip Dorsett,WR,active,new-england-patriots,2537500,2019
27331,1995000,223357,Joe Thuney,G,active,new-england-patriots,2218357,2019
27332,917577,1270308,Sony Michel,RB,active,new-england-patriots,2187885,2019
27333,2025000,25089,Elandon Roberts,ILB,active,new-england-patriots,2050089,2019
27334,495000,1341063,N'Keal Harry,WR,active,new-england-patriots,1836063,2019
27335,900000,850000,John Simon,DE,active,new-england-patriots,1750000,2019
27336,1000000,687500,Brandon Bolden,RB,active,new-england-patriots,1687500,2019
27337,805000,626250,Terrence Brooks,FS,active,new-england-patriots,1431250,2019
27338,700000,150000,Matt LaCosse,TE,active,new-england-patriots,850000,2019
27339,495000,707141,Joejuan Williams,CB,active,new-england-patriots,1202141,2019
27340,805000,225000,Danny Shelton,DT,active,new-england-patriots,1030000,2019
27341,805000,150000,Joe Cardona,LS,active,new-england-patriots,955000,2019
27342,800000,140000,Benjamin Watson,TE,active,new-england-patriots,940000,2019
27343,645000,145140,Deatrich Wise,DE,active,new-england-patriots,790140,2019
27344,495000,249328,Chase Winovich,DE,active,new-england-patriots,744328,2019
27345,720000,0,Shilique Calhoun,OLB,active,new-england-patriots,720000,2019
27346,720000,0,James Ferentz,C,active,new-england-patriots,720000,2019
27347,720000,0,Ted Karras,C,active,new-england-patriots,720000,2019
27348,495000,221534,Damien Harris,RB,active,new-england-patriots,716534,2019
27349,495000,158423,Jarrett Stidham,QB,active,new-england-patriots,653423,2019
27350,645000,1668,Adam Butler,DT,active,new-england-patriots,646668,2019
27351,570000,75988,Ja'whaun Bentley,ILB,active,new-england-patriots,645988,2019
27352,645000,0,Jermaine Eluemunor,G,active,new-england-patriots,645000,2019
27353,875294,0,Marshall Newhouse,RT,active,new-england-patriots,875294,2019
27354,570000,3333,J.C. Jackson,CB,active,new-england-patriots,573333,2019
27355,570000,0,Korey Cunningham,T,active,new-england-patriots,570000,2019
27356,495000,74861,Byron Cowart,DT,active,new-england-patriots,569861,2019
27357,495000,72245,Jake Bailey,P,active,new-england-patriots,567245,2019
27358,547059,0,Justin Bethel,CB,active,new-england-patriots,547059,2019
27359,495000,17267,Ryan Izzo,TE,active,new-england-patriots,512267,2019
27360,495000,3333,Jakobi Meyers,WR,active,new-england-patriots,498333,2019
27361,381176,0,Cody Kessler,QB,active,new-england-patriots,381176,2019
27362,242353,0,Nick Folk,K,active,new-england-patriots,242353,2019
27363,2000000,1100000,David Andrews,C,injured_reserve,new-england-patriots,3100000,2019
27364,1100000,1387500,Stephen Gostkowski,K,injured_reserve,new-england-patriots,2487500,2019
27365,925000,466667,Brandon King,FS,injured_reserve,new-england-patriots,1391667,2019
27366,1000000,275000,James Develin,FB,injured_reserve,new-england-patriots,1275000,2019
27367,645000,235724,Derek Rivers,OLB,injured_reserve,new-england-patriots,880724,2019
27368,378000,180153,Hjalte Froholdt,G,injured_reserve,new-england-patriots,558153,2019
27369,453706,833,Gunner Olszewski,WR,injured_reserve,new-england-patriots,454539,2019
27370,393000,0,Keionta Davis,DE,injured_reserve,new-england-patriots,393000,2019
27371,378000,3333,Malik Gant,S,injured_reserve,new-england-patriots,381333,2019
27372,378000,833,D'Angelo Ross,CB,injured_reserve,new-england-patriots,378833,2019
27373,361059,0,Jakob Johnson,FB,injured_reserve,new-england-patriots,361059,2019
27374,342059,205545,Yodny Cajuste,T,non_fb_injury,new-england-patriots,547604,2019
27375,24000,0,Eric Lee,DE,practice_squad,new-england-patriots,24000,2019
27376,1025000,4725000,Antonio Brown,WR,dead_cap,new-england-patriots,5750000,2019
27377,1058824,2562500,Michael Bennett,DE,dead_cap,new-england-patriots,3621324,2019
27378,0,2000000,Adrian Clayborn,DE,dead_cap,new-england-patriots,2000000,2019
27379,0,4000000,Rob Gronkowski,TE,dead_cap,new-england-patriots,4000000,2019
27380,1494485,300000,Demaryius Thomas,WR,dead_cap,new-england-patriots,1794485,2019
27381,1510000,200000,Brian Hoyer,QB,dead_cap,new-england-patriots,1710000,2019
27382,500000,750000,Jared Veldheer,RT,dead_cap,new-england-patriots,1250000,2019
27383,952941,0,Josh Gordon,WR,dead_cap,new-england-patriots,952941,2019
27384,729247,32812,Obi Melifonwu,S,dead_cap,new-england-patriots,762059,2019
27385,170588,458824,Benjamin Watson,TE,dead_cap,new-england-patriots,629412,2019
27386,0,400000,Dontrelle Inman,WR,dead_cap,new-england-patriots,400000,2019
27387,0,382704,Duke Dawson,CB,dead_cap,new-england-patriots,382704,2019
27388,94000,262500,Caleb Benenoch,RT,dead_cap,new-england-patriots,356500,2019
27389,0,350000,Mike Pennel,DE,dead_cap,new-england-patriots,350000,2019
27390,0,278491,Cyrus Jones,CB,dead_cap,new-england-patriots,278491,2019
27391,272000,0,Najee Toran,T,dead_cap,new-england-patriots,272000,2019
27392,211000,3333,Terez Hall,LB,dead_cap,new-england-patriots,214333,2019
27393,79059,130000,Maurice Harris,WR,dead_cap,new-england-patriots,209059,2019
27394,187500,0,Calvin Munson,ILB,dead_cap,new-england-patriots,187500,2019
27395,0,161355,Vincent Valentine,DT,dead_cap,new-england-patriots,161355,2019
27396,242353,0,Mike Nugent,K,dead_cap,new-england-patriots,242353,2019
27397,146824,0,Cameron Meredith,WR,dead_cap,new-england-patriots,146824,2019
27398,0,144498,Malcolm Mitchell,WR,dead_cap,new-england-patriots,144498,2019
27399,142059,0,Jordan Richards,SS,dead_cap,new-england-patriots,142059,2019
27400,136000,0,Nick Thurman,DE,dead_cap,new-england-patriots,136000,2019
27401,242353,0,Nick Folk,K,dead_cap,new-england-patriots,242353,2019
27402,127059,0,Cody Kessler,QB,dead_cap,new-england-patriots,127059,2019
27403,116000,3333,Tyler Gauthier,C,dead_cap,new-england-patriots,119333,2019
27404,104000,0,Nate Brooks,CB,dead_cap,new-england-patriots,104000,2019
27405,0,100000,Ryan Allen,P,dead_cap,new-england-patriots,100000,2019
27406,88000,0,Devin Ross,WR,dead_cap,new-england-patriots,88000,2019
27407,84706,0,Eric Tomlinson,TE,dead_cap,new-england-patriots,84706,2019
27408,0,78021,Danny Etling,QB,dead_cap,new-england-patriots,78021,2019
27409,70000,0,Ufomba Kamalu,DE,dead_cap,new-england-patriots,70000,2019
27410,60000,3333,Ryan Davis,WR,dead_cap,new-england-patriots,63333,2019
27411,48000,10000,Dan Skipper,T,dead_cap,new-england-patriots,58000,2019
27412,0,50000,Austin Seferian-Jenkins,TE,dead_cap,new-england-patriots,50000,2019
27413,48000,0,Quincy Adeboyejo,WR,dead_cap,new-england-patriots,48000,2019
27414,48000,0,Tashawn Bower,DE,dead_cap,new-england-patriots,48000,2019
27415,0,47059,Lance Kendricks,TE,dead_cap,new-england-patriots,47059,2019
27416,0,45374,Christian Sam,ILB,dead_cap,new-england-patriots,45374,2019
27417,36000,0,Gerri Green,DE,dead_cap,new-england-patriots,36000,2019
27418,54706,0,Kai Forbath,K,dead_cap,new-england-patriots,54706,2019
27419,30000,2500,Nick Brossette,RB,dead_cap,new-england-patriots,32500,2019
27420,25000,5000,Calvin Anderson,T,dead_cap,new-england-patriots,30000,2019
27421,0,29602,Braxton Berrios,WR,dead_cap,new-england-patriots,29602,2019
27422,0,25000,Bruce Ellington,WR,dead_cap,new-england-patriots,25000,2019
27423,24000,0,Adarius Pickett,S,dead_cap,new-england-patriots,24000,2019
27424,24000,0,Jason Vander Laan,TE,dead_cap,new-england-patriots,24000,2019
27425,20000,2500,Tyree St. Louis,T,dead_cap,new-england-patriots,22500,2019
27426,0,20000,David Parry,DT,dead_cap,new-england-patriots,20000,2019
27427,0,18644,Ken Webster,CB,dead_cap,new-england-patriots,18644,2019
27428,0,18598,Keion Crossen,CB,dead_cap,new-england-patriots,18598,2019
27429,17500,0,Stephen Anderson,TE,dead_cap,new-england-patriots,17500,2019
27430,16000,0,Jakob Johnson,FB,dead_cap,new-england-patriots,16000,2019
27431,16000,0,Younghoe Koo,K,dead_cap,new-england-patriots,16000,2019
27432,16000,0,Scooby Wright,ILB,dead_cap,new-england-patriots,16000,2019
27433,0,13334,Ralph Webb,RB,dead_cap,new-england-patriots,13334,2019
27434,0,10000,A.J. Howard,S,dead_cap,new-england-patriots,10000,2019
27435,0,10000,James Ferentz,C,dead_cap,new-england-patriots,10000,2019
27436,8000,0,Colby Gossett,G,dead_cap,new-england-patriots,8000,2019
27437,8000,0,Aaron Monteiro,T,dead_cap,new-england-patriots,8000,2019
27438,0,5000,Andrew Beck,TE,dead_cap,new-england-patriots,5000,2019
27439,0,5000,Cedrick Lang,T,dead_cap,new-england-patriots,5000,2019
27440,0,5000,Harvey Langi,ILB,dead_cap,new-england-patriots,5000,2019
27441,0,3334,Darren Andrews,WR,dead_cap,new-england-patriots,3334,2019
27442,0,3334,Jacob Hollister,TE,dead_cap,new-england-patriots,3334,2019
27443,0,2000,Cole Croston,T,dead_cap,new-england-patriots,2000,2019
27444,10500000,8170833,Stephon Gilmore,CB,active,new-england-patriots,18670833,2020
27445,30000000,6750000,Tom Brady,QB,active,new-england-patriots,36750000,2020
27446,8000000,3320305,Dont'a Hightower,OLB,active,new-england-patriots,11320305,2020
27447,5700000,3216667,Marcus Cannon,RT,active,new-england-patriots,8916667,2020
27448,5000000,3687500,Shaq Mason,G,active,new-england-patriots,8687500,2020
27449,3300000,3866667,Julian Edelman,WR,active,new-england-patriots,7166667,2020
27450,6500000,0,Mohamed Sanu,WR,active,new-england-patriots,6500000,2020
27451,3200000,2818750,Jonathan Jones,CB,active,new-england-patriots,6018750,2020
27452,2900000,2936844,Patrick Chung,SS,active,new-england-patriots,5836844,2020
27453,2650000,2900000,Jason McCourty,CB,active,new-england-patriots,5550000,2020
27454,3500000,2000000,Duron Harmon,SS,active,new-england-patriots,5500000,2020
27455,2900000,2066668,Lawrence Guy,DT,active,new-england-patriots,4966668,2020
27456,3500000,1387500,Stephen Gostkowski,K,active,new-england-patriots,4887500,2020
27457,3000000,1593750,James White,RB,active,new-england-patriots,4593750,2020
27458,2500000,1406250,Rex Burkhead,RB,active,new-england-patriots,3906250,2020
27459,3000000,400000,David Andrews,C,active,new-england-patriots,3400000,2020
27460,1520173,1600346,Isaiah Wynn,LT,active,new-england-patriots,3120519,2020
27461,1355154,1270308,Sony Michel,RB,active,new-england-patriots,2625462,2020
27462,1500000,850000,John Simon,DE,active,new-england-patriots,2350000,2020
27463,954016,1341063,N'Keal Harry,WR,active,new-england-patriots,2295079,2020
27464,1000000,987500,Brandon Bolden,RB,active,new-england-patriots,1987500,2020
27465,850000,925000,Terrence Brooks,FS,active,new-england-patriots,1775000,2020
27466,1000000,150000,Matt LaCosse,TE,active,new-england-patriots,1150000,2020
27467,795535,707141,Joejuan Williams,CB,active,new-england-patriots,1502676,2020
27468,1200000,275000,James Develin,FB,active,new-england-patriots,1475000,2020
27469,1200000,266666,Brandon King,FS,active,new-england-patriots,1466666,2020
27470,820000,170000,Joe Cardona,LS,active,new-england-patriots,990000,2020
27471,735000,239724,Derek Rivers,OLB,active,new-england-patriots,974724,2020
27472,681000,249328,Chase Winovich,DE,active,new-england-patriots,930328,2020
27473,735000,145140,Deatrich Wise,DE,active,new-england-patriots,880140,2020
27474,658000,221534,Damien Harris,RB,active,new-england-patriots,879534,2020
27475,635000,205545,Yodny Cajuste,T,active,new-england-patriots,840545,2020
27476,820000,0,Cody Kessler,QB,active,new-england-patriots,820000,2020
27477,585000,158423,Jarrett Stidham,QB,active,new-england-patriots,743423,2020
27478,660000,75988,Ja'whaun Bentley,ILB,active,new-england-patriots,735988,2020
27479,510000,180153,Hjalte Froholdt,G,active,new-england-patriots,690153,2020
27480,660000,17267,Ryan Izzo,TE,active,new-england-patriots,677267,2020
27481,660000,3334,J.C. Jackson,CB,active,new-england-patriots,663334,2020
27482,660000,0,Korey Cunningham,T,active,new-england-patriots,660000,2020
27483,585000,74861,Byron Cowart,DT,active,new-england-patriots,659861,2020
27484,585000,72245,Jake Bailey,P,active,new-england-patriots,657245,2020
27485,585000,3333,Jakobi Meyers,WR,active,new-england-patriots,588333,2020
27486,585000,833,Gunner Olszewski,WR,active,new-england-patriots,585833,2020
27487,585000,833,D'Angelo Ross,CB,active,new-england-patriots,585833,2020
27488,585000,0,Jakob Johnson,FB,active,new-england-patriots,585000,2020
27489,510000,3333,Malik Gant,S,active,new-england-patriots,513333,2020
27490,0,0,Quincy Adeboyejo,WR,active,new-england-patriots,0,2020
27491,0,0,Tashawn Bower,DE,active,new-england-patriots,0,2020
27492,0,0,Terez Hall,LB,active,new-england-patriots,0,2020
27493,0,0,Obi Melifonwu,S,active,new-england-patriots,0,2020
27494,0,0,Adarius Pickett,S,active,new-england-patriots,0,2020
27495,0,0,Devin Ross,WR,active,new-england-patriots,0,2020
27496,0,0,Nick Thurman,DE,active,new-england-patriots,0,2020
27497,0,0,Najee Toran,T,active,new-england-patriots,0,2020
27498,0,4500000,Antonio Brown,WR,dead_cap,new-england-patriots,4500000,2020
27499,0,2000000,Michael Bennett,DE,dead_cap,new-england-patriots,2000000,2020
27500,0,765408,Duke Dawson,CB,dead_cap,new-england-patriots,765408,2020
27501,0,250000,Mike Pennel,DE,dead_cap,new-england-patriots,250000,2020
27502,0,90748,Christian Sam,ILB,dead_cap,new-england-patriots,90748,2020
27503,0,59204,Braxton Berrios,WR,dead_cap,new-england-patriots,59204,2020
27504,0,55932,Ken Webster,CB,dead_cap,new-england-patriots,55932,2020
27505,0,37196,Keion Crossen,CB,dead_cap,new-england-patriots,37196,2020
27506,0,10000,Andrew Beck,TE,dead_cap,new-england-patriots,10000,2020
27507,0,6667,Ryan Davis,WR,dead_cap,new-england-patriots,6667,2020
27508,0,6667,Tyler Gauthier,C,dead_cap,new-england-patriots,6667,2020
27509,0,6667,Terez Hall,LB,dead_cap,new-england-patriots,6667,2020
27510,0,5000,Nick Brossette,RB,dead_cap,new-england-patriots,5000,2020
27511,0,5000,Tyree St. Louis,T,dead_cap,new-england-patriots,5000,2020
27512,2800000,6600000,Drew Brees,QB,active,new-orleans-saints,9400000,2007
27513,875000,5300000,Reggie Bush,RB,active,new-orleans-saints,6175000,2007
27514,3000000,733332,Jeff Faine,C,active,new-orleans-saints,3733332,2007
27515,2000000,1205000,Hollis Thomas,DT,active,new-orleans-saints,3205000,2007
27516,2000000,1000000,Scott Fujita,LB,active,new-orleans-saints,3000000,2007
27517,900000,2000000,Jon Stinchcomb,T,active,new-orleans-saints,2900000,2007
27518,435000,2780000,Jammal Brown,T,active,new-orleans-saints,3215000,2007
27519,720000,1080000,Brian Simmons,ILB,active,new-orleans-saints,1800000,2007
27520,1500000,250000,Olindo Mare,K,active,new-orleans-saints,1750000,2007
27521,695000,1690000,Will Smith,OLB,active,new-orleans-saints,2385000,2007
27522,700000,1000000,Scott Shanle,LB,active,new-orleans-saints,1700000,2007
27523,1300000,350000,Jonathan Goodwin,C,active,new-orleans-saints,1650000,2007
27524,1250000,187500,Aaron Stecker,RB,active,new-orleans-saints,1437500,2007
27525,1250000,83333,Kendrick Clancy,DT,active,new-orleans-saints,1333333,2007
27526,600000,350000,Terrance Copper,WR,active,new-orleans-saints,950000,2007
27527,285000,705000,Robert Meachem,WR,active,new-orleans-saints,990000,2007
27528,510000,258750,Devery Henderson,WR,active,new-orleans-saints,768750,2007
27529,385000,150000,Josh Bullocks,S,active,new-orleans-saints,535000,2007
27530,720000,50000,Kevin Houser,LS,active,new-orleans-saints,770000,2007
27531,360000,460000,Roman Harper,SS,active,new-orleans-saints,820000,2007
27532,435000,174000,Alfred Fincher,LB,active,new-orleans-saints,609000,2007
27533,285000,207000,Usama Young,S,active,new-orleans-saints,492000,2007
27534,360000,115433,Jahri Evans,G,active,new-orleans-saints,475433,2007
27535,285000,163000,Andy Alleman,C,active,new-orleans-saints,448000,2007
27536,720000,40000,Billy Miller,TE,active,new-orleans-saints,760000,2007
27537,435000,0,Lance Moore,WR,active,new-orleans-saints,435000,2007
27538,285000,103620,Jermon Bushrod,G,active,new-orleans-saints,388620,2007
27539,360000,15310,Zach Strief,RT,active,new-orleans-saints,375310,2007
27540,360000,8200,Marques Colston,WR,active,new-orleans-saints,368200,2007
27541,360000,0,Orien Harris,DT,active,new-orleans-saints,360000,2007
27542,360000,0,Steve Weatherford,P,active,new-orleans-saints,360000,2007
27543,285000,1667,Pierre Thomas,RB,active,new-orleans-saints,286667,2007
27544,217941,0,Marvin Mitchell,OLB,active,new-orleans-saints,217941,2007
27545,2600000,1400000,Deuce McAllister,RB,injured_reserve,new-orleans-saints,4000000,2007
27546,79900,0,Marvin Mitchell,OLB,practice_squad,new-orleans-saints,79900,2007
27547,0,7171426,Johnathan Sullivan,DT,dead_cap,new-orleans-saints,7171426,2007
27548,0,4200000,Joe Horn,WR,dead_cap,new-orleans-saints,4200000,2007
27549,0,1190000,Donte Stallworth,WR,dead_cap,new-orleans-saints,1190000,2007
27550,118390,0,Antonio Pittman,RB,dead_cap,new-orleans-saints,118390,2007
27551,106000,0,Chase Lyman,WR,dead_cap,new-orleans-saints,106000,2007
27552,90000,0,Mitch Berger,P,dead_cap,new-orleans-saints,90000,2007
27553,64407,0,Mike Hass,WR,dead_cap,new-orleans-saints,64407,2007
27554,56000,0,Josh Lay,CB,dead_cap,new-orleans-saints,56000,2007
27555,51150,0,Jeremy Mincey,DE,dead_cap,new-orleans-saints,51150,2007
27556,48093,0,Rob Ninkovich,OLB,dead_cap,new-orleans-saints,48093,2007
27557,41918,0,Adrian McPherson,QB,dead_cap,new-orleans-saints,41918,2007
27558,14100,0,Marvin Mitchell,OLB,dead_cap,new-orleans-saints,14100,2007
27559,5000,0,Steve Weatherford,P,dead_cap,new-orleans-saints,5000,2007
27560,4800000,6600000,Drew Brees,QB,active,new-orleans-saints,11400000,2008
27561,4097500,3015000,Jonathan Vilma,ILB,active,new-orleans-saints,7112500,2008
27562,1550000,6000000,Reggie Bush,RB,active,new-orleans-saints,7550000,2008
27563,2000000,1400000,Deuce McAllister,RB,active,new-orleans-saints,3400000,2008
27564,1650000,2000000,Jon Stinchcomb,T,active,new-orleans-saints,3650000,2008
27565,1925000,3500000,Jeremy Shockey,TE,active,new-orleans-saints,5425000,2008
27566,700000,3690000,Will Smith,OLB,active,new-orleans-saints,4390000,2008
27567,650000,600000,Bobby McCray,DE,active,new-orleans-saints,1250000,2008
27568,500000,2639450,Marques Colston,WR,active,new-orleans-saints,3139450,2008
27569,2000000,1000000,Scott Fujita,LB,active,new-orleans-saints,3000000,2008
27570,1500000,1000000,Scott Shanle,LB,active,new-orleans-saints,2500000,2008
27571,295000,1941000,Sedrick Ellis,DT,active,new-orleans-saints,2236000,2008
27572,752500,2780000,Jammal Brown,T,active,new-orleans-saints,3532500,2008
27573,950000,950000,Devery Henderson,WR,active,new-orleans-saints,1900000,2008
27574,1600000,233333,Kendrick Clancy,DT,active,new-orleans-saints,1833333,2008
27575,650000,983333,Jonathan Goodwin,C,active,new-orleans-saints,1633333,2008
27576,370000,1345000,Robert Meachem,WR,active,new-orleans-saints,1715000,2008
27577,750000,300000,Terrance Copper,WR,active,new-orleans-saints,1050000,2008
27578,730000,0,Billy Miller,TE,active,new-orleans-saints,730000,2008
27579,460000,150000,Josh Bullocks,S,active,new-orleans-saints,610000,2008
27580,445000,510000,Roman Harper,SS,active,new-orleans-saints,955000,2008
27581,730000,50000,Kevin Houser,LS,active,new-orleans-saints,780000,2008
27582,295000,355000,Tracy Porter,CB,active,new-orleans-saints,650000,2008
27583,605000,40000,Joey Harrington,QB,active,new-orleans-saints,645000,2008
27584,370000,207000,Usama Young,S,active,new-orleans-saints,577000,2008
27585,445000,115433,Jahri Evans,G,active,new-orleans-saints,560433,2008
27586,520000,0,Lance Moore,WR,active,new-orleans-saints,520000,2008
27587,370000,103620,Jermon Bushrod,G,active,new-orleans-saints,473620,2008
27588,445000,15310,Zach Strief,RT,active,new-orleans-saints,460310,2008
27589,730000,30000,Matt Lehr,C,active,new-orleans-saints,760000,2008
27590,445000,0,Courtney Roby,WR,active,new-orleans-saints,445000,2008
27591,370000,1667,Pierre Thomas,RB,active,new-orleans-saints,371667,2008
27592,370000,0,Remi Ayodele,DT,active,new-orleans-saints,370000,2008
27593,370000,0,Tory Humphrey,TE,active,new-orleans-saints,370000,2008
27594,370000,0,Marvin Mitchell,OLB,active,new-orleans-saints,370000,2008
27595,295000,46333,DeMario Pressley,DT,active,new-orleans-saints,341333,2008
27596,295000,39250,Carl Nicks,G,active,new-orleans-saints,334250,2008
27597,200000,111250,Adrian Arrington,WR,active,new-orleans-saints,311250,2008
27598,295000,1667,JoLonn Dunbar,OLB,active,new-orleans-saints,296667,2008
27599,156176,0,Garret Hartley,K,active,new-orleans-saints,156176,2008
27600,875000,1205000,Hollis Thomas,DT,injured_reserve,new-orleans-saints,2080000,2008
27601,1050000,250000,Aaron Stecker,RB,injured_reserve,new-orleans-saints,1300000,2008
27602,102000,0,Pago Togafu,LB,practice_squad,new-orleans-saints,102000,2008
27603,0,2000000,Brian Simmons,ILB,dead_cap,new-orleans-saints,2000000,2008
27604,0,1910000,Hollis Thomas,DT,dead_cap,new-orleans-saints,1910000,2008
27605,236780,0,Antonio Pittman,RB,dead_cap,new-orleans-saints,236780,2008
27606,163000,0,Andy Alleman,C,dead_cap,new-orleans-saints,163000,2008
27607,48093,0,Rob Ninkovich,OLB,dead_cap,new-orleans-saints,48093,2008
27608,45106,0,David Jones,CB,dead_cap,new-orleans-saints,45106,2008
27609,28200,0,Marvin Mitchell,OLB,dead_cap,new-orleans-saints,28200,2008
27610,25367,0,Taylor Mehlhaff,K,dead_cap,new-orleans-saints,25367,2008
27611,2585000,10500000,Reggie Bush,RB,active,new-orleans-saints,13085000,2009
27612,4487500,8920600,Drew Brees,QB,active,new-orleans-saints,13408100,2009
27613,1070000,9290000,Will Smith,OLB,active,new-orleans-saints,10360000,2009
27614,5200000,750000,Jabari Greer,CB,active,new-orleans-saints,5950000,2009
27615,3366000,3000000,Sedrick Ellis,DT,active,new-orleans-saints,6366000,2009
27616,2725000,3500000,Jeremy Shockey,TE,active,new-orleans-saints,6225000,2009
27617,3300000,1200000,Jonathan Vilma,ILB,active,new-orleans-saints,4500000,2009
27618,2000000,1000000,Scott Fujita,LB,active,new-orleans-saints,3000000,2009
27619,2250000,1431250,Marques Colston,WR,active,new-orleans-saints,3681250,2009
27620,1950000,1233333,Jonathan Goodwin,C,active,new-orleans-saints,3183333,2009
27621,2100000,1000000,Scott Shanle,LB,active,new-orleans-saints,3100000,2009
27622,1000000,600000,Bobby McCray,DE,active,new-orleans-saints,1600000,2009
27623,2792000,0,Jahri Evans,G,active,new-orleans-saints,2792000,2009
27624,1500000,1000000,Jon Stinchcomb,T,active,new-orleans-saints,2500000,2009
27625,1500000,875000,Devery Henderson,WR,active,new-orleans-saints,2375000,2009
27626,1000000,200000,Darren Sharper,S,active,new-orleans-saints,1200000,2009
27627,310000,1260000,Malcolm Jenkins,FS,active,new-orleans-saints,1570000,2009
27628,1545000,0,Lance Moore,WR,active,new-orleans-saints,1545000,2009
27629,1545000,0,Zach Strief,RT,active,new-orleans-saints,1545000,2009
27630,492500,1412500,Robert Meachem,WR,active,new-orleans-saints,1905000,2009
27631,535000,460000,Roman Harper,SS,active,new-orleans-saints,995000,2009
27632,455000,355000,Tracy Porter,CB,active,new-orleans-saints,810000,2009
27633,460000,207000,Usama Young,S,active,new-orleans-saints,667000,2009
27634,620000,0,Anthony Hargrove,DE,active,new-orleans-saints,620000,2009
27635,460000,103620,Jermon Bushrod,G,active,new-orleans-saints,563620,2009
27636,535000,16018,David Thomas,TE,active,new-orleans-saints,551018,2009
27637,535000,0,Courtney Roby,WR,active,new-orleans-saints,535000,2009
27638,385000,111250,Adrian Arrington,WR,active,new-orleans-saints,496250,2009
27639,460000,1667,Pierre Thomas,RB,active,new-orleans-saints,461667,2009
27640,460000,0,Remi Ayodele,DT,active,new-orleans-saints,460000,2009
27641,460000,0,Tory Humphrey,TE,active,new-orleans-saints,460000,2009
27642,460000,0,Marvin Mitchell,OLB,active,new-orleans-saints,460000,2009
27643,460000,0,Anthony Waters,LB,active,new-orleans-saints,460000,2009
27644,385000,46333,DeMario Pressley,DT,active,new-orleans-saints,431333,2009
27645,310000,117750,Stanley Arnoux,LB,active,new-orleans-saints,427750,2009
27646,385000,39250,Carl Nicks,G,active,new-orleans-saints,424250,2009
27647,310000,50763,Chip Vaughn,S,active,new-orleans-saints,360763,2009
27648,310000,41250,Thomas Morstead,P,active,new-orleans-saints,351250,2009
27649,310000,2500,Jonathan Casillas,OLB,active,new-orleans-saints,312500,2009
27650,294412,0,Garret Hartley,K,active,new-orleans-saints,294412,2009
27651,164117,0,Chase Daniel,QB,active,new-orleans-saints,164117,2009
27652,3290000,2780000,Jammal Brown,T,injured_reserve,new-orleans-saints,6070000,2009
27653,1800000,233334,Kendrick Clancy,DT,injured_reserve,new-orleans-saints,2033334,2009
27654,920000,0,Billy Miller,TE,injured_reserve,new-orleans-saints,920000,2009
27655,385000,1667,JoLonn Dunbar,OLB,injured_reserve,new-orleans-saints,386667,2009
27656,335000,50000,Dan Campbell,TE,injured_reserve,new-orleans-saints,385000,2009
27657,265200,0,Chase Daniel,QB,practice_squad,new-orleans-saints,265200,2009
27658,3000000,0,Deuce McAllister,RB,dead_cap,new-orleans-saints,3000000,2009
27659,300000,0,Terrance Copper,WR,dead_cap,new-orleans-saints,300000,2009
27660,163000,0,Andy Alleman,C,dead_cap,new-orleans-saints,163000,2009
27661,109411,0,Nick Leckey,C,dead_cap,new-orleans-saints,109411,2009
27662,90212,0,David Jones,CB,dead_cap,new-orleans-saints,90212,2009
27663,50734,0,Taylor Mehlhaff,K,dead_cap,new-orleans-saints,50734,2009
27664,0,50000,Joey Harrington,QB,dead_cap,new-orleans-saints,50000,2009
27665,40000,0,Kevin Houser,LS,dead_cap,new-orleans-saints,40000,2009
27666,6489000,8920600,Drew Brees,QB,active,new-orleans-saints,15409600,2010
27667,8000000,6490000,Reggie Bush,RB,active,new-orleans-saints,14490000,2010
27668,1930000,7700000,Will Smith,OLB,active,new-orleans-saints,9630000,2010
27669,7000000,2200000,Jahri Evans,G,active,new-orleans-saints,9200000,2010
27670,4000000,3182500,Jonathan Vilma,ILB,active,new-orleans-saints,7182500,2010
27671,3525000,3500000,Jeremy Shockey,TE,active,new-orleans-saints,7025000,2010
27672,3652000,3250000,Sedrick Ellis,DT,active,new-orleans-saints,6902000,2010
27673,432000,6144000,Malcolm Jenkins,FS,active,new-orleans-saints,6576000,2010
27674,2700000,1681250,Marques Colston,WR,active,new-orleans-saints,4381250,2010
27675,1800000,1000000,Jon Stinchcomb,T,active,new-orleans-saints,2800000,2010
27676,2700000,1233333,Jonathan Goodwin,C,active,new-orleans-saints,3933333,2010
27677,1800000,1000000,Scott Shanle,LB,active,new-orleans-saints,2800000,2010
27678,1800000,875000,Devery Henderson,WR,active,new-orleans-saints,2675000,2010
27679,1800000,850000,Jabari Greer,CB,active,new-orleans-saints,2650000,2010
27680,2521000,0,Roman Harper,SS,active,new-orleans-saints,2521000,2010
27681,1500000,75000,Darren Sharper,S,active,new-orleans-saints,1575000,2010
27682,1759000,0,Lance Moore,WR,active,new-orleans-saints,1759000,2010
27683,1759000,0,Zach Strief,RT,active,new-orleans-saints,1759000,2010
27684,1684000,0,Jermon Bushrod,G,active,new-orleans-saints,1684000,2010
27685,1684000,0,Pierre Thomas,RB,active,new-orleans-saints,1684000,2010
27686,648000,1424500,Robert Meachem,WR,active,new-orleans-saints,2072500,2010
27687,550000,725000,David Hawthorne,ILB,active,new-orleans-saints,1275000,2010
27688,325000,912000,Patrick Robinson,CB,active,new-orleans-saints,1237000,2010
27689,1226000,0,Anthony Hargrove,DE,active,new-orleans-saints,1226000,2010
27690,1176000,0,Courtney Roby,WR,active,new-orleans-saints,1176000,2010
27691,1101000,0,Remi Ayodele,DT,active,new-orleans-saints,1101000,2010
27692,1101000,0,Jeff Charleston,DE,active,new-orleans-saints,1101000,2010
27693,1101000,0,Marvin Mitchell,OLB,active,new-orleans-saints,1101000,2010
27694,1101000,0,Usama Young,S,active,new-orleans-saints,1101000,2010
27695,545000,355000,Tracy Porter,CB,active,new-orleans-saints,900000,2010
27696,685000,0,Clint Ingram,LB,active,new-orleans-saints,685000,2010
27697,630000,0,Julius Jones,RB,active,new-orleans-saints,630000,2010
27698,470000,111250,Adrian Arrington,WR,active,new-orleans-saints,581250,2010
27699,315000,250000,Charles Brown,LT,active,new-orleans-saints,565000,2010
27700,550000,0,Anthony Waters,LB,active,new-orleans-saints,550000,2010
27701,470000,46333,DeMario Pressley,DT,active,new-orleans-saints,516333,2010
27702,395000,117750,Stanley Arnoux,LB,active,new-orleans-saints,512750,2010
27703,470000,39250,Carl Nicks,G,active,new-orleans-saints,509250,2010
27704,320000,166285,Jimmy Graham,TE,active,new-orleans-saints,486285,2010
27705,470000,1667,JoLonn Dunbar,OLB,active,new-orleans-saints,471667,2010
27706,470000,0,Garret Hartley,K,active,new-orleans-saints,470000,2010
27707,470000,0,Tory Humphrey,TE,active,new-orleans-saints,470000,2010
27708,395000,41250,Thomas Morstead,P,active,new-orleans-saints,436250,2010
27709,407647,0,Matt Giordano,S,active,new-orleans-saints,407647,2010
27710,395000,2500,Jonathan Casillas,OLB,active,new-orleans-saints,397500,2010
27711,395000,0,Chase Daniel,QB,active,new-orleans-saints,395000,2010
27712,320000,44125,Matt Tennant,G,active,new-orleans-saints,364125,2010
27713,320000,2667,Clint Gresham,LS,active,new-orleans-saints,322667,2010
27714,320000,1667,Junior Galette,OLB,active,new-orleans-saints,321667,2010
27715,320000,1667,Chris Ivory,RB,active,new-orleans-saints,321667,2010
27716,170312,0,DeShawn Wynn,RB,active,new-orleans-saints,170312,2010
27717,88400,0,Brian De La Puente,C,practice_squad,new-orleans-saints,88400,2010
27718,0,3176000,Jammal Brown,T,dead_cap,new-orleans-saints,3176000,2010
27719,600000,0,Bobby McCray,DE,dead_cap,new-orleans-saints,600000,2010
27720,0,115530,Al Woods,DT,dead_cap,new-orleans-saints,115530,2010
27721,0,100000,Patrick Ramsey,QB,dead_cap,new-orleans-saints,100000,2010
27722,44078,0,Fenuki Tupou,T,dead_cap,new-orleans-saints,44078,2010
27723,0,11475,Sean Canfield,QB,dead_cap,new-orleans-saints,11475,2010
27724,7393500,7161800,Drew Brees,QB,active,new-orleans-saints,14555300,2011
27725,6000000,2150000,Will Smith,OLB,active,new-orleans-saints,8150000,2011
27726,5130000,3182500,Jonathan Vilma,ILB,active,new-orleans-saints,8312500,2011
27727,3782000,3250000,Sedrick Ellis,DT,active,new-orleans-saints,7032000,2011
27728,4500000,850000,Jabari Greer,CB,active,new-orleans-saints,5350000,2011
27729,3000000,2200000,Jahri Evans,G,active,new-orleans-saints,5200000,2011
27730,3000000,1406250,Marques Colston,WR,active,new-orleans-saints,4406250,2011
27731,1900000,1750000,Roman Harper,SS,active,new-orleans-saints,3650000,2011
27732,640000,2700000,Pierre Thomas,RB,active,new-orleans-saints,3340000,2011
27733,2250000,875000,Devery Henderson,WR,active,new-orleans-saints,3125000,2011
27734,1000000,1900000,Jermon Bushrod,G,active,new-orleans-saints,2900000,2011
27735,2611000,0,Carl Nicks,G,active,new-orleans-saints,2611000,2011
27736,2000000,600000,Lance Moore,WR,active,new-orleans-saints,2600000,2011
27737,712000,3236000,Malcolm Jenkins,FS,active,new-orleans-saints,3948000,2011
27738,950000,1492000,Robert Meachem,WR,active,new-orleans-saints,2442000,2011
27739,1250000,500000,Scott Shanle,LB,active,new-orleans-saints,1750000,2011
27740,1000000,750000,Darren Sproles,RB,active,new-orleans-saints,1750000,2011
27741,1200000,333333,Will Herring,LB,active,new-orleans-saints,1533333,2011
27742,1000000,500000,David Thomas,TE,active,new-orleans-saints,1500000,2011
27743,450000,1607000,Patrick Robinson,CB,active,new-orleans-saints,2057000,2011
27744,375000,1030709,Cameron Jordan,DE,active,new-orleans-saints,1405709,2011
27745,375000,973500,Mark Ingram,RB,active,new-orleans-saints,1348500,2011
27746,1000000,250000,Zach Strief,RT,active,new-orleans-saints,1250000,2011
27747,1200000,0,Turk McBride,DE,active,new-orleans-saints,1200000,2011
27748,600000,505200,Garret Hartley,K,active,new-orleans-saints,1105200,2011
27749,630000,355000,Tracy Porter,CB,active,new-orleans-saints,985000,2011
27750,700000,280000,Korey Hall,RB,active,new-orleans-saints,980000,2011
27751,405000,250000,Charles Brown,LT,active,new-orleans-saints,655000,2011
27752,405000,166285,Jimmy Graham,TE,active,new-orleans-saints,571285,2011
27753,375000,164081,Martez Wilson,OLB,active,new-orleans-saints,539081,2011
27754,480000,41250,Thomas Morstead,P,active,new-orleans-saints,521250,2011
27755,375000,136250,Johnny Patrick,CB,active,new-orleans-saints,511250,2011
27756,480000,2500,Jonathan Casillas,OLB,active,new-orleans-saints,482500,2011
27757,480000,0,Chase Daniel,QB,active,new-orleans-saints,480000,2011
27758,450000,1667,Chris Ivory,RB,active,new-orleans-saints,451667,2011
27759,450000,0,Jonathon Amaya,S,active,new-orleans-saints,450000,2011
27760,405000,44125,Matt Tennant,G,active,new-orleans-saints,449125,2011
27761,405000,1667,Junior Galette,OLB,active,new-orleans-saints,406667,2011
27762,405000,0,Justin Drescher,LS,active,new-orleans-saints,405000,2011
27763,375000,25000,Tom Johnson,DT,active,new-orleans-saints,400000,2011
27764,375000,12456,Greg Romeus,DE,active,new-orleans-saints,387456,2011
27765,375000,11475,Nathan Bussey,LB,active,new-orleans-saints,386475,2011
27766,375000,1667,Isa Abdul-Quddus,FS,active,new-orleans-saints,376667,2011
27767,375000,1333,Joseph Morgan,WR,active,new-orleans-saints,376333,2011
27768,375000,0,Jed Collins,FB,active,new-orleans-saints,375000,2011
27769,685000,0,Alex Barron,LT,injured_reserve,new-orleans-saints,685000,2011
27770,0,6000000,Reggie Bush,RB,dead_cap,new-orleans-saints,6000000,2011
27771,2375000,0,Jon Stinchcomb,T,dead_cap,new-orleans-saints,2375000,2011
27772,1200000,0,Bobby McCray,DE,dead_cap,new-orleans-saints,1200000,2011
27773,0,346590,Al Woods,DT,dead_cap,new-orleans-saints,346590,2011
27774,44078,0,Fenuki Tupou,T,dead_cap,new-orleans-saints,44078,2011
27775,0,34425,Sean Canfield,QB,dead_cap,new-orleans-saints,34425,2011
27776,0,11475,Nathan Bussey,LB,dead_cap,new-orleans-saints,11475,2011
27777,3000000,7400000,Drew Brees,QB,active,new-orleans-saints,10400000,2012
27778,5816000,3250000,Sedrick Ellis,DT,active,new-orleans-saints,9066000,2012
27779,3250000,3500000,Jermon Bushrod,G,active,new-orleans-saints,6750000,2012
27780,4500000,1850000,Roman Harper,SS,active,new-orleans-saints,6350000,2012
27781,825000,5208333,Will Smith,OLB,active,new-orleans-saints,6033333,2012
27782,2400000,2175000,Jabari Greer,CB,active,new-orleans-saints,4575000,2012
27783,2400000,1850000,Darren Sproles,RB,active,new-orleans-saints,4250000,2012
27784,2650000,875000,Devery Henderson,WR,active,new-orleans-saints,3525000,2012
27785,700000,2660000,Jahri Evans,G,active,new-orleans-saints,3360000,2012
27786,1200000,2100000,Marques Colston,WR,active,new-orleans-saints,3300000,2012
27787,1524000,3236000,Malcolm Jenkins,FS,active,new-orleans-saints,4760000,2012
27788,700000,2000000,Ben Grubbs,G,active,new-orleans-saints,2700000,2012
27789,825000,1843750,Lance Moore,WR,active,new-orleans-saints,2668750,2012
27790,2160000,100000,Pierre Thomas,RB,active,new-orleans-saints,2260000,2012
27791,1900000,325000,Zach Strief,RT,active,new-orleans-saints,2225000,2012
27792,540000,2104333,Patrick Robinson,CB,active,new-orleans-saints,2644333,2012
27793,1275000,741250,Thomas Morstead,P,active,new-orleans-saints,2016250,2012
27794,1100000,500000,David Thomas,TE,active,new-orleans-saints,1600000,2012
27795,726427,1030709,Cameron Jordan,DE,active,new-orleans-saints,1757136,2012
27796,1300000,433333,Will Herring,LB,active,new-orleans-saints,1733333,2012
27797,700000,1000000,Curtis Lofton,ILB,active,new-orleans-saints,1700000,2012
27798,712125,973500,Mark Ingram,RB,active,new-orleans-saints,1685625,2012
27799,700000,900000,Brodrick Bunkley,DT,active,new-orleans-saints,1600000,2012
27800,1050000,500000,Scott Shanle,LB,active,new-orleans-saints,1550000,2012
27801,700000,760000,David Hawthorne,ILB,active,new-orleans-saints,1460000,2012
27802,700000,685000,Garret Hartley,K,active,new-orleans-saints,1385000,2012
27803,1260000,0,Jonathan Casillas,OLB,active,new-orleans-saints,1260000,2012
27804,700000,400000,Chris Chamberlain,ILB,active,new-orleans-saints,1100000,2012
27805,800000,0,Turk McBride,DE,active,new-orleans-saints,800000,2012
27806,700000,300000,Chase Daniel,QB,active,new-orleans-saints,1000000,2012
27807,495000,250000,Charles Brown,LT,active,new-orleans-saints,745000,2012
27808,540000,166285,Jimmy Graham,TE,active,new-orleans-saints,706285,2012
27809,700000,0,Elbert Mack,CB,active,new-orleans-saints,700000,2012
27810,700000,0,Courtney Roby,WR,active,new-orleans-saints,700000,2012
27811,465000,164081,Martez Wilson,OLB,active,new-orleans-saints,629081,2012
27812,615000,0,Ramon Humber,OLB,active,new-orleans-saints,615000,2012
27813,465000,136250,Johnny Patrick,CB,active,new-orleans-saints,601250,2012
27814,540000,1667,Chris Ivory,RB,active,new-orleans-saints,541667,2012
27815,540000,0,Brian De La Puente,C,active,new-orleans-saints,540000,2012
27816,540000,0,Justin Drescher,LS,active,new-orleans-saints,540000,2012
27817,390000,135725,Akiem Hicks,DE,active,new-orleans-saints,525725,2012
27818,490000,1667,Junior Galette,OLB,active,new-orleans-saints,491667,2012
27819,465000,25000,Tom Johnson,DT,active,new-orleans-saints,490000,2012
27820,465000,12456,Greg Romeus,DE,active,new-orleans-saints,477456,2012
27821,925000,65000,Daniel Graham,TE,active,new-orleans-saints,990000,2012
27822,465000,1667,Isa Abdul-Quddus,FS,active,new-orleans-saints,466667,2012
27823,465000,1333,Joseph Morgan,WR,active,new-orleans-saints,466333,2012
27824,465000,0,Rafael Bush,FS,active,new-orleans-saints,465000,2012
27825,465000,0,Eric Olsen,C,active,new-orleans-saints,465000,2012
27826,390000,44125,Corey White,CB,active,new-orleans-saints,434125,2012
27827,390000,28000,Andrew Tiller,G,active,new-orleans-saints,418000,2012
27828,415000,0,Jed Collins,FB,active,new-orleans-saints,415000,2012
27829,390000,12150,Marcel Jones,RT,active,new-orleans-saints,402150,2012
27830,700000,0,Greg Camarillo,WR,active,new-orleans-saints,700000,2012
27831,390000,3333,Adrian Davis,CB,active,new-orleans-saints,393333,2012
27832,390000,1667,Travaris Cadet,RB,active,new-orleans-saints,391667,2012
27833,390000,1000,Tyrunn Walker,DT,active,new-orleans-saints,391000,2012
27834,390000,833,Chris Givens,WR,active,new-orleans-saints,390833,2012
27835,390000,0,Saalim Hakim,WR,active,new-orleans-saints,390000,2012
27836,390000,0,Bryce Harris,RT,active,new-orleans-saints,390000,2012
27837,390000,0,Nick Hixon,CB,active,new-orleans-saints,390000,2012
27838,390000,0,Lawrence Wilson,ILB,active,new-orleans-saints,390000,2012
27839,615000,0,William Robinson,T,active,new-orleans-saints,615000,2012
27840,465000,0,Ricky Henry,G,active,new-orleans-saints,465000,2012
27841,390000,0,Jerico Nelson,S,active,new-orleans-saints,390000,2012
27842,540000,0,Fenuki Tupou,T,active,new-orleans-saints,540000,2012
27843,195000,101903,Nick Toon,WR,injured_reserve,new-orleans-saints,296903,2012
27844,4750000,0,Jon Stinchcomb,T,dead_cap,new-orleans-saints,4750000,2012
27845,257812,0,Barrett Ruud,LB,dead_cap,new-orleans-saints,257812,2012
27846,300000,0,Korey Hall,RB,dead_cap,new-orleans-saints,300000,2012
27847,65000,0,John Kasay,K,dead_cap,new-orleans-saints,65000,2012
27848,0,44125,Matt Tennant,G,dead_cap,new-orleans-saints,44125,2012
27849,0,34425,Nathan Bussey,LB,dead_cap,new-orleans-saints,34425,2012
27850,5000,0,Brian Folkerts,C,dead_cap,new-orleans-saints,5000,2012
27851,5000,0,Aderious Simmons,T,dead_cap,new-orleans-saints,5000,2012
27852,5000,0,Johnny Thomas,S,dead_cap,new-orleans-saints,5000,2012
27853,9750000,7650000,Drew Brees,QB,active,new-orleans-saints,17400000,2013
27854,3040000,3700000,Jahri Evans,G,active,new-orleans-saints,6740000,2013
27855,3600000,1875000,Jabari Greer,CB,active,new-orleans-saints,5475000,2013
27856,2600000,2343750,Lance Moore,WR,active,new-orleans-saints,4943750,2013
27857,1700000,2800000,Marques Colston,WR,active,new-orleans-saints,4500000,2013
27858,1200000,4100000,Ben Grubbs,G,active,new-orleans-saints,5300000,2013
27859,2264000,3236000,Malcolm Jenkins,FS,active,new-orleans-saints,5500000,2013
27860,2900000,850000,Darren Sproles,RB,active,new-orleans-saints,3750000,2013
27861,840000,2820000,Roman Harper,SS,active,new-orleans-saints,3660000,2013
27862,1100000,2000000,Curtis Lofton,ILB,active,new-orleans-saints,3100000,2013
27863,2225000,350000,Zach Strief,RT,active,new-orleans-saints,2575000,2013
27864,850000,1712500,Brodrick Bunkley,DT,active,new-orleans-saints,2562500,2013
27865,1000000,2260000,David Hawthorne,ILB,active,new-orleans-saints,3260000,2013
27866,2100000,400000,Pierre Thomas,RB,active,new-orleans-saints,2500000,2013
27867,1000000,1250000,Keenan Lewis,CB,active,new-orleans-saints,2250000,2013
27868,725000,2104333,Patrick Robinson,CB,active,new-orleans-saints,2829333,2013
27869,1077855,1030709,Cameron Jordan,DE,active,new-orleans-saints,2108564,2013
27870,2023000,0,Brian De La Puente,C,active,new-orleans-saints,2023000,2013
27871,1049250,973500,Mark Ingram,RB,active,new-orleans-saints,2022750,2013
27872,900000,1050000,Thomas Morstead,P,active,new-orleans-saints,1950000,2013
27873,405000,1308584,Kenny Vaccaro,SS,active,new-orleans-saints,1713584,2013
27874,800000,900000,Junior Galette,OLB,active,new-orleans-saints,1700000,2013
27875,950000,700000,Benjamin Watson,TE,active,new-orleans-saints,1650000,2013
27876,1323000,166285,Jimmy Graham,TE,active,new-orleans-saints,1489285,2013
27877,1150000,131250,Parys Haralson,DE,active,new-orleans-saints,1281250,2013
27878,630000,250000,Charles Brown,LT,active,new-orleans-saints,880000,2013
27879,750000,25000,Tom Johnson,DT,active,new-orleans-saints,775000,2013
27880,630000,130000,Justin Drescher,LS,active,new-orleans-saints,760000,2013
27881,715000,0,Robert Meachem,WR,active,new-orleans-saints,715000,2013
27882,480000,148225,Akiem Hicks,DE,active,new-orleans-saints,628225,2013
27883,715000,50000,Will Herring,LB,active,new-orleans-saints,765000,2013
27884,480000,101903,Nick Toon,WR,active,new-orleans-saints,581903,2013
27885,715000,25000,Ramon Humber,OLB,active,new-orleans-saints,740000,2013
27886,405000,154359,Terron Armstead,LT,active,new-orleans-saints,559359,2013
27887,840000,0,Luke McCown,QB,active,new-orleans-saints,840000,2013
27888,555000,0,Rafael Bush,FS,active,new-orleans-saints,555000,2013
27889,555000,0,Jed Collins,FB,active,new-orleans-saints,555000,2013
27890,405000,141890,John Jenkins,DE,active,new-orleans-saints,546890,2013
27891,480000,44125,Corey White,CB,active,new-orleans-saints,524125,2013
27892,480000,1667,Travaris Cadet,RB,active,new-orleans-saints,481667,2013
27893,480000,1000,Tyrunn Walker,DT,active,new-orleans-saints,481000,2013
27894,480000,0,Bryce Harris,RT,active,new-orleans-saints,480000,2013
27895,405000,48613,Kenny Stills,WR,active,new-orleans-saints,453613,2013
27896,405000,2333,Glenn Foster,DE,active,new-orleans-saints,407333,2013
27897,405000,1666,Josh Hill,TE,active,new-orleans-saints,406666,2013
27898,405000,1666,Tim Lelito,G,active,new-orleans-saints,406666,2013
27899,405000,1666,Kevin Reddick,ILB,active,new-orleans-saints,406666,2013
27900,405000,1666,Rod Sweeting,CB,active,new-orleans-saints,406666,2013
27901,405000,333,Khiry Robinson,RB,active,new-orleans-saints,405333,2013
27902,715000,0,Keyunta Dawson,DE,active,new-orleans-saints,715000,2013
27903,840000,0,Chris Carr,CB,active,new-orleans-saints,840000,2013
27904,405000,0,Ryan Griffin,QB,active,new-orleans-saints,405000,2013
27905,480000,0,Trevin Wade,CB,active,new-orleans-saints,480000,2013
27906,940000,0,Shayne Graham,K,active,new-orleans-saints,940000,2013
27907,405000,0,Terrence Frederick,CB,active,new-orleans-saints,405000,2013
27908,405000,0,Kyle Knox,OLB,active,new-orleans-saints,405000,2013
27909,3000000,5541666,Will Smith,OLB,injured_reserve,new-orleans-saints,8541666,2013
27910,1000000,5065000,Jonathan Vilma,ILB,injured_reserve,new-orleans-saints,6065000,2013
27911,940000,65000,Kenyon Coleman,DE,injured_reserve,new-orleans-saints,1005000,2013
27912,555000,1334,Joseph Morgan,WR,injured_reserve,new-orleans-saints,556334,2013
27913,303000,833,Chris Givens,WR,injured_reserve,new-orleans-saints,303833,2013
27914,288000,3333,Adrian Davis,CB,injured_reserve,new-orleans-saints,291333,2013
27915,42000,0,Ryan Griffin,QB,practice_squad,new-orleans-saints,42000,2013
27916,30000,0,Saalim Hakim,WR,practice_squad,new-orleans-saints,30000,2013
27917,18000,0,Austin Johnson,FB,practice_squad,new-orleans-saints,18000,2013
27918,18000,0,Senio Kelemete,G,practice_squad,new-orleans-saints,18000,2013
27919,1744400,505200,Garret Hartley,K,dead_cap,new-orleans-saints,2249600,2013
27920,556668,0,Isa Abdul-Quddus,FS,dead_cap,new-orleans-saints,556668,2013
27921,500000,0,David Thomas,TE,dead_cap,new-orleans-saints,500000,2013
27922,288529,164081,Martez Wilson,OLB,dead_cap,new-orleans-saints,452610,2013
27923,400000,0,Chris Chamberlain,ILB,dead_cap,new-orleans-saints,400000,2013
27924,333334,0,Will Herring,LB,dead_cap,new-orleans-saints,333334,2013
27925,272690,0,Johnny Patrick,CB,dead_cap,new-orleans-saints,272690,2013
27926,228529,0,Chris Carr,CB,dead_cap,new-orleans-saints,228529,2013
27927,222588,0,Chris Williams,G,dead_cap,new-orleans-saints,222588,2013
27928,130588,0,Jay Richardson,DE,dead_cap,new-orleans-saints,130588,2013
27929,65294,0,Eric Frampton,S,dead_cap,new-orleans-saints,65294,2013
27930,0,65000,Jason Smith,LT,dead_cap,new-orleans-saints,65000,2013
27931,65000,0,Jim Leonhard,S,dead_cap,new-orleans-saints,65000,2013
27932,65000,0,Courtney Roby,WR,dead_cap,new-orleans-saints,65000,2013
27933,47647,0,Andy Tanner,WR,dead_cap,new-orleans-saints,47647,2013
27934,0,44125,Matt Tennant,G,dead_cap,new-orleans-saints,44125,2013
27935,32647,0,Eric Olsen,C,dead_cap,new-orleans-saints,32647,2013
27936,30000,0,Jumal Rolle,CB,dead_cap,new-orleans-saints,30000,2013
27937,28000,0,Andrew Tiller,G,dead_cap,new-orleans-saints,28000,2013
27938,26327,0,Rufus Johnson,OLB,dead_cap,new-orleans-saints,26327,2013
27939,0,24912,Greg Romeus,DE,dead_cap,new-orleans-saints,24912,2013
27940,12150,0,Marcel Jones,RT,dead_cap,new-orleans-saints,12150,2013
27941,11666,0,Ryan Griffin,QB,dead_cap,new-orleans-saints,11666,2013
27942,5000,0,Ryan Lacy,CB,dead_cap,new-orleans-saints,5000,2013
27943,2500,0,Isaako Aaitui,DT,dead_cap,new-orleans-saints,2500,2013
27944,1667,0,Eric Martin,ILB,dead_cap,new-orleans-saints,1667,2013
27945,1666,0,Elliot Mealer,G,dead_cap,new-orleans-saints,1666,2013
27946,1666,0,Keavon Milton,T,dead_cap,new-orleans-saints,1666,2013
27947,1666,0,Rayford Shipman,ILB,dead_cap,new-orleans-saints,1666,2013
27948,1666,0,Michael Thomas,FS,dead_cap,new-orleans-saints,1666,2013
27949,333,0,Brent Leonard,WR,dead_cap,new-orleans-saints,333,2013
27950,333,0,Jose Maltos,K,dead_cap,new-orleans-saints,333,2013
27951,10750000,7650000,Drew Brees,QB,active,new-orleans-saints,18400000,2014
27952,6800000,4200000,Jahri Evans,G,active,new-orleans-saints,11000000,2014
27953,6000000,4100000,Ben Grubbs,G,active,new-orleans-saints,10100000,2014
27954,5500000,2800000,Marques Colston,WR,active,new-orleans-saints,8300000,2014
27955,1000000,4200000,Curtis Lofton,ILB,active,new-orleans-saints,5200000,2014
27956,1000000,3000000,Jimmy Graham,TE,active,new-orleans-saints,4000000,2014
27957,1000000,3260000,David Hawthorne,ILB,active,new-orleans-saints,4260000,2014
27958,1300000,2200000,Jairus Byrd,FS,active,new-orleans-saints,3500000,2014
27959,1000000,2350000,Keenan Lewis,CB,active,new-orleans-saints,3350000,2014
27960,2185000,1050000,Thomas Morstead,P,active,new-orleans-saints,3235000,2014
27961,750000,2200000,Junior Galette,OLB,active,new-orleans-saints,2950000,2014
27962,1282500,2104333,Patrick Robinson,CB,active,new-orleans-saints,3386833,2014
27963,1429282,1030709,Cameron Jordan,DE,active,new-orleans-saints,2459991,2014
27964,1386375,973500,Mark Ingram,RB,active,new-orleans-saints,2359875,2014
27965,833396,1308584,Kenny Vaccaro,SS,active,new-orleans-saints,2141980,2014
27966,900000,1200000,Zach Strief,RT,active,new-orleans-saints,2100000,2014
27967,1850000,0,Rafael Bush,FS,active,new-orleans-saints,1850000,2014
27968,1000000,684375,Benjamin Watson,TE,active,new-orleans-saints,1684375,2014
27969,420000,1104264,Brandin Cooks,WR,active,new-orleans-saints,1524264,2014
27970,750000,300000,Erik Lorig,FB,active,new-orleans-saints,1050000,2014
27971,730000,130000,Justin Drescher,LS,active,new-orleans-saints,860000,2014
27972,570000,148225,Akiem Hicks,DE,active,new-orleans-saints,718225,2014
27973,525000,154359,Terron Armstead,LT,active,new-orleans-saints,679359,2014
27974,570000,101903,Nick Toon,WR,active,new-orleans-saints,671903,2014
27975,420000,241224,Stanley Jean-Baptiste,CB,active,new-orleans-saints,661224,2014
27976,515000,141890,John Jenkins,DE,active,new-orleans-saints,656890,2014
27977,955000,65000,Jonathan Goodwin,C,active,new-orleans-saints,1020000,2014
27978,855000,65000,Parys Haralson,DE,active,new-orleans-saints,920000,2014
27979,855000,65000,Luke McCown,QB,active,new-orleans-saints,920000,2014
27980,730000,65000,Ramon Humber,OLB,active,new-orleans-saints,795000,2014
27981,570000,44125,Corey White,CB,active,new-orleans-saints,614125,2014
27982,570000,1667,Travaris Cadet,RB,active,new-orleans-saints,571667,2014
27983,570000,1000,Tyrunn Walker,DT,active,new-orleans-saints,571000,2014
27984,955000,0,Shayne Graham,K,active,new-orleans-saints,955000,2014
27985,855000,0,Robert Meachem,WR,active,new-orleans-saints,855000,2014
27986,730000,0,Brandon Deaderick,DT,active,new-orleans-saints,730000,2014
27987,570000,0,Bryce Harris,RT,active,new-orleans-saints,570000,2014
27988,570000,0,Cheta Ozougwu,DE,active,new-orleans-saints,570000,2014
27989,495000,48613,Kenny Stills,WR,active,new-orleans-saints,543613,2014
27990,495000,1666,Josh Hill,TE,active,new-orleans-saints,496666,2014
27991,495000,1666,Tim Lelito,G,active,new-orleans-saints,496666,2014
27992,495000,333,Khiry Robinson,RB,active,new-orleans-saints,495333,2014
27993,495000,0,Senio Kelemete,G,active,new-orleans-saints,495000,2014
27994,420000,44125,Vinnie Sunseri,SS,active,new-orleans-saints,464125,2014
27995,420000,42215,Ronald Powell,OLB,active,new-orleans-saints,462215,2014
27996,420000,2000,Marcus Ball,FS,active,new-orleans-saints,422000,2014
27997,420000,2000,Kasim Edebali,OLB,active,new-orleans-saints,422000,2014
27998,420000,1666,Brian Dixon,CB,active,new-orleans-saints,421666,2014
27999,420000,0,Kyle Knox,OLB,active,new-orleans-saints,420000,2014
28000,420000,0,Austin Johnson,FB,active,new-orleans-saints,420000,2014
28001,300588,0,Jamarca Sanford,SS,active,new-orleans-saints,300588,2014
28002,232941,0,Nick Becton,LT,active,new-orleans-saints,232941,2014
28003,570000,0,Moise Fokou,ILB,active,new-orleans-saints,570000,2014
28004,420000,0,Terrence Frederick,CB,active,new-orleans-saints,420000,2014
28005,420000,0,Jalen Saunders,WR,active,new-orleans-saints,420000,2014
28006,420000,0,Pierre Warren,FS,active,new-orleans-saints,420000,2014
28007,420000,0,Lawrence Virgil,DE,active,new-orleans-saints,420000,2014
28008,420000,0,Seantavius Jones,WR,active,new-orleans-saints,420000,2014
28009,570000,0,Jerry Franklin,OLB,active,new-orleans-saints,570000,2014
28010,420000,0,Brandon Coleman,WR,active,new-orleans-saints,420000,2014
28011,1300000,1962500,Brodrick Bunkley,DT,injured_reserve,new-orleans-saints,3262500,2014
28012,855000,715000,Pierre Thomas,RB,injured_reserve,new-orleans-saints,1570000,2014
28013,495000,2333,Glenn Foster,DE,injured_reserve,new-orleans-saints,497333,2014
28014,303000,3334,Adrian Davis,CB,injured_reserve,new-orleans-saints,306334,2014
28015,303000,1500,Ty Zimmerman,SS,injured_reserve,new-orleans-saints,304500,2014
28016,303000,0,Andy Tanner,WR,injured_reserve,new-orleans-saints,303000,2014
28017,107100,0,Ryan Griffin,QB,practice_squad,new-orleans-saints,107100,2014
28018,107100,0,Tavon Rooks,LT,practice_squad,new-orleans-saints,107100,2014
28019,88200,0,Orson Charles,FB,practice_squad,new-orleans-saints,88200,2014
28020,37800,0,Edwin Baker,RB,practice_squad,new-orleans-saints,37800,2014
28021,18900,0,Toben Opurum,DE,practice_squad,new-orleans-saints,18900,2014
28022,18900,0,Willie Snead,WR,practice_squad,new-orleans-saints,18900,2014
28023,12600,0,Dustin Hopkins,K,practice_squad,new-orleans-saints,12600,2014
28024,6300,0,Mike Brewster,C,practice_squad,new-orleans-saints,6300,2014
28025,3690000,0,Roman Harper,SS,dead_cap,new-orleans-saints,3690000,2014
28026,0,2650000,Jabari Greer,CB,dead_cap,new-orleans-saints,2650000,2014
28027,2537500,0,Lance Moore,WR,dead_cap,new-orleans-saints,2537500,2014
28028,0,2352451,Will Smith,OLB,dead_cap,new-orleans-saints,2352451,2014
28029,0,1010400,Garret Hartley,K,dead_cap,new-orleans-saints,1010400,2014
28030,750000,0,Darren Sproles,RB,dead_cap,new-orleans-saints,750000,2014
28031,0,475000,Victor Butler,OLB,dead_cap,new-orleans-saints,475000,2014
28032,400000,0,Chris Chamberlain,ILB,dead_cap,new-orleans-saints,400000,2014
28033,349412,0,Joseph Morgan,WR,dead_cap,new-orleans-saints,349412,2014
28034,0,250000,Champ Bailey,CB,dead_cap,new-orleans-saints,250000,2014
28035,123529,103140,Khairi Fortt,OLB,dead_cap,new-orleans-saints,226669,2014
28036,167646,0,Tom Crabtree,TE,dead_cap,new-orleans-saints,167646,2014
28037,0,164081,Martez Wilson,OLB,dead_cap,new-orleans-saints,164081,2014
28038,147971,0,Edwin Baker,RB,dead_cap,new-orleans-saints,147971,2014
28039,113824,0,Eric Olsen,C,dead_cap,new-orleans-saints,113824,2014
28040,111918,0,Todd Davis,ILB,dead_cap,new-orleans-saints,111918,2014
28041,88200,700,Seantavius Jones,WR,dead_cap,new-orleans-saints,88900,2014
28042,86900,1666,Brandon Coleman,WR,dead_cap,new-orleans-saints,88566,2014
28043,78981,0,Rufus Johnson,OLB,dead_cap,new-orleans-saints,78981,2014
28044,75600,1666,Lawrence Virgil,DE,dead_cap,new-orleans-saints,77266,2014
28045,69300,0,Terrence Frederick,CB,dead_cap,new-orleans-saints,69300,2014
28046,0,65000,Robert Meachem,WR,dead_cap,new-orleans-saints,65000,2014
28047,56000,0,Andrew Tiller,G,dead_cap,new-orleans-saints,56000,2014
28048,50400,0,DeMarcus Love,LT,dead_cap,new-orleans-saints,50400,2014
28049,31500,0,Jerry Franklin,OLB,dead_cap,new-orleans-saints,31500,2014
28050,31500,0,Michael Zordich,FB,dead_cap,new-orleans-saints,31500,2014
28051,25200,0,Antoine McClain,G,dead_cap,new-orleans-saints,25200,2014
28052,25200,0,Alex Parsons,C,dead_cap,new-orleans-saints,25200,2014
28053,0,24358,Tavon Rooks,LT,dead_cap,new-orleans-saints,24358,2014
28054,24300,0,Marcel Jones,RT,dead_cap,new-orleans-saints,24300,2014
28055,18706,3750,Ty Nsekhe,LT,dead_cap,new-orleans-saints,22456,2014
28056,18900,1666,Nic Jacobs,TE,dead_cap,new-orleans-saints,20566,2014
28057,18900,1333,Pierre Warren,FS,dead_cap,new-orleans-saints,20233,2014
28058,18900,0,Tauren Poole,RB,dead_cap,new-orleans-saints,18900,2014
28059,18900,0,Garrison Smith,DE,dead_cap,new-orleans-saints,18900,2014
28060,12600,0,Trevin Wade,CB,dead_cap,new-orleans-saints,12600,2014
28061,10000,2500,Matt Armstrong,C,dead_cap,new-orleans-saints,12500,2014
28062,0,10000,Shayne Graham,K,dead_cap,new-orleans-saints,10000,2014
28063,5000,1666,Chidera Uzo-Diribe,DE,dead_cap,new-orleans-saints,6666,2014
28064,0,5000,Keyunta Dawson,DE,dead_cap,new-orleans-saints,5000,2014
28065,0,5000,Micajah Reynolds,DT,dead_cap,new-orleans-saints,5000,2014
28066,3334,0,Ryan Griffin,QB,dead_cap,new-orleans-saints,3334,2014
28067,3334,0,Eric Martin,ILB,dead_cap,new-orleans-saints,3334,2014
28068,3334,0,Elliot Mealer,G,dead_cap,new-orleans-saints,3334,2014
28069,3334,0,Keavon Milton,T,dead_cap,new-orleans-saints,3334,2014
28070,3334,0,Rayford Shipman,ILB,dead_cap,new-orleans-saints,3334,2014
28071,3334,0,Michael Thomas,FS,dead_cap,new-orleans-saints,3334,2014
28072,0,3000,Derrius Brooks,CB,dead_cap,new-orleans-saints,3000,2014
28073,0,3000,Brandon McCray,DT,dead_cap,new-orleans-saints,3000,2014
28074,2500,0,Isaako Aaitui,DT,dead_cap,new-orleans-saints,2500,2014
28075,0,1667,George Uko,DT,dead_cap,new-orleans-saints,1667,2014
28076,0,1666,Tim Flanders,RB,dead_cap,new-orleans-saints,1666,2014
28077,0,1666,Logan Kilgore,QB,dead_cap,new-orleans-saints,1666,2014
28078,0,1666,Kevin Reddick,ILB,dead_cap,new-orleans-saints,1666,2014
28079,0,1666,Rod Sweeting,CB,dead_cap,new-orleans-saints,1666,2014
28080,0,1333,Je'Ron Hamm,WR,dead_cap,new-orleans-saints,1333,2014
28081,834,0,Chris Givens,WR,dead_cap,new-orleans-saints,834,2014
28082,667,0,Brent Leonard,WR,dead_cap,new-orleans-saints,667,2014
28083,667,0,Jose Maltos,K,dead_cap,new-orleans-saints,667,2014
28084,0,500,Spencer Hadley,OLB,dead_cap,new-orleans-saints,500,2014
28085,13550000,10250000,Drew Brees,QB,active,new-orleans-saints,23800000,2015
28086,1003000,5997000,Jahri Evans,G,active,new-orleans-saints,7000000,2015
28087,1445000,5055000,Marques Colston,WR,active,new-orleans-saints,6500000,2015
28088,2000000,3500000,Jairus Byrd,FS,active,new-orleans-saints,5500000,2015
28089,969000,3200000,Cameron Jordan,DE,active,new-orleans-saints,4169000,2015
28090,1190000,3570000,David Hawthorne,ILB,active,new-orleans-saints,4760000,2015
28091,2350000,1050000,Thomas Morstead,P,active,new-orleans-saints,3400000,2015
28092,2000000,1200000,Zach Strief,RT,active,new-orleans-saints,3200000,2015
28093,1500000,1500000,Max Unger,C,active,new-orleans-saints,3000000,2015
28094,1261792,1308584,Kenny Vaccaro,SS,active,new-orleans-saints,2570376,2015
28095,1100000,1300000,Brandon Browner,CB,active,new-orleans-saints,2400000,2015
28096,435000,1636544,Andrus Peat,G,active,new-orleans-saints,2071544,2015
28097,1950000,0,Rafael Bush,FS,active,new-orleans-saints,1950000,2015
28098,801066,1104264,Brandin Cooks,WR,active,new-orleans-saints,1905330,2015
28099,1200000,700000,Benjamin Watson,TE,active,new-orleans-saints,1900000,2015
28100,1100000,1500000,Dannell Ellerbe,OLB,active,new-orleans-saints,2600000,2015
28101,1000000,500000,Kevin Williams,DT,active,new-orleans-saints,1500000,2015
28102,435000,970766,Stephone Anthony,OLB,active,new-orleans-saints,1405766,2015
28103,850000,167000,Ramon Humber,OLB,active,new-orleans-saints,1017000,2015
28104,435000,522511,Hau'oli Kikaha,OLB,active,new-orleans-saints,957511,2015
28105,658824,281250,Michael Hoomanawanui,TE,active,new-orleans-saints,940074,2015
28106,745000,130000,Justin Drescher,LS,active,new-orleans-saints,875000,2015
28107,615000,154359,Terron Armstead,LT,active,new-orleans-saints,769359,2015
28108,605000,141890,John Jenkins,DE,active,new-orleans-saints,746890,2015
28109,870000,80000,Anthony Spencer,OLB,active,new-orleans-saints,950000,2015
28110,745000,80000,Jamarca Sanford,SS,active,new-orleans-saints,825000,2015
28111,745000,80000,Kyle Wilson,CB,active,new-orleans-saints,825000,2015
28112,435000,183291,Garrett Grayson,QB,active,new-orleans-saints,618291,2015
28113,585000,1668,Josh Hill,TE,active,new-orleans-saints,586668,2015
28114,585000,1668,Tim Lelito,G,active,new-orleans-saints,586668,2015
28115,585000,0,Senio Kelemete,G,active,new-orleans-saints,585000,2015
28116,585000,0,Michael Mauti,OLB,active,new-orleans-saints,585000,2015
28117,818823,0,Mike McGlynn,G,active,new-orleans-saints,818823,2015
28118,510000,2000,Kasim Edebali,OLB,active,new-orleans-saints,512000,2015
28119,510000,1666,Brian Dixon,CB,active,new-orleans-saints,511666,2015
28120,318000,176654,P.J. Williams,CB,active,new-orleans-saints,494654,2015
28121,435000,54306,Tyeler Davison,DT,active,new-orleans-saints,489306,2015
28122,569705,0,Tony Hills,LT,active,new-orleans-saints,569705,2015
28123,435000,4000,Delvin Breaux,CB,active,new-orleans-saints,439000,2015
28124,435000,3333,Kaleb Eulls,DT,active,new-orleans-saints,438333,2015
28125,435000,2500,Tavaris Barnes,DE,active,new-orleans-saints,437500,2015
28126,435000,1666,Bobby Richardson,DE,active,new-orleans-saints,436666,2015
28127,435000,0,Brandon Coleman,WR,active,new-orleans-saints,435000,2015
28128,435000,0,Obum Gwacham,DE,active,new-orleans-saints,435000,2015
28129,435000,0,Willie Snead,WR,active,new-orleans-saints,435000,2015
28130,427058,0,Kai Forbath,K,active,new-orleans-saints,427058,2015
28131,333000,44125,Vinnie Sunseri,SS,active,new-orleans-saints,377125,2015
28132,318000,55433,Davis Tull,DE,active,new-orleans-saints,373433,2015
28133,394411,0,Tim Hightower,RB,active,new-orleans-saints,394411,2015
28134,409411,0,James Anderson,OLB,active,new-orleans-saints,409411,2015
28135,409411,0,Matt Flynn,QB,active,new-orleans-saints,409411,2015
28136,307058,0,Christopher Owens,CB,active,new-orleans-saints,307058,2015
28137,120000,0,Austin Johnson,FB,active,new-orleans-saints,120000,2015
28138,77647,0,Travaris Cadet,RB,active,new-orleans-saints,77647,2015
28139,68823,0,Ryan Seymour,G,active,new-orleans-saints,68823,2015
28140,60000,0,Seantavius Jones,WR,active,new-orleans-saints,60000,2015
28141,25588,0,Rashaun Allen,TE,active,new-orleans-saints,25588,2015
28142,25588,0,Toben Opurum,DE,active,new-orleans-saints,25588,2015
28143,850000,3650000,Keenan Lewis,CB,injured_reserve,new-orleans-saints,4500000,2015
28144,1000000,1000000,Mark Ingram,RB,injured_reserve,new-orleans-saints,2000000,2015
28145,750000,1250000,C.J. Spiller,RB,injured_reserve,new-orleans-saints,2000000,2015
28146,970000,80000,Luke McCown,QB,injured_reserve,new-orleans-saints,1050000,2015
28147,414352,46807,Damian Swann,CB,injured_reserve,new-orleans-saints,461159,2015
28148,459529,334,Khiry Robinson,RB,injured_reserve,new-orleans-saints,459863,2015
28149,414352,17322,Marcus Murphy,RB,injured_reserve,new-orleans-saints,431674,2015
28150,333000,0,Lawrence Virgil,DE,injured_reserve,new-orleans-saints,333000,2015
28151,318000,1000,Jack Tabb,TE,injured_reserve,new-orleans-saints,319000,2015
28152,318000,0,Austin Brown,DT,injured_reserve,new-orleans-saints,318000,2015
28153,116470,0,Kendall Hunter,RB,injured_reserve,new-orleans-saints,116470,2015
28154,0,9000000,Jimmy Graham,TE,dead_cap,new-orleans-saints,9000000,2015
28155,0,8000000,Ben Grubbs,G,dead_cap,new-orleans-saints,8000000,2015
28156,1250000,4200000,Junior Galette,OLB,dead_cap,new-orleans-saints,5450000,2015
28157,0,8000000,Curtis Lofton,ILB,dead_cap,new-orleans-saints,8000000,2015
28158,0,1912500,Brodrick Bunkley,DT,dead_cap,new-orleans-saints,1912500,2015
28159,0,830000,Pierre Thomas,RB,dead_cap,new-orleans-saints,830000,2015
28160,426150,241224,Stanley Jean-Baptiste,CB,dead_cap,new-orleans-saints,667374,2015
28161,269911,148225,Akiem Hicks,DE,dead_cap,new-orleans-saints,418136,2015
28162,270000,80000,Parys Haralson,DE,dead_cap,new-orleans-saints,350000,2015
28163,349411,0,T.J. Graham,WR,dead_cap,new-orleans-saints,349411,2015
28164,0,309420,Khairi Fortt,OLB,dead_cap,new-orleans-saints,309420,2015
28165,0,300000,Erik Lorig,FB,dead_cap,new-orleans-saints,300000,2015
28166,273000,0,Austin Johnson,FB,dead_cap,new-orleans-saints,273000,2015
28167,0,250000,Champ Bailey,CB,dead_cap,new-orleans-saints,250000,2015
28168,172058,0,Don Jones,FS,dead_cap,new-orleans-saints,172058,2015
28169,153529,0,Zach Hocker,K,dead_cap,new-orleans-saints,153529,2015
28170,137646,15000,Joseph Morgan,WR,dead_cap,new-orleans-saints,152646,2015
28171,143576,0,Toben Opurum,DE,dead_cap,new-orleans-saints,143576,2015
28172,38823,101903,Nick Toon,WR,dead_cap,new-orleans-saints,140726,2015
28173,204705,0,JoLonn Dunbar,OLB,dead_cap,new-orleans-saints,204705,2015
28174,115800,1400,Seantavius Jones,WR,dead_cap,new-orleans-saints,117200,2015
28175,112200,2000,Cyril Lemon,G,dead_cap,new-orleans-saints,114200,2015
28176,112200,1800,Ashaad Mabry,DT,dead_cap,new-orleans-saints,114000,2015
28177,112200,0,Chris Manhertz,TE,dead_cap,new-orleans-saints,112200,2015
28178,105600,0,Alden Darby,FS,dead_cap,new-orleans-saints,105600,2015
28179,131470,0,Kenny Phillips,FS,dead_cap,new-orleans-saints,131470,2015
28180,103235,0,Phillip Hunt,DE,dead_cap,new-orleans-saints,103235,2015
28181,58764,42215,Ronald Powell,OLB,dead_cap,new-orleans-saints,100979,2015
28182,0,97226,Kenny Stills,WR,dead_cap,new-orleans-saints,97226,2015
28183,85800,0,Reggie Bell,WR,dead_cap,new-orleans-saints,85800,2015
28184,82800,0,Sammy Seamster,CB,dead_cap,new-orleans-saints,82800,2015
28185,81882,0,Kevin Brock,TE,dead_cap,new-orleans-saints,81882,2015
28186,73200,0,Akeem Davis,SS,dead_cap,new-orleans-saints,73200,2015
28187,0,73074,Tavon Rooks,LT,dead_cap,new-orleans-saints,73074,2015
28188,102352,0,Brandon Fields,P,dead_cap,new-orleans-saints,102352,2015
28189,34411,30000,Mike McGlynn,G,dead_cap,new-orleans-saints,64411,2015
28190,61411,0,Mike Brewster,C,dead_cap,new-orleans-saints,61411,2015
28191,0,60000,Bryce Harris,RT,dead_cap,new-orleans-saints,60000,2015
28192,59400,0,Ryan Seymour,G,dead_cap,new-orleans-saints,59400,2015
28193,59400,0,Bryan Witzmann,G,dead_cap,new-orleans-saints,59400,2015
28194,46200,0,Rashaun Allen,TE,dead_cap,new-orleans-saints,46200,2015
28195,0,44125,Corey White,CB,dead_cap,new-orleans-saints,44125,2015
28196,39600,0,Connor Hamlett,TE,dead_cap,new-orleans-saints,39600,2015
28197,38823,0,Tony Carter,CB,dead_cap,new-orleans-saints,38823,2015
28198,38823,0,Mike Mohamed,ILB,dead_cap,new-orleans-saints,38823,2015
28199,43823,0,Tim Hightower,RB,dead_cap,new-orleans-saints,43823,2015
28200,26400,0,Bronson Hill,RB,dead_cap,new-orleans-saints,26400,2015
28201,19100,3333,Sean Hickey,T,dead_cap,new-orleans-saints,22433,2015
28202,19800,0,Shane Wynn,WR,dead_cap,new-orleans-saints,19800,2015
28203,13200,0,Henry Coley,LB,dead_cap,new-orleans-saints,13200,2015
28204,13200,0,DuJuan Harris,RB,dead_cap,new-orleans-saints,13200,2015
28205,0,10000,Shayne Graham,K,dead_cap,new-orleans-saints,10000,2015
28206,6600,1800,R.J. Harris,WR,dead_cap,new-orleans-saints,8400,2015
28207,5000,2000,Marcus Pierce-Brewster,LB,dead_cap,new-orleans-saints,7000,2015
28208,6600,0,Blake Annen,TE,dead_cap,new-orleans-saints,6600,2015
28209,6600,0,Cameron Brate,TE,dead_cap,new-orleans-saints,6600,2015
28210,6600,0,Jeff Luc,ILB,dead_cap,new-orleans-saints,6600,2015
28211,0,5000,Matt Armstrong,C,dead_cap,new-orleans-saints,5000,2015
28212,0,4000,Marcus Ball,FS,dead_cap,new-orleans-saints,4000,2015
28213,0,3750,Ty Nsekhe,LT,dead_cap,new-orleans-saints,3750,2015
28214,0,3334,Brandon Coleman,WR,dead_cap,new-orleans-saints,3334,2015
28215,0,3334,Tim Flanders,RB,dead_cap,new-orleans-saints,3334,2015
28216,0,3334,Nic Jacobs,TE,dead_cap,new-orleans-saints,3334,2015
28217,0,3334,Logan Kilgore,QB,dead_cap,new-orleans-saints,3334,2015
28218,0,3334,George Uko,DT,dead_cap,new-orleans-saints,3334,2015
28219,0,3334,Chidera Uzo-Diribe,DE,dead_cap,new-orleans-saints,3334,2015
28220,0,3334,Lawrence Virgil,DE,dead_cap,new-orleans-saints,3334,2015
28221,0,3000,Derrius Brooks,CB,dead_cap,new-orleans-saints,3000,2015
28222,0,3000,Ty Zimmerman,SS,dead_cap,new-orleans-saints,3000,2015
28223,0,2667,Je'Ron Hamm,WR,dead_cap,new-orleans-saints,2667,2015
28224,0,2667,Pierre Warren,FS,dead_cap,new-orleans-saints,2667,2015
28225,0,2500,Derek Dimke,K,dead_cap,new-orleans-saints,2500,2015
28226,0,2334,Glenn Foster,DE,dead_cap,new-orleans-saints,2334,2015
28227,0,1800,Harold Spears,TE,dead_cap,new-orleans-saints,1800,2015
28228,0,1668,Kevin Reddick,ILB,dead_cap,new-orleans-saints,1668,2015
28229,0,1668,Rod Sweeting,CB,dead_cap,new-orleans-saints,1668,2015
28230,0,1000,Spencer Hadley,OLB,dead_cap,new-orleans-saints,1000,2015
28231,1000000,16250000,Drew Brees,QB,active,new-orleans-saints,17250000,2016
28232,7400000,3500000,Jairus Byrd,FS,active,new-orleans-saints,10900000,2016
28233,765000,5047000,Cameron Jordan,DE,active,new-orleans-saints,5812000,2016
28234,850000,3506240,Max Unger,C,active,new-orleans-saints,4356240,2016
28235,1000000,2700000,Zach Strief,RT,active,new-orleans-saints,3700000,2016
28236,1700000,1500000,Dannell Ellerbe,OLB,active,new-orleans-saints,3200000,2016
28237,900000,2150000,Thomas Morstead,P,active,new-orleans-saints,3050000,2016
28238,952887,1636544,Andrus Peat,G,active,new-orleans-saints,2589431,2016
28239,765000,1745000,Mark Ingram,RB,active,new-orleans-saints,2510000,2016
28240,800000,1600000,Coby Fleener,TE,active,new-orleans-saints,2400000,2016
28241,450000,1877572,Sheldon Rankins,DT,active,new-orleans-saints,2327572,2016
28242,1182132,1104264,Brandin Cooks,WR,active,new-orleans-saints,2286396,2016
28243,1671000,0,Tim Lelito,G,active,new-orleans-saints,1671000,2016
28244,900000,700000,Paul Kruger,OLB,active,new-orleans-saints,1600000,2016
28245,765000,745000,Nick Fairley,DT,active,new-orleans-saints,1510000,2016
28246,1000000,250000,Luke McCown,QB,active,new-orleans-saints,1250000,2016
28247,765000,435000,Craig Robertson,ILB,active,new-orleans-saints,1200000,2016
28248,977500,172500,Senio Kelemete,G,active,new-orleans-saints,1150000,2016
28249,675000,400000,Nathan Stupar,OLB,active,new-orleans-saints,1075000,2016
28250,1000000,0,Jahri Evans,G,active,new-orleans-saints,1000000,2016
28251,450000,480722,Michael Thomas,WR,active,new-orleans-saints,930722,2016
28252,760000,130000,Justin Drescher,LS,active,new-orleans-saints,890000,2016
28253,760000,80000,Tim Hightower,RB,active,new-orleans-saints,840000,2016
28254,450000,272236,Vonn Bell,SS,active,new-orleans-saints,722236,2016
28255,985000,80000,Roman Harper,SS,active,new-orleans-saints,1065000,2016
28256,670588,0,Tony Hills,LT,active,new-orleans-saints,670588,2016
28257,635294,0,B.W. Webb,CB,active,new-orleans-saints,635294,2016
28258,600000,2000,Kasim Edebali,OLB,active,new-orleans-saints,602000,2016
28259,985000,0,John Kuhn,FB,active,new-orleans-saints,985000,2016
28260,985000,0,Darryl Tapp,DE,active,new-orleans-saints,985000,2016
28261,760000,0,Travaris Cadet,RB,active,new-orleans-saints,760000,2016
28262,760000,0,Sterling Moore,CB,active,new-orleans-saints,760000,2016
28263,450000,135586,David Onyemata,DT,active,new-orleans-saints,585586,2016
28264,525000,54306,Tyeler Davison,DT,active,new-orleans-saints,579306,2016
28265,525000,17322,Marcus Murphy,RB,active,new-orleans-saints,542322,2016
28266,525000,0,Brandon Coleman,WR,active,new-orleans-saints,525000,2016
28267,525000,0,Willie Snead,WR,active,new-orleans-saints,525000,2016
28268,450000,18869,Daniel Lasco,RB,active,new-orleans-saints,468869,2016
28269,450000,1666,Tommylee Lewis,WR,active,new-orleans-saints,451666,2016
28270,450000,1666,Landon Turner,G,active,new-orleans-saints,451666,2016
28271,450000,1333,Devante Harris,CB,active,new-orleans-saints,451333,2016
28272,450000,0,Will Lutz,K,active,new-orleans-saints,450000,2016
28273,357647,0,Shiloh Keo,SS,active,new-orleans-saints,357647,2016
28274,317647,0,Sam Barrington,ILB,active,new-orleans-saints,317647,2016
28275,317640,0,Jake Lampman,WR,active,new-orleans-saints,317640,2016
28276,357647,0,John Phillips,TE,active,new-orleans-saints,357647,2016
28277,277941,0,Chris Banjo,SS,active,new-orleans-saints,277941,2016
28278,156176,0,Jason Trusnik,ILB,active,new-orleans-saints,156176,2016
28279,105880,0,Jack Allen,T,active,new-orleans-saints,105880,2016
28280,105880,0,Travis Feeney,OLB,active,new-orleans-saints,105880,2016
28281,70588,0,Corey Fuller,WR,active,new-orleans-saints,70588,2016
28282,61764,0,Robenson Therezie,FS,active,new-orleans-saints,61764,2016
28283,26470,0,Travez Calhoun,S,active,new-orleans-saints,26470,2016
28284,680000,2395359,Terron Armstead,LT,injured_reserve,new-orleans-saints,3075359,2016
28285,786442,970766,Stephone Anthony,OLB,injured_reserve,new-orleans-saints,1757208,2016
28286,750000,833333,Josh Hill,TE,injured_reserve,new-orleans-saints,1583333,2016
28287,850000,383333,Michael Hoomanawanui,TE,injured_reserve,new-orleans-saints,1233333,2016
28288,550000,176654,P.J. Williams,CB,injured_reserve,new-orleans-saints,726654,2016
28289,885000,80000,Jamarca Sanford,SS,injured_reserve,new-orleans-saints,965000,2016
28290,760000,80000,Kyle Wilson,CB,injured_reserve,new-orleans-saints,840000,2016
28291,525000,4000,Delvin Breaux,CB,injured_reserve,new-orleans-saints,529000,2016
28292,450000,1666,Ken Crawley,CB,injured_reserve,new-orleans-saints,451666,2016
28293,348000,46807,Damian Swann,CB,injured_reserve,new-orleans-saints,394807,2016
28294,379235,0,Obum Gwacham,DE,injured_reserve,new-orleans-saints,379235,2016
28295,367408,0,Erik Harris,CB,injured_reserve,new-orleans-saints,367408,2016
28296,333000,1666,D.J. Pettway,DT,injured_reserve,new-orleans-saints,334666,2016
28297,333000,0,Jimmy Pruitt,CB,injured_reserve,new-orleans-saints,333000,2016
28298,675000,0,Michael Mauti,OLB,non_fb_injury,new-orleans-saints,675000,2016
28299,408706,1666,Mitchell Loewen,TE,non_fb_injury,new-orleans-saints,410372,2016
28300,408705,0,Avery Young,T,non_fb_injury,new-orleans-saints,408705,2016
28301,27600,0,Rob Crisp,LT,practice_squad,new-orleans-saints,27600,2016
28302,0,12100000,Junior Galette,OLB,dead_cap,new-orleans-saints,12100000,2016
28303,0,5100000,Jahri Evans,G,dead_cap,new-orleans-saints,5100000,2016
28304,1700000,2800000,C.J. Spiller,RB,dead_cap,new-orleans-saints,4500000,2016
28305,2750000,1300000,Brandon Browner,CB,dead_cap,new-orleans-saints,4050000,2016
28306,0,3650000,Keenan Lewis,CB,dead_cap,new-orleans-saints,3650000,2016
28307,0,3400000,Marques Colston,WR,dead_cap,new-orleans-saints,3400000,2016
28308,0,3010000,David Hawthorne,ILB,dead_cap,new-orleans-saints,3010000,2016
28309,0,1612500,Brodrick Bunkley,DT,dead_cap,new-orleans-saints,1612500,2016
28310,950000,650000,James Laurinaitis,ILB,dead_cap,new-orleans-saints,1600000,2016
28311,884647,141890,John Jenkins,DE,dead_cap,new-orleans-saints,1026537,2016
28312,0,500000,Erik Lorig,FB,dead_cap,new-orleans-saints,500000,2016
28313,0,482448,Stanley Jean-Baptiste,CB,dead_cap,new-orleans-saints,482448,2016
28314,117300,183292,Garrett Grayson,QB,dead_cap,new-orleans-saints,300592,2016
28315,217076,1668,Brian Dixon,CB,dead_cap,new-orleans-saints,218744,2016
28316,0,167000,Ramon Humber,OLB,dead_cap,new-orleans-saints,167000,2016
28317,132350,0,Chris Manhertz,TE,dead_cap,new-orleans-saints,132350,2016
28318,117300,3600,Ashaad Mabry,DT,dead_cap,new-orleans-saints,120900,2016
28319,117300,0,John Fullington,G,dead_cap,new-orleans-saints,117300,2016
28320,117300,0,Garrett Griffin,TE,dead_cap,new-orleans-saints,117300,2016
28321,117300,0,Jordan Williams,WR,dead_cap,new-orleans-saints,117300,2016
28322,110400,0,Jake Stoneburner,TE,dead_cap,new-orleans-saints,110400,2016
28323,110400,0,Travez Calhoun,S,dead_cap,new-orleans-saints,110400,2016
28324,97940,0,Tyrus Thompson,T,dead_cap,new-orleans-saints,97940,2016
28325,89700,0,Jack Allen,T,dead_cap,new-orleans-saints,89700,2016
28326,0,88250,Vinnie Sunseri,SS,dead_cap,new-orleans-saints,88250,2016
28327,0,84432,Ronald Powell,OLB,dead_cap,new-orleans-saints,84432,2016
28328,0,80000,Travaris Cadet,RB,dead_cap,new-orleans-saints,80000,2016
28329,0,80000,Kai Forbath,K,dead_cap,new-orleans-saints,80000,2016
28330,79976,0,Chris McCain,OLB,dead_cap,new-orleans-saints,79976,2016
28331,57941,0,Khalif Barnes,LT,dead_cap,new-orleans-saints,57941,2016
28332,0,55433,Davis Tull,DE,dead_cap,new-orleans-saints,55433,2016
28333,0,50000,Cortland Finnegan,CB,dead_cap,new-orleans-saints,50000,2016
28334,39176,0,Jeff Schoettmer,S,dead_cap,new-orleans-saints,39176,2016
28335,34504,0,Lamar Louis,ILB,dead_cap,new-orleans-saints,34504,2016
28336,34500,0,Jake Lampman,WR,dead_cap,new-orleans-saints,34500,2016
28337,26470,0,Joe Callahan,QB,dead_cap,new-orleans-saints,26470,2016
28338,26470,0,Ryker Matthews,T,dead_cap,new-orleans-saints,26470,2016
28339,20700,0,Justin Zimmer,DT,dead_cap,new-orleans-saints,20700,2016
28340,13800,0,Royce LaFrance,DT,dead_cap,new-orleans-saints,13800,2016
28341,6900,1666,Bobby Richardson,DE,dead_cap,new-orleans-saints,8566,2016
28342,6900,0,Brian Blechen,OLB,dead_cap,new-orleans-saints,6900,2016
28343,6900,0,Austin Johnson,FB,dead_cap,new-orleans-saints,6900,2016
28344,6900,0,Will Lutz,K,dead_cap,new-orleans-saints,6900,2016
28345,6900,0,Tony Steward,OLB,dead_cap,new-orleans-saints,6900,2016
28346,0,6667,Sean Hickey,T,dead_cap,new-orleans-saints,6667,2016
28347,2500,3000,Mike Caputo,S,dead_cap,new-orleans-saints,5500,2016
28348,0,5000,Tavaris Barnes,DE,dead_cap,new-orleans-saints,5000,2016
28349,0,4000,Cyril Lemon,G,dead_cap,new-orleans-saints,4000,2016
28350,0,4000,Marcus Pierce-Brewster,LB,dead_cap,new-orleans-saints,4000,2016
28351,0,3600,R.J. Harris,WR,dead_cap,new-orleans-saints,3600,2016
28352,0,3600,Harold Spears,TE,dead_cap,new-orleans-saints,3600,2016
28353,0,1500,Dominque Tovell,OLB,dead_cap,new-orleans-saints,1500,2016
28354,0,1000,Jack Tabb,TE,dead_cap,new-orleans-saints,1000,2016
28355,0,333,Kaleb Eulls,DT,dead_cap,new-orleans-saints,333,2016
28356,13000000,6000000,Drew Brees,QB,active,new-orleans-saints,19000000,2017
28357,7000000,5047000,Cameron Jordan,DE,active,new-orleans-saints,12047000,2017
28358,4200000,3300000,Terron Armstead,LT,active,new-orleans-saints,7500000,2017
28359,1700000,5700000,Max Unger,C,active,new-orleans-saints,7400000,2017
28360,3100000,2245000,Mark Ingram,RB,active,new-orleans-saints,5345000,2017
28361,3150000,1550000,Thomas Morstead,P,active,new-orleans-saints,4700000,2017
28362,1700000,2100000,Larry Warford,G,active,new-orleans-saints,3800000,2017
28363,2000000,1000000,Ted Ginn Jr.,WR,active,new-orleans-saints,3000000,2017
28364,1031893,1877572,Sheldon Rankins,DT,active,new-orleans-saints,2909465,2017
28365,465000,2327647,Marshon Lattimore,CB,active,new-orleans-saints,2792647,2017
28366,1650000,945833,Josh Hill,TE,active,new-orleans-saints,2595833,2017
28367,1350000,583333,Michael Hoomanawanui,TE,active,new-orleans-saints,1933333,2017
28368,1105000,695000,Craig Robertson,ILB,active,new-orleans-saints,1800000,2017
28369,1275000,475000,Senio Kelemete,G,active,new-orleans-saints,1750000,2017
28370,850000,825000,Manti Te'o,ILB,active,new-orleans-saints,1675000,2017
28371,465000,1151646,Ryan Ramczyk,RT,active,new-orleans-saints,1616646,2017
28372,682681,480722,Michael Thomas,WR,active,new-orleans-saints,1163403,2017
28373,465000,669625,Marcus Williams,FS,active,new-orleans-saints,1134625,2017
28374,850000,200000,Chris Banjo,SS,active,new-orleans-saints,1050000,2017
28375,630559,272236,Vonn Bell,SS,active,new-orleans-saints,902795,2017
28376,900000,0,Chase Daniel,QB,active,new-orleans-saints,900000,2017
28377,640000,176654,P.J. Williams,CB,active,new-orleans-saints,816654,2017
28378,465000,243193,Alvin Kamara,RB,active,new-orleans-saints,708193,2017
28379,775000,80000,Rafael Bush,FS,active,new-orleans-saints,855000,2017
28380,540000,135586,David Onyemata,DT,active,new-orleans-saints,675586,2017
28381,615000,54306,Tyeler Davison,DT,active,new-orleans-saints,669306,2017
28382,465000,176572,Trey Hendrickson,DE,active,new-orleans-saints,641572,2017
28383,775000,0,Josh LeRibeus,C,active,new-orleans-saints,775000,2017
28384,615000,0,Brandon Coleman,WR,active,new-orleans-saints,615000,2017
28385,540000,1666,Ken Crawley,CB,active,new-orleans-saints,541666,2017
28386,540000,1666,Tommylee Lewis,WR,active,new-orleans-saints,541666,2017
28387,540000,0,Wil Lutz,K,active,new-orleans-saints,540000,2017
28388,506471,0,Willie Snead,WR,active,new-orleans-saints,506471,2017
28389,465000,37616,Al-Quadin Muhammad,DE,active,new-orleans-saints,502616,2017
28390,592644,0,Zach Line,FB,active,new-orleans-saints,592644,2017
28391,465000,0,Austin Carr,WR,active,new-orleans-saints,465000,2017
28392,465000,0,Trey Edmunds,RB,active,new-orleans-saints,465000,2017
28393,465000,0,Taysom Hill,QB,active,new-orleans-saints,465000,2017
28394,465000,0,Zach Wood,DE,active,new-orleans-saints,465000,2017
28395,547059,0,Gerald Hodges,OLB,active,new-orleans-saints,547059,2017
28396,410294,0,Justin Hardee,CB,active,new-orleans-saints,410294,2017
28397,501471,0,Michael Mauti,OLB,active,new-orleans-saints,501471,2017
28398,273529,0,Cameron Tom,G,active,new-orleans-saints,273529,2017
28399,222353,25000,Jonathan Williams,RB,active,new-orleans-saints,247353,2017
28400,136765,0,Arthur Maulet,CB,active,new-orleans-saints,136765,2017
28401,136765,0,Jonathan Freeny,OLB,active,new-orleans-saints,136765,2017
28402,136765,0,George Johnson,DE,active,new-orleans-saints,136765,2017
28403,105882,0,Sterling Moore,CB,active,new-orleans-saints,105882,2017
28404,40588,0,Kasim Edebali,OLB,active,new-orleans-saints,40588,2017
28405,27353,0,John Fullington,G,active,new-orleans-saints,27353,2017
28406,0,0,John Phillips,TE,active,new-orleans-saints,0,2017
28407,5800000,1700000,Coby Fleener,TE,injured_reserve,new-orleans-saints,7500000,2017
28408,1700000,4400000,Zach Strief,RT,injured_reserve,new-orleans-saints,6100000,2017
28409,5676000,0,Kenny Vaccaro,SS,injured_reserve,new-orleans-saints,5676000,2017
28410,1470773,1636544,Andrus Peat,G,injured_reserve,new-orleans-saints,3107317,2017
28411,1700000,1100000,A.J. Klein,ILB,injured_reserve,new-orleans-saints,2800000,2017
28412,935000,1065000,Alex Okafor,DE,injured_reserve,new-orleans-saints,2000000,2017
28413,1350000,450000,Nathan Stupar,OLB,injured_reserve,new-orleans-saints,1800000,2017
28414,913755,522511,Hau'oli Kikaha,OLB,injured_reserve,new-orleans-saints,1436266,2017
28415,615000,4000,Delvin Breaux,CB,injured_reserve,new-orleans-saints,619000,2017
28416,900000,0,Clay Harbor,TE,injured_reserve,new-orleans-saints,900000,2017
28417,375530,216148,Alex Anzalone,OLB,injured_reserve,new-orleans-saints,591678,2017
28418,823529,0,John Kuhn,FB,injured_reserve,new-orleans-saints,823529,2017
28419,465000,1666,Mitchell Loewen,TE,injured_reserve,new-orleans-saints,466666,2017
28420,465000,0,Dan Arnold,WR,injured_reserve,new-orleans-saints,465000,2017
28421,364706,0,John Hughes,DE,injured_reserve,new-orleans-saints,364706,2017
28422,363000,0,Jack Allen,T,injured_reserve,new-orleans-saints,363000,2017
28423,349412,0,Daniel Lasco,RB,injured_reserve,new-orleans-saints,349412,2017
28424,348000,500,Devaroe Lawrence,DT,injured_reserve,new-orleans-saints,348500,2017
28425,347471,0,David Parry,DT,injured_reserve,new-orleans-saints,347471,2017
28426,136765,0,Garrett Griffin,TE,injured_reserve,new-orleans-saints,136765,2017
28427,58824,0,Tony McDaniel,DT,injured_reserve,new-orleans-saints,58824,2017
28428,1000000,2000000,Nick Fairley,DT,non_fb_injury,new-orleans-saints,3000000,2017
28429,0,3600000,Keenan Lewis,CB,dead_cap,new-orleans-saints,3600000,2017
28430,0,3400000,Jairus Byrd,FS,dead_cap,new-orleans-saints,3400000,2017
28431,0,2500000,C.J. Spiller,RB,dead_cap,new-orleans-saints,2500000,2017
28432,294118,1250000,Adrian Peterson,RB,dead_cap,new-orleans-saints,1544118,2017
28433,0,1490000,Nick Fairley,DT,dead_cap,new-orleans-saints,1490000,2017
28434,0,1400000,Paul Kruger,OLB,dead_cap,new-orleans-saints,1400000,2017
28435,0,1300000,Brandon Browner,CB,dead_cap,new-orleans-saints,1300000,2017
28436,0,1200000,James Laurinaitis,ILB,dead_cap,new-orleans-saints,1200000,2017
28437,133869,970766,Stephone Anthony,OLB,dead_cap,new-orleans-saints,1104635,2017
28438,0,1104264,Brandin Cooks,WR,dead_cap,new-orleans-saints,1104264,2017
28439,933824,125000,Sterling Moore,CB,dead_cap,new-orleans-saints,1058824,2017
28440,0,800000,Dannell Ellerbe,OLB,dead_cap,new-orleans-saints,800000,2017
28441,1000000,80000,John Kuhn,FB,dead_cap,new-orleans-saints,1080000,2017
28442,409976,1333,Devante Harris,CB,dead_cap,new-orleans-saints,411309,2017
28443,0,366584,Garrett Grayson,QB,dead_cap,new-orleans-saints,366584,2017
28444,365292,0,Corey Fuller,WR,dead_cap,new-orleans-saints,365292,2017
28445,273528,0,Bryce Harris,RT,dead_cap,new-orleans-saints,273528,2017
28446,264706,0,John Greco,G,dead_cap,new-orleans-saints,264706,2017
28447,0,250000,Luke McCown,QB,dead_cap,new-orleans-saints,250000,2017
28448,192177,0,Martin Wallace,LT,dead_cap,new-orleans-saints,192177,2017
28449,182859,0,Adam Bighill,ILB,dead_cap,new-orleans-saints,182859,2017
28450,182353,0,John Hughes,DE,dead_cap,new-orleans-saints,182353,2017
28451,52941,80000,John Phillips,TE,dead_cap,new-orleans-saints,132941,2017
28452,121553,4000,Arthur Maulet,CB,dead_cap,new-orleans-saints,125553,2017
28453,122400,1666,Landon Turner,G,dead_cap,new-orleans-saints,124066,2017
28454,122400,0,Travin Dural,WR,dead_cap,new-orleans-saints,122400,2017
28455,122400,0,Alex Jenkins,DE,dead_cap,new-orleans-saints,122400,2017
28456,115200,0,John Fullington,G,dead_cap,new-orleans-saints,115200,2017
28457,0,110866,Davis Tull,DE,dead_cap,new-orleans-saints,110866,2017
28458,86400,0,Garrett Griffin,TE,dead_cap,new-orleans-saints,86400,2017
28459,86400,0,Woodrow Hamilton,DT,dead_cap,new-orleans-saints,86400,2017
28460,86400,0,Shayne Skov,ILB,dead_cap,new-orleans-saints,86400,2017
28461,0,80000,Travaris Cadet,RB,dead_cap,new-orleans-saints,80000,2017
28462,0,80000,Michael Mauti,OLB,dead_cap,new-orleans-saints,80000,2017
28463,72000,0,Nate Theaker,G,dead_cap,new-orleans-saints,72000,2017
28464,60400,3333,Cameron Tom,G,dead_cap,new-orleans-saints,63733,2017
28465,0,60000,Darryl Tapp,DE,dead_cap,new-orleans-saints,60000,2017
28466,36000,18870,Daniel Lasco,RB,dead_cap,new-orleans-saints,54870,2017
28467,50400,0,Gabe Martin,ILB,dead_cap,new-orleans-saints,50400,2017
28468,0,46808,Damian Swann,CB,dead_cap,new-orleans-saints,46808,2017
28469,43376,0,Ben Heeney,ILB,dead_cap,new-orleans-saints,43376,2017
28470,741176,0,Kendall Langford,DE,dead_cap,new-orleans-saints,741176,2017
28471,36176,0,Dexter McDougle,CB,dead_cap,new-orleans-saints,36176,2017
28472,36000,0,Alex Ellis,TE,dead_cap,new-orleans-saints,36000,2017
28473,15000,10000,Colin Buchanan,T,dead_cap,new-orleans-saints,25000,2017
28474,21600,0,Bradley Sylve,CB,dead_cap,new-orleans-saints,21600,2017
28475,0,17323,Marcus Murphy,RB,dead_cap,new-orleans-saints,17323,2017
28476,14400,0,Justin Hardee,CB,dead_cap,new-orleans-saints,14400,2017
28477,14400,0,Gabe Ikard,C,dead_cap,new-orleans-saints,14400,2017
28478,14400,0,Justin Murray,T,dead_cap,new-orleans-saints,14400,2017
28479,14400,0,David Parry,DT,dead_cap,new-orleans-saints,14400,2017
28480,7200,0,Max McCaffrey,WR,dead_cap,new-orleans-saints,7200,2017
28481,7200,0,Kristjan Sokoli,G,dead_cap,new-orleans-saints,7200,2017
28482,7200,0,Mykkele Thompson,FS,dead_cap,new-orleans-saints,7200,2017
28483,0,3334,Kaleb Eulls,DT,dead_cap,new-orleans-saints,3334,2017
28484,0,3334,D.J. Pettway,DT,dead_cap,new-orleans-saints,3334,2017
28485,0,3000,Dominque Tovell,OLB,dead_cap,new-orleans-saints,3000,2017
28486,0,1668,Bobby Richardson,DE,dead_cap,new-orleans-saints,1668,2017
28487,0,1000,Jack Tabb,TE,dead_cap,new-orleans-saints,1000,2017
28488,10200000,13800000,Drew Brees,QB,active,new-orleans-saints,24000000,2018
28489,8650000,5847000,Cameron Jordan,DE,active,new-orleans-saints,14497000,2018
28490,5400000,4650000,Terron Armstead,LT,active,new-orleans-saints,10050000,2018
28491,4250000,4750000,Larry Warford,G,active,new-orleans-saints,9000000,2018
28492,4500000,3500000,Max Unger,C,active,new-orleans-saints,8000000,2018
28493,3058824,2245000,Mark Ingram,RB,active,new-orleans-saints,5303824,2018
28494,4100000,1100000,A.J. Klein,OLB,active,new-orleans-saints,5200000,2018
28495,3000000,1500000,Ted Ginn Jr.,WR,active,new-orleans-saints,4500000,2018
28496,1988657,1636547,Andrus Peat,G,active,new-orleans-saints,3625204,2018
28497,1800000,1783334,Josh Hill,TE,active,new-orleans-saints,3583334,2018
28498,1163162,2327647,Marshon Lattimore,CB,active,new-orleans-saints,3490809,2018
28499,1700000,1600000,Kurt Coleman,SS,active,new-orleans-saints,3300000,2018
28500,850000,2450000,Demario Davis,OLB,active,new-orleans-saints,3300000,2018
28501,1700000,1100000,Manti Te'o,ILB,active,new-orleans-saints,2800000,2018
28502,918000,1732000,Thomas Morstead,P,active,new-orleans-saints,2650000,2018
28503,850000,1650000,Alex Okafor,DE,active,new-orleans-saints,2500000,2018
28504,480000,2018526,Marcus Davenport,DE,active,new-orleans-saints,2498526,2018
28505,935000,1355000,Teddy Bridgewater,QB,active,new-orleans-saints,2290000,2018
28506,869162,1151646,Ryan Ramczyk,RT,active,new-orleans-saints,2020808,2018
28507,1275000,725000,Craig Robertson,ILB,active,new-orleans-saints,2000000,2018
28508,1105000,895000,Benjamin Watson,TE,active,new-orleans-saints,2000000,2018
28509,1907000,54307,Tyeler Davison,DT,active,new-orleans-saints,1961307,2018
28510,1000000,550000,Chris Banjo,SS,active,new-orleans-saints,1550000,2018
28511,748656,669625,Marcus Williams,FS,active,new-orleans-saints,1418281,2018
28512,915361,480722,Michael Thomas,WR,active,new-orleans-saints,1396083,2018
28513,811118,272236,Vonn Bell,SS,active,new-orleans-saints,1083354,2018
28514,1074991,0,Eli Apple,CB,active,new-orleans-saints,1074991,2018
28515,850000,150000,Zach Line,FB,active,new-orleans-saints,1000000,2018
28516,730000,176657,P.J. Williams,CB,active,new-orleans-saints,906657,2018
28517,635000,243193,Alvin Kamara,RB,active,new-orleans-saints,878193,2018
28518,610000,216148,Alex Anzalone,OLB,active,new-orleans-saints,826148,2018
28519,630000,135586,David Onyemata,DT,active,new-orleans-saints,765586,2018
28520,578000,176572,Trey Hendrickson,DE,active,new-orleans-saints,754572,2018
28521,480000,204256,Tre'quan Smith,WR,active,new-orleans-saints,684256,2018
28522,630000,1668,Ken Crawley,CB,active,new-orleans-saints,631668,2018
28523,630000,1668,Tommylee Lewis,WR,active,new-orleans-saints,631668,2018
28524,630000,0,Wil Lutz,K,active,new-orleans-saints,630000,2018
28525,955294,0,Jermon Bushrod,G,active,new-orleans-saints,955294,2018
28526,555000,0,Austin Carr,WR,active,new-orleans-saints,555000,2018
28527,555000,0,Justin Hardee,CB,active,new-orleans-saints,555000,2018
28528,555000,0,Taysom Hill,QB,active,new-orleans-saints,555000,2018
28529,555000,0,Cameron Tom,G,active,new-orleans-saints,555000,2018
28530,555000,0,Zach Wood,LS,active,new-orleans-saints,555000,2018
28531,518824,0,Dwayne Washington,RB,active,new-orleans-saints,518824,2018
28532,480000,18285,Will Clapp,C,active,new-orleans-saints,498285,2018
28533,489706,0,Vince Biegel,OLB,active,new-orleans-saints,489706,2018
28534,480000,3333,Taylor Stallworth,DT,active,new-orleans-saints,483333,2018
28535,480000,0,Dan Arnold,WR,active,new-orleans-saints,480000,2018
28536,225880,0,Keith Kirkwood,WR,active,new-orleans-saints,225880,2018
28537,53824,0,Derek Newton,RT,active,new-orleans-saints,53824,2018
28538,0,0,Tyrunn Walker,DT,active,new-orleans-saints,0,2018
28539,1613786,1877572,Sheldon Rankins,DT,injured_reserve,new-orleans-saints,3491358,2018
28540,850000,1850000,Cameron Meredith,WR,injured_reserve,new-orleans-saints,2700000,2018
28541,1000000,1250000,Patrick Robinson,CB,injured_reserve,new-orleans-saints,2250000,2018
28542,1350000,583334,Michael Hoomanawanui,TE,injured_reserve,new-orleans-saints,1933334,2018
28543,790000,0,Josh LeRibeus,G,injured_reserve,new-orleans-saints,790000,2018
28544,588235,0,Dez Bryant,WR,injured_reserve,new-orleans-saints,588235,2018
28545,511176,0,Jay Bromley,DT,injured_reserve,new-orleans-saints,511176,2018
28546,790000,0,Michael Ola,T,injured_reserve,new-orleans-saints,790000,2018
28547,363000,0,Travin Dural,WR,injured_reserve,new-orleans-saints,363000,2018
28548,363000,0,Rickey Jefferson,CB,injured_reserve,new-orleans-saints,363000,2018
28549,84705,0,Simmie Cobbs Jr.,WR,injured_reserve,new-orleans-saints,84705,2018
28550,393000,0,Daniel Lasco,RB,non_fb_injury,new-orleans-saints,393000,2018
28551,129200,0,Nate Wozniak,G,practice_squad,new-orleans-saints,129200,2018
28552,3400000,1600000,Coby Fleener,TE,dead_cap,new-orleans-saints,5000000,2018
28553,0,4600000,Jairus Byrd,FS,dead_cap,new-orleans-saints,4600000,2018
28554,0,3000000,Nick Fairley,DT,dead_cap,new-orleans-saints,3000000,2018
28555,0,1250000,Adrian Peterson,RB,dead_cap,new-orleans-saints,1250000,2018
28556,0,1100000,Zach Strief,RT,dead_cap,new-orleans-saints,1100000,2018
28557,0,970766,Stephone Anthony,OLB,dead_cap,new-orleans-saints,970766,2018
28558,790000,60000,Mike Gillislee,RB,dead_cap,new-orleans-saints,850000,2018
28559,0,625000,Nathan Stupar,OLB,dead_cap,new-orleans-saints,625000,2018
28560,0,522511,Hau'oli Kikaha,OLB,dead_cap,new-orleans-saints,522511,2018
28561,451760,1668,Mitchell Loewen,TE,dead_cap,new-orleans-saints,453428,2018
28562,592059,0,Josh Robinson,CB,dead_cap,new-orleans-saints,592059,2018
28563,335550,1666,J.T. Gray,DE,dead_cap,new-orleans-saints,337216,2018
28564,277000,5666,Keith Kirkwood,LB,dead_cap,new-orleans-saints,282666,2018
28565,179118,90000,Jermon Bushrod,G,dead_cap,new-orleans-saints,269118,2018
28566,207353,0,Chaz Green,G,dead_cap,new-orleans-saints,207353,2018
28567,148235,50000,Jonathan Williams,RB,dead_cap,new-orleans-saints,198235,2018
28568,30400,153357,Rick Leonard,T,dead_cap,new-orleans-saints,183757,2018
28569,238824,0,Brandon Marshall,WR,dead_cap,new-orleans-saints,238824,2018
28570,148235,0,Jay Bromley,DT,dead_cap,new-orleans-saints,148235,2018
28571,148235,0,Brandon Tate,WR,dead_cap,new-orleans-saints,148235,2018
28572,0,145000,Tom Savage,QB,dead_cap,new-orleans-saints,145000,2018
28573,135941,8000,Arthur Maulet,CB,dead_cap,new-orleans-saints,143941,2018
28574,106400,36494,Boston Scott,RB,dead_cap,new-orleans-saints,142894,2018
28575,129200,0,Garrett Griffin,TE,dead_cap,new-orleans-saints,129200,2018
28576,129200,0,Alex Jenkins,DE,dead_cap,new-orleans-saints,129200,2018
28577,120441,0,Demetri Goodson,CB,dead_cap,new-orleans-saints,120441,2018
28578,114000,0,Darnell Sankey,ILB,dead_cap,new-orleans-saints,114000,2018
28579,105400,5000,Deon Yelder,TE,dead_cap,new-orleans-saints,110400,2018
28580,106400,0,Tomasi Laulile,DT,dead_cap,new-orleans-saints,106400,2018
28581,0,100000,Brandon Coleman,WR,dead_cap,new-orleans-saints,100000,2018
28582,98800,0,J.T. Barrett,QB,dead_cap,new-orleans-saints,98800,2018
28583,83600,0,Chris Campbell,CB,dead_cap,new-orleans-saints,83600,2018
28584,0,66405,Natrell Jamerson,S,dead_cap,new-orleans-saints,66405,2018
28585,60800,0,Will Holden,T,dead_cap,new-orleans-saints,60800,2018
28586,53824,0,Derek Newton,RT,dead_cap,new-orleans-saints,53824,2018
28587,0,46808,Damian Swann,CB,dead_cap,new-orleans-saints,46808,2018
28588,0,39620,Kamrin Moore,CB,dead_cap,new-orleans-saints,39620,2018
28589,0,37740,Daniel Lasco,RB,dead_cap,new-orleans-saints,37740,2018
28590,0,37616,Al-Quadin Muhammad,DE,dead_cap,new-orleans-saints,37616,2018
28591,46471,0,Cornelius Lucas,RT,dead_cap,new-orleans-saints,46471,2018
28592,46471,0,Michael Ola,T,dead_cap,new-orleans-saints,46471,2018
28593,0,30000,George Johnson,DE,dead_cap,new-orleans-saints,30000,2018
28594,28200,0,Dwayne Washington,RB,dead_cap,new-orleans-saints,28200,2018
28595,22800,0,Woodrow Hamilton,DT,dead_cap,new-orleans-saints,22800,2018
28596,22800,0,Isaiah Williams,G,dead_cap,new-orleans-saints,22800,2018
28597,0,21334,Devante Harris,CB,dead_cap,new-orleans-saints,21334,2018
28598,0,17323,Marcus Murphy,RB,dead_cap,new-orleans-saints,17323,2018
28599,15200,0,Vince Biegel,OLB,dead_cap,new-orleans-saints,15200,2018
28600,15200,0,Darius Hillary,CB,dead_cap,new-orleans-saints,15200,2018
28601,15200,0,Chris Lammons,CB,dead_cap,new-orleans-saints,15200,2018
28602,15200,0,Tanner McEvoy,WR,dead_cap,new-orleans-saints,15200,2018
28603,15200,0,Martez Carter,RB,dead_cap,new-orleans-saints,15200,2018
28604,7600,0,Arrion Springs,S,dead_cap,new-orleans-saints,7600,2018
28605,0,6667,Cameron Tom,G,dead_cap,new-orleans-saints,6667,2018
28606,0,1668,Landon Turner,G,dead_cap,new-orleans-saints,1668,2018
28607,0,500,Devaroe Lawrence,DT,dead_cap,new-orleans-saints,500,2018
28608,6800000,15900000,Drew Brees,QB,active,new-orleans-saints,22700000,2019
28609,10700000,5268750,Terron Armstead,LT,active,new-orleans-saints,15968750,2019
28610,9625000,0,Andrus Peat,G,active,new-orleans-saints,9625000,2019
28611,935000,10359000,Cameron Jordan,DE,active,new-orleans-saints,11294000,2019
28612,5950000,2550000,Demario Davis,OLB,active,new-orleans-saints,8500000,2019
28613,3100000,5225000,Larry Warford,G,active,new-orleans-saints,8325000,2019
28614,1648043,4480722,Michael Thomas,WR,active,new-orleans-saints,6128765,2019
28615,4100000,1575000,A.J. Klein,ILB,active,new-orleans-saints,5675000,2019
28616,4000000,1350000,Patrick Robinson,CB,active,new-orleans-saints,5350000,2019
28617,2950000,1300000,Thomas Morstead,P,active,new-orleans-saints,4250000,2019
28618,1861324,2327647,Marshon Lattimore,CB,active,new-orleans-saints,4188971,2019
28619,2000000,2000000,Jared Cook,TE,active,new-orleans-saints,4000000,2019
28620,2500000,1000000,Ted Ginn Jr.,WR,active,new-orleans-saints,3500000,2019
28621,1250000,2000000,Teddy Bridgewater,QB,active,new-orleans-saints,3250000,2019
28622,2516225,0,Eli Apple,CB,active,new-orleans-saints,2516225,2019
28623,2000000,500000,Nick Easton,G,active,new-orleans-saints,2500000,2019
28624,1000000,1500000,Malcom Brown,DT,active,new-orleans-saints,2500000,2019
28625,1273323,1151646,Ryan Ramczyk,RT,active,new-orleans-saints,2424969,2019
28626,850000,1400000,P.J. Williams,CB,active,new-orleans-saints,2250000,2019
28627,1905882,127610,David Onyemata,DT,active,new-orleans-saints,2033492,2019
28628,850000,1050000,Josh Hill,TE,active,new-orleans-saints,1900000,2019
28629,850000,1050000,Wil Lutz,K,active,new-orleans-saints,1900000,2019
28630,1000000,850000,Latavius Murray,RB,active,new-orleans-saints,1850000,2019
28631,1032313,669625,Marcus Williams,FS,active,new-orleans-saints,1701938,2019
28632,1000000,700000,Craig Robertson,ILB,active,new-orleans-saints,1700000,2019
28633,935000,525000,Mario Edwards,DT,active,new-orleans-saints,1460000,2019
28634,991677,272237,Vonn Bell,SS,active,new-orleans-saints,1263914,2019
28635,850000,350000,Zach Line,FB,active,new-orleans-saints,1200000,2019
28636,1194118,0,Janoris Jenkins,CB,active,new-orleans-saints,1194118,2019
28637,495000,610045,Erik McCoy,C,active,new-orleans-saints,1105045,2019
28638,807500,243193,Alvin Kamara,RB,active,new-orleans-saints,1050693,2019
28639,850000,0,Kiko Alonso,OLB,active,new-orleans-saints,850000,2019
28640,668000,176572,Trey Hendrickson,DE,active,new-orleans-saints,844572,2019
28641,616500,204256,Tre'quan Smith,WR,active,new-orleans-saints,820756,2019
28642,720000,0,Dwayne Washington,RB,active,new-orleans-saints,720000,2019
28643,495000,196025,Chauncey Gardner-Johnson,S,active,new-orleans-saints,691025,2019
28644,805000,0,Patrick Omameh,RT,active,new-orleans-saints,805000,2019
28645,645000,0,Justin Hardee,CB,active,new-orleans-saints,645000,2019
28646,645000,0,Taysom Hill,QB,active,new-orleans-saints,645000,2019
28647,645000,0,Zach Wood,LS,active,new-orleans-saints,645000,2019
28648,570000,18285,Will Clapp,C,active,new-orleans-saints,588285,2019
28649,570000,0,J.T. Gray,SS,active,new-orleans-saints,570000,2019
28650,495000,5000,Carl Granderson,DE,active,new-orleans-saints,500000,2019
28651,495000,3333,Deonte Harris,WR,active,new-orleans-saints,498333,2019
28652,495000,2500,Ethan Greenidge,T,active,new-orleans-saints,497500,2019
28653,495000,1666,Shy Tuttle,DT,active,new-orleans-saints,496666,2019
28654,473529,0,Stephone Anthony,ILB,active,new-orleans-saints,473529,2019
28655,189412,0,Manti Te'o,ILB,active,new-orleans-saints,189412,2019
28656,127059,0,Noah Spence,DE,active,new-orleans-saints,127059,2019
28657,94706,0,D.J. Swearinger,FS,active,new-orleans-saints,94706,2019
28658,67059,0,Taylor Stallworth,DT,active,new-orleans-saints,67059,2019
28659,29118,0,Lil’jordan Humphrey,WR,active,new-orleans-saints,29118,2019
28660,2195680,1877573,Sheldon Rankins,DT,injured_reserve,new-orleans-saints,4073253,2019
28661,779632,2343526,Marcus Davenport,DE,injured_reserve,new-orleans-saints,3123158,2019
28662,717000,216148,Alex Anzalone,ILB,injured_reserve,new-orleans-saints,933148,2019
28663,645000,0,Cameron Tom,G,injured_reserve,new-orleans-saints,645000,2019
28664,561353,0,Austin Carr,WR,injured_reserve,new-orleans-saints,561353,2019
28665,547059,0,Johnson Bademosi,CB,injured_reserve,new-orleans-saints,547059,2019
28666,495000,48802,Saquan Hampton,S,injured_reserve,new-orleans-saints,543802,2019
28667,398648,19079,Kaden Elliss,LB,injured_reserve,new-orleans-saints,417727,2019
28668,413823,0,Keith Kirkwood,WR,injured_reserve,new-orleans-saints,413823,2019
28669,805000,0,Josh Martin,OLB,injured_reserve,new-orleans-saints,805000,2019
28670,393000,0,Garrett Griffin,TE,injured_reserve,new-orleans-saints,393000,2019
28671,378000,0,Colton Jumper,LB,injured_reserve,new-orleans-saints,378000,2019
28672,291176,0,Krishawn Hogan,WR,injured_reserve,new-orleans-saints,291176,2019
28673,201176,0,Jason Vander Laan,TE,injured_reserve,new-orleans-saints,201176,2019
28674,102000,1666,Chase Hansen,LB,non_fb_injury,new-orleans-saints,103666,2019
28675,24000,0,Jerell Adams,TE,practice_squad,new-orleans-saints,24000,2019
28676,8000,0,Casey Dunn,C,practice_squad,new-orleans-saints,8000,2019
28677,500000,2850000,Cameron Meredith,WR,dead_cap,new-orleans-saints,3350000,2019
28678,0,3200000,Coby Fleener,TE,dead_cap,new-orleans-saints,3200000,2019
28679,0,3000000,Kurt Coleman,FS,dead_cap,new-orleans-saints,3000000,2019
28680,0,2710000,Teddy Bridgewater,QB,dead_cap,new-orleans-saints,2710000,2019
28681,0,1750000,Max Unger,C,dead_cap,new-orleans-saints,1750000,2019
28682,850000,650000,Chris Banjo,SS,dead_cap,new-orleans-saints,1500000,2019
28683,952944,0,Ken Crawley,CB,dead_cap,new-orleans-saints,952944,2019
28684,0,950000,Alex Okafor,DE,dead_cap,new-orleans-saints,950000,2019
28685,0,460071,Rick Leonard,T,dead_cap,new-orleans-saints,460071,2019
28686,241588,0,Lil’jordan Humphrey,WR,dead_cap,new-orleans-saints,241588,2019
28687,236765,0,Ray-Ray Armstrong,ILB,dead_cap,new-orleans-saints,236765,2019
28688,0,199215,Natrell Jamerson,S,dead_cap,new-orleans-saints,199215,2019
28689,175765,0,Chris Clark,LT,dead_cap,new-orleans-saints,175765,2019
28690,171058,3333,Taylor Stallworth,DT,dead_cap,new-orleans-saints,174391,2019
28691,170000,500,Emmanuel Butler,WR,dead_cap,new-orleans-saints,170500,2019
28692,162353,0,T.J. Green,S,dead_cap,new-orleans-saints,162353,2019
28693,161529,0,Mitchell Loewen,TE,dead_cap,new-orleans-saints,161529,2019
28694,150000,0,John Leglue,G,dead_cap,new-orleans-saints,150000,2019
28695,148588,0,Dan Arnold,WR,dead_cap,new-orleans-saints,148588,2019
28696,142059,0,Stephone Anthony,ILB,dead_cap,new-orleans-saints,142059,2019
28697,142059,0,Michael Ola,T,dead_cap,new-orleans-saints,142059,2019
28698,47353,90000,Wes Horton,DE,dead_cap,new-orleans-saints,137353,2019
28699,136000,0,Derrick Kelly,T,dead_cap,new-orleans-saints,136000,2019
28700,136000,0,Taquan Mizzell,RB,dead_cap,new-orleans-saints,136000,2019
28701,130221,0,Zach Zenner,RB,dead_cap,new-orleans-saints,130221,2019
28702,127059,0,T.Y. McGill,DT,dead_cap,new-orleans-saints,127059,2019
28703,0,118862,Kamrin Moore,CB,dead_cap,new-orleans-saints,118862,2019
28704,0,109485,Boston Scott,RB,dead_cap,new-orleans-saints,109485,2019
28705,0,90000,Ryan Groy,G,dead_cap,new-orleans-saints,90000,2019
28706,0,90000,Marshall Newhouse,RT,dead_cap,new-orleans-saints,90000,2019
28707,0,90000,Marcus Sherels,CB,dead_cap,new-orleans-saints,90000,2019
28708,0,75232,Al-Quadin Muhammad,DE,dead_cap,new-orleans-saints,75232,2019
28709,48000,0,Andrew Dowell,LB,dead_cap,new-orleans-saints,48000,2019
28710,0,45000,Javorius Allen,RB,dead_cap,new-orleans-saints,45000,2019
28711,40000,0,J.T. Barrett,QB,dead_cap,new-orleans-saints,40000,2019
28712,40000,0,Krishawn Hogan,WR,dead_cap,new-orleans-saints,40000,2019
28713,16000,23409,Alize Mack,TE,dead_cap,new-orleans-saints,39409,2019
28714,32000,0,Trae Elston,S,dead_cap,new-orleans-saints,32000,2019
28715,32000,0,Jason Vander Laan,TE,dead_cap,new-orleans-saints,32000,2019
28716,24000,0,Matt Dayes,RB,dead_cap,new-orleans-saints,24000,2019
28717,16000,0,Jalen Dalton,DT,dead_cap,new-orleans-saints,16000,2019
28718,16000,0,Chris Johnson,S,dead_cap,new-orleans-saints,16000,2019
28719,16000,0,Ricky Ortiz,FB,dead_cap,new-orleans-saints,16000,2019
28720,16000,0,Terrell Williams,S,dead_cap,new-orleans-saints,16000,2019
28721,0,11334,Keith Kirkwood,LB,dead_cap,new-orleans-saints,11334,2019
28722,0,10000,Deon Yelder,TE,dead_cap,new-orleans-saints,10000,2019
28723,8000,0,Nate Wozniak,G,dead_cap,new-orleans-saints,8000,2019
28724,3000,1000,Corbin Kaufusi,DE,dead_cap,new-orleans-saints,4000,2019
28725,0,3334,J.T. Gray,DE,dead_cap,new-orleans-saints,3334,2019
28726,0,1000,Mike Herndon,G,dead_cap,new-orleans-saints,1000,2019
28727,0,500,Devaroe Lawrence,DT,dead_cap,new-orleans-saints,500,2019
28728,0,15900000,Drew Brees,QB,active,new-orleans-saints,15900000,2020
28729,10700000,5268750,Terron Armstead,LT,active,new-orleans-saints,15968750,2020
28730,11000000,4000000,Michael Thomas,WR,active,new-orleans-saints,15000000,2020
28731,7650000,5225000,Larry Warford,G,active,new-orleans-saints,12875000,2020
28732,10150000,1100000,Janoris Jenkins,CB,active,new-orleans-saints,11250000,2020
28733,7350000,2550000,Demario Davis,OLB,active,new-orleans-saints,9900000,2020
28734,7000000,2000000,Jared Cook,TE,active,new-orleans-saints,9000000,2020
28735,1500000,8594000,Cameron Jordan,DE,active,new-orleans-saints,10094000,2020
28736,7690000,0,Sheldon Rankins,DT,active,new-orleans-saints,7690000,2020
28737,6375000,25000,Kiko Alonso,OLB,active,new-orleans-saints,6400000,2020
28738,4800000,1350000,Patrick Robinson,CB,active,new-orleans-saints,6150000,2020
28739,4100000,1900000,Malcom Brown,DT,active,new-orleans-saints,6000000,2020
28740,4500000,843750,Nick Easton,G,active,new-orleans-saints,5343750,2020
28741,2559486,2327650,Marshon Lattimore,CB,active,new-orleans-saints,4887136,2020
28742,2950000,1350000,Thomas Morstead,P,active,new-orleans-saints,4300000,2020
28743,3100000,1100000,Wil Lutz,K,active,new-orleans-saints,4200000,2020
28744,2800000,1250000,Latavius Murray,RB,active,new-orleans-saints,4050000,2020
28745,0,2000000,Teddy Bridgewater,QB,active,new-orleans-saints,2000000,2020
28746,1729263,2018526,Marcus Davenport,DE,active,new-orleans-saints,3747789,2020
28747,2295000,945000,Mario Edwards,DT,active,new-orleans-saints,3240000,2020
28748,1785000,1060000,Josh Hill,TE,active,new-orleans-saints,2845000,2020
28749,1677485,1151646,Ryan Ramczyk,RT,active,new-orleans-saints,2829131,2020
28750,1700000,700000,Craig Robertson,ILB,active,new-orleans-saints,2400000,2020
28751,1315969,669626,Marcus Williams,FS,active,new-orleans-saints,1985595,2020
28752,771261,610045,Erik McCoy,C,active,new-orleans-saints,1381306,2020
28753,977500,243193,Alvin Kamara,RB,active,new-orleans-saints,1220693,2020
28754,809000,216148,Alex Anzalone,ILB,active,new-orleans-saints,1025148,2020
28755,9000000,1000000,A.J. Klein,ILB,active,new-orleans-saints,10000000,2020
28756,758500,176572,Trey Hendrickson,DE,active,new-orleans-saints,935072,2020
28757,708000,204256,Tre'quan Smith,WR,active,new-orleans-saints,912256,2020
28758,585000,196025,Chauncey Gardner-Johnson,S,active,new-orleans-saints,781025,2020
28759,660000,18285,Will Clapp,C,active,new-orleans-saints,678285,2020
28760,660000,0,Garrett Griffin,TE,active,new-orleans-saints,660000,2020
28761,660000,0,Taylor Stallworth,DT,active,new-orleans-saints,660000,2020
28762,660000,0,Jason Vander Laan,TE,active,new-orleans-saints,660000,2020
28763,585000,48802,Saquan Hampton,S,active,new-orleans-saints,633802,2020
28764,585000,19079,Kaden Elliss,LB,active,new-orleans-saints,604079,2020
28765,585000,5000,Carl Granderson,DE,active,new-orleans-saints,590000,2020
28766,585000,3333,Deonte Harris,WR,active,new-orleans-saints,588333,2020
28767,585000,2500,Ethan Greenidge,T,active,new-orleans-saints,587500,2020
28768,585000,1666,Chase Hansen,LB,active,new-orleans-saints,586666,2020
28769,585000,1666,Shy Tuttle,DT,active,new-orleans-saints,586666,2020
28770,585000,0,Krishawn Hogan,WR,active,new-orleans-saints,585000,2020
28771,0,0,Emmanuel Butler,WR,active,new-orleans-saints,0,2020
28772,0,0,Jalen Dalton,DT,active,new-orleans-saints,0,2020
28773,0,0,Andrew Dowell,LB,active,new-orleans-saints,0,2020
28774,0,0,Maurice Harris,WR,active,new-orleans-saints,0,2020
28775,0,0,Chris Johnson,S,active,new-orleans-saints,0,2020
28776,0,0,Derrick Kelly,T,active,new-orleans-saints,0,2020
28777,0,0,Mitchell Loewen,TE,active,new-orleans-saints,0,2020
28778,0,0,Taquan Mizzell,RB,active,new-orleans-saints,0,2020
28779,0,0,Tim White,WR,active,new-orleans-saints,0,2020
28780,0,0,Cole Wick,TE,active,new-orleans-saints,0,2020
28781,0,1200000,Chris Banjo,SS,dead_cap,new-orleans-saints,1200000,2020
28782,0,70227,Alize Mack,TE,dead_cap,new-orleans-saints,70227,2020
28783,0,3333,Taylor Stallworth,DT,dead_cap,new-orleans-saints,3333,2020
28784,0,2000,Corbin Kaufusi,DE,dead_cap,new-orleans-saints,2000,2020
28785,0,1000,Emmanuel Butler,WR,dead_cap,new-orleans-saints,1000,2020
28786,6450000,8733332,Eli Manning,QB,active,new-york-giants,15183332,2007
28787,4000000,2728285,Michael Strahan,DE,active,new-york-giants,6728285,2007
28788,3295000,2280000,Plaxico Burress,WR,active,new-york-giants,5575000,2007
28789,595000,5550000,Osi Umenyiora,OLB,active,new-york-giants,6145000,2007
28790,285000,2785000,Aaron Ross,CB,active,new-york-giants,3070000,2007
28791,435000,1684250,Justin Tuck,DE,active,new-york-giants,2119250,2007
28792,1475000,625000,R.W. McQuarters,CB,active,new-york-giants,2100000,2007
28793,1200000,200000,David Diehl,RT,active,new-york-giants,1400000,2007
28794,790000,643750,Rich Seubert,G,active,new-york-giants,1433750,2007
28795,875000,300000,David Tyree,WR,active,new-york-giants,1175000,2007
28796,285000,275000,Steve Smith,WR,active,new-york-giants,560000,2007
28797,560000,467000,Chris Snee,G,active,new-york-giants,1027000,2007
28798,850000,0,Reggie Torbor,LB,active,new-york-giants,850000,2007
28799,850000,0,Derrick Ward,RB,active,new-york-giants,850000,2007
28800,720000,80000,Jim Finn,FB,active,new-york-giants,800000,2007
28801,435000,425000,Corey Webster,CB,active,new-york-giants,860000,2007
28802,360000,175000,Sinorice Moss,WR,active,new-york-giants,535000,2007
28803,600000,25000,Lawrence Tynes,K,active,new-york-giants,625000,2007
28804,470000,175000,Chase Blackburn,OLB,active,new-york-giants,645000,2007
28805,435000,113750,Brandon Jacobs,RB,active,new-york-giants,548750,2007
28806,360000,176750,Derek Hagan,WR,active,new-york-giants,536750,2007
28807,435000,100000,Madison Hedgecock,FB,active,new-york-giants,535000,2007
28808,360000,145875,Gerris Wilkinson,LB,active,new-york-giants,505875,2007
28809,285000,179500,Jay Alford,DT,active,new-york-giants,464500,2007
28810,360000,101156,Barry Cofield,DT,active,new-york-giants,461156,2007
28811,360000,96250,Guy Whimper,G,active,new-york-giants,456250,2007
28812,285000,110625,Zak DeOssie,LS,active,new-york-giants,395625,2007
28813,360000,0,Kevin Boothe,G,active,new-york-giants,360000,2007
28814,360000,0,Domenik Hixon,WR,active,new-york-giants,360000,2007
28815,310000,25000,Ryan Grant,RB,active,new-york-giants,335000,2007
28816,285000,43340,Kevin Boss,TE,active,new-york-giants,328340,2007
28817,285000,23812,Adam Koets,T,active,new-york-giants,308812,2007
28818,285000,13700,Michael Johnson,S,active,new-york-giants,298700,2007
28819,285000,9181,Ahmad Bradshaw,RB,active,new-york-giants,294181,2007
28820,285000,5000,Craig Dahl,SS,active,new-york-giants,290000,2007
28821,285000,2500,Michael Matthews,TE,active,new-york-giants,287500,2007
28822,285000,0,Rashad Barksdale,CB,active,new-york-giants,285000,2007
28823,595000,6306668,Jeremy Shockey,TE,injured_reserve,new-york-giants,6901668,2007
28824,705000,639219,William Joseph,DT,injured_reserve,new-york-giants,1344219,2007
28825,485000,1717500,Mathias Kiwanuka,DE,injured_reserve,new-york-giants,2202500,2007
28826,0,3910000,Luke Petitgout,RT,dead_cap,new-york-giants,3910000,2007
28827,253333,0,Jay Feely,K,dead_cap,new-york-giants,253333,2007
28828,118875,0,Charlie Peprah,S,dead_cap,new-york-giants,118875,2007
28829,47124,0,Eric Moore,DE,dead_cap,new-york-giants,47124,2007
28830,34050,0,Gerrick McPhearson,CB,dead_cap,new-york-giants,34050,2007
28831,0,20000,Marcus Bell,DT,dead_cap,new-york-giants,20000,2007
28832,8450000,10233332,Eli Manning,QB,active,new-york-giants,18683332,2008
28833,2390000,3217000,Chris Snee,G,active,new-york-giants,5607000,2008
28834,1700000,5200000,Osi Umenyiora,OLB,active,new-york-giants,6900000,2008
28835,2406250,3160000,Plaxico Burress,WR,active,new-york-giants,5566250,2008
28836,520000,1934250,Justin Tuck,DE,active,new-york-giants,2454250,2008
28837,1000000,1300000,Corey Webster,CB,active,new-york-giants,2300000,2008
28838,1475000,625000,R.W. McQuarters,CB,active,new-york-giants,2100000,2008
28839,750000,1063750,Rich Seubert,G,active,new-york-giants,1813750,2008
28840,1000000,700000,David Diehl,RT,active,new-york-giants,1700000,2008
28841,850000,350000,Sammy Knight,S,active,new-york-giants,1200000,2008
28842,370000,1843000,Aaron Ross,CB,active,new-york-giants,2213000,2008
28843,650000,250000,Derrick Ward,RB,active,new-york-giants,900000,2008
28844,450000,1767500,Mathias Kiwanuka,DE,active,new-york-giants,2217500,2008
28845,550000,100000,Madison Hedgecock,FB,active,new-york-giants,650000,2008
28846,925000,300000,David Tyree,WR,active,new-york-giants,1225000,2008
28847,295000,875000,Kenny Phillips,FS,active,new-york-giants,1170000,2008
28848,927000,113750,Brandon Jacobs,RB,active,new-york-giants,1040750,2008
28849,625000,250000,Lawrence Tynes,K,active,new-york-giants,875000,2008
28850,1000000,0,Jerome McDougle,DE,active,new-york-giants,1000000,2008
28851,700000,300000,David Carr,QB,active,new-york-giants,1000000,2008
28852,445000,175000,Sinorice Moss,WR,active,new-york-giants,620000,2008
28853,545000,125000,Chase Blackburn,OLB,active,new-york-giants,670000,2008
28854,370000,275000,Steve Smith,WR,active,new-york-giants,645000,2008
28855,445000,176750,Derek Hagan,WR,active,new-york-giants,621750,2008
28856,445000,145875,Gerris Wilkinson,LB,active,new-york-giants,590875,2008
28857,370000,179500,Jay Alford,DT,active,new-york-giants,549500,2008
28858,445000,101156,Barry Cofield,DT,active,new-york-giants,546156,2008
28859,445000,96250,Guy Whimper,G,active,new-york-giants,541250,2008
28860,295000,217750,Terrell Thomas,CB,active,new-york-giants,512750,2008
28861,370000,110625,Zak DeOssie,LS,active,new-york-giants,480625,2008
28862,295000,154250,Mario Manningham,WR,active,new-york-giants,449250,2008
28863,445000,0,Kevin Boothe,G,active,new-york-giants,445000,2008
28864,445000,0,Derek Hagan,WR,active,new-york-giants,445000,2008
28865,445000,0,Domenik Hixon,WR,active,new-york-giants,445000,2008
28866,370000,43340,Kevin Boss,TE,active,new-york-giants,413340,2008
28867,295000,108308,Bryan Kehl,ILB,active,new-york-giants,403308,2008
28868,370000,23812,Adam Koets,T,active,new-york-giants,393812,2008
28869,370000,13700,Michael Johnson,S,active,new-york-giants,383700,2008
28870,370000,9181,Ahmad Bradshaw,RB,active,new-york-giants,379181,2008
28871,370000,5000,Craig Dahl,SS,active,new-york-giants,375000,2008
28872,370000,2500,Michael Matthews,TE,active,new-york-giants,372500,2008
28873,370000,0,Dave Tollefson,DE,active,new-york-giants,370000,2008
28874,295000,0,Wallace Gilberry,DE,active,new-york-giants,295000,2008
28875,200000,19475,Robert Henderson,DE,active,new-york-giants,219475,2008
28876,88400,0,Andre Woodson,QB,active,new-york-giants,88400,2008
28877,43529,0,Edmond Miles,LB,active,new-york-giants,43529,2008
28878,0,2228285,Michael Strahan,DE,dead_cap,new-york-giants,2228285,2008
28879,2100000,0,Jeremy Shockey,TE,dead_cap,new-york-giants,2100000,2008
28880,0,539219,William Joseph,DT,dead_cap,new-york-giants,539219,2008
28881,0,160000,Jim Finn,FB,dead_cap,new-york-giants,160000,2008
28882,20350,0,Andre Woodson,QB,dead_cap,new-york-giants,20350,2008
28883,7500000,11333336,Eli Manning,QB,active,new-york-giants,18833336,2009
28884,1000000,6650000,Justin Tuck,DE,active,new-york-giants,7650000,2009
28885,5400000,2740000,Corey Webster,CB,active,new-york-giants,8140000,2009
28886,2550000,5200000,Osi Umenyiora,OLB,active,new-york-giants,7750000,2009
28887,3500000,2000000,Brandon Jacobs,RB,active,new-york-giants,5500000,2009
28888,3750000,1700000,Chris Canty,DE,active,new-york-giants,5450000,2009
28889,1950000,2300000,Chris Snee,G,active,new-york-giants,4250000,2009
28890,2500000,1400000,Michael Boley,LB,active,new-york-giants,3900000,2009
28891,2400000,700000,David Diehl,RT,active,new-york-giants,3100000,2009
28892,1900000,1250000,Rocky Bernard,DT,active,new-york-giants,3150000,2009
28893,1200000,1063750,Rich Seubert,G,active,new-york-giants,2263750,2009
28894,1000000,400000,Ceandris Brown,CB,active,new-york-giants,1400000,2009
28895,1000000,1010000,David Carr,QB,active,new-york-giants,2010000,2009
28896,650000,1767500,Mathias Kiwanuka,DE,active,new-york-giants,2417500,2009
28897,1100000,300000,David Tyree,WR,active,new-york-giants,1400000,2009
28898,900000,250000,Lawrence Tynes,K,active,new-york-giants,1150000,2009
28899,310000,895000,Hakeem Nicks,WR,active,new-york-giants,1205000,2009
28900,1010000,101156,Barry Cofield,DT,active,new-york-giants,1111156,2009
28901,757000,100000,Madison Hedgecock,FB,active,new-york-giants,857000,2009
28902,535000,175000,Sinorice Moss,WR,active,new-york-giants,710000,2009
28903,645000,125000,Chase Blackburn,OLB,active,new-york-giants,770000,2009
28904,750000,0,Derek Hagan,WR,active,new-york-giants,750000,2009
28905,460000,275000,Steve Smith,WR,active,new-york-giants,735000,2009
28906,310000,402500,Clint Sintim,LB,active,new-york-giants,712500,2009
28907,530000,176750,Derek Hagan,WR,active,new-york-giants,706750,2009
28908,535000,145875,Gerris Wilkinson,LB,active,new-york-giants,680875,2009
28909,460000,179500,Jay Alford,DT,active,new-york-giants,639500,2009
28910,530000,96250,Guy Whimper,G,active,new-york-giants,626250,2009
28911,385000,217750,Terrell Thomas,CB,active,new-york-giants,602750,2009
28912,460000,110625,Zak DeOssie,LS,active,new-york-giants,570625,2009
28913,310000,230000,William Beatty,LT,active,new-york-giants,540000,2009
28914,385000,154250,Mario Manningham,WR,active,new-york-giants,539250,2009
28915,535000,0,Kevin Boothe,G,active,new-york-giants,535000,2009
28916,530000,0,Domenik Hixon,WR,active,new-york-giants,530000,2009
28917,460000,43340,Kevin Boss,TE,active,new-york-giants,503340,2009
28918,385000,108308,Bryan Kehl,ILB,active,new-york-giants,493308,2009
28919,310000,182789,Ramses Barden,WR,active,new-york-giants,492789,2009
28920,460000,23812,Adam Koets,T,active,new-york-giants,483812,2009
28921,460000,13700,Michael Johnson,S,active,new-york-giants,473700,2009
28922,460000,9181,Ahmad Bradshaw,RB,active,new-york-giants,469181,2009
28923,310000,153250,Travis Beckum,TE,active,new-york-giants,463250,2009
28924,460000,0,Aaron Rouse,S,active,new-york-giants,460000,2009
28925,460000,0,Dave Tollefson,DE,active,new-york-giants,460000,2009
28926,460000,0,D.J. Ware,RB,active,new-york-giants,460000,2009
28927,385000,41250,Erik Ainge,QB,active,new-york-giants,426250,2009
28928,310000,107500,Andre Brown,RB,active,new-york-giants,417500,2009
28929,310000,46295,Rhett Bomar,QB,active,new-york-giants,356295,2009
28930,310000,19475,Robert Henderson,DE,active,new-york-giants,329475,2009
28931,310000,0,Bear Pascoe,TE,active,new-york-giants,310000,2009
28932,291764,0,Gartrell Johnson,RB,active,new-york-giants,291764,2009
28933,144375,0,Andrew Carnahan,T,active,new-york-giants,144375,2009
28934,450000,1984000,Kenny Phillips,FS,injured_reserve,new-york-giants,2434000,2009
28935,613000,1843000,Aaron Ross,CB,injured_reserve,new-york-giants,2456000,2009
28936,88400,0,Nehemiah Broughton,RB,practice_squad,new-york-giants,88400,2009
28937,5860000,0,Plaxico Burress,WR,dead_cap,new-york-giants,5860000,2009
28938,3600000,0,Jeremy Shockey,TE,dead_cap,new-york-giants,3600000,2009
28939,700000,0,Sammy Knight,S,dead_cap,new-york-giants,700000,2009
28940,0,539219,William Joseph,DT,dead_cap,new-york-giants,539219,2009
28941,88400,0,Anthony Bryant,DT,dead_cap,new-york-giants,88400,2009
28942,61050,0,Andre Woodson,QB,dead_cap,new-york-giants,61050,2009
28943,23252,0,DeAndre Wright,CB,dead_cap,new-york-giants,23252,2009
28944,11518,0,Stoney Woodson,CB,dead_cap,new-york-giants,11518,2009
28945,5000,0,Craig Dahl,SS,dead_cap,new-york-giants,5000,2009
28946,2500,0,Michael Matthews,TE,dead_cap,new-york-giants,2500,2009
28947,8000000,6565000,Corey Webster,CB,active,new-york-giants,14565000,2010
28948,6500000,8100000,Eli Manning,QB,active,new-york-giants,14600000,2010
28949,4500000,1950000,Chris Canty,DE,active,new-york-giants,6450000,2010
28950,4750000,1250000,Antrel Rolle,SS,active,new-york-giants,6000000,2010
28951,3650000,2000000,Brandon Jacobs,RB,active,new-york-giants,5650000,2010
28952,2450000,3300000,Chris Snee,G,active,new-york-giants,5750000,2010
28953,3100000,4300000,Osi Umenyiora,OLB,active,new-york-giants,7400000,2010
28954,1600000,3400000,Justin Tuck,DE,active,new-york-giants,5000000,2010
28955,3750000,500000,David Diehl,RT,active,new-york-giants,4250000,2010
28956,2750000,1400000,Michael Boley,LB,active,new-york-giants,4150000,2010
28957,2450000,1250000,Rocky Bernard,DT,active,new-york-giants,3700000,2010
28958,2000000,700000,Rich Seubert,G,active,new-york-giants,2700000,2010
28959,2600000,466667,Sage Rosenfels,QB,active,new-york-giants,3066667,2010
28960,400000,2960000,Hakeem Nicks,WR,active,new-york-giants,3360000,2010
28961,856000,1843000,Aaron Ross,CB,active,new-york-giants,2699000,2010
28962,1759000,0,Barry Cofield,DT,active,new-york-giants,1759000,2010
28963,1684000,0,Domenik Hixon,WR,active,new-york-giants,1684000,2010
28964,1684000,0,Dave Tollefson,DE,active,new-york-giants,1684000,2010
28965,1300000,300000,David Tyree,WR,active,new-york-giants,1600000,2010
28966,320000,1255000,Jason Pierre-Paul,DE,active,new-york-giants,1575000,2010
28967,1250000,300000,Shawn Andrews,G,active,new-york-giants,1550000,2010
28968,320000,1224500,Linval Joseph,DT,active,new-york-giants,1544500,2010
28969,589000,1256500,Kenny Phillips,FS,active,new-york-giants,1845500,2010
28970,1100000,250000,Lawrence Tynes,K,active,new-york-giants,1350000,2010
28971,1350000,43340,Kevin Boss,TE,active,new-york-giants,1393340,2010
28972,1176000,0,Kevin Boothe,G,active,new-york-giants,1176000,2010
28973,1176000,0,Derek Hagan,WR,active,new-york-giants,1176000,2010
28974,1176000,0,Gerris Wilkinson,LB,active,new-york-giants,1176000,2010
28975,855000,250000,Keith Bulluck,LB,active,new-york-giants,1105000,2010
28976,900000,100000,Madison Hedgecock,FB,active,new-york-giants,1000000,2010
28977,1001000,9181,Ahmad Bradshaw,RB,active,new-york-giants,1010181,2010
28978,650000,295000,Chase Blackburn,OLB,active,new-york-giants,945000,2010
28979,598000,291292,Zak DeOssie,LS,active,new-york-giants,889292,2010
28980,550000,275000,Steve Smith,WR,active,new-york-giants,825000,2010
28981,385000,402500,Clint Sintim,LB,active,new-york-giants,787500,2010
28982,595000,143812,Adam Koets,T,active,new-york-giants,738812,2010
28983,470000,217750,Terrell Thomas,CB,active,new-york-giants,687750,2010
28984,470000,0,Devin Thomas,WR,active,new-york-giants,470000,2010
28985,661500,0,Sinorice Moss,WR,active,new-york-giants,661500,2010
28986,630000,0,Will Blackmon,CB,active,new-york-giants,630000,2010
28987,395000,230000,William Beatty,LT,active,new-york-giants,625000,2010
28988,470000,154250,Mario Manningham,WR,active,new-york-giants,624250,2010
28989,395000,182789,Ramses Barden,WR,active,new-york-giants,577789,2010
28990,555000,0,Alex Hall,OLB,active,new-york-giants,555000,2010
28991,395000,153250,Travis Beckum,TE,active,new-york-giants,548250,2010
28992,525000,0,D.J. Ware,RB,active,new-york-giants,525000,2010
28993,470000,0,Darius Reynaud,RB,active,new-york-giants,470000,2010
28994,470000,0,Brian Witherspoon,CB,active,new-york-giants,470000,2010
28995,320000,123160,Phillip Dillard,ILB,active,new-york-giants,443160,2010
28996,395000,0,Scott Chandler,TE,active,new-york-giants,395000,2010
28997,395000,0,Jamon Meredith,RT,active,new-york-giants,395000,2010
28998,395000,0,Bear Pascoe,TE,active,new-york-giants,395000,2010
28999,320000,47790,Mitch Petrus,G,active,new-york-giants,367790,2010
29000,320000,6667,Duke Calhoun,WR,active,new-york-giants,326667,2010
29001,325000,0,Nate Collins,DT,active,new-york-giants,325000,2010
29002,320000,0,Victor Cruz,WR,active,new-york-giants,320000,2010
29003,295000,14856,Matt Dodge,P,active,new-york-giants,309856,2010
29004,253125,13700,Michael Johnson,S,active,new-york-giants,266825,2010
29005,255000,0,Courtney Brown,S,active,new-york-giants,255000,2010
29006,1776000,1717500,Mathias Kiwanuka,DE,injured_reserve,new-york-giants,3493500,2010
29007,320000,225000,Jim Sorgi,QB,injured_reserve,new-york-giants,545000,2010
29008,88400,0,Jim Cordle,C,practice_squad,new-york-giants,88400,2010
29009,322500,0,Andre Brown,RB,dead_cap,new-york-giants,322500,2010
29010,0,206491,Chad Jones,S,dead_cap,new-york-giants,206491,2010
29011,179500,0,Jay Alford,DT,dead_cap,new-york-giants,179500,2010
29012,108308,0,Bryan Kehl,ILB,dead_cap,new-york-giants,108308,2010
29013,69756,0,DeAndre Wright,CB,dead_cap,new-york-giants,69756,2010
29014,34554,0,Stoney Woodson,CB,dead_cap,new-york-giants,34554,2010
29015,19475,0,Robert Henderson,DE,dead_cap,new-york-giants,19475,2010
29016,8500000,8100000,Eli Manning,QB,active,new-york-giants,16600000,2011
29017,5250000,1950000,Chris Canty,DE,active,new-york-giants,7200000,2011
29018,4650000,2000000,Brandon Jacobs,RB,active,new-york-giants,6650000,2011
29019,3700000,2800000,Chris Snee,G,active,new-york-giants,6500000,2011
29020,3500000,3565000,Corey Webster,CB,active,new-york-giants,7065000,2011
29021,3450000,1650000,Justin Tuck,DE,active,new-york-giants,5100000,2011
29022,3500000,1400000,Michael Boley,LB,active,new-york-giants,4900000,2011
29023,4000000,500000,David Diehl,RT,active,new-york-giants,4500000,2011
29024,475000,5423000,Jason Pierre-Paul,DE,active,new-york-giants,5898000,2011
29025,3125000,500000,Osi Umenyiora,OLB,active,new-york-giants,3625000,2011
29026,1250000,2250000,Antrel Rolle,SS,active,new-york-giants,3500000,2011
29027,3000000,466667,Sage Rosenfels,QB,active,new-york-giants,3466667,2011
29028,1750000,1100000,Mathias Kiwanuka,DE,active,new-york-giants,2850000,2011
29029,1500000,1250000,Ahmad Bradshaw,RB,active,new-york-giants,2750000,2011
29030,1000000,1700000,David Baas,C,active,new-york-giants,2700000,2011
29031,1274000,1843000,Aaron Ross,CB,active,new-york-giants,3117000,2011
29032,722500,1256500,Kenny Phillips,FS,active,new-york-giants,1979000,2011
29033,575000,1460000,Hakeem Nicks,WR,active,new-york-giants,2035000,2011
29034,1400000,154250,Mario Manningham,WR,active,new-york-giants,1554250,2011
29035,1200000,250000,Lawrence Tynes,K,active,new-york-giants,1450000,2011
29036,375000,1112436,Prince Amukamara,CB,active,new-york-giants,1487436,2011
29037,1000000,287500,Kevin Boothe,G,active,new-york-giants,1287500,2011
29038,640000,0,D.J. Ware,RB,active,new-york-giants,640000,2011
29039,736000,180667,Zak DeOssie,LS,active,new-york-giants,916667,2011
29040,480000,402500,Clint Sintim,LB,active,new-york-giants,882500,2011
29041,700000,150000,Steve Weatherford,P,active,new-york-giants,850000,2011
29042,600000,250000,Domenik Hixon,WR,active,new-york-giants,850000,2011
29043,600000,217750,Terrell Thomas,CB,active,new-york-giants,817750,2011
29044,810000,0,Michael Clayton,WR,active,new-york-giants,810000,2011
29045,405000,382000,Linval Joseph,DT,active,new-york-giants,787000,2011
29046,525000,230000,William Beatty,LT,active,new-york-giants,755000,2011
29047,555000,0,Devin Thomas,WR,active,new-york-giants,555000,2011
29048,375000,311509,Marvin Austin,DT,active,new-york-giants,686509,2011
29049,480000,182789,Ramses Barden,WR,active,new-york-giants,662789,2011
29050,480000,153250,Travis Beckum,TE,active,new-york-giants,633250,2011
29051,600000,0,Chris Horton,S,active,new-york-giants,600000,2011
29052,555000,30500,Darius Reynaud,RB,active,new-york-giants,585500,2011
29053,810000,50000,Rocky Bernard,DT,active,new-york-giants,860000,2011
29054,810000,50000,David Carr,QB,active,new-york-giants,860000,2011
29055,810000,0,Jimmy Kennedy,DT,active,new-york-giants,810000,2011
29056,685000,0,Chase Blackburn,OLB,active,new-york-giants,685000,2011
29057,685000,0,Will Blackmon,CB,active,new-york-giants,685000,2011
29058,685000,0,Dave Tollefson,DE,active,new-york-giants,685000,2011
29059,685000,0,Tony Ugoh,T,active,new-york-giants,685000,2011
29060,375000,143813,Jerrel Jernigan,WR,active,new-york-giants,518813,2011
29061,375000,108023,James Brewer,G,active,new-york-giants,483023,2011
29062,480000,0,Bruce Johnson,CB,active,new-york-giants,480000,2011
29063,480000,0,Bear Pascoe,TE,active,new-york-giants,480000,2011
29064,480000,0,Brian Witherspoon,CB,active,new-york-giants,480000,2011
29065,450000,6667,Duke Calhoun,WR,active,new-york-giants,456667,2011
29066,405000,47790,Mitch Petrus,G,active,new-york-giants,452790,2011
29067,450000,0,Andre Brown,RB,active,new-york-giants,450000,2011
29068,375000,51894,Greg Jones,ILB,active,new-york-giants,426894,2011
29069,405000,0,Jake Ballard,TE,active,new-york-giants,405000,2011
29070,405000,0,Victor Cruz,WR,active,new-york-giants,405000,2011
29071,390000,5000,Martin Parker,DT,active,new-york-giants,395000,2011
29072,375000,19760,Tyler Sash,S,active,new-york-giants,394760,2011
29073,375000,19670,Jacquian Williams,OLB,active,new-york-giants,394670,2011
29074,375000,13988,Da'Rel Scott,RB,active,new-york-giants,388988,2011
29075,375000,5000,Mark Herzlich,OLB,active,new-york-giants,380000,2011
29076,375000,5000,Henry Hynoski,FB,active,new-york-giants,380000,2011
29077,375000,1000,Spencer Paysinger,ILB,active,new-york-giants,376000,2011
29078,375000,0,Jim Cordle,C,active,new-york-giants,375000,2011
29079,375000,0,Martin Parker,DT,active,new-york-giants,375000,2011
29080,2500000,0,Rocky Bernard,DT,dead_cap,new-york-giants,2500000,2011
29081,700000,0,Rich Seubert,G,dead_cap,new-york-giants,700000,2011
29082,0,619473,Chad Jones,S,dead_cap,new-york-giants,619473,2011
29083,132500,0,Adam Koets,T,dead_cap,new-york-giants,132500,2011
29084,0,123160,Phillip Dillard,ILB,dead_cap,new-york-giants,123160,2011
29085,108308,0,Bryan Kehl,ILB,dead_cap,new-york-giants,108308,2011
29086,100000,0,Madison Hedgecock,FB,dead_cap,new-york-giants,100000,2011
29087,0,50000,Shawn Andrews,G,dead_cap,new-york-giants,50000,2011
29088,0,26326,Adrian Tracy,DE,dead_cap,new-york-giants,26326,2011
29089,19475,0,Robert Henderson,DE,dead_cap,new-york-giants,19475,2011
29090,0,14856,Matt Dodge,P,dead_cap,new-york-giants,14856,2011
29091,5700000,4300000,Chris Snee,G,active,new-york-giants,10000000,2012
29092,7000000,3565000,Corey Webster,CB,active,new-york-giants,10565000,2012
29093,1750000,10350000,Eli Manning,QB,active,new-york-giants,12100000,2012
29094,6750000,2250000,Antrel Rolle,SS,active,new-york-giants,9000000,2012
29095,6000000,1950000,Chris Canty,DE,active,new-york-giants,7950000,2012
29096,4000000,1400000,Michael Boley,LB,active,new-york-giants,5400000,2012
29097,3700000,1650000,Justin Tuck,DE,active,new-york-giants,5350000,2012
29098,2500000,2432555,Osi Umenyiora,OLB,active,new-york-giants,4932555,2012
29099,3000000,1500000,Ahmad Bradshaw,RB,active,new-york-giants,4500000,2012
29100,950000,3175000,Mathias Kiwanuka,DE,active,new-york-giants,4125000,2012
29101,1200000,2125000,David Diehl,RT,active,new-york-giants,3325000,2012
29102,900000,2475000,David Baas,C,active,new-york-giants,3375000,2012
29103,2080000,1256500,Kenny Phillips,FS,active,new-york-giants,3336500,2012
29104,2500000,0,Martellus Bennett,TE,active,new-york-giants,2500000,2012
29105,825000,2650000,Jason Pierre-Paul,DE,active,new-york-giants,3475000,2012
29106,746859,1112436,Prince Amukamara,CB,active,new-york-giants,1859295,2012
29107,1500000,287500,Kevin Boothe,G,active,new-york-giants,1787500,2012
29108,750000,1460000,Hakeem Nicks,WR,active,new-york-giants,2210000,2012
29109,1300000,250000,Lawrence Tynes,K,active,new-york-giants,1550000,2012
29110,565000,925789,Ramses Barden,WR,active,new-york-giants,1490789,2012
29111,775000,675000,Steve Weatherford,P,active,new-york-giants,1450000,2012
29112,390000,825364,David Wilson,RB,active,new-york-giants,1215364,2012
29113,700000,405667,Zak DeOssie,LS,active,new-york-giants,1105667,2012
29114,650000,428125,Keith Rivers,OLB,active,new-york-giants,1078125,2012
29115,925000,0,Rocky Bernard,DT,active,new-york-giants,925000,2012
29116,540000,382000,Linval Joseph,DT,active,new-york-giants,922000,2012
29117,825000,65000,Sean Locklear,T,active,new-york-giants,890000,2012
29118,546627,311509,Marvin Austin,DT,active,new-york-giants,858136,2012
29119,615000,230000,William Beatty,LT,active,new-york-giants,845000,2012
29120,700000,0,Justin Tryon,CB,active,new-york-giants,700000,2012
29121,465000,168813,Jerrel Jernigan,WR,active,new-york-giants,633813,2012
29122,615000,0,Domenik Hixon,WR,active,new-york-giants,615000,2012
29123,615000,0,Bear Pascoe,TE,active,new-york-giants,615000,2012
29124,925000,0,Shaun Rogers,DT,active,new-york-giants,925000,2012
29125,390000,208533,Rueben Randle,WR,active,new-york-giants,598533,2012
29126,465000,108023,James Brewer,G,active,new-york-giants,573023,2012
29127,925000,65000,David Carr,QB,active,new-york-giants,990000,2012
29128,825000,0,Chase Blackburn,OLB,active,new-york-giants,825000,2012
29129,540000,0,Stevie Brown,SS,active,new-york-giants,540000,2012
29130,540000,0,Adrian Tracy,DE,active,new-york-giants,540000,2012
29131,390000,128750,Jayron Hosley,CB,active,new-york-giants,518750,2012
29132,490000,0,Victor Cruz,WR,active,new-york-giants,490000,2012
29133,390000,96413,Adrien Robinson,TE,active,new-york-giants,486413,2012
29134,465000,19760,Tyler Sash,S,active,new-york-giants,484760,2012
29135,465000,19670,Jacquian Williams,OLB,active,new-york-giants,484670,2012
29136,465000,13988,Da'Rel Scott,RB,active,new-york-giants,478988,2012
29137,465000,5000,Mark Herzlich,OLB,active,new-york-giants,470000,2012
29138,465000,5000,Henry Hynoski,FB,active,new-york-giants,470000,2012
29139,465000,1000,Spencer Paysinger,ILB,active,new-york-giants,466000,2012
29140,390000,75146,Brandon Mosley,G,active,new-york-giants,465146,2012
29141,465000,0,Jim Cordle,C,active,new-york-giants,465000,2012
29142,465000,0,Justin Trattou,DE,active,new-york-giants,465000,2012
29143,390000,11474,Markus Kuhn,DT,active,new-york-giants,401474,2012
29144,390000,500,Adewale Ojomo,DE,active,new-york-giants,390500,2012
29145,390000,0,Selvish Capers,G,active,new-york-giants,390000,2012
29146,390000,0,Terrence Frederick,CB,active,new-york-giants,390000,2012
29147,298236,0,Will Hill,SS,active,new-york-giants,298236,2012
29148,615000,0,Kregg Lumpkin,RB,active,new-york-giants,615000,2012
29149,615000,0,Ryan Torain,RB,active,new-york-giants,615000,2012
29150,1000000,250000,Terrell Thomas,CB,injured_reserve,new-york-giants,1250000,2012
29151,615000,153250,Travis Beckum,TE,injured_reserve,new-york-giants,768250,2012
29152,540000,0,Bruce Johnson,CB,injured_reserve,new-york-giants,540000,2012
29153,540000,0,Brian Witherspoon,CB,injured_reserve,new-york-giants,540000,2012
29154,465000,5000,Martin Parker,DT,injured_reserve,new-york-giants,470000,2012
29155,355588,0,Andre Brown,RB,injured_reserve,new-york-giants,355588,2012
29156,1962500,0,Brandon Jacobs,RB,dead_cap,new-york-giants,1962500,2012
29157,700000,0,Rich Seubert,G,dead_cap,new-york-giants,700000,2012
29158,402500,0,Clint Sintim,LB,dead_cap,new-york-giants,402500,2012
29159,0,246320,Phillip Dillard,ILB,dead_cap,new-york-giants,246320,2012
29160,0,150000,Shawn Andrews,G,dead_cap,new-york-giants,150000,2012
29161,132500,0,Adam Koets,T,dead_cap,new-york-giants,132500,2012
29162,103788,0,Greg Jones,ILB,dead_cap,new-york-giants,103788,2012
29163,100000,0,Madison Hedgecock,FB,dead_cap,new-york-giants,100000,2012
29164,0,52652,Adrian Tracy,DE,dead_cap,new-york-giants,52652,2012
29165,0,47790,Mitch Petrus,G,dead_cap,new-york-giants,47790,2012
29166,0,29712,Matt Dodge,P,dead_cap,new-york-giants,29712,2012
29167,22058,0,Matt McCants,RT,dead_cap,new-york-giants,22058,2012
29168,6667,0,Duke Calhoun,WR,dead_cap,new-york-giants,6667,2012
29169,5000,0,Martin Parker,DT,dead_cap,new-york-giants,5000,2012
29170,4166,0,Matt Broha,DE,dead_cap,new-york-giants,4166,2012
29171,3333,0,David Douglas,WR,dead_cap,new-york-giants,3333,2012
29172,2500,0,Jojo Nicolas,S,dead_cap,new-york-giants,2500,2012
29173,1667,0,Janzen Jackson,S,dead_cap,new-york-giants,1667,2012
29174,1000,0,Stephen Goodin,G,dead_cap,new-york-giants,1000,2012
29175,13000000,10350000,Eli Manning,QB,active,new-york-giants,23350000,2013
29176,7000000,2250000,Antrel Rolle,SS,active,new-york-giants,9250000,2013
29177,4500000,1650000,Justin Tuck,DE,active,new-york-giants,6150000,2013
29178,1000000,5078125,Jon Beason,ILB,active,new-york-giants,6078125,2013
29179,1450000,2675000,Mathias Kiwanuka,DE,active,new-york-giants,4125000,2013
29180,2725000,1460000,Hakeem Nicks,WR,active,new-york-giants,4185000,2013
29181,1000000,2550000,William Beatty,LT,active,new-york-giants,3550000,2013
29182,1000000,0,David Diehl,RT,active,new-york-giants,1000000,2013
29183,1175000,2650000,Jason Pierre-Paul,DE,active,new-york-giants,3825000,2013
29184,630000,1900000,Victor Cruz,WR,active,new-york-giants,2530000,2013
29185,1118718,1112436,Prince Amukamara,CB,active,new-york-giants,2231154,2013
29186,2023000,0,Stevie Brown,SS,active,new-york-giants,2023000,2013
29187,2023000,0,Andre Brown,RB,active,new-york-giants,2023000,2013
29188,925000,900000,Steve Weatherford,P,active,new-york-giants,1825000,2013
29189,1100000,716666,Cullen Jenkins,DE,active,new-york-giants,1816666,2013
29190,405000,1112436,Justin Pugh,G,active,new-york-giants,1517436,2013
29191,630000,820000,Terrell Thomas,CB,active,new-york-giants,1450000,2013
29192,725000,400000,Brandon Myers,TE,active,new-york-giants,1125000,2013
29193,824000,225000,Zak DeOssie,LS,active,new-york-giants,1049000,2013
29194,630000,382000,Linval Joseph,DT,active,new-york-giants,1012000,2013
29195,715000,177500,Bear Pascoe,TE,active,new-york-giants,892500,2013
29196,715000,85000,Keith Rivers,OLB,active,new-york-giants,800000,2013
29197,1000000,0,Jon Beason,ILB,active,new-york-giants,1000000,2013
29198,539633,208533,Rueben Randle,WR,active,new-york-giants,748166,2013
29199,405000,327852,Johnathan Hankins,DT,active,new-york-giants,732852,2013
29200,555000,168813,Jerrel Jernigan,WR,active,new-york-giants,723813,2013
29201,555000,108023,James Brewer,G,active,new-york-giants,663023,2013
29202,630000,0,Trumaine McBride,CB,active,new-york-giants,630000,2013
29203,630000,0,Curtis Painter,QB,active,new-york-giants,630000,2013
29204,940000,65000,Josh Brown,K,active,new-york-giants,1005000,2013
29205,840000,40000,Mike Patterson,DT,active,new-york-giants,880000,2013
29206,715000,65000,Ryan Mundy,SS,active,new-york-giants,780000,2013
29207,715000,65000,Louis Murphy,WR,active,new-york-giants,780000,2013
29208,480000,136250,Jayron Hosley,CB,active,new-york-giants,616250,2013
29209,840000,65000,Kevin Boothe,G,active,new-york-giants,905000,2013
29210,480000,96413,Adrien Robinson,TE,active,new-york-giants,576413,2013
29211,555000,19670,Jacquian Williams,OLB,active,new-york-giants,574670,2013
29212,555000,5000,Mark Herzlich,OLB,active,new-york-giants,560000,2013
29213,555000,5000,Henry Hynoski,FB,active,new-york-giants,560000,2013
29214,555000,1000,Spencer Paysinger,ILB,active,new-york-giants,556000,2013
29215,480000,75146,Brandon Mosley,G,active,new-york-giants,555146,2013
29216,405000,143813,Damontre Moore,DE,active,new-york-giants,548813,2013
29217,630000,0,John Conner,FB,active,new-york-giants,630000,2013
29218,405000,113400,Ryan Nassib,QB,active,new-york-giants,518400,2013
29219,480000,11474,Markus Kuhn,DT,active,new-york-giants,491474,2013
29220,480000,0,Allen Bradford,ILB,active,new-york-giants,480000,2013
29221,405000,11474,Michael Cox,RB,active,new-york-giants,416474,2013
29222,405000,0,Larry Donnell,TE,active,new-york-giants,405000,2013
29223,367059,0,Will Hill,SS,active,new-york-giants,367059,2013
29224,715000,0,Peyton Hillis,RB,active,new-york-giants,715000,2013
29225,405000,0,Charles James,CB,active,new-york-giants,405000,2013
29226,480000,0,Dallas Reynolds,G,active,new-york-giants,480000,2013
29227,555000,0,Da'Rel Scott,RB,active,new-york-giants,555000,2013
29228,405000,0,Stephen Goodin,G,active,new-york-giants,405000,2013
29229,480000,0,Marcus Dowtin,OLB,active,new-york-giants,480000,2013
29230,405000,0,Julian Talley,WR,active,new-york-giants,405000,2013
29231,405000,0,Eric Herman,RT,active,new-york-giants,405000,2013
29232,1700000,6800000,Chris Snee,G,injured_reserve,new-york-giants,8500000,2013
29233,1250000,4815000,Corey Webster,CB,injured_reserve,new-york-giants,6065000,2013
29234,1250000,3475000,David Baas,C,injured_reserve,new-york-giants,4725000,2013
29235,693841,825364,David Wilson,RB,injured_reserve,new-york-giants,1519205,2013
29236,715000,65000,Aaron Ross,CB,injured_reserve,new-york-giants,780000,2013
29237,555000,0,Jim Cordle,C,injured_reserve,new-york-giants,555000,2013
29238,940000,65000,Shaun Rogers,DT,injured_reserve,new-york-giants,1005000,2013
29239,840000,0,Brandon Jacobs,RB,injured_reserve,new-york-giants,840000,2013
29240,405000,46813,Cooper Taylor,FS,injured_reserve,new-york-giants,451813,2013
29241,303000,0,Kris Adams,WR,injured_reserve,new-york-giants,303000,2013
29242,96000,0,Eric Herman,RT,practice_squad,new-york-giants,96000,2013
29243,90000,0,Julian Talley,WR,practice_squad,new-york-giants,90000,2013
29244,72000,0,Stephen Goodin,G,practice_squad,new-york-giants,72000,2013
29245,36000,0,Emmanuel Acho,ILB,practice_squad,new-york-giants,36000,2013
29246,24000,0,Charles James,CB,practice_squad,new-york-giants,24000,2013
29247,18000,0,Steven Baker,RT,practice_squad,new-york-giants,18000,2013
29248,18000,0,Marcus Harris,WR,practice_squad,new-york-giants,18000,2013
29249,18000,0,Brandon Jones,CB,practice_squad,new-york-giants,18000,2013
29250,2500000,0,Ahmad Bradshaw,RB,dead_cap,new-york-giants,2500000,2013
29251,1700000,0,Chris Canty,DE,dead_cap,new-york-giants,1700000,2013
29252,1400000,0,Michael Boley,LB,dead_cap,new-york-giants,1400000,2013
29253,0,932555,Osi Umenyiora,OLB,dead_cap,new-york-giants,932555,2013
29254,620000,0,Dan Connor,ILB,dead_cap,new-york-giants,620000,2013
29255,311509,0,Marvin Austin,DT,dead_cap,new-york-giants,311509,2013
29256,223823,0,Ramses Barden,WR,dead_cap,new-york-giants,223823,2013
29257,100000,65000,David Carr,QB,dead_cap,new-york-giants,165000,2013
29258,144576,0,Da'Rel Scott,RB,dead_cap,new-york-giants,144576,2013
29259,141177,0,Dallas Reynolds,G,dead_cap,new-york-giants,141177,2013
29260,141175,0,Justin Trattou,DE,dead_cap,new-york-giants,141175,2013
29261,47790,47790,Mitch Petrus,G,dead_cap,new-york-giants,95580,2013
29262,66174,0,Matt McCants,RT,dead_cap,new-york-giants,66174,2013
29263,60000,0,Jawanza Starling,S,dead_cap,new-york-giants,60000,2013
29264,56118,0,Jeremy Horne,WR,dead_cap,new-york-giants,56118,2013
29265,51894,0,Greg Jones,ILB,dead_cap,new-york-giants,51894,2013
29266,0,51750,Justin Anderson,RT,dead_cap,new-york-giants,51750,2013
29267,48000,0,Darin Drakeford,ILB,dead_cap,new-york-giants,48000,2013
29268,28235,500,Adewale Ojomo,DE,dead_cap,new-york-giants,28735,2013
29269,26334,0,Matt Broha,DE,dead_cap,new-york-giants,26334,2013
29270,24000,0,Marcus Dowtin,OLB,dead_cap,new-york-giants,24000,2013
29271,18513,0,Tyler Sash,S,dead_cap,new-york-giants,18513,2013
29272,17824,0,Selvish Capers,G,dead_cap,new-york-giants,17824,2013
29273,17000,0,Jeremy Wright,RT,dead_cap,new-york-giants,17000,2013
29274,0,15000,Aaron Curry,OLB,dead_cap,new-york-giants,15000,2013
29275,15000,0,Marcus Davis,WR,dead_cap,new-york-giants,15000,2013
29276,13988,0,Eric Herman,RT,dead_cap,new-york-giants,13988,2013
29277,12000,0,Ty Powell,ILB,dead_cap,new-york-giants,12000,2013
29278,10000,0,Martin Parker,DT,dead_cap,new-york-giants,10000,2013
29279,6667,0,David Douglas,WR,dead_cap,new-york-giants,6667,2013
29280,5000,0,Jojo Nicolas,S,dead_cap,new-york-giants,5000,2013
29281,3334,0,Janzen Jackson,S,dead_cap,new-york-giants,3334,2013
29282,2500,0,Charles James,CB,dead_cap,new-york-giants,2500,2013
29283,2500,0,Etienne Sabino,OLB,dead_cap,new-york-giants,2500,2013
29284,2500,0,Alonzo Tweedy,S,dead_cap,new-york-giants,2500,2013
29285,2000,0,Stephen Goodin,G,dead_cap,new-york-giants,2000,2013
29286,2000,0,Joe Martinek,FB,dead_cap,new-york-giants,2000,2013
29287,1334,0,Julian Talley,WR,dead_cap,new-york-giants,1334,2013
29288,833,0,Chase Clement,TE,dead_cap,new-york-giants,833,2013
29289,15150000,7750000,Eli Manning,QB,active,new-york-giants,22900000,2014
29290,7000000,2250000,Antrel Rolle,SS,active,new-york-giants,9250000,2014
29291,3999000,3425000,Victor Cruz,WR,active,new-york-giants,7424000,2014
29292,4850000,2550000,William Beatty,LT,active,new-york-giants,7400000,2014
29293,3161000,2650000,Jason Pierre-Paul,DE,active,new-york-giants,5811000,2014
29294,2450000,816666,Cullen Jenkins,DE,active,new-york-giants,3266666,2014
29295,1975000,1025000,Walter Thurmond,FS,active,new-york-giants,3000000,2014
29296,1725000,1025000,Stevie Brown,SS,active,new-york-giants,2750000,2014
29297,730000,2020000,Dominique Rodgers-Cromartie,CB,active,new-york-giants,2750000,2014
29298,795200,1807813,Prince Amukamara,CB,active,new-york-giants,2603013,2014
29299,1500000,825000,Geoff Schwartz,G,active,new-york-giants,2325000,2014
29300,1250000,1062500,J.D. Walton,C,active,new-york-giants,2312500,2014
29301,900000,1075000,Steve Weatherford,P,active,new-york-giants,1975000,2014
29302,1250000,675000,Jameel McClain,ILB,active,new-york-giants,1925000,2014
29303,784359,1112436,Justin Pugh,G,active,new-york-giants,1896795,2014
29304,420000,1472036,Odell Beckham Jr.,WR,active,new-york-giants,1892036,2014
29305,1431000,19670,Jacquian Williams,OLB,active,new-york-giants,1450670,2014
29306,1431000,0,Spencer Paysinger,ILB,active,new-york-giants,1431000,2014
29307,1000000,350000,Josh Brown,K,active,new-york-giants,1350000,2014
29308,730000,582500,Rashad Jennings,RB,active,new-york-giants,1312500,2014
29309,730000,520000,Robert Ayers,DE,active,new-york-giants,1250000,2014
29310,925000,225000,Zak DeOssie,LS,active,new-york-giants,1150000,2014
29311,775000,225000,Mark Herzlich,OLB,active,new-york-giants,1000000,2014
29312,730000,270000,Quintin Demps,SS,active,new-york-giants,1000000,2014
29313,725000,275000,Henry Hynoski,FB,active,new-york-giants,1000000,2014
29314,588213,327852,Johnathan Hankins,DT,active,new-york-giants,916065,2014
29315,664266,233533,Rueben Randle,WR,active,new-york-giants,897799,2014
29316,420000,466791,Weston Richburg,C,active,new-york-giants,886791,2014
29317,645000,168813,Jerrel Jernigan,WR,active,new-york-giants,813813,2014
29318,650000,108023,James Brewer,G,active,new-york-giants,758023,2014
29319,570000,96413,Adrien Robinson,TE,active,new-york-giants,666413,2014
29320,495000,163813,Damontre Moore,DE,active,new-york-giants,658813,2014
29321,570000,75146,Brandon Mosley,G,active,new-york-giants,645146,2014
29322,855000,65000,Mike Patterson,DT,active,new-york-giants,920000,2014
29323,730000,65000,Zackary Bowman,CB,active,new-york-giants,795000,2014
29324,730000,65000,John Jerry,G,active,new-york-giants,795000,2014
29325,495000,113400,Ryan Nassib,QB,active,new-york-giants,608400,2014
29326,570000,11474,Markus Kuhn,DT,active,new-york-giants,581474,2014
29327,420000,160969,Jay Bromley,DT,active,new-york-giants,580969,2014
29328,435882,136250,Jayron Hosley,CB,active,new-york-giants,572132,2014
29329,730000,0,Daniel Fells,TE,active,new-york-giants,730000,2014
29330,570000,0,Preston Parker,WR,active,new-york-giants,570000,2014
29331,570000,0,Dallas Reynolds,G,active,new-york-giants,570000,2014
29332,420000,113400,Andre Williams,RB,active,new-york-giants,533400,2014
29333,495000,11474,Michael Cox,RB,active,new-york-giants,506474,2014
29334,495000,0,Larry Donnell,TE,active,new-york-giants,495000,2014
29335,420000,48200,Nat Berhe,SS,active,new-york-giants,468200,2014
29336,420000,36140,Devon Kennard,OLB,active,new-york-giants,456140,2014
29337,420000,2500,Kerry Wynn,DE,active,new-york-giants,422500,2014
29338,420000,0,Corey Washington,WR,active,new-york-giants,420000,2014
29339,472352,0,Kevin Ogletree,WR,active,new-york-giants,472352,2014
29340,645000,0,Chykie Brown,CB,active,new-york-giants,645000,2014
29341,301764,0,Mike Harris,CB,active,new-york-giants,301764,2014
29342,420000,0,Chandler Fenner,CB,active,new-york-giants,420000,2014
29343,420000,0,Orleans Darkwa,RB,active,new-york-giants,420000,2014
29344,730000,0,Chris Ogbonnaya,RB,active,new-york-giants,730000,2014
29345,495000,0,Paul Hazel,DE,active,new-york-giants,495000,2014
29346,420000,0,James Davidson,DE,active,new-york-giants,420000,2014
29347,420000,0,Eric Herman,RT,active,new-york-giants,420000,2014
29348,570000,0,Adam Gettis,G,active,new-york-giants,570000,2014
29349,420000,0,Jerome Cunningham,TE,active,new-york-giants,420000,2014
29350,420000,0,Dominique Hamilton,DE,active,new-york-giants,420000,2014
29351,1500000,3500000,Mathias Kiwanuka,DE,injured_reserve,new-york-giants,5000000,2014
29352,730000,2411666,Jon Beason,ILB,injured_reserve,new-york-giants,3141666,2014
29353,997682,825364,David Wilson,RB,injured_reserve,new-york-giants,1823046,2014
29354,750000,559375,Trumaine McBride,CB,injured_reserve,new-york-giants,1309375,2014
29355,730000,125000,Peyton Hillis,RB,injured_reserve,new-york-giants,855000,2014
29356,645000,0,Troy Kropog,RT,injured_reserve,new-york-giants,645000,2014
29357,855000,0,Adam Snyder,G,injured_reserve,new-york-giants,855000,2014
29358,318000,46813,Cooper Taylor,FS,injured_reserve,new-york-giants,364813,2014
29359,303000,0,Rogers Gaines,LT,injured_reserve,new-york-giants,303000,2014
29360,303000,0,Marcus Harris,WR,injured_reserve,new-york-giants,303000,2014
29361,303000,0,Travis Howard,CB,injured_reserve,new-york-giants,303000,2014
29362,570000,0,Terrell Manning,ILB,injured_reserve,new-york-giants,570000,2014
29363,107100,0,Bennett Jackson,SS,practice_squad,new-york-giants,107100,2014
29364,75600,0,Julian Talley,WR,practice_squad,new-york-giants,75600,2014
29365,44100,0,Josh Victorian,CB,practice_squad,new-york-giants,44100,2014
29366,31500,0,Michael Bamiro,RT,practice_squad,new-york-giants,31500,2014
29367,25200,0,Jordan Stanton,OLB,practice_squad,new-york-giants,25200,2014
29368,12600,0,Nikita Whitlock,FB,practice_squad,new-york-giants,12600,2014
29369,6300,0,Uani Unga,ILB,practice_squad,new-york-giants,6300,2014
29370,50000,4500000,Chris Snee,G,dead_cap,new-york-giants,4550000,2014
29371,3225000,0,David Baas,C,dead_cap,new-york-giants,3225000,2014
29372,1250000,0,Corey Webster,CB,dead_cap,new-york-giants,1250000,2014
29373,1125000,0,Brandon Myers,TE,dead_cap,new-york-giants,1125000,2014
29374,730000,65000,Charles Brown,LT,dead_cap,new-york-giants,795000,2014
29375,311509,0,Marvin Austin,DT,dead_cap,new-york-giants,311509,2014
29376,167648,130000,Trindon Holliday,KR,dead_cap,new-york-giants,297648,2014
29377,83647,50000,Mario Manningham,WR,dead_cap,new-york-giants,133647,2014
29378,112906,0,Dominique Hamilton,DE,dead_cap,new-york-giants,112906,2014
29379,104964,0,Eric Herman,RT,dead_cap,new-york-giants,104964,2014
29380,94500,0,Jerome Cunningham,TE,dead_cap,new-york-giants,94500,2014
29381,91718,1666,Dan Fox,ILB,dead_cap,new-york-giants,93384,2014
29382,86718,0,Julian Talley,WR,dead_cap,new-york-giants,86718,2014
29383,69300,0,James Davidson,DE,dead_cap,new-york-giants,69300,2014
29384,67012,0,Justin Anderson,ILB,dead_cap,new-york-giants,67012,2014
29385,0,65000,Curtis Painter,QB,dead_cap,new-york-giants,65000,2014
29386,0,65000,Josh Freeman,QB,dead_cap,new-york-giants,65000,2014
29387,56206,0,Chandler Fenner,CB,dead_cap,new-york-giants,56206,2014
29388,31500,11474,Michael Cox,RB,dead_cap,new-york-giants,42974,2014
29389,0,35000,Kellen Davis,TE,dead_cap,new-york-giants,35000,2014
29390,0,27515,Bennett Jackson,SS,dead_cap,new-york-giants,27515,2014
29391,25200,0,Travis Harvey,WR,dead_cap,new-york-giants,25200,2014
29392,18900,0,Mark Asper,LT,dead_cap,new-york-giants,18900,2014
29393,18900,0,Rishaw  Johnson,G,dead_cap,new-york-giants,18900,2014
29394,18513,0,Tyler Sash,S,dead_cap,new-york-giants,18513,2014
29395,13988,0,Da'Rel Scott,RB,dead_cap,new-york-giants,13988,2014
29396,12600,500,Jordan Stanton,OLB,dead_cap,new-york-giants,13100,2014
29397,12600,0,Carlos Fields,OLB,dead_cap,new-york-giants,12600,2014
29398,12600,0,L'Damian Washington,WR,dead_cap,new-york-giants,12600,2014
29399,7500,2500,Emmanuel Dieke,DE,dead_cap,new-york-giants,10000,2014
29400,0,10000,John Conner,FB,dead_cap,new-york-giants,10000,2014
29401,6300,0,Paul Hazel,DE,dead_cap,new-york-giants,6300,2014
29402,6300,0,Kyle Sebetic,CB,dead_cap,new-york-giants,6300,2014
29403,5000,0,Charles James,CB,dead_cap,new-york-giants,5000,2014
29404,5000,0,Etienne Sabino,OLB,dead_cap,new-york-giants,5000,2014
29405,5000,0,Alonzo Tweedy,S,dead_cap,new-york-giants,5000,2014
29406,0,3333,Xavier Grimble,TE,dead_cap,new-york-giants,3333,2014
29407,0,3333,Kelcy Quarles,DT,dead_cap,new-york-giants,3333,2014
29408,1667,0,Chase Clement,TE,dead_cap,new-york-giants,1667,2014
29409,0,1666,C.J. Barnett,S,dead_cap,new-york-giants,1666,2014
29410,0,1666,Thomas Gordon,S,dead_cap,new-york-giants,1666,2014
29411,0,500,Eathyn Manumaluene,DT,dead_cap,new-york-giants,500,2014
29412,0,500,Adewale Ojomo,DE,dead_cap,new-york-giants,500,2014
29413,5500000,8950000,Eli Manning,QB,active,new-york-giants,14450000,2015
29414,1500000,5850000,Jason Pierre-Paul,DE,active,new-york-giants,7350000,2015
29415,4230000,3020000,Dominique Rodgers-Cromartie,CB,active,new-york-giants,7250000,2015
29416,6898000,0,Prince Amukamara,CB,active,new-york-giants,6898000,2015
29417,2230000,582500,Rashad Jennings,RB,active,new-york-giants,2812500,2015
29418,435000,2181676,Ereck Flowers,RT,active,new-york-giants,2616676,2015
29419,1250000,1266666,Shane Vereen,RB,active,new-york-giants,2516666,2015
29420,1230000,1207500,Robert Ayers,DE,active,new-york-giants,2437500,2015
29421,893009,1472036,Odell Beckham Jr.,WR,active,new-york-giants,2365045,2015
29422,1163718,1112436,Justin Pugh,G,active,new-york-giants,2276154,2015
29423,1000000,1091668,Cullen Jenkins,DE,active,new-york-giants,2091668,2015
29424,975000,825000,Dwayne Harris,WR,active,new-york-giants,1800000,2015
29425,975000,691666,Jonathan Casillas,OLB,active,new-york-giants,1666666,2015
29426,1000000,550000,Trumaine McBride,CB,active,new-york-giants,1550000,2015
29427,850000,550000,John Jerry,G,active,new-york-giants,1400000,2015
29428,1000000,350000,Josh Brown,K,active,new-york-giants,1350000,2015
29429,850000,450000,Marshall Newhouse,RT,active,new-york-giants,1300000,2015
29430,975000,225000,George Selvie,DE,active,new-york-giants,1200000,2015
29431,950000,250000,Mark Herzlich,OLB,active,new-york-giants,1200000,2015
29432,435000,677828,Landon Collins,FS,active,new-york-giants,1112828,2015
29433,641698,466791,Weston Richburg,C,active,new-york-giants,1108489,2015
29434,813899,233533,Rueben Randle,WR,active,new-york-giants,1047432,2015
29435,660000,136250,Jayron Hosley,CB,active,new-york-giants,796250,2015
29436,660000,75146,Brandon Mosley,G,active,new-york-giants,735146,2015
29437,510000,195969,Jay Bromley,DT,active,new-york-giants,705969,2015
29438,660000,40000,Dallas Reynolds,G,active,new-york-giants,700000,2015
29439,585000,113400,Ryan Nassib,QB,active,new-york-giants,698400,2015
29440,870000,80000,Daniel Fells,TE,active,new-york-giants,950000,2015
29441,510000,113400,Andre Williams,RB,active,new-york-giants,623400,2015
29442,870000,0,Craig Dahl,SS,active,new-york-giants,870000,2015
29443,745000,0,Jasper Brinkley,ILB,active,new-york-giants,745000,2015
29444,585000,0,Trevin Wade,CB,active,new-york-giants,585000,2015
29445,510000,2500,Kerry Wynn,DE,active,new-york-giants,512500,2015
29446,510000,0,Orleans Darkwa,RB,active,new-york-giants,510000,2015
29447,510000,0,Brad Wing,P,active,new-york-giants,510000,2015
29448,435000,31770,Geremy Davis,WR,active,new-york-giants,466770,2015
29449,435000,17897,Bobby Hart,RT,active,new-york-giants,452897,2015
29450,435000,0,Uani Unga,ILB,active,new-york-giants,435000,2015
29451,390000,0,Myles White,WR,active,new-york-giants,390000,2015
29452,333000,48200,Nat Berhe,SS,active,new-york-giants,381200,2015
29453,318000,57215,Mykkele Thompson,FS,active,new-york-giants,375215,2015
29454,358235,0,Will Tye,TE,active,new-york-giants,358235,2015
29455,318000,0,Justin Currie,SS,active,new-york-giants,318000,2015
29456,318000,0,Bennett Jackson,SS,active,new-york-giants,318000,2015
29457,318000,0,Brett Jones,C,active,new-york-giants,318000,2015
29458,275294,0,Montori Hughes,DT,active,new-york-giants,275294,2015
29459,306764,0,Hakeem Nicks,WR,active,new-york-giants,306764,2015
29460,230294,0,Jerome Cunningham,TE,active,new-york-giants,230294,2015
29461,210000,0,Cooper Taylor,FS,active,new-york-giants,210000,2015
29462,179117,0,Emmett Cleary,RT,active,new-york-giants,179117,2015
29463,172058,0,Adam Gettis,G,active,new-york-giants,172058,2015
29464,137647,0,Stansly Maponga,DE,active,new-york-giants,137647,2015
29465,120000,0,Tramain Jacobs,CB,active,new-york-giants,120000,2015
29466,153529,0,Barry Cofield,DT,active,new-york-giants,153529,2015
29467,102352,0,Brandon Meriweather,SS,active,new-york-giants,102352,2015
29468,51176,0,Brad Bars,DE,active,new-york-giants,51176,2015
29469,51176,0,Ben Edwards,WR,active,new-york-giants,51176,2015
29470,51176,0,Matt LaCosse,TE,active,new-york-giants,51176,2015
29471,30000,0,Nico Johnson,ILB,active,new-york-giants,30000,2015
29472,25588,0,Tyler Ott,LS,active,new-york-giants,25588,2015
29473,6150000,1975000,Victor Cruz,WR,injured_reserve,new-york-giants,8125000,2015
29474,1900000,2254166,Jon Beason,ILB,injured_reserve,new-york-giants,4154166,2015
29475,1675000,1170833,Geoff Schwartz,G,injured_reserve,new-york-giants,2845833,2015
29476,975000,1025000,J.T. Thomas,OLB,injured_reserve,new-york-giants,2000000,2015
29477,975000,225000,Zak DeOssie,LS,injured_reserve,new-york-giants,1200000,2015
29478,771426,327852,Johnathan Hankins,DT,injured_reserve,new-york-giants,1099278,2015
29479,660000,11474,Markus Kuhn,DT,injured_reserve,new-york-giants,671474,2015
29480,435000,185125,Owamagbe Odighizuwa,DE,injured_reserve,new-york-giants,620125,2015
29481,585000,0,Larry Donnell,TE,injured_reserve,new-york-giants,585000,2015
29482,499588,36140,Devon Kennard,OLB,injured_reserve,new-york-giants,535728,2015
29483,421235,0,Nikita Whitlock,FB,injured_reserve,new-york-giants,421235,2015
29484,318000,0,Marcus Harris,WR,injured_reserve,new-york-giants,318000,2015
29485,153529,0,James Morris,ILB,injured_reserve,new-york-giants,153529,2015
29486,175294,0,Danny Aiken,LS,injured_reserve,new-york-giants,175294,2015
29487,3225000,0,David Baas,C,dead_cap,new-york-giants,3225000,2015
29488,0,2625000,Mathias Kiwanuka,DE,dead_cap,new-york-giants,2625000,2015
29489,0,2550000,Jason Pierre-Paul,DE,dead_cap,new-york-giants,2550000,2015
29490,0,900000,Steve Weatherford,P,dead_cap,new-york-giants,900000,2015
29491,0,825364,David Wilson,RB,dead_cap,new-york-giants,825364,2015
29492,0,750000,Jameel McClain,ILB,dead_cap,new-york-giants,750000,2015
29493,0,625000,J.D. Walton,C,dead_cap,new-york-giants,625000,2015
29494,447353,163813,Damontre Moore,DE,dead_cap,new-york-giants,611166,2015
29495,870000,0,Brandon Meriweather,SS,dead_cap,new-york-giants,870000,2015
29496,238823,325000,Kenrick Ellis,DT,dead_cap,new-york-giants,563823,2015
29497,250000,150000,Henry Hynoski,FB,dead_cap,new-york-giants,400000,2015
29498,292800,0,Louis Nix,DT,dead_cap,new-york-giants,292800,2015
29499,176471,100000,Chykie Brown,CB,dead_cap,new-york-giants,276471,2015
29500,219670,46813,Cooper Taylor,FS,dead_cap,new-york-giants,266483,2015
29501,232870,0,Leon McFadden,CB,dead_cap,new-york-giants,232870,2015
29502,166729,0,Jerome Cunningham,TE,dead_cap,new-york-giants,166729,2015
29503,122964,0,James Morris,ILB,dead_cap,new-york-giants,122964,2015
29504,119400,0,Tramain Jacobs,CB,dead_cap,new-york-giants,119400,2015
29505,99000,0,Brad Bars,DE,dead_cap,new-york-giants,99000,2015
29506,99000,0,G.J. Kinne,QB,dead_cap,new-york-giants,99000,2015
29507,93529,4166,Akeem Hunt,RB,dead_cap,new-york-giants,97695,2015
29508,0,96413,Adrien Robinson,TE,dead_cap,new-york-giants,96413,2015
29509,92400,0,Tavarres King,WR,dead_cap,new-york-giants,92400,2015
29510,0,82545,Bennett Jackson,SS,dead_cap,new-york-giants,82545,2015
29511,0,80000,James Jones,WR,dead_cap,new-york-giants,80000,2015
29512,77647,0,Preston Parker,WR,dead_cap,new-york-giants,77647,2015
29513,75423,0,Brandon McGee,CB,dead_cap,new-york-giants,75423,2015
29514,74824,0,Tony Johnson,LB,dead_cap,new-york-giants,74824,2015
29515,72600,0,Julian Talley,WR,dead_cap,new-york-giants,72600,2015
29516,66000,0,Emmett Cleary,RT,dead_cap,new-york-giants,66000,2015
29517,59400,0,Montori Hughes,DT,dead_cap,new-york-giants,59400,2015
29518,56700,0,Nick Becton,LT,dead_cap,new-york-giants,56700,2015
29519,46200,1666,Matt LaCosse,TE,dead_cap,new-york-giants,47866,2015
29520,46200,0,Nico Johnson,ILB,dead_cap,new-york-giants,46200,2015
29521,46200,0,Shane McDermott,C,dead_cap,new-york-giants,46200,2015
29522,46200,0,Adam Gettis,G,dead_cap,new-york-giants,46200,2015
29523,40941,0,Josh Gordy,CB,dead_cap,new-york-giants,40941,2015
29524,33000,0,Ben Edwards,WR,dead_cap,new-york-giants,33000,2015
29525,33000,0,Dax Swanson,SS,dead_cap,new-york-giants,33000,2015
29526,26400,0,Jake Rodgers,T,dead_cap,new-york-giants,26400,2015
29527,26400,0,Myles White,WR,dead_cap,new-york-giants,26400,2015
29528,0,25000,Kevin Ogletree,WR,dead_cap,new-york-giants,25000,2015
29529,0,22948,Michael Cox,RB,dead_cap,new-york-giants,22948,2015
29530,15000,5000,Sean Donnelly,T,dead_cap,new-york-giants,20000,2015
29531,19800,0,Will Tye,TE,dead_cap,new-york-giants,19800,2015
29532,13200,0,Vinston Painter,RT,dead_cap,new-york-giants,13200,2015
29533,0,10000,Chris Ogbonnaya,RB,dead_cap,new-york-giants,10000,2015
29534,0,6667,Xavier Grimble,TE,dead_cap,new-york-giants,6667,2015
29535,0,6667,Kelcy Quarles,DT,dead_cap,new-york-giants,6667,2015
29536,6600,0,Glenn Carson,ILB,dead_cap,new-york-giants,6600,2015
29537,6600,0,C.J. Conway,CB,dead_cap,new-york-giants,6600,2015
29538,6600,0,T.J. Heath,CB,dead_cap,new-york-giants,6600,2015
29539,6600,0,Dominique Jones,TE,dead_cap,new-york-giants,6600,2015
29540,6600,0,Xavier Proctor,DT,dead_cap,new-york-giants,6600,2015
29541,6600,0,Gerald Rivers,DE,dead_cap,new-york-giants,6600,2015
29542,0,5000,Emmanuel Dieke,DE,dead_cap,new-york-giants,5000,2015
29543,0,3334,C.J. Barnett,S,dead_cap,new-york-giants,3334,2015
29544,0,3334,Dan Fox,ILB,dead_cap,new-york-giants,3334,2015
29545,0,3334,Thomas Gordon,S,dead_cap,new-york-giants,3334,2015
29546,0,1666,Justin Currie,SS,dead_cap,new-york-giants,1666,2015
29547,0,1666,Cole Farrand,ILB,dead_cap,new-york-giants,1666,2015
29548,0,1666,Brad Harrah,DT,dead_cap,new-york-giants,1666,2015
29549,0,1000,Eathyn Manumaluene,DT,dead_cap,new-york-giants,1000,2015
29550,0,1000,Jordan Stanton,OLB,dead_cap,new-york-giants,1000,2015
29551,17500000,6700000,Eli Manning,QB,active,new-york-giants,24200000,2016
29552,1750000,11250000,Olivier Vernon,DE,active,new-york-giants,13000000,2016
29553,4250000,5150000,Jason Pierre-Paul,DE,active,new-york-giants,9400000,2016
29554,5980000,2020000,Dominique Rodgers-Cromartie,CB,active,new-york-giants,8000000,2016
29555,1400000,6600000,Janoris Jenkins,CB,active,new-york-giants,8000000,2016
29556,1750000,4850000,Damon Harrison,DT,active,new-york-giants,6600000,2016
29557,2400000,2000000,Victor Cruz,WR,active,new-york-giants,4400000,2016
29558,2975000,825000,Dwayne Harris,WR,active,new-york-giants,3800000,2016
29559,2475000,941666,Jonathan Casillas,OLB,active,new-york-giants,3416666,2016
29560,1089169,2181676,Ereck Flowers,RT,active,new-york-giants,3270845,2016
29561,1366018,1472036,Odell Beckham Jr.,WR,active,new-york-giants,2838054,2016
29562,2230000,582500,Rashad Jennings,RB,active,new-york-giants,2812500,2016
29563,450000,2304967,Eli Apple,CB,active,new-york-giants,2754967,2016
29564,1157307,1498206,Justin Pugh,G,active,new-york-giants,2655513,2016
29565,1150000,1384375,Keenan Robinson,OLB,active,new-york-giants,2534375,2016
29566,1450000,500000,Marshall Newhouse,RT,active,new-york-giants,1950000,2016
29567,1250000,650000,John Jerry,G,active,new-york-giants,1900000,2016
29568,1671000,0,Larry Donnell,TE,active,new-york-giants,1671000,2016
29569,885000,552500,Leon Hall,CB,active,new-york-giants,1437500,2016
29570,1000000,400000,Mark Herzlich,OLB,active,new-york-giants,1400000,2016
29571,713208,677828,Landon Collins,FS,active,new-york-giants,1391036,2016
29572,863396,466791,Weston Richburg,C,active,new-york-giants,1330187,2016
29573,954639,327852,Johnathan Hankins,DT,active,new-york-giants,1282491,2016
29574,1100000,0,William Beatty,LT,active,new-york-giants,1100000,2016
29575,825000,275000,Zak DeOssie,LS,active,new-york-giants,1100000,2016
29576,600000,500000,Brad Wing,P,active,new-york-giants,1100000,2016
29577,450000,630831,Sterling Shepard,WR,active,new-york-giants,1080831,2016
29578,605000,200969,Jay Bromley,DT,active,new-york-giants,805969,2016
29579,525000,220125,Owamagbe Odighizuwa,DE,active,new-york-giants,745125,2016
29580,760000,80000,Bobby Rainey,RB,active,new-york-giants,840000,2016
29581,760000,80000,Kelvin Sheppard,ILB,active,new-york-giants,840000,2016
29582,675000,0,Trevin Wade,CB,active,new-york-giants,675000,2016
29583,600000,48200,Nat Berhe,SS,active,new-york-giants,648200,2016
29584,600000,36140,Devon Kennard,OLB,active,new-york-giants,636140,2016
29585,600000,2500,Kerry Wynn,DE,active,new-york-giants,602500,2016
29586,885000,0,Josh Johnson,QB,active,new-york-giants,885000,2016
29587,600000,0,Tavarres King,WR,active,new-york-giants,600000,2016
29588,450000,145551,B.J. Goodson,ILB,active,new-york-giants,595551,2016
29589,525000,17897,Bobby Hart,RT,active,new-york-giants,542897,2016
29590,536470,0,Coty Sensabaugh,CB,active,new-york-giants,536470,2016
29591,525000,0,Will Tye,TE,active,new-york-giants,525000,2016
29592,450000,63137,Paul Perkins,RB,active,new-york-giants,513137,2016
29593,450000,35713,Jerell Adams,TE,active,new-york-giants,485713,2016
29594,450000,6166,Roger Lewis,WR,active,new-york-giants,456166,2016
29595,450000,5000,Romeo Okwara,DE,active,new-york-giants,455000,2016
29596,450000,0,Brett Jones,C,active,new-york-giants,450000,2016
29597,450000,0,Robert Thomas,DT,active,new-york-giants,450000,2016
29598,397050,0,Andrew Adam,S,active,new-york-giants,397050,2016
29599,637532,0,Robbie Gould,K,active,new-york-giants,637532,2016
29600,154411,0,Eric Pinkins,SS,active,new-york-giants,154411,2016
29601,123529,0,Deontae Skinner,OLB,active,new-york-giants,123529,2016
29602,70588,0,George Winn,RB,active,new-york-giants,70588,2016
29603,52940,0,Ishaq Williams,OLB,active,new-york-giants,52940,2016
29604,3150000,1766666,Shane Vereen,RB,injured_reserve,new-york-giants,4916666,2016
29605,1500000,1100000,J.T. Thomas,OLB,injured_reserve,new-york-giants,2600000,2016
29606,800000,225000,Will Johnson,FB,injured_reserve,new-york-giants,1025000,2016
29607,675000,113400,Ryan Nassib,QB,injured_reserve,new-york-giants,788400,2016
29608,450000,209284,Darian Thompson,FS,injured_reserve,new-york-giants,659284,2016
29609,600000,0,Orleans Darkwa,RB,injured_reserve,new-york-giants,600000,2016
29610,346761,57216,Mykkele Thompson,FS,injured_reserve,new-york-giants,403977,2016
29611,348000,0,Uani Unga,ILB,injured_reserve,new-york-giants,348000,2016
29612,348000,0,Nikita Whitlock,FB,injured_reserve,new-york-giants,348000,2016
29613,333000,0,Ben Edwards,WR,injured_reserve,new-york-giants,333000,2016
29614,333000,0,Matt LaCosse,TE,injured_reserve,new-york-giants,333000,2016
29615,117300,0,Donte Deayon,S,injured_reserve,new-york-giants,117300,2016
29616,0,5000000,William Beatty,LT,dead_cap,new-york-giants,5000000,2016
29617,0,1916667,Geoff Schwartz,G,dead_cap,new-york-giants,1916667,2016
29618,1200000,600000,Jasper Brinkley,ILB,dead_cap,new-york-giants,1800000,2016
29619,1152941,353125,Josh Brown,K,dead_cap,new-york-giants,1506066,2016
29620,0,1466668,Jon Beason,ILB,dead_cap,new-york-giants,1466668,2016
29621,0,875000,Steve Weatherford,P,dead_cap,new-york-giants,875000,2016
29622,241623,0,Adam Gettis,G,dead_cap,new-york-giants,241623,2016
29623,204070,0,Deontae Skinner,OLB,dead_cap,new-york-giants,204070,2016
29624,198530,0,Montori Hughes,DT,dead_cap,new-york-giants,198530,2016
29625,170000,0,Stansly Maponga,DE,dead_cap,new-york-giants,170000,2016
29626,149540,0,Michael Hunter,CB,dead_cap,new-york-giants,149540,2016
29627,0,143813,Damontre Moore,DE,dead_cap,new-york-giants,143813,2016
29628,0,125000,Henry Hynoski,FB,dead_cap,new-york-giants,125000,2016
29629,117300,0,Donte Deayon,S,dead_cap,new-york-giants,117300,2016
29630,117300,0,Darius Powe,WR,dead_cap,new-york-giants,117300,2016
29631,0,113400,Andre Williams,RB,dead_cap,new-york-giants,113400,2016
29632,103500,0,Ishaq Williams,OLB,dead_cap,new-york-giants,103500,2016
29633,0,100000,Chykie Brown,CB,dead_cap,new-york-giants,100000,2016
29634,96600,0,Jon Halapio,G,dead_cap,new-york-giants,96600,2016
29635,62100,31770,Geremy Davis,WR,dead_cap,new-york-giants,93870,2016
29636,82800,0,Laurence Gibson,T,dead_cap,new-york-giants,82800,2016
29637,50352,20000,Byron Stingily,RT,dead_cap,new-york-giants,70352,2016
29638,66740,0,Shane McDermott,C,dead_cap,new-york-giants,66740,2016
29639,55200,0,Kevin Norwood,WR,dead_cap,new-york-giants,55200,2016
29640,48300,0,Eric Pinkins,SS,dead_cap,new-york-giants,48300,2016
29641,48300,0,Logan Thomas,TE,dead_cap,new-york-giants,48300,2016
29642,0,46814,Cooper Taylor,FS,dead_cap,new-york-giants,46814,2016
29643,41400,0,George Winn,RB,dead_cap,new-york-giants,41400,2016
29644,44705,0,Randy Bullock,K,dead_cap,new-york-giants,44705,2016
29645,34500,0,Tyler Ott,LS,dead_cap,new-york-giants,34500,2016
29646,27600,0,Christian Bryant,FS,dead_cap,new-york-giants,27600,2016
29647,27600,0,Jordan Williams,DT,dead_cap,new-york-giants,27600,2016
29648,20700,0,Doran Grant,CB,dead_cap,new-york-giants,20700,2016
29649,13800,0,Andrew Adam,S,dead_cap,new-york-giants,13800,2016
29650,13800,0,Russell Hansbrough,RB,dead_cap,new-york-giants,13800,2016
29651,0,10000,Sean Donnelly,T,dead_cap,new-york-giants,10000,2016
29652,7000,1666,Mike Rose,DE,dead_cap,new-york-giants,8666,2016
29653,0,8334,Akeem Hunt,RB,dead_cap,new-york-giants,8334,2016
29654,6900,0,Da'Ron Brown,WR,dead_cap,new-york-giants,6900,2016
29655,6900,0,Jacob Huesman,RB,dead_cap,new-york-giants,6900,2016
29656,6900,0,Ryan Murphy,FS,dead_cap,new-york-giants,6900,2016
29657,6900,0,Michael Ola,T,dead_cap,new-york-giants,6900,2016
29658,6900,0,Keith Wenning,QB,dead_cap,new-york-giants,6900,2016
29659,0,3334,Justin Currie,SS,dead_cap,new-york-giants,3334,2016
29660,0,3334,Cole Farrand,ILB,dead_cap,new-york-giants,3334,2016
29661,0,3334,Brad Harrah,DT,dead_cap,new-york-giants,3334,2016
29662,0,3334,Matt LaCosse,TE,dead_cap,new-york-giants,3334,2016
29663,0,3333,Melvin Lewis,DT,dead_cap,new-york-giants,3333,2016
29664,13000000,6700000,Eli Manning,QB,active,new-york-giants,19700000,2017
29665,11750000,4250000,Olivier Vernon,DE,active,new-york-giants,16000000,2017
29666,8750000,1850000,Damon Harrison,DT,active,new-york-giants,10600000,2017
29667,6569412,2020000,Dominique Rodgers-Cromartie,CB,active,new-york-giants,8589412,2017
29668,1250000,6250000,Jason Pierre-Paul,DE,active,new-york-giants,7500000,2017
29669,1743338,2181676,Ereck Flowers,RT,active,new-york-giants,3925014,2017
29670,2150000,1766668,Shane Vereen,RB,active,new-york-giants,3916668,2017
29671,1071757,2304967,Eli Apple,CB,active,new-york-giants,3376724,2017
29672,975000,1275000,Rhett Ellison,TE,active,new-york-giants,2250000,2017
29673,465000,1483782,Evan Engram,TE,active,new-york-giants,1948782,2017
29674,1797000,36140,Devon Kennard,OLB,active,new-york-giants,1833140,2017
29675,1125000,675000,Brad Wing,P,active,new-york-giants,1800000,2017
29676,1797000,0,Kerry Wynn,DE,active,new-york-giants,1797000,2017
29677,925000,825000,John Jerry,G,active,new-york-giants,1750000,2017
29678,720208,630831,Sterling Shepard,WR,active,new-york-giants,1351039,2017
29679,1000000,300000,Zak DeOssie,LS,active,new-york-giants,1300000,2017
29680,1000000,100000,Ross Cockrell,CB,active,new-york-giants,1100000,2017
29681,775000,312500,Geno Smith,QB,active,new-york-giants,1087500,2017
29682,690000,347500,Orleans Darkwa,RB,active,new-york-giants,1037500,2017
29683,725000,185969,Jay Bromley,DT,active,new-york-giants,910969,2017
29684,465000,366291,Dalvin Tomlinson,DT,active,new-york-giants,831291,2017
29685,585000,234284,Darian Thompson,FS,active,new-york-giants,819284,2017
29686,690000,48200,Nat Berhe,SS,active,new-york-giants,738200,2017
29687,465000,191605,Davis Webb,QB,active,new-york-giants,656605,2017
29688,615000,0,Brett Jones,C,active,new-york-giants,615000,2017
29689,540000,63137,Paul Perkins,RB,active,new-york-giants,603137,2017
29690,540000,35713,Jerell Adams,TE,active,new-york-giants,575713,2017
29691,465000,104912,Wayne Gallman,RB,active,new-york-giants,569912,2017
29692,540000,6166,Roger Lewis,WR,active,new-york-giants,546166,2017
29693,540000,0,Andrew Adam,S,active,new-york-giants,540000,2017
29694,540000,0,Robert Thomas,DT,active,new-york-giants,540000,2017
29695,465000,63692,Avery Moss,DE,active,new-york-giants,528692,2017
29696,465000,6666,Chad Wheeler,T,active,new-york-giants,471666,2017
29697,465000,3333,Calvin Munson,ILB,active,new-york-giants,468333,2017
29698,465000,0,Aldrick Rosas,K,active,new-york-giants,465000,2017
29699,446294,5000,Romeo Okwara,DE,active,new-york-giants,451294,2017
29700,423529,0,Kelvin Sheppard,ILB,active,new-york-giants,423529,2017
29701,294118,78125,Ray-Ray Armstrong,OLB,active,new-york-giants,372243,2017
29702,370588,0,John Greco,G,active,new-york-giants,370588,2017
29703,355589,0,Jon Halapio,G,active,new-york-giants,355589,2017
29704,328235,0,Travis Rudolph,WR,active,new-york-giants,328235,2017
29705,319118,0,Akeem Ayers,OLB,active,new-york-giants,319118,2017
29706,227941,0,Darryl Morris,CB,active,new-york-giants,227941,2017
29707,222353,0,Kalif Raymond,WR,active,new-york-giants,222353,2017
29708,218824,0,Shane Smith,FB,active,new-york-giants,218824,2017
29709,158825,0,Brandon Dixon,CB,active,new-york-giants,158825,2017
29710,82059,0,Damien Mama,T,active,new-york-giants,82059,2017
29711,82059,0,Ryan Murphy,FS,active,new-york-giants,82059,2017
29712,82059,0,Hunter Sharp,WR,active,new-york-giants,82059,2017
29713,40588,0,Nick Becton,LT,active,new-york-giants,40588,2017
29714,31765,0,Marquis Bundy,WR,active,new-york-giants,31765,2017
29715,31765,0,Ryan O'Malley,TE,active,new-york-giants,31765,2017
29716,27353,0,Adam Bisnowaty,T,active,new-york-giants,27353,2017
29717,27353,0,Derrick Mathews,ILB,active,new-york-giants,27353,2017
29718,12900000,2100000,Janoris Jenkins,CB,injured_reserve,new-york-giants,15000000,2017
29719,8821000,0,Justin Pugh,G,injured_reserve,new-york-giants,8821000,2017
29720,3000000,1468750,Brandon Marshall,WR,injured_reserve,new-york-giants,4468750,2017
29721,2750000,941668,Jonathan Casillas,OLB,injured_reserve,new-york-giants,3691668,2017
29722,1839027,1472036,Odell Beckham Jr.,WR,injured_reserve,new-york-giants,3311063,2017
29723,2475000,825000,Dwayne Harris,WR,injured_reserve,new-york-giants,3300000,2017
29724,1500000,1500000,D.J. Fluker,G,injured_reserve,new-york-giants,3000000,2017
29725,1500000,1500000,Keenan Robinson,OLB,injured_reserve,new-york-giants,3000000,2017
29726,991415,677828,Landon Collins,FS,injured_reserve,new-york-giants,1669243,2017
29727,1085093,466791,Weston Richburg,C,injured_reserve,new-york-giants,1551884,2017
29728,775000,80000,Mark Herzlich,OLB,injured_reserve,new-york-giants,855000,2017
29729,540000,145551,B.J. Goodson,ILB,injured_reserve,new-york-giants,685551,2017
29730,443000,50000,Adam Gettis,G,injured_reserve,new-york-giants,493000,2017
29731,487059,0,Tavarres King,WR,injured_reserve,new-york-giants,487059,2017
29732,437648,0,Curtis Grant,ILB,injured_reserve,new-york-giants,437648,2017
29733,348000,3333,Jessamen Dunker,T,injured_reserve,new-york-giants,351333,2017
29734,348000,833,Josh Banks,DT,injured_reserve,new-york-giants,348833,2017
29735,348000,0,Keeon Johnson,WR,injured_reserve,new-york-giants,348000,2017
29736,348000,0,Ishaq Williams,OLB,injured_reserve,new-york-giants,348000,2017
29737,328236,0,Donte Deayon,S,injured_reserve,new-york-giants,328236,2017
29738,289412,0,Deontae Skinner,OLB,injured_reserve,new-york-giants,289412,2017
29739,127059,0,Darius Powe,WR,injured_reserve,new-york-giants,127059,2017
29740,0,1900000,Victor Cruz,WR,dead_cap,new-york-giants,1900000,2017
29741,775000,1045000,J.T. Thomas,OLB,dead_cap,new-york-giants,1820000,2017
29742,690000,50000,Adam Gettis,G,dead_cap,new-york-giants,740000,2017
29743,0,562500,Rashad Jennings,RB,dead_cap,new-york-giants,562500,2017
29744,412943,0,Michael Hunter,CB,dead_cap,new-york-giants,412943,2017
29745,352730,0,Tim Scott,SS,dead_cap,new-york-giants,352730,2017
29746,274977,0,Matt LaCosse,TE,dead_cap,new-york-giants,274977,2017
29747,0,250000,Josh Brown,K,dead_cap,new-york-giants,250000,2017
29748,245640,1666,Evan Schwan,DE,dead_cap,new-york-giants,247306,2017
29749,244585,0,Kevin Norwood,WR,dead_cap,new-york-giants,244585,2017
29750,0,225125,Owamagbe Odighizuwa,DE,dead_cap,new-york-giants,225125,2017
29751,222350,0,Corbin Bryant,DT,dead_cap,new-york-giants,222350,2017
29752,0,200000,Will Johnson,FB,dead_cap,new-york-giants,200000,2017
29753,178835,0,Nordly Capi,OLB,dead_cap,new-york-giants,178835,2017
29754,163939,0,Nigel Harris,OLB,dead_cap,new-york-giants,163939,2017
29755,158365,0,Ed Eagan,WR,dead_cap,new-york-giants,158365,2017
29756,115200,36633,Adam Bisnowaty,T,dead_cap,new-york-giants,151833,2017
29757,91176,60000,Devin Taylor,DE,dead_cap,new-york-giants,151176,2017
29758,146965,0,Jordan Williams,DT,dead_cap,new-york-giants,146965,2017
29759,125259,0,Shane Smith,FB,dead_cap,new-york-giants,125259,2017
29760,0,125000,Shaun Draughn,RB,dead_cap,new-york-giants,125000,2017
29761,115200,0,Marquis Bundy,WR,dead_cap,new-york-giants,115200,2017
29762,0,115000,Josh Johnson,QB,dead_cap,new-york-giants,115000,2017
29763,0,113400,Andre Williams,RB,dead_cap,new-york-giants,113400,2017
29764,100800,0,Ryan Murphy,FS,dead_cap,new-york-giants,100800,2017
29765,95294,0,Jeremy Cash,OLB,dead_cap,new-york-giants,95294,2017
29766,91176,0,Khyri Thornton,DT,dead_cap,new-york-giants,91176,2017
29767,86400,0,Ethan Cooper,G,dead_cap,new-york-giants,86400,2017
29768,81176,0,Tavarres King,WR,dead_cap,new-york-giants,81176,2017
29769,0,63540,Geremy Davis,WR,dead_cap,new-york-giants,63540,2017
29770,57600,0,Darius Powe,WR,dead_cap,new-york-giants,57600,2017
29771,0,57216,Mykkele Thompson,FS,dead_cap,new-york-giants,57216,2017
29772,46000,3333,Travis Rudolph,WR,dead_cap,new-york-giants,49333,2017
29773,43200,0,Trevor Bates,ILB,dead_cap,new-york-giants,43200,2017
29774,43200,0,Nick Becton,LT,dead_cap,new-york-giants,43200,2017
29775,36176,0,Deontae Skinner,OLB,dead_cap,new-york-giants,36176,2017
29776,36000,0,Donte Deayon,S,dead_cap,new-york-giants,36000,2017
29777,36000,0,Jeremiah McKinnon,CB,dead_cap,new-york-giants,36000,2017
29778,36000,0,Kalif Raymond,WR,dead_cap,new-york-giants,36000,2017
29779,28800,0,Jon Halapio,G,dead_cap,new-york-giants,28800,2017
29780,21600,0,Derrick Mathews,ILB,dead_cap,new-york-giants,21600,2017
29781,0,20000,Antwon Blake,CB,dead_cap,new-york-giants,20000,2017
29782,0,17897,Bobby Hart,RT,dead_cap,new-york-giants,17897,2017
29783,14400,0,Brandon Dixon,CB,dead_cap,new-york-giants,14400,2017
29784,14400,0,Amba Etta-Tawo,WR,dead_cap,new-york-giants,14400,2017
29785,14400,0,Ryan O'Malley,TE,dead_cap,new-york-giants,14400,2017
29786,7200,0,Anthony Fabiano,T,dead_cap,new-york-giants,7200,2017
29787,7200,0,Curtis Grant,ILB,dead_cap,new-york-giants,7200,2017
29788,7200,0,Canaan Severin,WR,dead_cap,new-york-giants,7200,2017
29789,7200,0,Kristjan Sokoli,G,dead_cap,new-york-giants,7200,2017
29790,0,6667,Melvin Lewis,DT,dead_cap,new-york-giants,6667,2017
29791,0,3334,Mike Rose,DE,dead_cap,new-york-giants,3334,2017
29792,10500000,11700000,Eli Manning,QB,active,new-york-giants,22200000,2018
29793,12750000,4250000,Olivier Vernon,OLB,active,new-york-giants,17000000,2018
29794,6400000,3600000,Janoris Jenkins,CB,active,new-york-giants,10000000,2018
29795,5900000,4100000,Nate Solder,LT,active,new-york-giants,10000000,2018
29796,480000,5191773,Saquon Barkley,RB,active,new-york-giants,5671773,2018
29797,1459000,4000000,Odell Beckham Jr.,WR,active,new-york-giants,5459000,2018
29798,3000000,1750000,Alec Ogletree,ILB,active,new-york-giants,4750000,2018
29799,2475000,1275000,Rhett Ellison,TE,active,new-york-giants,3750000,2018
29800,2250000,1266666,Kareem Martin,OLB,active,new-york-giants,3516666,2018
29801,975000,1525000,Cody Latimer,WR,active,new-york-giants,2500000,2018
29802,952196,1483782,Evan Engram,TE,active,new-york-giants,2435978,2018
29803,1100000,900000,Michael Thomas,FS,active,new-york-giants,2000000,2018
29804,1270000,365000,Connor Barwin,OLB,active,new-york-giants,1635000,2018
29805,990416,630831,Sterling Shepard,WR,active,new-york-giants,1621247,2018
29806,480000,874680,Will Hernandez,G,active,new-york-giants,1354680,2018
29807,1255521,0,Mario Edwards,DT,active,new-york-giants,1255521,2018
29808,900000,350000,Russell Shepard,WR,active,new-york-giants,1250000,2018
29809,825000,425000,Kerry Wynn,DE,active,new-york-giants,1250000,2018
29810,672823,366291,Dalvin Tomlinson,DT,active,new-york-giants,1039114,2018
29811,1015000,0,Zak DeOssie,LS,active,new-york-giants,1015000,2018
29812,850000,150000,Nathan Stupar,OLB,active,new-york-giants,1000000,2018
29813,890813,0,Jamon Brown,RT,active,new-york-giants,890813,2018
29814,630000,145551,B.J. Goodson,ILB,active,new-york-giants,775551,2018
29815,480000,262451,Lorenzo Carter,DE,active,new-york-giants,742451,2018
29816,480000,257379,B.J. Hill,DE,active,new-york-giants,737379,2018
29817,1015000,90000,John Greco,C,active,new-york-giants,1105000,2018
29818,705000,0,Scott Simonson,TE,active,new-york-giants,705000,2018
29819,555000,104912,Wayne Gallman,RB,active,new-york-giants,659912,2018
29820,480000,176924,Kyle Lauletta,QB,active,new-york-giants,656924,2018
29821,790000,25000,B.W. Webb,CB,active,new-york-giants,815000,2018
29822,790000,0,John Jenkins,DE,active,new-york-giants,790000,2018
29823,630000,0,Riley Dixon,P,active,new-york-giants,630000,2018
29824,630000,0,Spencer Pulley,C,active,new-york-giants,630000,2018
29825,630000,0,Curtis Riley,FS,active,new-york-giants,630000,2018
29826,604117,90000,Josh Mauro,DT,active,new-york-giants,694117,2018
29827,555000,6666,Chad Wheeler,RT,active,new-york-giants,561666,2018
29828,555000,0,Aldrick Rosas,K,active,new-york-giants,555000,2018
29829,555000,0,Alex Tanney,QB,active,new-york-giants,555000,2018
29830,418058,80368,R.J. McIntosh,DT,active,new-york-giants,498426,2018
29831,489705,0,Elijhaa Penny,RB,active,new-york-giants,489705,2018
29832,480000,3333,Evan Brown,C,active,new-york-giants,483333,2018
29833,480000,3333,Sean Chandler,S,active,new-york-giants,483333,2018
29834,480000,1666,Tae Davis,LB,active,new-york-giants,481666,2018
29835,480000,0,Kamrin Moore,CB,active,new-york-giants,480000,2018
29836,456176,0,Bennie Fowler,WR,active,new-york-giants,456176,2018
29837,444706,0,Brian Mihalik,T,active,new-york-giants,444706,2018
29838,370588,0,Corey Coleman,WR,active,new-york-giants,370588,2018
29839,370588,0,Tony Lippett,CB,active,new-york-giants,370588,2018
29840,359118,0,Ukeme Eligwe,ILB,active,new-york-giants,359118,2018
29841,310588,0,Grant Haley,CB,active,new-york-giants,310588,2018
29842,141175,0,Garrett Dickerson,TE,active,new-york-giants,141175,2018
29843,130588,0,Kenny Ladler,SS,active,new-york-giants,130588,2018
29844,28235,0,Alonzo Russell,WR,active,new-york-giants,28235,2018
29845,1400000,2475000,Jonathan Stewart,RB,injured_reserve,new-york-giants,3875000,2018
29846,1269620,677830,Landon Collins,SS,injured_reserve,new-york-giants,1947450,2018
29847,630000,0,Antonio Hamilton,CB,injured_reserve,new-york-giants,630000,2018
29848,363000,262122,Sam Beal,CB,injured_reserve,new-york-giants,625122,2018
29849,555000,0,Jon Halapio,C,injured_reserve,new-york-giants,555000,2018
29850,388412,0,Jawill Davis,WR,injured_reserve,new-york-giants,388412,2018
29851,378000,0,Kristjan Sokoli,G,injured_reserve,new-york-giants,378000,2018
29852,378000,0,Jordan Williams,DT,injured_reserve,new-york-giants,378000,2018
29853,363000,1666,Nick Gates,G,injured_reserve,new-york-giants,364666,2018
29854,191470,0,Quadree Henderson,WR,injured_reserve,new-york-giants,191470,2018
29855,398000,63137,Paul Perkins,RB,non_fb_injury,new-york-giants,461137,2018
29856,0,15000000,Jason Pierre-Paul,DE,dead_cap,new-york-giants,15000000,2018
29857,3191176,1850000,Damon Harrison,DT,dead_cap,new-york-giants,5041176,2018
29858,2397507,2181677,Ereck Flowers,RT,dead_cap,new-york-giants,4579184,2018
29859,752493,2304967,Eli Apple,CB,dead_cap,new-york-giants,3057460,2018
29860,125000,2425000,John Jerry,G,dead_cap,new-york-giants,2550000,2018
29861,900000,1600000,Patrick Omameh,G,dead_cap,new-york-giants,2500000,2018
29862,0,2000000,Dominique Rodgers-Cromartie,CB,dead_cap,new-york-giants,2000000,2018
29863,0,1600000,Dwayne Harris,WR,dead_cap,new-york-giants,1600000,2018
29864,1000000,125000,Ray-Ray Armstrong,OLB,dead_cap,new-york-giants,1125000,2018
29865,0,1000000,Brandon Marshall,WR,dead_cap,new-york-giants,1000000,2018
29866,0,1000000,Brad Wing,P,dead_cap,new-york-giants,1000000,2018
29867,790000,90000,William Gay,CB,dead_cap,new-york-giants,880000,2018
29868,296472,0,Mike Jordan,CB,dead_cap,new-york-giants,296472,2018
29869,0,234284,Darian Thompson,FS,dead_cap,new-york-giants,234284,2018
29870,0,216605,Davis Webb,QB,dead_cap,new-york-giants,216605,2018
29871,195882,0,Donte Deayon,S,dead_cap,new-york-giants,195882,2018
29872,129200,63692,Avery Moss,DE,dead_cap,new-york-giants,192892,2018
29873,0,185125,Owamagbe Odighizuwa,DE,dead_cap,new-york-giants,185125,2018
29874,175292,0,Stacy Coley,WR,dead_cap,new-york-giants,175292,2018
29875,173741,0,Garrett Dickerson,TE,dead_cap,new-york-giants,173741,2018
29876,148235,0,Kaelin Clay,WR,dead_cap,new-york-giants,148235,2018
29877,129200,0,Robert Martin,RB,dead_cap,new-york-giants,129200,2018
29878,129200,0,Victor Salako,T,dead_cap,new-york-giants,129200,2018
29879,128933,0,Grant Haley,CB,dead_cap,new-york-giants,128933,2018
29880,121600,0,Alonzo Russell,WR,dead_cap,new-york-giants,121600,2018
29881,0,109899,Adam Bisnowaty,T,dead_cap,new-york-giants,109899,2018
29882,101275,0,Shane Smith,FB,dead_cap,new-york-giants,101275,2018
29883,98800,0,Jylan Ware,T,dead_cap,new-york-giants,98800,2018
29884,92472,0,Thurston Armbrister,OLB,dead_cap,new-york-giants,92472,2018
29885,0,90000,Mark Herzlich,OLB,dead_cap,new-york-giants,90000,2018
29886,84705,0,Quadree Henderson,WR,dead_cap,new-york-giants,84705,2018
29887,83600,0,Myles Humphrey,DE,dead_cap,new-york-giants,83600,2018
29888,83600,0,Ronald Zamort,CB,dead_cap,new-york-giants,83600,2018
29889,76000,0,A.J. Howard,S,dead_cap,new-york-giants,76000,2018
29890,0,75000,Teddy Williams,CB,dead_cap,new-york-giants,75000,2018
29891,68400,0,Jhurrell Pressley,RB,dead_cap,new-york-giants,68400,2018
29892,0,57216,Mykkele Thompson,FS,dead_cap,new-york-giants,57216,2018
29893,0,50000,Adam Gettis,G,dead_cap,new-york-giants,50000,2018
29894,45600,0,Ukeme Eligwe,ILB,dead_cap,new-york-giants,45600,2018
29895,38000,0,Hakeem Valles,TE,dead_cap,new-york-giants,38000,2018
29896,0,35713,Jerell Adams,TE,dead_cap,new-york-giants,35713,2018
29897,30400,0,Brian Mihalik,T,dead_cap,new-york-giants,30400,2018
29898,28200,0,Jawill Davis,WR,dead_cap,new-york-giants,28200,2018
29899,22800,0,Woodrow Hamilton,DT,dead_cap,new-york-giants,22800,2018
29900,22800,0,Kenny Ladler,SS,dead_cap,new-york-giants,22800,2018
29901,0,17899,Bobby Hart,RT,dead_cap,new-york-giants,17899,2018
29902,15200,0,Brock Miller,P,dead_cap,new-york-giants,15200,2018
29903,7600,3333,Calvin Munson,ILB,dead_cap,new-york-giants,10933,2018
29904,7600,833,Josh Banks,DT,dead_cap,new-york-giants,8433,2018
29905,7600,0,Corey Coleman,WR,dead_cap,new-york-giants,7600,2018
29906,7600,0,Amba Etta-Tawo,WR,dead_cap,new-york-giants,7600,2018
29907,7600,0,Marshall Koehn,K,dead_cap,new-york-giants,7600,2018
29908,0,6667,Jessamen Dunker,T,dead_cap,new-york-giants,6667,2018
29909,0,6667,Travis Rudolph,WR,dead_cap,new-york-giants,6667,2018
29910,0,6168,Roger Lewis,WR,dead_cap,new-york-giants,6168,2018
29911,0,5000,Romeo Okwara,DE,dead_cap,new-york-giants,5000,2018
29912,0,3334,Evan Schwan,DE,dead_cap,new-york-giants,3334,2018
29913,11500000,11700000,Eli Manning,QB,active,new-york-giants,23200000,2019
29914,5400000,6600000,Nate Solder,LT,active,new-york-giants,12000000,2019
29915,4000000,7750000,Alec Ogletree,ILB,active,new-york-giants,11750000,2019
29916,1897943,5191773,Saquon Barkley,RB,active,new-york-giants,7089716,2019
29917,1510294,4760293,Golden Tate,WR,active,new-york-giants,6270587,2019
29918,3250000,2691666,Kareem Martin,OLB,active,new-york-giants,5941666,2019
29919,2500000,2500000,Kevin Zeitler,G,active,new-york-giants,5000000,2019
29920,975000,3775000,Markus Golden,OLB,active,new-york-giants,4750000,2019
29921,495000,4171192,Daniel Jones,QB,active,new-york-giants,4666192,2019
29922,1725000,1900000,Antoine Bethea,FS,active,new-york-giants,3625000,2019
29923,3517647,0,Leonard Williams,DE,active,new-york-giants,3517647,2019
29924,760624,2630831,Sterling Shepard,WR,active,new-york-giants,3391455,2019
29925,975000,1925000,Spencer Pulley,C,active,new-york-giants,2900000,2019
29926,1125000,1375000,Mike Remmers,RT,active,new-york-giants,2500000,2019
29927,495000,1913734,Dexter Lawrence,DE,active,new-york-giants,2408734,2019
29928,1900000,100000,Michael Thomas,FS,active,new-york-giants,2000000,2019
29929,495000,1418766,Deandre Baker,CB,active,new-york-giants,1913766,2019
29930,818670,874680,Will Hernandez,G,active,new-york-giants,1693350,2019
29931,925000,565000,Cody Latimer,WR,active,new-york-giants,1490000,2019
29932,880646,366291,Dalvin Tomlinson,DT,active,new-york-giants,1246937,2019
29933,825000,175000,Antonio Hamilton,CB,active,new-york-giants,1000000,2019
29934,665613,262451,Lorenzo Carter,OLB,active,new-york-giants,928064,2019
29935,665559,262122,Sam Beal,CB,active,new-york-giants,927681,2019
29936,664345,257379,B.J. Hill,DE,active,new-york-giants,921724,2019
29937,720000,145002,Riley Dixon,P,active,new-york-giants,865002,2019
29938,805000,0,David Mayo,ILB,active,new-york-giants,805000,2019
29939,645000,104912,Wayne Gallman,RB,active,new-york-giants,749912,2019
29940,720000,0,Cody Core,WR,active,new-york-giants,720000,2019
29941,495000,209195,Oshane Ximines,OLB,active,new-york-giants,704195,2019
29942,495000,192715,Julian Love,CB,active,new-york-giants,687715,2019
29943,570000,80368,R.J. McIntosh,DE,active,new-york-giants,650368,2019
29944,645000,0,Jon Halapio,C,active,new-york-giants,645000,2019
29945,645000,0,Elijhaa Penny,FB,active,new-york-giants,645000,2019
29946,645000,0,Aldrick Rosas,K,active,new-york-giants,645000,2019
29947,570000,0,Grant Haley,CB,active,new-york-giants,570000,2019
29948,570000,0,Chad Slade,RT,active,new-york-giants,570000,2019
29949,570000,0,Eric Smith,G,active,new-york-giants,570000,2019
29950,495000,58497,Darius Slayton,WR,active,new-york-giants,553497,2019
29951,547059,0,Alex Tanney,QB,active,new-york-giants,547059,2019
29952,495000,46302,Corey Ballentine,CB,active,new-york-giants,541302,2019
29953,495000,1666,Nick Gates,G,active,new-york-giants,496666,2019
29954,568235,0,Javorius Allen,RB,active,new-york-giants,568235,2019
29955,436770,0,Kaden Smith,TE,active,new-york-giants,436770,2019
29956,473529,0,Deone Bucannon,ILB,active,new-york-giants,473529,2019
29957,378529,0,Josiah Tauaefa,LB,active,new-york-giants,378529,2019
29958,335294,0,Devante Downs,ILB,active,new-york-giants,335294,2019
29959,331471,0,Scott Simonson,TE,active,new-york-giants,331471,2019
29960,189706,0,Colin Holba,LS,active,new-york-giants,189706,2019
29961,167647,0,Da'Mari Scott,WR,active,new-york-giants,167647,2019
29962,134118,0,Sean Chandler,S,active,new-york-giants,134118,2019
29963,67059,0,Rashaan Gaulden,S,active,new-york-giants,67059,2019
29964,58235,0,David Sills,WR,active,new-york-giants,58235,2019
29965,29118,0,Chris Slayton,DT,active,new-york-giants,29118,2019
29966,2598235,2213382,Rhett Ellison,TE,injured_reserve,new-york-giants,4811617,2019
29967,1439391,1483782,Evan Engram,TE,injured_reserve,new-york-giants,2923173,2019
29968,1405181,0,Jabrill Peppers,S,injured_reserve,new-york-giants,1405181,2019
29969,975000,118750,Russell Shepard,WR,injured_reserve,new-york-giants,1093750,2019
29970,1030000,90000,Zak DeOssie,LS,injured_reserve,new-york-giants,1120000,2019
29971,720000,0,Corey Coleman,WR,injured_reserve,new-york-giants,720000,2019
29972,405531,83723,Ryan Connelly,LB,injured_reserve,new-york-giants,489254,2019
29973,378000,23092,George Asafo-adjei,T,injured_reserve,new-york-giants,401092,2019
29974,378000,3333,Mark McLaurin,S,injured_reserve,new-york-giants,381333,2019
29975,378000,1666,Nate Harvey,DE,injured_reserve,new-york-giants,379666,2019
29976,378000,0,Amba Etta-Tawo,WR,injured_reserve,new-york-giants,378000,2019
29977,351000,0,Chris Peace,DE,injured_reserve,new-york-giants,351000,2019
29978,289059,0,Isaiah Searight,TE,injured_reserve,new-york-giants,289059,2019
29979,56000,0,Garrett Dickerson,TE,practice_squad,new-york-giants,56000,2019
29980,0,16000000,Odell Beckham Jr.,WR,dead_cap,new-york-giants,16000000,2019
29981,8955882,4600000,Janoris Jenkins,CB,dead_cap,new-york-giants,13555882,2019
29982,0,8000000,Olivier Vernon,OLB,dead_cap,new-york-giants,8000000,2019
29983,0,3200000,Damon Harrison,DT,dead_cap,new-york-giants,3200000,2019
29984,0,3000000,Patrick Omameh,G,dead_cap,new-york-giants,3000000,2019
29985,0,2304968,Eli Apple,CB,dead_cap,new-york-giants,2304968,2019
29986,775000,337500,Alex Tanney,QB,dead_cap,new-york-giants,1112500,2019
29987,929118,90000,Bennie Fowler,WR,dead_cap,new-york-giants,1019118,2019
29988,825000,109375,Olsen Pierre,DE,dead_cap,new-york-giants,934375,2019
29989,720000,0,Eric Tomlinson,TE,dead_cap,new-york-giants,720000,2019
29990,0,383210,Davis Webb,QB,dead_cap,new-york-giants,383210,2019
29991,0,365000,Connor Barwin,OLB,dead_cap,new-york-giants,365000,2019
29992,277059,90000,Nathan Stupar,OLB,dead_cap,new-york-giants,367059,2019
29993,333765,3333,Sean Chandler,S,dead_cap,new-york-giants,337098,2019
29994,268232,1666,Tae Davis,LB,dead_cap,new-york-giants,269898,2019
29995,234706,0,Garrett Dickerson,TE,dead_cap,new-york-giants,234706,2019
29996,0,209284,Darian Thompson,FS,dead_cap,new-york-giants,209284,2019
29997,206706,0,Tuzar Skipper,DE,dead_cap,new-york-giants,206706,2019
29998,204353,0,Jonathan Hilliman,RB,dead_cap,new-york-giants,204353,2019
29999,0,176925,Kyle Lauletta,QB,dead_cap,new-york-giants,176925,2019
30000,155645,0,Keion Adams,OLB,dead_cap,new-york-giants,155645,2019
30001,84706,63137,Paul Perkins,RB,dead_cap,new-york-giants,147843,2019
30002,128000,18893,Chris Slayton,DT,dead_cap,new-york-giants,146893,2019
30003,0,145554,B.J. Goodson,ILB,dead_cap,new-york-giants,145554,2019
30004,142059,0,TJ Jones,WR,dead_cap,new-york-giants,142059,2019
30005,47353,90000,Scott Simonson,TE,dead_cap,new-york-giants,137353,2019
30006,127000,5000,Josiah Tauaefa,LB,dead_cap,new-york-giants,132000,2019
30007,125118,3333,Evan Brown,C,dead_cap,new-york-giants,128451,2019
30008,0,127384,Avery Moss,DE,dead_cap,new-york-giants,127384,2019
30009,120000,1666,Reggie White Jr,WR,dead_cap,new-york-giants,121666,2019
30010,120000,0,David Sills,WR,dead_cap,new-york-giants,120000,2019
30011,114000,0,Rod Smith,RB,dead_cap,new-york-giants,114000,2019
30012,80000,0,Freedom Akinmoladun,DE,dead_cap,new-york-giants,80000,2019
30013,80000,0,Corn Elder,CB,dead_cap,new-york-giants,80000,2019
30014,64000,2500,Jake Carlock,CB,dead_cap,new-york-giants,66500,2019
30015,64000,0,Da'Mari Scott,WR,dead_cap,new-york-giants,64000,2019
30016,0,60000,Tony Lippett,CB,dead_cap,new-york-giants,60000,2019
30017,56000,0,Alex Bachman,WR,dead_cap,new-york-giants,56000,2019
30018,48000,0,Derrick Baity,CB,dead_cap,new-york-giants,48000,2019
30019,37941,6668,Chad Wheeler,T,dead_cap,new-york-giants,44609,2019
30020,0,35716,Jerell Adams,TE,dead_cap,new-york-giants,35716,2019
30021,32000,0,Tanner Volson,C,dead_cap,new-york-giants,32000,2019
30022,30000,1666,James O'Hagan,C,dead_cap,new-york-giants,31666,2019
30023,30000,0,Austin Walter,RB,dead_cap,new-york-giants,30000,2019
30024,22235,5000,Alex Wesley,WR,dead_cap,new-york-giants,27235,2019
30025,26353,0,Jonathan Anderson,ILB,dead_cap,new-york-giants,26353,2019
30026,24000,0,Devante Downs,ILB,dead_cap,new-york-giants,24000,2019
30027,24000,0,Brittan Golden,WR,dead_cap,new-york-giants,24000,2019
30028,24000,0,Sean Smith,P,dead_cap,new-york-giants,24000,2019
30029,22235,0,Victor Salako,T,dead_cap,new-york-giants,22235,2019
30030,16000,3333,C.J. Conrad,TE,dead_cap,new-york-giants,19333,2019
30031,16000,0,Rashaan Gaulden,S,dead_cap,new-york-giants,16000,2019
30032,16000,0,Colin Holba,LS,dead_cap,new-york-giants,16000,2019
30033,16000,0,Kevin Wilkins,DT,dead_cap,new-york-giants,16000,2019
30034,16000,0,Nate Wozniak,G,dead_cap,new-york-giants,16000,2019
30035,0,15000,John Jenkins,DE,dead_cap,new-york-giants,15000,2019
30036,0,13333,Jeremiah Harris,LB,dead_cap,new-york-giants,13333,2019
30037,8000,0,George Aston,FB,dead_cap,new-york-giants,8000,2019
30038,0,3334,Calvin Munson,ILB,dead_cap,new-york-giants,3334,2019
30039,0,3333,Paul Adams,T,dead_cap,new-york-giants,3333,2019
30040,0,2750,Ronald Zamort,CB,dead_cap,new-york-giants,2750,2019
30041,0,1666,Eric Dungey,QB,dead_cap,new-york-giants,1666,2019
30042,0,834,Josh Banks,DT,dead_cap,new-york-giants,834,2019
30043,0,500,Alex Jenkins,DE,dead_cap,new-york-giants,500,2019
30044,0,166,Tenny Adewusi,S,dead_cap,new-york-giants,166,2019
30045,0,166,Ryan Anderson,P,dead_cap,new-york-giants,166,2019
30046,9900000,9600000,Nate Solder,LT,active,new-york-giants,19500000,2020
30047,10000000,2500000,Kevin Zeitler,G,active,new-york-giants,12500000,2020
30048,10000000,1750000,Alec Ogletree,ILB,active,new-york-giants,11750000,2020
30049,7975000,2525000,Golden Tate,WR,active,new-york-giants,10500000,2020
30050,3315886,5191773,Saquon Barkley,RB,active,new-york-giants,8507659,2020
30051,6475000,2025000,Sterling Shepard,WR,active,new-york-giants,8500000,2020
30052,4975000,2213384,Rhett Ellison,TE,active,new-york-giants,7188384,2020
30053,4200000,1766668,Kareem Martin,OLB,active,new-york-giants,5966668,2020
30054,1661548,4171192,Daniel Jones,QB,active,new-york-giants,5832740,2020
30055,1926587,1483784,Evan Engram,TE,active,new-york-giants,3410371,2020
30056,1097184,1913734,Dexter Lawrence,DE,active,new-york-giants,3010918,2020
30057,2475000,400000,Antoine Bethea,FS,active,new-york-giants,2875000,2020
30058,2325000,425000,Spencer Pulley,C,active,new-york-giants,2750000,2020
30059,850000,1875000,Riley Dixon,P,active,new-york-giants,2725000,2020
30060,973442,1418766,Deandre Baker,CB,active,new-york-giants,2392208,2020
30061,1157340,874680,Will Hernandez,G,active,new-york-giants,2032020,2020
30062,1875271,0,Jabrill Peppers,S,active,new-york-giants,1875271,2020
30063,1088468,366291,Dalvin Tomlinson,DT,active,new-york-giants,1454759,2020
30064,851226,262451,Lorenzo Carter,OLB,active,new-york-giants,1113677,2020
30065,851118,262122,Sam Beal,CB,active,new-york-giants,1113240,2020
30066,848690,257379,B.J. Hill,DE,active,new-york-giants,1106069,2020
30067,735000,104912,Wayne Gallman,RB,active,new-york-giants,839912,2020
30068,618000,209195,Oshane Ximines,OLB,active,new-york-giants,827195,2020
30069,585000,192715,Julian Love,CB,active,new-york-giants,777715,2020
30070,660000,80368,R.J. McIntosh,DE,active,new-york-giants,740368,2020
30071,585000,83723,Ryan Connelly,LB,active,new-york-giants,668723,2020
30072,660000,1668,Nick Gates,G,active,new-york-giants,661668,2020
30073,660000,0,Rashaan Gaulden,S,active,new-york-giants,660000,2020
30074,585000,58497,Darius Slayton,WR,active,new-york-giants,643497,2020
30075,585000,46302,Corey Ballentine,CB,active,new-york-giants,631302,2020
30076,585000,0,Chris Peace,DE,active,new-york-giants,585000,2020
30077,585000,0,David Sills,WR,active,new-york-giants,585000,2020
30078,585000,0,Chris Slayton,DT,active,new-york-giants,585000,2020
30079,585000,0,Kaden Smith,TE,active,new-york-giants,585000,2020
30080,585000,0,Josiah Tauaefa,LB,active,new-york-giants,585000,2020
30081,510000,23092,George Asafo-adjei,T,active,new-york-giants,533092,2020
30082,510000,3333,Mark McLaurin,S,active,new-york-giants,513333,2020
30083,510000,1666,Nate Harvey,DE,active,new-york-giants,511666,2020
30084,0,0,George Aston,FB,active,new-york-giants,0,2020
30085,0,0,Alex Bachman,WR,active,new-york-giants,0,2020
30086,0,0,Derrick Baity,CB,active,new-york-giants,0,2020
30087,0,0,C.J. Conrad,TE,active,new-york-giants,0,2020
30088,0,0,Jonathan Hilliman,RB,active,new-york-giants,0,2020
30089,0,0,Drew Scott,LS,active,new-york-giants,0,2020
30090,0,0,Sean Smith,P,active,new-york-giants,0,2020
30091,0,0,Tanner Volson,C,active,new-york-giants,0,2020
30092,0,0,Reggie White Jr,WR,active,new-york-giants,0,2020
30093,0,0,Kevin Wilkins,DT,active,new-york-giants,0,2020
30094,0,0,Nate Wozniak,G,active,new-york-giants,0,2020
30095,0,3500000,Janoris Jenkins,CB,dead_cap,new-york-giants,3500000,2020
30096,0,353849,Kyle Lauletta,QB,dead_cap,new-york-giants,353849,2020
30097,0,56679,Chris Slayton,DT,dead_cap,new-york-giants,56679,2020
30098,0,37500,Alex Tanney,QB,dead_cap,new-york-giants,37500,2020
30099,0,10000,Josiah Tauaefa,LB,dead_cap,new-york-giants,10000,2020
30100,0,10000,Alex Wesley,WR,dead_cap,new-york-giants,10000,2020
30101,0,6667,Paul Adams,T,dead_cap,new-york-giants,6667,2020
30102,0,6667,C.J. Conrad,TE,dead_cap,new-york-giants,6667,2020
30103,0,6667,Jeremiah Harris,LB,dead_cap,new-york-giants,6667,2020
30104,0,5000,Jake Carlock,CB,dead_cap,new-york-giants,5000,2020
30105,0,3334,Evan Brown,C,dead_cap,new-york-giants,3334,2020
30106,0,3334,Sean Chandler,S,dead_cap,new-york-giants,3334,2020
30107,0,3334,Eric Dungey,QB,dead_cap,new-york-giants,3334,2020
30108,0,3334,James O'Hagan,C,dead_cap,new-york-giants,3334,2020
30109,0,3334,Reggie White Jr,WR,dead_cap,new-york-giants,3334,2020
30110,0,2750,Ronald Zamort,CB,dead_cap,new-york-giants,2750,2020
30111,0,1666,Tae Davis,LB,dead_cap,new-york-giants,1666,2020
30112,0,334,Tenny Adewusi,S,dead_cap,new-york-giants,334,2020
30113,0,334,Ryan Anderson,P,dead_cap,new-york-giants,334,2020
30114,4975000,4786903,Dewayne Robertson,DT,active,new-york-jets,9761903,2007
30115,2000000,5000000,Chad Pennington,QB,active,new-york-jets,7000000,2007
30116,4500000,3633333,Shaun Ellis,DE,active,new-york-jets,8133333,2007
30117,900000,3600000,Thomas Jones,RB,active,new-york-jets,4500000,2007
30118,3600000,842000,David Barrett,CB,active,new-york-jets,4442000,2007
30119,360000,6192500,D'Brickashaw Ferguson,LT,active,new-york-jets,6552500,2007
30120,1500000,1700000,Bryan Thomas,LB,active,new-york-jets,3200000,2007
30121,750000,3015000,Jonathan Vilma,ILB,active,new-york-jets,3765000,2007
30122,1800000,66667,Brandon Moore,G,active,new-york-jets,1866667,2007
30123,1566500,250000,Chris Baker,TE,active,new-york-jets,1816500,2007
30124,360000,1995500,Nick Mangold,C,active,new-york-jets,2355500,2007
30125,285000,1116916,Darrelle Revis,CB,active,new-york-jets,1401916,2007
30126,770000,350000,Anthony Clement,T,active,new-york-jets,1120000,2007
30127,595000,304000,Victor Hobson,LB,active,new-york-jets,899000,2007
30128,850000,41250,Erik Coleman,S,active,new-york-jets,891250,2007
30129,435000,566666,Mike Nugent,K,active,new-york-jets,1001666,2007
30130,360000,402500,Kellen Clemens,QB,active,new-york-jets,762500,2007
30131,435000,168750,Justin Miller,CB,active,new-york-jets,603750,2007
30132,285000,350000,David Harris,ILB,active,new-york-jets,635000,2007
30133,510000,40000,Wade Smith,G,active,new-york-jets,550000,2007
30134,385000,153250,Sione Pouha,DT,active,new-york-jets,538250,2007
30135,510000,9550,Rashad Washington,ILB,active,new-york-jets,519550,2007
30136,360000,143125,Eric Smith,S,active,new-york-jets,503125,2007
30137,385000,103000,Kerry Rhodes,S,active,new-york-jets,488000,2007
30138,360000,118250,Brad Smith,WR,active,new-york-jets,478250,2007
30139,360000,107312,Leon Washington,RB,active,new-york-jets,467312,2007
30140,435000,0,Alphonso Hodge,CB,active,new-york-jets,435000,2007
30141,435000,0,C.J. Mosley,DT,active,new-york-jets,435000,2007
30142,360000,42031,Jason Pociask,TE,active,new-york-jets,402031,2007
30143,360000,23250,Drew Coleman,CB,active,new-york-jets,383250,2007
30144,360000,10000,Will Montgomery,C,active,new-york-jets,370000,2007
30145,360000,0,Adrien Clarke,G,active,new-york-jets,360000,2007
30146,285000,27500,Jacob Bender,T,active,new-york-jets,312500,2007
30147,285000,667,Mike DeVito,DE,active,new-york-jets,285667,2007
30148,285000,667,Robert Turner,C,active,new-york-jets,285667,2007
30149,285000,0,David Clowney,WR,active,new-york-jets,285000,2007
30150,190000,0,James Ihedigbo,SS,active,new-york-jets,190000,2007
30151,190000,0,Jason Trusnik,ILB,active,new-york-jets,190000,2007
30152,4000000,1000000,Laveranues Coles,WR,injured_reserve,new-york-jets,5000000,2007
30153,195588,19418,Chansi Stuckey,WR,injured_reserve,new-york-jets,215006,2007
30154,385000,23687,Cedric Houston,RB,non_fb_injury,new-york-jets,408687,2007
30155,144500,0,David Clowney,WR,practice_squad,new-york-jets,144500,2007
30156,79900,0,Jason Trusnik,ILB,practice_squad,new-york-jets,79900,2007
30157,0,2385471,Curtis Martin,RB,dead_cap,new-york-jets,2385471,2007
30158,183500,0,Anthony Schlegel,LB,dead_cap,new-york-jets,183500,2007
30159,79000,0,Andre Maddox,CB,dead_cap,new-york-jets,79000,2007
30160,41250,0,Titus Adams,DT,dead_cap,new-york-jets,41250,2007
30161,13042,0,Darrell McClover,LB,dead_cap,new-york-jets,13042,2007
30162,10000,0,Will Montgomery,C,dead_cap,new-york-jets,10000,2007
30163,9550,0,Trevor  Johnson,DE,dead_cap,new-york-jets,9550,2007
30164,666,0,Jason Trusnik,ILB,dead_cap,new-york-jets,666,2007
30165,12000000,0,Brett Favre,QB,active,new-york-jets,12000000,2008
30166,5000000,1000000,Laveranues Coles,WR,active,new-york-jets,6000000,2008
30167,2000000,3600000,Thomas Jones,RB,active,new-york-jets,5600000,2008
30168,1000000,4420000,Alan Faneca,G,active,new-york-jets,5420000,2008
30169,2320000,5655000,D'Brickashaw Ferguson,LT,active,new-york-jets,7975000,2008
30170,3077059,3633333,Shaun Ellis,DE,active,new-york-jets,6710392,2008
30171,370000,3565916,Darrelle Revis,CB,active,new-york-jets,3935916,2008
30172,1700000,1700000,Bryan Thomas,LB,active,new-york-jets,3400000,2008
30173,2200000,842000,David Barrett,CB,active,new-york-jets,3042000,2008
30174,750000,2083333,Calvin Pace,OLB,active,new-york-jets,2833333,2008
30175,1605000,1166667,Jerricho Cotchery,WR,active,new-york-jets,2771667,2008
30176,295000,2025000,Vernon Gholston,LB,active,new-york-jets,2320000,2008
30177,522000,1769666,Kerry Rhodes,S,active,new-york-jets,2291666,2008
30178,370000,1500000,David Clowney,WR,active,new-york-jets,1870000,2008
30179,460000,403250,Sione Pouha,DT,active,new-york-jets,863250,2008
30180,1000000,66667,Brandon Moore,G,active,new-york-jets,1066667,2008
30181,445000,1688000,Nick Mangold,C,active,new-york-jets,2133000,2008
30182,295000,895000,Dustin Keller,TE,active,new-york-jets,1190000,2008
30183,370000,745000,David Harris,ILB,active,new-york-jets,1115000,2008
30184,520000,566668,Mike Nugent,K,active,new-york-jets,1086668,2008
30185,927000,0,Justin Green,RB,active,new-york-jets,927000,2008
30186,445000,402500,Kellen Clemens,QB,active,new-york-jets,847500,2008
30187,730000,0,Jay Feely,K,active,new-york-jets,730000,2008
30188,325000,168750,Justin Miller,CB,active,new-york-jets,493750,2008
30189,445000,143125,Eric Smith,S,active,new-york-jets,588125,2008
30190,445000,118250,Brad Smith,WR,active,new-york-jets,563250,2008
30191,445000,107312,Leon Washington,RB,active,new-york-jets,552312,2008
30192,520000,0,Ahmad Carroll,CB,active,new-york-jets,520000,2008
30193,520000,0,Wayne Hunter,T,active,new-york-jets,520000,2008
30194,520000,0,C.J. Mosley,DT,active,new-york-jets,520000,2008
30195,445000,23250,Drew Coleman,CB,active,new-york-jets,468250,2008
30196,295000,116125,Dwight Lowery,FS,active,new-york-jets,411125,2008
30197,370000,667,Mike DeVito,DE,active,new-york-jets,370667,2008
30198,295000,41250,Erik Ainge,QB,active,new-york-jets,336250,2008
30199,295000,8693,Chansi Stuckey,WR,active,new-york-jets,303693,2008
30200,297000,0,Jason Trusnik,ILB,active,new-york-jets,297000,2008
30201,295000,667,Robert Turner,C,active,new-york-jets,295667,2008
30202,295000,0,James Ihedigbo,SS,active,new-york-jets,295000,2008
30203,200000,666,Danny Woodhead,RB,active,new-york-jets,200666,2008
30204,157059,0,Will Montgomery,C,active,new-york-jets,157059,2008
30205,88400,27800,Marcus Henry,WR,active,new-york-jets,116200,2008
30206,605000,40000,Jesse Chatman,RB,injured_reserve,new-york-jets,645000,2008
30207,88400,0,Jehuu Caulcrick,RB,practice_squad,new-york-jets,88400,2008
30208,88400,0,James Ihedigbo,SS,practice_squad,new-york-jets,88400,2008
30209,88400,0,Ropati Pitoitua,DE,practice_squad,new-york-jets,88400,2008
30210,88400,0,Stefan Rodgers,T,practice_squad,new-york-jets,88400,2008
30211,0,7523810,Dewayne Robertson,DT,dead_cap,new-york-jets,7523810,2008
30212,0,3000000,Chad Pennington,QB,dead_cap,new-york-jets,3000000,2008
30213,0,2385471,Curtis Martin,RB,dead_cap,new-york-jets,2385471,2008
30214,0,600000,Anthony Clement,T,dead_cap,new-york-jets,600000,2008
30215,367000,0,Anthony Schlegel,LB,dead_cap,new-york-jets,367000,2008
30216,55000,0,Jacob Bender,T,dead_cap,new-york-jets,55000,2008
30217,42031,0,Jason Pociask,TE,dead_cap,new-york-jets,42031,2008
30218,23687,0,Cedric Houston,RB,dead_cap,new-york-jets,23687,2008
30219,15625,0,Nate Garner,RT,dead_cap,new-york-jets,15625,2008
30220,1334,0,Jason Trusnik,ILB,dead_cap,new-york-jets,1334,2008
30221,0,666,Ropati Pitoitua,DE,dead_cap,new-york-jets,666,2008
30222,10100000,0,Mark Sanchez,QB,active,new-york-jets,10100000,2009
30223,7500000,1500000,Bart Scott,LB,active,new-york-jets,9000000,2009
30224,7000000,845000,Alan Faneca,G,active,new-york-jets,7845000,2009
30225,460000,7065916,Darrelle Revis,CB,active,new-york-jets,7525916,2009
30226,4650000,3633333,Shaun Ellis,DE,active,new-york-jets,8283333,2009
30227,2922500,5655000,D'Brickashaw Ferguson,LT,active,new-york-jets,8577500,2009
30228,573529,5183333,Calvin Pace,OLB,active,new-york-jets,5756862,2009
30229,700000,6268666,Kerry Rhodes,S,active,new-york-jets,6968666,2009
30230,4550000,825000,Braylon Edwards,WR,active,new-york-jets,5375000,2009
30231,2900000,1570000,Vernon Gholston,LB,active,new-york-jets,4470000,2009
30232,1900000,1850000,Bryan Thomas,LB,active,new-york-jets,3750000,2009
30233,2825000,360417,Brandon Moore,G,active,new-york-jets,3185417,2009
30234,1780000,1166667,Jerricho Cotchery,WR,active,new-york-jets,2946667,2009
30235,900000,1600000,Thomas Jones,RB,active,new-york-jets,2500000,2009
30236,535000,1760500,Nick Mangold,C,active,new-york-jets,2295500,2009
30237,1200000,383333,Jim Leonhard,S,active,new-york-jets,1583333,2009
30238,1475000,25000,Jay Feely,K,active,new-york-jets,1500000,2009
30239,662500,1013750,Dustin Keller,TE,active,new-york-jets,1676250,2009
30240,460000,1000667,Mike DeVito,DE,active,new-york-jets,1460667,2009
30241,1000000,275000,Ben Hartsock,TE,active,new-york-jets,1275000,2009
30242,980000,250000,Sione Pouha,DT,active,new-york-jets,1230000,2009
30243,535000,402500,Kellen Clemens,QB,active,new-york-jets,937500,2009
30244,460000,350000,David Harris,ILB,active,new-york-jets,810000,2009
30245,535000,143125,Eric Smith,S,active,new-york-jets,678125,2009
30246,535000,118250,Brad Smith,WR,active,new-york-jets,653250,2009
30247,620000,0,Wayne Hunter,T,active,new-york-jets,620000,2009
30248,535000,23250,Drew Coleman,CB,active,new-york-jets,558250,2009
30249,540000,0,Steve Weatherford,P,active,new-york-jets,540000,2009
30250,310000,226250,Shonn Greene,RB,active,new-york-jets,536250,2009
30251,385000,116125,Dwight Lowery,FS,active,new-york-jets,501125,2009
30252,620000,50000,Ahmad Carroll,CB,active,new-york-jets,670000,2009
30253,460000,0,Aundrae Allison,WR,active,new-york-jets,460000,2009
30254,460000,0,David Clowney,WR,active,new-york-jets,460000,2009
30255,385000,667,Robert Turner,C,active,new-york-jets,385667,2009
30256,385000,0,James Ihedigbo,SS,active,new-york-jets,385000,2009
30257,367812,0,Justin Miller,CB,active,new-york-jets,367812,2009
30258,310000,33170,Matt Slauson,G,active,new-york-jets,343170,2009
30259,310000,667,Jamaal Westerman,LB,active,new-york-jets,310667,2009
30260,310000,0,Matthew Mulligan,TE,active,new-york-jets,310000,2009
30261,310000,0,Ropati Pitoitua,DE,active,new-york-jets,310000,2009
30262,271764,0,Danny Woodhead,RB,active,new-york-jets,271764,2009
30263,88400,0,Marcus Henry,WR,active,new-york-jets,88400,2009
30264,535000,107312,Leon Washington,RB,injured_reserve,new-york-jets,642312,2009
30265,88400,0,Josh Mauga,ILB,practice_squad,new-york-jets,88400,2009
30266,88400,0,Danny Woodhead,RB,practice_squad,new-york-jets,88400,2009
30267,0,3000000,Chad Pennington,QB,dead_cap,new-york-jets,3000000,2009
30268,0,842000,David Barrett,CB,dead_cap,new-york-jets,842000,2009
30269,408250,0,Chris Baker,TE,dead_cap,new-york-jets,408250,2009
30270,110000,0,Jacob Bender,T,dead_cap,new-york-jets,110000,2009
30271,46875,0,Nate Garner,RT,dead_cap,new-york-jets,46875,2009
30272,42031,0,Jason Pociask,TE,dead_cap,new-york-jets,42031,2009
30273,27800,0,Marcus Henry,WR,dead_cap,new-york-jets,27800,2009
30274,0,1334,Ropati Pitoitua,DE,dead_cap,new-york-jets,1334,2009
30275,666,0,Danny Woodhead,RB,dead_cap,new-york-jets,666,2009
30276,7500000,1803916,Darrelle Revis,CB,active,new-york-jets,9303916,2010
30277,6442500,2503125,Mark Sanchez,QB,active,new-york-jets,8945625,2010
30278,3600000,1500000,Bart Scott,LB,active,new-york-jets,5100000,2010
30279,7500000,845000,Alan Faneca,G,active,new-york-jets,8345000,2010
30280,3750000,4443333,Calvin Pace,OLB,active,new-york-jets,8193333,2010
30281,630000,8514166,D'Brickashaw Ferguson,LT,active,new-york-jets,9144166,2010
30282,4335000,1500000,Braylon Edwards,WR,active,new-york-jets,5835000,2010
30283,2250000,4723333,Vernon Gholston,LB,active,new-york-jets,6973333,2010
30284,3000000,1850000,Bryan Thomas,LB,active,new-york-jets,4850000,2010
30285,2250000,293750,Brandon Moore,G,active,new-york-jets,2543750,2010
30286,3350000,0,Shaun Ellis,DE,active,new-york-jets,3350000,2010
30287,1800000,1166667,Jerricho Cotchery,WR,active,new-york-jets,2966667,2010
30288,1580000,250000,Sione Pouha,DT,active,new-york-jets,1830000,2010
30289,959400,2627100,Nick Mangold,C,active,new-york-jets,3586500,2010
30290,795000,1338750,Dustin Keller,TE,active,new-york-jets,2133750,2010
30291,1025500,875000,LaDainian Tomlinson,RB,active,new-york-jets,1900500,2010
30292,1009000,750000,Brad Smith,WR,active,new-york-jets,1759000,2010
30293,1000000,697500,Antonio Cromartie,CB,active,new-york-jets,1697500,2010
30294,1040000,350000,Mike DeVito,DE,active,new-york-jets,1390000,2010
30295,1300000,0,Brodney Pool,S,active,new-york-jets,1300000,2010
30296,481764,770000,Santonio Holmes,WR,active,new-york-jets,1251764,2010
30297,320000,930400,Kyle Wilson,CB,active,new-york-jets,1250400,2010
30298,900000,350000,David Harris,ILB,active,new-york-jets,1250000,2010
30299,1176000,55000,Wayne Hunter,T,active,new-york-jets,1231000,2010
30300,700000,500000,Ben Hartsock,TE,active,new-york-jets,1200000,2010
30301,1176000,0,Eric Smith,S,active,new-york-jets,1176000,2010
30302,1101000,0,James Ihedigbo,SS,active,new-york-jets,1101000,2010
30303,630000,220000,Drew Coleman,CB,active,new-york-jets,850000,2010
30304,630000,72000,Steve Weatherford,P,active,new-york-jets,702000,2010
30305,700000,0,Kellen Clemens,QB,active,new-york-jets,700000,2010
30306,395000,234370,Shonn Greene,RB,active,new-york-jets,629370,2010
30307,470000,116125,Dwight Lowery,FS,active,new-york-jets,586125,2010
30308,320000,256250,Vladimir Ducasse,G,active,new-york-jets,576250,2010
30309,545000,0,Nick Folk,K,active,new-york-jets,545000,2010
30310,470000,41250,Erik Ainge,QB,active,new-york-jets,511250,2010
30311,470000,0,Robert Turner,C,active,new-york-jets,470000,2010
30312,320000,125250,Joe McKnight,RB,active,new-york-jets,445250,2010
30313,395000,33170,Matt Slauson,G,active,new-york-jets,428170,2010
30314,395000,667,Jamaal Westerman,LB,active,new-york-jets,395667,2010
30315,395000,0,Patrick Turner,WR,active,new-york-jets,395000,2010
30316,390000,0,Matthew Mulligan,TE,active,new-york-jets,390000,2010
30317,320000,57870,John Conner,FB,active,new-york-jets,377870,2010
30318,320000,667,Jeff Cumberland,TE,active,new-york-jets,320667,2010
30319,320000,0,Marcus Dixon,DE,active,new-york-jets,320000,2010
30320,320000,0,Tanner Purdum,LS,active,new-york-jets,320000,2010
30321,320000,0,Martin Tevaseu,DT,active,new-york-jets,320000,2010
30322,188235,0,Josh Mauga,ILB,active,new-york-jets,188235,2010
30323,75294,0,Emanuel Cook,CB,active,new-york-jets,75294,2010
30324,69706,0,Jarron Gilbert,DE,active,new-york-jets,69706,2010
30325,1575000,383333,Jim Leonhard,S,injured_reserve,new-york-jets,1958333,2010
30326,240000,0,Ropati Pitoitua,DE,injured_reserve,new-york-jets,240000,2010
30327,88400,0,Jarron Gilbert,DE,practice_squad,new-york-jets,88400,2010
30328,88400,0,Josh Mauga,ILB,practice_squad,new-york-jets,88400,2010
30329,88400,0,Logan Payne,WR,practice_squad,new-york-jets,88400,2010
30330,88400,0,Cody Wallace,C,practice_squad,new-york-jets,88400,2010
30331,2535000,0,Alan Faneca,G,dead_cap,new-york-jets,2535000,2010
30332,0,1500000,Thomas Jones,RB,dead_cap,new-york-jets,1500000,2010
30333,55600,0,Marcus Henry,WR,dead_cap,new-york-jets,55600,2010
30334,43892,0,Brooks Foster,WR,dead_cap,new-york-jets,43892,2010
30335,8693,0,Chansi Stuckey,WR,dead_cap,new-york-jets,8693,2010
30336,668,0,Danny Woodhead,RB,dead_cap,new-york-jets,668,2010
30337,14225000,3003125,Mark Sanchez,QB,active,new-york-jets,17228125,2011
30338,6000000,8265916,Darrelle Revis,CB,active,new-york-jets,14265916,2011
30339,5615000,7471666,D'Brickashaw Ferguson,LT,active,new-york-jets,13086666,2011
30340,855000,6443333,Calvin Pace,OLB,active,new-york-jets,7298333,2011
30341,3900000,1500000,Bart Scott,LB,active,new-york-jets,5400000,2011
30342,2260000,3007100,Nick Mangold,C,active,new-york-jets,5267100,2011
30343,2750000,293750,Brandon Moore,G,active,new-york-jets,3043750,2011
30344,2000000,2000000,David Harris,ILB,active,new-york-jets,4000000,2011
30345,3200000,500000,Bryan Thomas,LB,active,new-york-jets,3700000,2011
30346,1000000,2250000,Santonio Holmes,WR,active,new-york-jets,3250000,2011
30347,3017000,0,Plaxico Burress,WR,active,new-york-jets,3017000,2011
30348,1500000,1000000,Wayne Hunter,T,active,new-york-jets,2500000,2011
30349,2125000,350000,Mike DeVito,DE,active,new-york-jets,2475000,2011
30350,2075000,383333,Jim Leonhard,S,active,new-york-jets,2458333,2011
30351,1000000,1250000,Antonio Cromartie,CB,active,new-york-jets,2250000,2011
30352,927500,1113750,Dustin Keller,TE,active,new-york-jets,2041250,2011
30353,1280000,250000,Sione Pouha,DT,active,new-york-jets,1530000,2011
30354,410000,1972400,Kyle Wilson,CB,active,new-york-jets,2382400,2011
30355,700000,0,Eric Smith,S,active,new-york-jets,700000,2011
30356,1125000,200000,LaDainian Tomlinson,RB,active,new-york-jets,1325000,2011
30357,375000,875000,Muhammad Wilkerson,DE,active,new-york-jets,1250000,2011
30358,1200000,0,Robert Turner,C,active,new-york-jets,1200000,2011
30359,685000,50000,Brodney Pool,S,active,new-york-jets,735000,2011
30360,480000,234370,Shonn Greene,RB,active,new-york-jets,714370,2011
30361,405000,256250,Vladimir Ducasse,G,active,new-york-jets,661250,2011
30362,480000,75000,Ropati Pitoitua,DE,active,new-york-jets,555000,2011
30363,545000,7280,Nick Folk,K,active,new-york-jets,552280,2011
30364,405000,125250,Joe McKnight,RB,active,new-york-jets,530250,2011
30365,525000,0,Aaron Maybin,OLB,active,new-york-jets,525000,2011
30366,525000,0,Kevin O'Connell,QB,active,new-york-jets,525000,2011
30367,525000,0,Patrick Turner,WR,active,new-york-jets,525000,2011
30368,480000,33170,Matt Slauson,G,active,new-york-jets,513170,2011
30369,375000,112500,Kenrick Ellis,DT,active,new-york-jets,487500,2011
30370,480000,667,Jamaal Westerman,LB,active,new-york-jets,480667,2011
30371,480000,0,Jarron Gilbert,DE,active,new-york-jets,480000,2011
30372,480000,0,Matthew Mulligan,TE,active,new-york-jets,480000,2011
30373,375000,100125,Bilal Powell,RB,active,new-york-jets,475125,2011
30374,405000,57870,John Conner,FB,active,new-york-jets,462870,2011
30375,450000,0,Marcus Dixon,DE,active,new-york-jets,450000,2011
30376,450000,0,Matt Kroul,C,active,new-york-jets,450000,2011
30377,450000,0,Ellis Lankster,CB,active,new-york-jets,450000,2011
30378,450000,0,Joey LaRocque,LB,active,new-york-jets,450000,2011
30379,450000,0,Josh Mauga,ILB,active,new-york-jets,450000,2011
30380,450000,0,Tanner Purdum,LS,active,new-york-jets,450000,2011
30381,375000,46062,Jeremy Kerley,WR,active,new-york-jets,421062,2011
30382,405000,667,Jeff Cumberland,TE,active,new-york-jets,405667,2011
30383,375000,26450,Caleb Schlauderaff,C,active,new-york-jets,401450,2011
30384,375000,16288,Greg McElroy,QB,active,new-york-jets,391288,2011
30385,375000,5000,Garrett McIntyre,OLB,active,new-york-jets,380000,2011
30386,375000,2333,Nick Bellore,ILB,active,new-york-jets,377333,2011
30387,375000,2333,Julian Posey,CB,active,new-york-jets,377333,2011
30388,375000,333,T.J. Conley,P,active,new-york-jets,375333,2011
30389,375000,0,Josh Baker,TE,active,new-york-jets,375000,2011
30390,375000,0,Taylor Boggs,G,active,new-york-jets,375000,2011
30391,375000,0,Dennis Landolt,G,active,new-york-jets,375000,2011
30392,375000,0,Logan Payne,WR,active,new-york-jets,375000,2011
30393,375000,0,Martin Tevaseu,DT,active,new-york-jets,375000,2011
30394,375000,0,Isaiah Trufant,CB,active,new-york-jets,375000,2011
30395,375000,0,Lorenzo Washington,DT,active,new-york-jets,375000,2011
30396,242647,0,Eron Riley,WR,active,new-york-jets,242647,2011
30397,158824,0,Austin Howard,RT,active,new-york-jets,158824,2011
30398,150194,0,Tracy Wilson,S,active,new-york-jets,150194,2011
30399,120882,0,Gerald Alexander,S,active,new-york-jets,120882,2011
30400,22059,0,Ricky Sapp,OLB,active,new-york-jets,22059,2011
30401,0,8946668,Vernon Gholston,LB,dead_cap,new-york-jets,8946668,2011
30402,2800000,0,Jerricho Cotchery,WR,dead_cap,new-york-jets,2800000,2011
30403,267647,400000,Derrick Mason,WR,dead_cap,new-york-jets,667647,2011
30404,400000,0,Ben Hartsock,TE,dead_cap,new-york-jets,400000,2011
30405,116125,0,Dwight Lowery,FS,dead_cap,new-york-jets,116125,2011
30406,43892,0,Brooks Foster,WR,dead_cap,new-york-jets,43892,2011
30407,41250,0,Erik Ainge,QB,dead_cap,new-york-jets,41250,2011
30408,0,12250,Scotty McKnight,WR,dead_cap,new-york-jets,12250,2011
30409,2333,0,Josh Baker,TE,dead_cap,new-york-jets,2333,2011
30410,9900000,2100000,David Harris,ILB,active,new-york-jets,12000000,2012
30411,4500000,10265916,Darrelle Revis,CB,active,new-york-jets,14765916,2012
30412,7750000,1500000,Santonio Holmes,WR,active,new-york-jets,9250000,2012
30413,3800000,4450000,Antonio Cromartie,CB,active,new-york-jets,8250000,2012
30414,3250000,4603125,Mark Sanchez,QB,active,new-york-jets,7853125,2012
30415,3085000,5443333,Calvin Pace,OLB,active,new-york-jets,8528333,2012
30416,4200000,1500000,Bart Scott,LB,active,new-york-jets,5700000,2012
30417,2233000,3007100,Nick Mangold,C,active,new-york-jets,5240100,2012
30418,2750000,293750,Brandon Moore,G,active,new-york-jets,3043750,2012
30419,985000,4116666,D'Brickashaw Ferguson,LT,active,new-york-jets,5101666,2012
30420,3052500,1113750,Dustin Keller,TE,active,new-york-jets,4166250,2012
30421,567000,3142400,Kyle Wilson,CB,active,new-york-jets,3709400,2012
30422,700000,1925000,LaRon Landry,S,active,new-york-jets,2625000,2012
30423,700000,1800000,Mike DeVito,DE,active,new-york-jets,2500000,2012
30424,2450000,0,Jason Smith,LT,active,new-york-jets,2450000,2012
30425,900000,1166667,Sione Pouha,DT,active,new-york-jets,2066667,2012
30426,1100000,1000000,Tim Tebow,QB,active,new-york-jets,2100000,2012
30427,1200000,0,Eric Smith,S,active,new-york-jets,1200000,2012
30428,390000,1210508,Quinton Coples,OLB,active,new-york-jets,1600508,2012
30429,687500,875000,Muhammad Wilkerson,DE,active,new-york-jets,1562500,2012
30430,1100000,300000,Yeremiah Bell,S,active,new-york-jets,1400000,2012
30431,725000,500000,Drew Stanton,QB,active,new-york-jets,1225000,2012
30432,615000,460050,Matt Slauson,G,active,new-york-jets,1075050,2012
30433,615000,400000,Aaron Maybin,OLB,active,new-york-jets,1015000,2012
30434,390000,466791,Stephen Hill,WR,active,new-york-jets,856791,2012
30435,615000,234370,Shonn Greene,RB,active,new-york-jets,849370,2012
30436,540000,256250,Vladimir Ducasse,G,active,new-york-jets,796250,2012
30437,700000,0,Ray Willis,T,active,new-york-jets,700000,2012
30438,540000,125250,Joe McKnight,RB,active,new-york-jets,665250,2012
30439,465000,152500,Kenrick Ellis,DT,active,new-york-jets,617500,2012
30440,700000,65000,Nick Folk,K,active,new-york-jets,765000,2012
30441,700000,65000,Chaz Schilens,WR,active,new-york-jets,765000,2012
30442,465000,100125,Bilal Powell,RB,active,new-york-jets,565125,2012
30443,540000,25000,Ellis Lankster,CB,active,new-york-jets,565000,2012
30444,540000,667,Jeff Cumberland,TE,active,new-york-jets,540667,2012
30445,700000,0,Stephon Heyer,T,active,new-york-jets,700000,2012
30446,540000,0,Austin Howard,RT,active,new-york-jets,540000,2012
30447,540000,0,Josh Mauga,ILB,active,new-york-jets,540000,2012
30448,540000,0,Tanner Purdum,LS,active,new-york-jets,540000,2012
30449,390000,144490,Demario Davis,ILB,active,new-york-jets,534490,2012
30450,0,50000,Aaron Berry,CB,active,new-york-jets,50000,2012
30451,465000,46062,Jeremy Kerley,WR,active,new-york-jets,511062,2012
30452,465000,0,DeAngelo Smith,CB,active,new-york-jets,465000,2012
30453,465000,5000,Garrett McIntyre,OLB,active,new-york-jets,470000,2012
30454,465000,2333,Nick Bellore,ILB,active,new-york-jets,467333,2012
30455,465000,0,Dedrick Epps,TE,active,new-york-jets,465000,2012
30456,465000,0,Clyde Gates,WR,active,new-york-jets,465000,2012
30457,465000,0,Mardy Gilyard,WR,active,new-york-jets,465000,2012
30458,465000,0,Robert Malone,P,active,new-york-jets,465000,2012
30459,465000,0,Caleb Schlauderaff,C,active,new-york-jets,465000,2012
30460,925000,0,Bryan Thomas,LB,active,new-york-jets,925000,2012
30461,390000,26055,Josh Bush,SS,active,new-york-jets,416055,2012
30462,615000,0,Lex Hilliard,RB,active,new-york-jets,615000,2012
30463,390000,16288,Greg McElroy,QB,active,new-york-jets,406288,2012
30464,390000,2790,Royce Adams,CB,active,new-york-jets,392790,2012
30465,390000,2333,Damon Harrison,DT,active,new-york-jets,392333,2012
30466,390000,0,Travis Baltz,PR,active,new-york-jets,390000,2012
30467,390000,0,DeMarco Cosby,TE,active,new-york-jets,390000,2012
30468,390000,0,Konrad Reuland,TE,active,new-york-jets,390000,2012
30469,381176,0,Daniel Muir,DT,active,new-york-jets,381176,2012
30470,390000,0,Johnathan Grimes,RB,active,new-york-jets,390000,2012
30471,303794,0,Antonio Allen,CB,active,new-york-jets,303794,2012
30472,390000,0,Hayden Smith,TE,active,new-york-jets,390000,2012
30473,243750,0,Marcus Dowtin,OLB,active,new-york-jets,243750,2012
30474,390000,0,Ricky Sapp,OLB,active,new-york-jets,390000,2012
30475,615000,0,Kahlil Bell,RB,active,new-york-jets,615000,2012
30476,390000,0,Darrin Walls,CB,active,new-york-jets,390000,2012
30477,390000,0,Jordan White,WR,active,new-york-jets,390000,2012
30478,390000,0,Julian Posey,CB,active,new-york-jets,390000,2012
30479,390000,0,John Griffin,RB,active,new-york-jets,390000,2012
30480,465000,0,Josh Baker,TE,active,new-york-jets,465000,2012
30481,465000,0,Isaiah Trufant,CB,injured_reserve,new-york-jets,465000,2012
30482,390000,0,Donnie Fletcher,S,injured_reserve,new-york-jets,390000,2012
30483,5700,0,LeQuan Lewis,CB,practice_squad,new-york-jets,5700,2012
30484,1666670,0,Jerricho Cotchery,WR,dead_cap,new-york-jets,1666670,2012
30485,500000,0,Drew Stanton,QB,dead_cap,new-york-jets,500000,2012
30486,332353,0,Patrick Turner,WR,dead_cap,new-york-jets,332353,2012
30487,252250,0,John Conner,FB,dead_cap,new-york-jets,252250,2012
30488,185862,0,Brian Linthicum,TE,dead_cap,new-york-jets,185862,2012
30489,95294,0,Marcus Dixon,DE,dead_cap,new-york-jets,95294,2012
30490,75000,0,Ropati Pitoitua,DE,dead_cap,new-york-jets,75000,2012
30491,68824,0,Dennis Landolt,G,dead_cap,new-york-jets,68824,2012
30492,50000,0,Wayne Hunter,T,dead_cap,new-york-jets,50000,2012
30493,0,36750,Scotty McKnight,WR,dead_cap,new-york-jets,36750,2012
30494,35000,0,Josh Brown,K,dead_cap,new-york-jets,35000,2012
30495,22800,0,Paul Cornick,RT,dead_cap,new-york-jets,22800,2012
30496,0,19670,Terrance Ganaway,RB,dead_cap,new-york-jets,19670,2012
30497,0,19670,Robert T. Griffin,G,dead_cap,new-york-jets,19670,2012
30498,0,11474,Jordan White,WR,dead_cap,new-york-jets,11474,2012
30499,11474,0,Antonio Allen,CB,dead_cap,new-york-jets,11474,2012
30500,11400,0,Royce Pollard,WR,dead_cap,new-york-jets,11400,2012
30501,8370,0,DaMarcus Ganaway,WR,dead_cap,new-york-jets,8370,2012
30502,7000,0,John Cullen,T,dead_cap,new-york-jets,7000,2012
30503,7000,0,Marcus Dowtin,OLB,dead_cap,new-york-jets,7000,2012
30504,5700,0,Stanley Arukwe,WR,dead_cap,new-york-jets,5700,2012
30505,4667,0,Josh Baker,TE,dead_cap,new-york-jets,4667,2012
30506,4667,0,Matthias Berning,LB,dead_cap,new-york-jets,4667,2012
30507,4667,0,Eddie Jones,LB,dead_cap,new-york-jets,4667,2012
30508,4667,0,Byron Landor,CB,dead_cap,new-york-jets,4667,2012
30509,4667,0,Davon Morgan,CB,dead_cap,new-york-jets,4667,2012
30510,4667,0,Julian Posey,CB,dead_cap,new-york-jets,4667,2012
30511,4667,0,Courtney Smith,WR,dead_cap,new-york-jets,4667,2012
30512,4667,0,Hayden Smith,TE,dead_cap,new-york-jets,4667,2012
30513,4667,0,Zane Taylor,C,dead_cap,new-york-jets,4667,2012
30514,2333,0,Donnie Fletcher,S,dead_cap,new-york-jets,2333,2012
30515,2333,0,G.J. Kinne,QB,dead_cap,new-york-jets,2333,2012
30516,2333,0,G.J. Kinnie,QB,dead_cap,new-york-jets,2333,2012
30517,2333,0,D'Anton Lynn,CB,dead_cap,new-york-jets,2333,2012
30518,2333,0,Donovan Robinson,LB,dead_cap,new-york-jets,2333,2012
30519,2333,0,Brett Roy,LB,dead_cap,new-york-jets,2333,2012
30520,2333,0,Ryan Steed,CB,dead_cap,new-york-jets,2333,2012
30521,2000,0,Chris Bryan,P,dead_cap,new-york-jets,2000,2012
30522,333,0,T.J. Conley,P,dead_cap,new-york-jets,333,2012
30523,10900000,2100000,David Harris,ILB,active,new-york-jets,13000000,2013
30524,8250000,4603125,Mark Sanchez,QB,active,new-york-jets,12853125,2013
30525,2510000,6607100,Nick Mangold,C,active,new-york-jets,9117100,2013
30526,7500000,1250000,Santonio Holmes,WR,active,new-york-jets,8750000,2013
30527,840000,6830000,Antonio Cromartie,CB,active,new-york-jets,7670000,2013
30528,840000,5398666,D'Brickashaw Ferguson,LT,active,new-york-jets,6238666,2013
30529,405000,1897000,Dee Milliner,CB,active,new-york-jets,2302000,2013
30530,2023000,0,Austin Howard,RT,active,new-york-jets,2023000,2013
30531,813000,2072400,Kyle Wilson,CB,active,new-york-jets,2885400,2013
30532,790127,1210508,Quinton Coples,OLB,active,new-york-jets,2000635,2013
30533,1000000,875000,Muhammad Wilkerson,DE,active,new-york-jets,1875000,2013
30534,405000,1423000,Sheldon Richardson,DT,active,new-york-jets,1828000,2013
30535,750000,750000,Chris Ivory,RB,active,new-york-jets,1500000,2013
30536,1323000,0,Jeff Cumberland,TE,active,new-york-jets,1323000,2013
30537,850000,325000,Dawan Landry,S,active,new-york-jets,1175000,2013
30538,1000000,0,Willie Colon,G,active,new-york-jets,1000000,2013
30539,1000000,100000,David Garrard,QB,active,new-york-jets,1100000,2013
30540,554197,516791,Stephen Hill,WR,active,new-york-jets,1070988,2013
30541,750000,300000,Antwan Barnes,OLB,active,new-york-jets,1050000,2013
30542,405000,507655,Geno Smith,QB,active,new-york-jets,912655,2013
30543,630000,256250,Vladimir Ducasse,G,active,new-york-jets,886250,2013
30544,742772,0,Benjamin Ijalana,RT,active,new-york-jets,742772,2013
30545,630000,100000,Josh Mauga,ILB,active,new-york-jets,730000,2013
30546,555000,152500,Kenrick Ellis,DT,active,new-york-jets,707500,2013
30547,630000,65000,Tanner Purdum,LS,active,new-york-jets,695000,2013
30548,331941,333333,Mike Goodson,RB,active,new-york-jets,665274,2013
30549,480000,184490,Demario Davis,ILB,active,new-york-jets,664490,2013
30550,555000,100125,Bilal Powell,RB,active,new-york-jets,655125,2013
30551,630000,25000,Ellis Lankster,CB,active,new-york-jets,655000,2013
30552,715000,65000,Nick Folk,K,active,new-york-jets,780000,2013
30553,555000,46062,Jeremy Kerley,WR,active,new-york-jets,601062,2013
30554,405000,160969,Brian Winters,G,active,new-york-jets,565969,2013
30555,555000,5000,Garrett McIntyre,OLB,active,new-york-jets,560000,2013
30556,555000,2333,Nick Bellore,ILB,active,new-york-jets,557333,2013
30557,940000,65000,Calvin Pace,OLB,active,new-york-jets,1005000,2013
30558,715000,0,Leger Douzable,DT,active,new-york-jets,715000,2013
30559,555000,0,Alexander Green,RB,active,new-york-jets,555000,2013
30560,555000,0,Caleb Schlauderaff,C,active,new-york-jets,555000,2013
30561,555000,0,Isaiah Trufant,CB,active,new-york-jets,555000,2013
30562,555000,0,Darrin Walls,CB,active,new-york-jets,555000,2013
30563,480000,26055,Josh Bush,SS,active,new-york-jets,506055,2013
30564,480000,2333,Damon Harrison,DT,active,new-york-jets,482333,2013
30565,480000,0,Antonio Allen,CB,active,new-york-jets,480000,2013
30566,480000,0,Jaiquawn Jarrett,FS,active,new-york-jets,480000,2013
30567,405000,49750,Oday Aboushi,G,active,new-york-jets,454750,2013
30568,840000,0,Joshua Cribbs,WR,active,new-york-jets,840000,2013
30569,405000,27625,William Campbell,G,active,new-york-jets,432625,2013
30570,642353,0,Kellen Winslow,TE,active,new-york-jets,642353,2013
30571,424412,0,David Nelson,WR,active,new-york-jets,424412,2013
30572,405000,15562,Tommy Bohanon,FB,active,new-york-jets,420562,2013
30573,480000,0,Konrad Reuland,TE,active,new-york-jets,480000,2013
30574,405000,0,Matt Simms,QB,active,new-york-jets,405000,2013
30575,940000,0,Ed Reed,S,active,new-york-jets,940000,2013
30576,555000,0,Greg Salas,WR,active,new-york-jets,555000,2013
30577,405000,0,Ryan Quigley,P,active,new-york-jets,405000,2013
30578,405000,0,Zach Sudfeld,TE,active,new-york-jets,405000,2013
30579,630000,0,Jermaine Cunningham,DE,active,new-york-jets,630000,2013
30580,715000,0,Darius Reynaud,RB,active,new-york-jets,715000,2013
30581,119117,0,Chris Pantale,TE,active,new-york-jets,119117,2013
30582,405000,0,Saalim Hakim,WR,active,new-york-jets,405000,2013
30583,650000,50000,Aaron Berry,CB,injured_reserve,new-york-jets,700000,2013
30584,555000,0,Clyde Gates,WR,injured_reserve,new-york-jets,555000,2013
30585,715000,65000,Lex Hilliard,RB,injured_reserve,new-york-jets,780000,2013
30586,288000,0,John Griffin,RB,injured_reserve,new-york-jets,288000,2013
30587,288000,0,Vidal Hazelton,WR,injured_reserve,new-york-jets,288000,2013
30588,405000,0,Troy Davis,OLB,injured_reserve,new-york-jets,405000,2013
30589,72000,0,Chris Pantale,TE,practice_squad,new-york-jets,72000,2013
30590,54000,0,Saalim Hakim,WR,practice_squad,new-york-jets,54000,2013
30591,24000,0,Troy Davis,OLB,practice_squad,new-york-jets,24000,2013
30592,6000,0,Miguel Maysonet,RB,practice_squad,new-york-jets,6000,2013
30593,0,12000000,Darrelle Revis,CB,dead_cap,new-york-jets,12000000,2013
30594,3013335,0,Calvin Pace,OLB,dead_cap,new-york-jets,3013335,2013
30595,2333334,0,Sione Pouha,DT,dead_cap,new-york-jets,2333334,2013
30596,0,1531875,Tim Tebow,QB,dead_cap,new-york-jets,1531875,2013
30597,1500000,0,Bart Scott,LB,dead_cap,new-york-jets,1500000,2013
30598,282354,0,Ricky Sapp,OLB,dead_cap,new-york-jets,282354,2013
30599,228529,0,Brady Quinn,QB,dead_cap,new-york-jets,228529,2013
30600,169412,0,Scott Solomon,OLB,dead_cap,new-york-jets,169412,2013
30601,167118,0,Michael Campbell,WR,dead_cap,new-york-jets,167118,2013
30602,130588,0,Ben Obomanu,WR,dead_cap,new-york-jets,130588,2013
30603,125250,0,Joe McKnight,RB,dead_cap,new-york-jets,125250,2013
30604,121451,0,Ryan Spadola,WR,dead_cap,new-york-jets,121451,2013
30605,100000,0,David Garrard,QB,dead_cap,new-york-jets,100000,2013
30606,97313,0,Rontez Miles,FS,dead_cap,new-york-jets,97313,2013
30607,94235,0,Danny Lansanah,ILB,dead_cap,new-york-jets,94235,2013
30608,65294,0,Robert Malone,P,dead_cap,new-york-jets,65294,2013
30609,65000,0,Antonio Garay,DE,dead_cap,new-york-jets,65000,2013
30610,0,59010,Terrance Ganaway,RB,dead_cap,new-york-jets,59010,2013
30611,0,59010,Robert T. Griffin,G,dead_cap,new-york-jets,59010,2013
30612,50000,0,Stephen Peterman,G,dead_cap,new-york-jets,50000,2013
30613,49750,0,John Conner,FB,dead_cap,new-york-jets,49750,2013
30614,0,34422,Jordan White,WR,dead_cap,new-york-jets,34422,2013
30615,34422,0,Antonio Allen,CB,dead_cap,new-york-jets,34422,2013
30616,30000,0,Junior Aumavae,DT,dead_cap,new-york-jets,30000,2013
30617,0,16288,Greg McElroy,QB,dead_cap,new-york-jets,16288,2013
30618,6667,0,Hayden Smith,TE,dead_cap,new-york-jets,6667,2013
30619,6000,0,Kareem Huggins,RB,dead_cap,new-york-jets,6000,2013
30620,6000,0,Rahsaan Vaughn,WR,dead_cap,new-york-jets,6000,2013
30621,4667,0,Donnie Fletcher,S,dead_cap,new-york-jets,4667,2013
30622,4667,0,G.J. Kinne,QB,dead_cap,new-york-jets,4667,2013
30623,4667,0,Brian Linthicum,TE,dead_cap,new-york-jets,4667,2013
30624,4667,0,D'Anton Lynn,CB,dead_cap,new-york-jets,4667,2013
30625,4667,0,Donovan Robinson,LB,dead_cap,new-york-jets,4667,2013
30626,4667,0,Brett Roy,LB,dead_cap,new-york-jets,4667,2013
30627,4667,0,Ryan Steed,CB,dead_cap,new-york-jets,4667,2013
30628,2333,0,Zach Rogers,WR,dead_cap,new-york-jets,2333,2013
30629,1667,0,Mike Edwards,CB,dead_cap,new-york-jets,1667,2013
30630,1667,0,Dalton Freeman,C,dead_cap,new-york-jets,1667,2013
30631,1000,0,Troy Davis,OLB,dead_cap,new-york-jets,1000,2013
30632,1000,0,Jake McDonough,DT,dead_cap,new-york-jets,1000,2013
30633,1000,0,Chris Pantale,TE,dead_cap,new-york-jets,1000,2013
30634,1000,0,Mark Popek,G,dead_cap,new-york-jets,1000,2013
30635,1000,0,Mike Shanahan,TE,dead_cap,new-york-jets,1000,2013
30636,1000,0,K.J. Stroud,WR,dead_cap,new-york-jets,1000,2013
30637,667,0,Trey Gilleo,LT,dead_cap,new-york-jets,667,2013
30638,333,0,T.J. Conley,P,dead_cap,new-york-jets,333,2013
30639,5950000,6398666,D'Brickashaw Ferguson,LT,active,new-york-jets,12348666,2014
30640,2970000,4257100,Nick Mangold,C,active,new-york-jets,7227100,2014
30641,4900000,2100000,David Harris,ILB,active,new-york-jets,7000000,2014
30642,6470588,0,Percy Harvin,WR,active,new-york-jets,6470588,2014
30643,2500000,1500000,Eric Decker,WR,active,new-york-jets,4000000,2014
30644,2000000,2000000,Michael Vick,QB,active,new-york-jets,4000000,2014
30645,1500000,2100000,Nick Folk,K,active,new-york-jets,3600000,2014
30646,1000000,2000000,Chris Johnson,RB,active,new-york-jets,3000000,2014
30647,1000000,1625000,Breno Giacomini,RT,active,new-york-jets,2625000,2014
30648,1375000,1125000,Calvin Pace,OLB,active,new-york-jets,2500000,2014
30649,1190254,1210508,Quinton Coples,OLB,active,new-york-jets,2400762,2014
30650,1190000,2072400,Kyle Wilson,CB,active,new-york-jets,3262400,2014
30651,862000,1423000,Sheldon Richardson,DT,active,new-york-jets,2285000,2014
30652,1212500,975000,Muhammad Wilkerson,DE,active,new-york-jets,2187500,2014
30653,1431000,646062,Jeremy Kerley,WR,active,new-york-jets,2077062,2014
30654,1000000,1000000,Willie Colon,G,active,new-york-jets,2000000,2014
30655,900000,1000000,Jeff Cumberland,TE,active,new-york-jets,1900000,2014
30656,1500000,325000,Dawan Landry,S,active,new-york-jets,1825000,2014
30657,1000000,750000,Chris Ivory,RB,active,new-york-jets,1750000,2014
30658,1100000,625000,Jason Babin,DE,active,new-york-jets,1725000,2014
30659,420000,1136955,Calvin Pryor,FS,active,new-york-jets,1556955,2014
30660,1431000,100125,Bilal Powell,RB,active,new-york-jets,1531125,2014
30661,1431000,0,Nick Bellore,ILB,active,new-york-jets,1431000,2014
30662,633164,507655,Geno Smith,QB,active,new-york-jets,1140819,2014
30663,750000,250000,Leger Douzable,DT,active,new-york-jets,1000000,2014
30664,650000,350000,Darrin Walls,CB,active,new-york-jets,1000000,2014
30665,926658,0,Benjamin Ijalana,RT,active,new-york-jets,926658,2014
30666,645000,152500,Kenrick Ellis,DT,active,new-york-jets,797500,2014
30667,730000,65000,Tanner Purdum,LS,active,new-york-jets,795000,2014
30668,420000,360544,Jace Amaro,TE,active,new-york-jets,780544,2014
30669,570000,194490,Demario Davis,ILB,active,new-york-jets,764490,2014
30670,529000,160969,Brian Winters,G,active,new-york-jets,689969,2014
30671,645000,0,Greg Salas,WR,active,new-york-jets,645000,2014
30672,570000,2333,Damon Harrison,DT,active,new-york-jets,572333,2014
30673,730000,0,Phillip Adams,CB,active,new-york-jets,730000,2014
30674,570000,0,Antonio Allen,CB,active,new-york-jets,570000,2014
30675,570000,0,Jaiquawn Jarrett,FS,active,new-york-jets,570000,2014
30676,495000,49750,Oday Aboushi,G,active,new-york-jets,544750,2014
30677,420000,75146,Dakota Dozier,G,active,new-york-jets,495146,2014
30678,495000,0,Saalim Hakim,WR,active,new-york-jets,495000,2014
30679,495000,0,Ryan Quigley,P,active,new-york-jets,495000,2014
30680,495000,0,Zach Sudfeld,TE,active,new-york-jets,495000,2014
30681,303000,149719,Dexter McDougle,CB,active,new-york-jets,452719,2014
30682,420000,19670,IK Enemkpali,OLB,active,new-york-jets,439670,2014
30683,730000,0,John Conner,FB,active,new-york-jets,730000,2014
30684,570000,0,T.J. Graham,WR,active,new-york-jets,570000,2014
30685,420000,14212,Trevor Reilly,OLB,active,new-york-jets,434212,2014
30686,420000,0,T.J. Barnes,DT,active,new-york-jets,420000,2014
30687,420000,0,Dalton Freeman,C,active,new-york-jets,420000,2014
30688,420000,0,Walter Powell,WR,active,new-york-jets,420000,2014
30689,303000,112725,Shaquelle Evans,WR,active,new-york-jets,415725,2014
30690,398000,0,Jermaine Cunningham,DE,active,new-york-jets,398000,2014
30691,359647,15562,Tommy Bohanon,FB,active,new-york-jets,375209,2014
30692,420000,0,Wesley Johnson,C,active,new-york-jets,420000,2014
30693,262058,0,Matt Simms,QB,active,new-york-jets,262058,2014
30694,420000,0,Marcus Williams,CB,active,new-york-jets,420000,2014
30695,495000,0,Chris Pantale,TE,active,new-york-jets,495000,2014
30696,570000,0,Chris Owusu,WR,active,new-york-jets,570000,2014
30697,420000,0,Rontez Miles,FS,active,new-york-jets,420000,2014
30698,420000,0,Quincy Enunwa,WR,active,new-york-jets,420000,2014
30699,495000,2382505,Dee Milliner,CB,injured_reserve,new-york-jets,2877505,2014
30700,75600,0,Dashaun Phillips,CB,practice_squad,new-york-jets,75600,2014
30701,56700,0,Chris Young,ILB,practice_squad,new-york-jets,56700,2014
30702,25200,0,Kona Schwenke,DT,practice_squad,new-york-jets,25200,2014
30703,18900,0,Keith Lewis,CB,practice_squad,new-york-jets,18900,2014
30704,12600,0,Mario Harvey,FB,practice_squad,new-york-jets,12600,2014
30705,0,0,Tevita Finau,FB,practice_squad,new-york-jets,0,2014
30706,0,0,Kerry Hyder,DE,practice_squad,new-york-jets,0,2014
30707,0,0,Brent Qvale,RT,practice_squad,new-york-jets,0,2014
30708,0,0,Daryl Richardson,RB,practice_squad,new-york-jets,0,2014
30709,0,6630000,Antonio Cromartie,CB,dead_cap,new-york-jets,6630000,2014
30710,4800000,0,Mark Sanchez,QB,dead_cap,new-york-jets,4800000,2014
30711,2500000,0,Santonio Holmes,WR,dead_cap,new-york-jets,2500000,2014
30712,1200000,300000,Antwan Barnes,OLB,dead_cap,new-york-jets,1500000,2014
30713,0,1000000,Dimitri Patterson,CB,dead_cap,new-york-jets,1000000,2014
30714,645000,0,David Nelson,WR,dead_cap,new-york-jets,645000,2014
30715,0,566791,Stephen Hill,WR,dead_cap,new-york-jets,566791,2014
30716,341471,0,Joshua Thomas,CB,dead_cap,new-york-jets,341471,2014
30717,326765,0,Ellis Lankster,CB,dead_cap,new-york-jets,326765,2014
30718,0,279412,Mike Goodson,RB,dead_cap,new-york-jets,279412,2014
30719,234706,26055,Josh Bush,SS,dead_cap,new-york-jets,260761,2014
30720,232941,0,A.J. Edds,OLB,dead_cap,new-york-jets,232941,2014
30721,98824,120362,Jalen Saunders,WR,dead_cap,new-york-jets,219186,2014
30722,192847,0,Chris Owusu,WR,dead_cap,new-york-jets,192847,2014
30723,100800,19670,Quincy Enunwa,WR,dead_cap,new-york-jets,120470,2014
30724,94501,3334,Rontez Miles,FS,dead_cap,new-york-jets,97835,2014
30725,77600,0,Chris Pantale,TE,dead_cap,new-york-jets,77600,2014
30726,71294,0,Tim Fugger,OLB,dead_cap,new-york-jets,71294,2014
30727,18900,47938,Jeremiah George,ILB,dead_cap,new-york-jets,66838,2014
30728,0,65000,Jacoby Ford,WR,dead_cap,new-york-jets,65000,2014
30729,61993,0,Leon McFadden,CB,dead_cap,new-york-jets,61993,2014
30730,0,55000,Johnny Patrick,CB,dead_cap,new-york-jets,55000,2014
30731,54318,0,LeQuan Lewis,CB,dead_cap,new-york-jets,54318,2014
30732,50400,0,Matt Simms,QB,dead_cap,new-york-jets,50400,2014
30733,31500,0,Marcus Williams,CB,dead_cap,new-york-jets,31500,2014
30734,0,27625,William Campbell,G,dead_cap,new-york-jets,27625,2014
30735,0,25966,Brandon Dixon,CB,dead_cap,new-york-jets,25966,2014
30736,0,19670,Tajh Boyd,QB,dead_cap,new-york-jets,19670,2014
30737,18657,0,Reggie Jordan,TE,dead_cap,new-york-jets,18657,2014
30738,0,16288,Greg McElroy,QB,dead_cap,new-york-jets,16288,2014
30739,6300,0,Brandon Smith,CB,dead_cap,new-york-jets,6300,2014
30740,4667,0,Zach Rogers,WR,dead_cap,new-york-jets,4667,2014
30741,4667,0,Ryan Spadola,WR,dead_cap,new-york-jets,4667,2014
30742,3334,0,Mike Edwards,CB,dead_cap,new-york-jets,3334,2014
30743,3334,0,Dalton Freeman,C,dead_cap,new-york-jets,3334,2014
30744,2000,0,Troy Davis,OLB,dead_cap,new-york-jets,2000,2014
30745,2000,0,Jake McDonough,DT,dead_cap,new-york-jets,2000,2014
30746,2000,0,Mark Popek,G,dead_cap,new-york-jets,2000,2014
30747,2000,0,Mike Shanahan,TE,dead_cap,new-york-jets,2000,2014
30748,2000,0,K.J. Stroud,WR,dead_cap,new-york-jets,2000,2014
30749,0,1666,Steele Divitto,ILB,dead_cap,new-york-jets,1666,2014
30750,0,1666,Zach Thompson,DE,dead_cap,new-york-jets,1666,2014
30751,1334,0,Trey Gilleo,LT,dead_cap,new-york-jets,1334,2014
30752,0,1333,Kerry Hyder,DE,dead_cap,new-york-jets,1333,2014
30753,0,833,Anthony Grady,DT,dead_cap,new-york-jets,833,2014
30754,0,666,Brent Qvale,RT,dead_cap,new-york-jets,666,2014
30755,0,500,Chad  Young,FB,dead_cap,new-york-jets,500,2014
30756,16000000,0,Darrelle Revis,CB,active,new-york-jets,16000000,2015
30757,5950000,6398666,D'Brickashaw Ferguson,LT,active,new-york-jets,12348666,2015
30758,4800000,5607100,Nick Mangold,C,active,new-york-jets,10407100,2015
30759,9000000,0,Brandon Marshall,WR,active,new-york-jets,9000000,2015
30760,7500000,0,David Harris,ILB,active,new-york-jets,7500000,2015
30761,5000000,2000000,Antonio Cromartie,CB,active,new-york-jets,7000000,2015
30762,6969000,0,Muhammad Wilkerson,DE,active,new-york-jets,6969000,2015
30763,5000000,1500000,Eric Decker,WR,active,new-york-jets,6500000,2015
30764,4500000,625000,Breno Giacomini,RT,active,new-york-jets,5125000,2015
30765,585000,2868010,Dee Milliner,CB,active,new-york-jets,3453010,2015
30766,435000,2952430,Leonard Williams,DE,active,new-york-jets,3387430,2015
30767,3250000,0,Ryan Fitzpatrick,QB,active,new-york-jets,3250000,2015
30768,1000000,2125000,Marcus Gilchrist,SS,active,new-york-jets,3125000,2015
30769,2000000,750000,Chris Ivory,RB,active,new-york-jets,2750000,2015
30770,1500000,1250000,Buster Skrine,CB,active,new-york-jets,2750000,2015
30771,2000000,600000,Jeremy Kerley,WR,active,new-york-jets,2600000,2015
30772,1008647,1423000,Sheldon Richardson,DT,active,new-york-jets,2431647,2015
30773,1500000,875000,James Carpenter,G,active,new-york-jets,2375000,2015
30774,2356000,0,Damon Harrison,DT,active,new-york-jets,2356000,2015
30775,2125000,125000,Calvin Pace,OLB,active,new-york-jets,2250000,2015
30776,1250000,750000,Bilal Powell,RB,active,new-york-jets,2000000,2015
30777,809239,1136955,Calvin Pryor,FS,active,new-york-jets,1946194,2015
30778,1900000,0,Jeff Cumberland,TE,active,new-york-jets,1900000,2015
30779,1492000,194490,Demario Davis,ILB,active,new-york-jets,1686490,2015
30780,1542000,0,Antonio Allen,CB,active,new-york-jets,1542000,2015
30781,585000,783983,Geno Smith,QB,active,new-york-jets,1368983,2015
30782,750000,450000,Leger Douzable,DT,active,new-york-jets,1200000,2015
30783,1075000,0,Darrin Walls,CB,active,new-york-jets,1075000,2015
30784,750000,281250,Stevan Ridley,RB,active,new-york-jets,1031250,2015
30785,615136,360544,Jace Amaro,TE,active,new-york-jets,975680,2015
30786,745000,132500,Tanner Purdum,LS,active,new-york-jets,877500,2015
30787,618000,160969,Brian Winters,G,active,new-york-jets,778969,2015
30788,660000,100000,Benjamin Ijalana,RT,active,new-york-jets,760000,2015
30789,525000,149719,Dexter McDougle,CB,active,new-york-jets,674719,2015
30790,870000,80000,Stephen Bowen,DE,active,new-york-jets,950000,2015
30791,745000,80000,Jamari Lattimore,ILB,active,new-york-jets,825000,2015
30792,870000,80000,Kellen Davis,TE,active,new-york-jets,950000,2015
30793,435000,168504,Lorenzo Mauldin,OLB,active,new-york-jets,603504,2015
30794,585000,15562,Tommy Bohanon,FB,active,new-york-jets,600562,2015
30795,510000,75146,Dakota Dozier,G,active,new-york-jets,585146,2015
30796,745000,0,Erin Henderson,ILB,active,new-york-jets,745000,2015
30797,585000,0,Ryan Quigley,P,active,new-york-jets,585000,2015
30798,435000,138424,Bryce Petty,QB,active,new-york-jets,573424,2015
30799,510000,14212,Trevor Reilly,OLB,active,new-york-jets,524212,2015
30800,510000,0,Marcus Williams,CB,active,new-york-jets,510000,2015
30801,435000,0,Brent Qvale,RT,active,new-york-jets,435000,2015
30802,378529,0,Kenbrell Thompkins,WR,active,new-york-jets,378529,2015
30803,358235,0,Dion Bailey,SS,active,new-york-jets,358235,2015
30804,332647,0,Quincy Enunwa,WR,active,new-york-jets,332647,2015
30805,310588,0,Randy Bullock,K,active,new-york-jets,310588,2015
30806,300000,0,Wesley Johnson,C,active,new-york-jets,300000,2015
30807,230294,0,Rontez Miles,FS,active,new-york-jets,230294,2015
30808,206470,0,Josh Martin,OLB,active,new-york-jets,206470,2015
30809,102352,0,Ronald Martin,SS,active,new-york-jets,102352,2015
30810,76764,0,Taiwan Jones,LB,active,new-york-jets,76764,2015
30811,1542000,0,Jaiquawn Jarrett,FS,injured_reserve,new-york-jets,1542000,2015
30812,870000,593333,Nick Folk,K,injured_reserve,new-york-jets,1463333,2015
30813,414352,632712,Devin Smith,WR,injured_reserve,new-york-jets,1047064,2015
30814,870000,80000,Willie Colon,G,injured_reserve,new-york-jets,950000,2015
30815,660000,0,Chris Owusu,WR,injured_reserve,new-york-jets,660000,2015
30816,585000,0,Zac Stacy,RB,injured_reserve,new-york-jets,585000,2015
30817,585000,0,Zach Sudfeld,TE,injured_reserve,new-york-jets,585000,2015
30818,210000,0,Mike Catapano,DE,injured_reserve,new-york-jets,210000,2015
30819,980540,1285508,Quinton Coples,OLB,dead_cap,new-york-jets,2266048,2015
30820,0,1500000,Chris Johnson,RB,dead_cap,new-york-jets,1500000,2015
30821,0,466791,Stephen Hill,WR,dead_cap,new-york-jets,466791,2015
30822,0,361086,Jalen Saunders,WR,dead_cap,new-york-jets,361086,2015
30823,257505,54962,Jarvis Harrison,G,dead_cap,new-york-jets,312467,2015
30824,0,300000,Antwan Barnes,OLB,dead_cap,new-york-jets,300000,2015
30825,283200,0,T.J. Barnes,DT,dead_cap,new-york-jets,283200,2015
30826,0,279412,Mike Goodson,RB,dead_cap,new-york-jets,279412,2015
30827,169164,18324,Deon Simon,DT,dead_cap,new-york-jets,187488,2015
30828,155152,0,Ronald Martin,SS,dead_cap,new-york-jets,155152,2015
30829,150176,3333,Wes Saxton,TE,dead_cap,new-york-jets,153509,2015
30830,0,143814,Jeremiah George,ILB,dead_cap,new-york-jets,143814,2015
30831,0,125000,Jason Babin,DE,dead_cap,new-york-jets,125000,2015
30832,112200,1333,Deion Barnes,DE,dead_cap,new-york-jets,113533,2015
30833,0,112725,Shaquelle Evans,WR,dead_cap,new-york-jets,112725,2015
30834,20470,80000,Kevin Vickerson,DT,dead_cap,new-york-jets,100470,2015
30835,92400,3333,Taiwan Jones,LB,dead_cap,new-york-jets,95733,2015
30836,92400,666,Julian Howsare,LB,dead_cap,new-york-jets,93066,2015
30837,32387,49750,Oday Aboushi,G,dead_cap,new-york-jets,82137,2015
30838,0,77898,Brandon Dixon,CB,dead_cap,new-york-jets,77898,2015
30839,66000,0,Mike Catapano,DE,dead_cap,new-york-jets,66000,2015
30840,66000,0,Kevin Short,CB,dead_cap,new-york-jets,66000,2015
30841,0,60000,James Brewer,G,dead_cap,new-york-jets,60000,2015
30842,0,60000,Matt Flynn,QB,dead_cap,new-york-jets,60000,2015
30843,0,60000,Corey Hilliard,RT,dead_cap,new-york-jets,60000,2015
30844,0,60000,Joe Mays,ILB,dead_cap,new-york-jets,60000,2015
30845,0,59010,Tajh Boyd,QB,dead_cap,new-york-jets,59010,2015
30846,0,59010,Quincy Enunwa,WR,dead_cap,new-york-jets,59010,2015
30847,0,55250,William Campbell,G,dead_cap,new-york-jets,55250,2015
30848,52800,0,Rontez Miles,FS,dead_cap,new-york-jets,52800,2015
30849,46200,0,Wesley Johnson,C,dead_cap,new-york-jets,46200,2015
30850,46200,0,Lawrence Okoye,DT,dead_cap,new-york-jets,46200,2015
30851,57058,0,Steve Weatherford,P,dead_cap,new-york-jets,57058,2015
30852,33000,0,Jeremy Harris,CB,dead_cap,new-york-jets,33000,2015
30853,33000,0,Julian Stanford,OLB,dead_cap,new-york-jets,33000,2015
30854,26400,0,Brandon Bostick,TE,dead_cap,new-york-jets,26400,2015
30855,26400,0,Walter Powell,WR,dead_cap,new-york-jets,26400,2015
30856,26400,0,Titus Davis,WR,dead_cap,new-york-jets,26400,2015
30857,0,26055,Josh Bush,SS,dead_cap,new-york-jets,26055,2015
30858,19800,0,Keon Lyn,CB,dead_cap,new-york-jets,19800,2015
30859,19800,0,Quanterus Smith,DE,dead_cap,new-york-jets,19800,2015
30860,0,19670,IK Enemkpali,OLB,dead_cap,new-york-jets,19670,2015
30861,13200,666,Jordan Williams,DT,dead_cap,new-york-jets,13866,2015
30862,13200,0,Joseph Anderson,WR,dead_cap,new-york-jets,13200,2015
30863,13200,0,Kenbrell Thompkins,WR,dead_cap,new-york-jets,13200,2015
30864,13200,0,Shane Wynn,WR,dead_cap,new-york-jets,13200,2015
30865,5000,2833,Durell Eskridge,FS,dead_cap,new-york-jets,7833,2015
30866,0,7500,Alexander Green,RB,dead_cap,new-york-jets,7500,2015
30867,0,5000,Davon Walls,DT,dead_cap,new-york-jets,5000,2015
30868,0,3500,Demarkus Perkins,S,dead_cap,new-york-jets,3500,2015
30869,0,3334,Steele Divitto,ILB,dead_cap,new-york-jets,3334,2015
30870,0,3334,Zach Thompson,DE,dead_cap,new-york-jets,3334,2015
30871,0,2667,Kerry Hyder,DE,dead_cap,new-york-jets,2667,2015
30872,0,1667,Anthony Grady,DT,dead_cap,new-york-jets,1667,2015
30873,0,1334,Brent Qvale,RT,dead_cap,new-york-jets,1334,2015
30874,0,1000,Chad  Young,FB,dead_cap,new-york-jets,1000,2015
30875,17000000,0,Darrelle Revis,CB,active,new-york-jets,17000000,2016
30876,7000000,3000000,Muhammad Wilkerson,DE,active,new-york-jets,10000000,2016
30877,9500000,0,Brandon Marshall,WR,active,new-york-jets,9500000,2016
30878,7500000,0,David Harris,ILB,active,new-york-jets,7500000,2016
30879,2000000,5000000,Ryan Fitzpatrick,QB,active,new-york-jets,7000000,2016
30880,2750000,2504000,Buster Skrine,CB,active,new-york-jets,5254000,2016
30881,525000,3709288,Leonard Williams,DE,active,new-york-jets,4234288,2016
30882,2750000,593333,Nick Folk,K,active,new-york-jets,3343333,2016
30883,760000,2355000,James Carpenter,G,active,new-york-jets,3115000,2016
30884,1671530,1423000,Sheldon Richardson,DT,active,new-york-jets,3094530,2016
30885,1750000,750000,Steve McLendon,DT,active,new-york-jets,2500000,2016
30886,1198478,1136955,Calvin Pryor,FS,active,new-york-jets,2335433,2016
30887,450000,1408481,Darron Lee,ILB,active,new-york-jets,1858481,2016
30888,1671000,160969,Brian Winters,G,active,new-york-jets,1831969,2016
30889,850000,883333,Bilal Powell,RB,active,new-york-jets,1733333,2016
30890,701929,632712,Devin Smith,WR,active,new-york-jets,1334641,2016
30891,800000,132500,Tanner Purdum,LS,active,new-york-jets,932500,2016
30892,450000,397327,Christian Hackenberg,QB,active,new-york-jets,847327,2016
30893,543000,168504,Lorenzo Mauldin,OLB,active,new-york-jets,711504,2016
30894,760000,80000,Bruce Carter,ILB,active,new-york-jets,840000,2016
30895,760000,80000,Benjamin Ijalana,RT,active,new-york-jets,840000,2016
30896,677534,0,Austin Seferian-Jenkins,TE,active,new-york-jets,677534,2016
30897,600000,75146,Dakota Dozier,G,active,new-york-jets,675146,2016
30898,675000,0,Josh Martin,OLB,active,new-york-jets,675000,2016
30899,450000,180980,Jordan Jenkins,OLB,active,new-york-jets,630980,2016
30900,600000,0,Brandon Bostick,TE,active,new-york-jets,600000,2016
30901,600000,0,Wesley Johnson,C,active,new-york-jets,600000,2016
30902,600000,0,Marcus Williams,CB,active,new-york-jets,600000,2016
30903,450000,137782,Juston Burris,CB,active,new-york-jets,587782,2016
30904,525000,0,Quincy Enunwa,WR,active,new-york-jets,525000,2016
30905,525000,0,Rontez Miles,FS,active,new-york-jets,525000,2016
30906,525000,0,Brent Qvale,RT,active,new-york-jets,525000,2016
30907,525000,0,Deon Simon,DT,active,new-york-jets,525000,2016
30908,450000,58991,Brandon Shell,T,active,new-york-jets,508991,2016
30909,450000,18948,Lac Edwards,P,active,new-york-jets,468948,2016
30910,450000,17095,Charone Peake,WR,active,new-york-jets,467095,2016
30911,450000,3333,Robby Anderson,WR,active,new-york-jets,453333,2016
30912,450000,2666,Jalin Marshall,WR,active,new-york-jets,452666,2016
30913,450000,0,Darryl Roberts,CB,active,new-york-jets,450000,2016
30914,370588,0,Nick Marshall,CB,active,new-york-jets,370588,2016
30915,282352,0,Anthony Johnson,DE,active,new-york-jets,282352,2016
30916,282352,0,Dexter McDougle,CB,active,new-york-jets,282352,2016
30917,238230,0,Eric Tomlinson,TE,active,new-york-jets,238230,2016
30918,105880,0,Freddie Bishop,OLB,active,new-york-jets,105880,2016
30919,105880,0,Doug Middleton,S,active,new-york-jets,105880,2016
30920,105880,0,Brandon Wilds,RB,active,new-york-jets,105880,2016
30921,92646,0,Ronald Martin,SS,active,new-york-jets,92646,2016
30922,79410,0,Craig Watts,G,active,new-york-jets,79410,2016
30923,70588,0,Randell Johnson,OLB,active,new-york-jets,70588,2016
30924,61764,0,Donald Hawkins,G,active,new-york-jets,61764,2016
30925,52940,0,Brandin Bryant,DE,active,new-york-jets,52940,2016
30926,40294,0,Corey Lemonier,OLB,active,new-york-jets,40294,2016
30927,26470,0,Brandon Burks,RB,active,new-york-jets,26470,2016
30928,26470,0,Bryson Keeton,CB,active,new-york-jets,26470,2016
30929,5600000,3000000,Nick Mangold,C,injured_reserve,new-york-jets,8600000,2016
30930,6500000,1500000,Eric Decker,WR,injured_reserve,new-york-jets,8000000,2016
30931,5000000,625000,Breno Giacomini,RT,injured_reserve,new-york-jets,5625000,2016
30932,5000000,625000,Marcus Gilchrist,SS,injured_reserve,new-york-jets,5625000,2016
30933,3500000,2000000,Ryan Clady,LT,injured_reserve,new-york-jets,5500000,2016
30934,1000000,2000000,Matt Forte,RB,injured_reserve,new-york-jets,3000000,2016
30935,675000,922146,Geno Smith,QB,injured_reserve,new-york-jets,1597146,2016
30936,885000,80000,Kellen Davis,TE,injured_reserve,new-york-jets,965000,2016
30937,675000,0,Antonio Allen,CB,injured_reserve,new-york-jets,675000,2016
30938,525000,138424,Bryce Petty,QB,injured_reserve,new-york-jets,663424,2016
30939,600000,0,Mike Catapano,DE,injured_reserve,new-york-jets,600000,2016
30940,436764,0,Julian Stanford,OLB,injured_reserve,new-york-jets,436764,2016
30941,397050,0,Braedon Bowman,TE,injured_reserve,new-york-jets,397050,2016
30942,353645,5000,Lawrence Thomas,DE,injured_reserve,new-york-jets,358645,2016
30943,333000,500,Julien Obioha,DE,injured_reserve,new-york-jets,333500,2016
30944,333000,0,Romar Morris,RB,injured_reserve,new-york-jets,333000,2016
30945,158823,0,Khiry Robinson,RB,injured_reserve,new-york-jets,158823,2016
30946,885000,365000,Erin Henderson,ILB,non_fb_injury,new-york-jets,1250000,2016
30947,0,5664000,D'Brickashaw Ferguson,LT,dead_cap,new-york-jets,5664000,2016
30948,675000,3353424,Dee Milliner,CB,dead_cap,new-york-jets,4028424,2016
30949,1500000,750000,Jarvis Jenkins,DE,dead_cap,new-york-jets,2250000,2016
30950,0,1800000,Jeremy Kerley,WR,dead_cap,new-york-jets,1800000,2016
30951,0,360544,Jace Amaro,TE,dead_cap,new-york-jets,360544,2016
30952,260294,0,C.J. Spiller,RB,dead_cap,new-york-jets,260294,2016
30953,90000,149719,Dexter McDougle,CB,dead_cap,new-york-jets,239719,2016
30954,0,225450,Shaquelle Evans,WR,dead_cap,new-york-jets,225450,2016
30955,211760,0,Troymaine Pope,RB,dead_cap,new-york-jets,211760,2016
30956,158822,50000,Jeremy Ross,WR,dead_cap,new-york-jets,208822,2016
30957,0,174886,Jarvis Harrison,G,dead_cap,new-york-jets,174886,2016
30958,149540,0,Victor Ochi,OLB,dead_cap,new-york-jets,149540,2016
30959,139817,0,Julian Stanford,OLB,dead_cap,new-york-jets,139817,2016
30960,0,130000,Khiry Robinson,RB,dead_cap,new-york-jets,130000,2016
30961,105880,6667,Taiwan Jones,LB,dead_cap,new-york-jets,112547,2016
30962,110400,0,Bryson Keeton,CB,dead_cap,new-york-jets,110400,2016
30963,104666,0,Arthur Brown,ILB,dead_cap,new-york-jets,104666,2016
30964,96600,0,Craig Watts,G,dead_cap,new-york-jets,96600,2016
30965,89700,5000,Doug Middleton,S,dead_cap,new-york-jets,94700,2016
30966,89700,2500,Freddie Bishop,OLB,dead_cap,new-york-jets,92200,2016
30967,89700,0,Ronald Martin,SS,dead_cap,new-york-jets,89700,2016
30968,0,75000,Darryl Morris,CB,dead_cap,new-york-jets,75000,2016
30969,69000,0,Brandon Wilds,RB,dead_cap,new-york-jets,69000,2016
30970,66740,1334,Julian Howsare,LB,dead_cap,new-york-jets,68074,2016
30971,61764,0,Jeremy Butler,WR,dead_cap,new-york-jets,61764,2016
30972,55200,0,Brandin Bryant,DE,dead_cap,new-york-jets,55200,2016
30973,0,54972,Deon Simon,DT,dead_cap,new-york-jets,54972,2016
30974,0,49750,Oday Aboushi,G,dead_cap,new-york-jets,49750,2016
30975,41400,0,Myles White,WR,dead_cap,new-york-jets,41400,2016
30976,0,39340,IK Enemkpali,OLB,dead_cap,new-york-jets,39340,2016
30977,39176,0,Jake Ceresna,DT,dead_cap,new-york-jets,39176,2016
30978,34500,0,Claude Pelon,DE,dead_cap,new-york-jets,34500,2016
30979,33370,0,Braedon Bowman,TE,dead_cap,new-york-jets,33370,2016
30980,27600,0,Darius Jennings,WR,dead_cap,new-york-jets,27600,2016
30981,27600,0,Chris Swain,FB,dead_cap,new-york-jets,27600,2016
30982,20700,5000,Dominique Williams,RB,dead_cap,new-york-jets,25700,2016
30983,20700,0,Kenny Anunike,DE,dead_cap,new-york-jets,20700,2016
30984,20700,0,Donald Hawkins,G,dead_cap,new-york-jets,20700,2016
30985,20700,0,Martin Wallace,LT,dead_cap,new-york-jets,20700,2016
30986,20700,0,Wendell Williams,WR,dead_cap,new-york-jets,20700,2016
30987,20700,0,Kyle Friend,T,dead_cap,new-york-jets,20700,2016
30988,19800,0,Zach Sterup,T,dead_cap,new-york-jets,19800,2016
30989,0,15562,Tommy Bohanon,FB,dead_cap,new-york-jets,15562,2016
30990,0,14212,Trevor Reilly,OLB,dead_cap,new-york-jets,14212,2016
30991,13800,0,Brandon Burks,RB,dead_cap,new-york-jets,13800,2016
30992,13800,0,Jesse Davis,T,dead_cap,new-york-jets,13800,2016
30993,13800,0,Jason Vander Laan,TE,dead_cap,new-york-jets,13800,2016
30994,6900,5000,Chandler Worthy,WR,dead_cap,new-york-jets,11900,2016
30995,0,10000,Davon Walls,DT,dead_cap,new-york-jets,10000,2016
30996,0,7000,Dri Archer,RB,dead_cap,new-york-jets,7000,2016
30997,6900,0,Reshard Cliett,OLB,dead_cap,new-york-jets,6900,2016
30998,6900,0,Michael Liedtke,G,dead_cap,new-york-jets,6900,2016
30999,6900,0,M.J. McFarland,TE,dead_cap,new-york-jets,6900,2016
31000,6900,0,Raheem Mostert,RB,dead_cap,new-york-jets,6900,2016
31001,6900,0,Jarrod Pughsley,LT,dead_cap,new-york-jets,6900,2016
31002,0,6667,Wes Saxton,TE,dead_cap,new-york-jets,6667,2016
31003,0,5667,Durell Eskridge,FS,dead_cap,new-york-jets,5667,2016
31004,0,2667,Deion Barnes,DE,dead_cap,new-york-jets,2667,2016
31005,0,1666,Tom Hackett,P,dead_cap,new-york-jets,1666,2016
31006,0,1666,Ross Martin,K,dead_cap,new-york-jets,1666,2016
31007,0,1334,Jordan Williams,DT,dead_cap,new-york-jets,1334,2016
31008,0,333,Quenton Bundrage,WR,dead_cap,new-york-jets,333,2016
31009,14750000,3250000,Muhammad Wilkerson,DE,active,new-york-jets,18000000,2017
31010,6000000,2500000,Buster Skrine,CB,active,new-york-jets,8500000,2017
31011,4450000,2355000,James Carpenter,G,active,new-york-jets,6805000,2017
31012,615000,4466146,Leonard Williams,DE,active,new-york-jets,5081146,2017
31013,1500000,3500000,Kelvin Beachum,LT,active,new-york-jets,5000000,2017
31014,2500000,2218750,Morris Claiborne,CB,active,new-york-jets,4718750,2017
31015,3750000,883333,Bilal Powell,RB,active,new-york-jets,4633333,2017
31016,2000000,2250000,Benjamin Ijalana,RT,active,new-york-jets,4250000,2017
31017,465000,3582038,Jamal Adams,SS,active,new-york-jets,4047038,2017
31018,2875000,1171875,Steve McLendon,DT,active,new-york-jets,4046875,2017
31019,2746000,0,Wesley Johnson,C,active,new-york-jets,2746000,2017
31020,914620,1408481,Darron Lee,ILB,active,new-york-jets,2323101,2017
31021,900000,1325000,Demario Davis,ILB,active,new-york-jets,2225000,2017
31022,2200000,0,Jermaine Kearse,WR,active,new-york-jets,2200000,2017
31023,1550000,375000,Josh Martin,OLB,active,new-york-jets,1925000,2017
31024,465000,726643,Marcus Maye,FS,active,new-york-jets,1191643,2017
31025,661832,397327,Christian Hackenberg,QB,active,new-york-jets,1059159,2017
31026,936690,75000,Austin Seferian-Jenkins,TE,active,new-york-jets,1011690,2017
31027,690000,221875,Mike Pennel,DE,active,new-york-jets,911875,2017
31028,900000,0,Chandler Catanzaro,K,active,new-york-jets,900000,2017
31029,700000,131250,Jonotthan Harrison,C,active,new-york-jets,831250,2017
31030,803660,0,Kony Ealy,DE,active,new-york-jets,803660,2017
31031,775000,0,Julian Stanford,OLB,active,new-york-jets,775000,2017
31032,690000,75146,Dakota Dozier,G,active,new-york-jets,765146,2017
31033,615000,138424,Bryce Petty,QB,active,new-york-jets,753424,2017
31034,560000,180980,Jordan Jenkins,OLB,active,new-york-jets,740980,2017
31035,705000,0,Terrence Brooks,FS,active,new-york-jets,705000,2017
31036,540000,137782,Juston Burris,CB,active,new-york-jets,677782,2017
31037,465000,211581,ArDarius Stewart,WR,active,new-york-jets,676581,2017
31038,775000,0,Bruce Carter,ILB,active,new-york-jets,775000,2017
31039,615000,0,Rontez Miles,FS,active,new-york-jets,615000,2017
31040,615000,0,Brent Qvale,RT,active,new-york-jets,615000,2017
31041,615000,0,Darryl Roberts,CB,active,new-york-jets,615000,2017
31042,540000,58991,Brandon Shell,T,active,new-york-jets,598991,2017
31043,465000,104912,Chad Hansen,WR,active,new-york-jets,569912,2017
31044,540000,18948,Lac Edwards,P,active,new-york-jets,558948,2017
31045,540000,3333,Robby Anderson,WR,active,new-york-jets,543333,2017
31046,683824,0,David Bass,DE,active,new-york-jets,683824,2017
31047,540000,0,Eric Tomlinson,TE,active,new-york-jets,540000,2017
31048,465000,42126,Elijah McGuire,RB,active,new-york-jets,507126,2017
31049,465000,36261,Derrick Jones,CB,active,new-york-jets,501261,2017
31050,470294,0,Obum Gwacham,DE,active,new-york-jets,470294,2017
31051,465000,0,Thomas Hennessy,LS,active,new-york-jets,465000,2017
31052,437647,0,Lawrence Thomas,DE,active,new-york-jets,437647,2017
31053,412941,0,Freddie Bishop,OLB,active,new-york-jets,412941,2017
31054,375522,37103,Jeremy Clark,CB,active,new-york-jets,412625,2017
31055,361765,0,Neal Sterling,TE,active,new-york-jets,361765,2017
31056,325588,0,Xavier Cooper,DE,active,new-york-jets,325588,2017
31057,285882,0,Rashard Robinson,CB,active,new-york-jets,285882,2017
31058,218824,0,Jojo Natson,WR,active,new-york-jets,218824,2017
31059,36176,0,Deon Simon,DT,active,new-york-jets,36176,2017
31060,36176,0,Lucky Whitehead,WR,active,new-york-jets,36176,2017
31061,27353,0,Jahad Thomas,RB,active,new-york-jets,27353,2017
31062,1000000,7000000,Brian Winters,G,injured_reserve,new-york-jets,8000000,2017
31063,3000000,3500000,Josh McCown,QB,injured_reserve,new-york-jets,6500000,2017
31064,4000000,1000000,Matt Forte,RB,injured_reserve,new-york-jets,5000000,2017
31065,968857,632712,Devin Smith,WR,injured_reserve,new-york-jets,1601569,2017
31066,633000,168504,Lorenzo Mauldin,OLB,injured_reserve,new-york-jets,801504,2017
31067,615000,0,Quincy Enunwa,WR,injured_reserve,new-york-jets,615000,2017
31068,403054,70511,Jordan Leggett,TE,injured_reserve,new-york-jets,473565,2017
31069,375529,50484,Dylan Donahue,OLB,injured_reserve,new-york-jets,426013,2017
31070,418000,0,Chris Gragg,TE,injured_reserve,new-york-jets,418000,2017
31071,394236,17095,Charone Peake,WR,injured_reserve,new-york-jets,411331,2017
31072,363000,0,Doug Middleton,S,injured_reserve,new-york-jets,363000,2017
31073,348000,1666,Brisly Estime,WR,injured_reserve,new-york-jets,349666,2017
31074,348000,0,Bryson Keeton,CB,injured_reserve,new-york-jets,348000,2017
31075,328235,0,Xavier Coleman,CB,injured_reserve,new-york-jets,328235,2017
31076,82059,0,Akeem Judd,RB,injured_reserve,new-york-jets,82059,2017
31077,5647059,0,Darrelle Revis,CB,dead_cap,new-york-jets,5647059,2017
31078,0,5000000,Ryan Fitzpatrick,QB,dead_cap,new-york-jets,5000000,2017
31079,0,1500000,Eric Decker,WR,dead_cap,new-york-jets,1500000,2017
31080,0,1136955,Calvin Pryor,FS,dead_cap,new-york-jets,1136955,2017
31081,0,750000,Jarvis Jenkins,DE,dead_cap,new-york-jets,750000,2017
31082,646118,0,Marcus Williams,CB,dead_cap,new-york-jets,646118,2017
31083,0,625000,Breno Giacomini,RT,dead_cap,new-york-jets,625000,2017
31084,0,625000,Marcus Gilchrist,SS,dead_cap,new-york-jets,625000,2017
31085,0,593334,Nick Folk,K,dead_cap,new-york-jets,593334,2017
31086,542647,0,Edmond Robinson,OLB,dead_cap,new-york-jets,542647,2017
31087,0,500000,Ryan Clady,LT,dead_cap,new-york-jets,500000,2017
31088,0,360544,Jace Amaro,TE,dead_cap,new-york-jets,360544,2017
31089,272329,0,Robert Nelson,CB,dead_cap,new-york-jets,272329,2017
31090,162353,0,Ed Stinson,DE,dead_cap,new-york-jets,162353,2017
31091,0,149719,Dexter McDougle,CB,dead_cap,new-york-jets,149719,2017
31092,182353,0,Travaris Cadet,RB,dead_cap,new-york-jets,182353,2017
31093,144704,0,Neal Sterling,TE,dead_cap,new-york-jets,144704,2017
31094,144704,0,Will Tye,TE,dead_cap,new-york-jets,144704,2017
31095,142553,0,Claude Pelon,DE,dead_cap,new-york-jets,142553,2017
31096,122400,0,Benjamin Braden,T,dead_cap,new-york-jets,122400,2017
31097,122400,0,Terrell Sinkfield,WR,dead_cap,new-york-jets,122400,2017
31098,122400,0,Damore'ea Stringfellow,WR,dead_cap,new-york-jets,122400,2017
31099,115200,0,Deon Simon,DT,dead_cap,new-york-jets,115200,2017
31100,110965,2666,Jalin Marshall,WR,dead_cap,new-york-jets,113631,2017
31101,100800,0,Geoff Gray,T,dead_cap,new-york-jets,100800,2017
31102,45588,40000,Corey Lemonier,OLB,dead_cap,new-york-jets,85588,2017
31103,0,80000,Bruce Carter,ILB,dead_cap,new-york-jets,80000,2017
31104,0,80000,Tanner Purdum,LS,dead_cap,new-york-jets,80000,2017
31105,72176,0,Lucky Whitehead,WR,dead_cap,new-york-jets,72176,2017
31106,70730,0,Kalif Raymond,WR,dead_cap,new-york-jets,70730,2017
31107,64800,0,Jojo Natson,WR,dead_cap,new-york-jets,64800,2017
31108,50400,0,Akeem Judd,RB,dead_cap,new-york-jets,50400,2017
31109,38965,2500,Freddie Bishop,OLB,dead_cap,new-york-jets,41465,2017
31110,40000,0,K.D. Cannon,WR,dead_cap,new-york-jets,40000,2017
31111,36000,0,Xavier Coleman,CB,dead_cap,new-york-jets,36000,2017
31112,36000,0,Tre McBride,WR,dead_cap,new-york-jets,36000,2017
31113,28800,0,Jeremy Cash,OLB,dead_cap,new-york-jets,28800,2017
31114,28800,0,Jeremy Langford,RB,dead_cap,new-york-jets,28800,2017
31115,28800,0,Marcus Murphy,RB,dead_cap,new-york-jets,28800,2017
31116,0,25000,Quinton Patton,WR,dead_cap,new-york-jets,25000,2017
31117,21600,0,Zach Conque,TE,dead_cap,new-york-jets,21600,2017
31118,21600,0,Korren Kirven,T,dead_cap,new-york-jets,21600,2017
31119,21600,0,Joel Stave,QB,dead_cap,new-york-jets,21600,2017
31120,21600,0,Jahad Thomas,RB,dead_cap,new-york-jets,21600,2017
31121,0,20000,Corey White,CB,dead_cap,new-york-jets,20000,2017
31122,14400,0,Michael Hunter,CB,dead_cap,new-york-jets,14400,2017
31123,0,14212,Trevor Reilly,OLB,dead_cap,new-york-jets,14212,2017
31124,7200,5000,Lawrence Thomas,DE,dead_cap,new-york-jets,12200,2017
31125,0,10000,Jarvis Harrison,G,dead_cap,new-york-jets,10000,2017
31126,0,10000,Doug Middleton,S,dead_cap,new-york-jets,10000,2017
31127,7200,0,Frank Beltre,OLB,dead_cap,new-york-jets,7200,2017
31128,7200,0,Harold Jones-Quartey,SS,dead_cap,new-york-jets,7200,2017
31129,7200,0,Francis Kallon,DE,dead_cap,new-york-jets,7200,2017
31130,7200,0,Daniel Williams,WR,dead_cap,new-york-jets,7200,2017
31131,0,5000,Dominique Williams,RB,dead_cap,new-york-jets,5000,2017
31132,0,5000,Chandler Worthy,WR,dead_cap,new-york-jets,5000,2017
31133,0,3334,Tom Hackett,P,dead_cap,new-york-jets,3334,2017
31134,0,3334,Ross Martin,K,dead_cap,new-york-jets,3334,2017
31135,0,1000,Julien Obioha,DE,dead_cap,new-york-jets,1000,2017
31136,0,667,Quenton Bundrage,WR,dead_cap,new-york-jets,667,2017
31137,6000000,4000000,Trumaine Johnson,CB,active,new-york-jets,10000000,2018
31138,5000000,5000000,Josh McCown,QB,active,new-york-jets,10000000,2018
31139,8000000,1500000,Kelvin Beachum,LT,active,new-york-jets,9500000,2018
31140,6000000,2500000,Buster Skrine,CB,active,new-york-jets,8500000,2018
31141,7000000,0,Brian Winters,G,active,new-york-jets,7000000,2018
31142,5000000,1937500,Spencer Long,C,active,new-york-jets,6937500,2018
31143,4000000,2000000,Avery Williamson,ILB,active,new-york-jets,6000000,2018
31144,2975572,2952431,Leonard Williams,DE,active,new-york-jets,5928003,2018
31145,5000000,550000,Jermaine Kearse,WR,active,new-york-jets,5550000,2018
31146,480000,5019584,Sam Darnold,QB,active,new-york-jets,5499584,2018
31147,555000,4503802,Jamal Adams,SS,active,new-york-jets,5058802,2018
31148,3125000,1250000,Steve McLendon,DT,active,new-york-jets,4375000,2018
31149,1500000,1333333,Mike Pennel,DE,active,new-york-jets,2833333,2018
31150,1907000,0,Henry Anderson,DE,active,new-york-jets,1907000,2018
31151,1907000,0,Brent Qvale,RT,active,new-york-jets,1907000,2018
31152,1400000,500000,Terrence Brooks,FS,active,new-york-jets,1900000,2018
31153,1000000,200000,Brandon Copeland,DE,active,new-york-jets,1200000,2018
31154,650000,180980,Jordan Jenkins,OLB,active,new-york-jets,830980,2018
31155,480000,246931,Nathan Shepherd,DE,active,new-york-jets,726931,2018
31156,915000,90000,Andre Roberts,WR,active,new-york-jets,1005000,2018
31157,790000,90000,Dakota Dozier,G,active,new-york-jets,880000,2018
31158,790000,90000,Jonotthan Harrison,C,active,new-york-jets,880000,2018
31159,705000,0,Neville Hewitt,OLB,active,new-york-jets,705000,2018
31160,705000,0,Jason Myers,K,active,new-york-jets,705000,2018
31161,705000,0,Darryl Roberts,CB,active,new-york-jets,705000,2018
31162,480000,177841,Chris Herndon,TE,active,new-york-jets,657841,2018
31163,630000,18948,Lac Edwards,P,active,new-york-jets,648948,2018
31164,630000,17095,Charone Peake,WR,active,new-york-jets,647095,2018
31165,630000,3334,Robby Anderson,WR,active,new-york-jets,633334,2018
31166,555000,70511,Jordan Leggett,TE,active,new-york-jets,625511,2018
31167,555000,36261,Derrick Jones,CB,active,new-york-jets,591261,2018
31168,555000,0,Thomas Hennessy,LS,active,new-york-jets,555000,2018
31169,480000,44370,Parry Nickerson,CB,active,new-york-jets,524370,2018
31170,480000,43563,Foley Fatukasi,DT,active,new-york-jets,523563,2018
31171,480000,34806,Trenton Cannon,RB,active,new-york-jets,514806,2018
31172,471689,42126,Elijah McGuire,RB,active,new-york-jets,513815,2018
31173,481764,0,Rashard Robinson,CB,active,new-york-jets,481764,2018
31174,480000,0,Frankie Luvu,LB,active,new-york-jets,480000,2018
31175,451176,0,Tarell Basham,OLB,active,new-york-jets,451176,2018
31176,310585,0,Deontay Burnett,WR,active,new-york-jets,310585,2018
31177,261176,0,Davis Webb,QB,active,new-york-jets,261176,2018
31178,163235,0,Jeremy Clark,CB,active,new-york-jets,163235,2018
31179,141175,0,Benjamin Braden,T,active,new-york-jets,141175,2018
31180,130588,0,Bronson Kaufusi,DE,active,new-york-jets,130588,2018
31181,97941,0,De'Angelo Henderson,RB,active,new-york-jets,97941,2018
31182,74118,0,Emmanuel Lamur,OLB,active,new-york-jets,74118,2018
31183,56470,0,Eric Smith,T,active,new-york-jets,56470,2018
31184,56470,0,Anthony Wint,LB,active,new-york-jets,56470,2018
31185,41471,0,Clive Walford,TE,active,new-york-jets,41471,2018
31186,37059,0,Destiny Vaeao,DT,active,new-york-jets,37059,2018
31187,28235,0,Brandon Bryant,CB,active,new-york-jets,28235,2018
31188,28235,0,J.J. Jones,WR,active,new-york-jets,28235,2018
31189,3850000,3140625,Morris Claiborne,CB,injured_reserve,new-york-jets,6990625,2018
31190,4450000,2261250,James Carpenter,G,injured_reserve,new-york-jets,6711250,2018
31191,4000000,883334,Bilal Powell,RB,injured_reserve,new-york-jets,4883334,2018
31192,2914000,1800000,Quincy Enunwa,WR,injured_reserve,new-york-jets,4714000,2018
31193,1900000,500000,Benjamin Ijalana,RT,injured_reserve,new-york-jets,2400000,2018
31194,1411765,845588,Kevin Pierre-Louis,OLB,injured_reserve,new-york-jets,2257353,2018
31195,1800000,375000,Josh Martin,OLB,injured_reserve,new-york-jets,2175000,2018
31196,1000000,1000000,Isaiah Crowell,RB,injured_reserve,new-york-jets,2000000,2018
31197,1907000,0,Neal Sterling,TE,injured_reserve,new-york-jets,1907000,2018
31198,762911,726643,Marcus Maye,FS,injured_reserve,new-york-jets,1489554,2018
31199,790000,431250,Jeremiah Attaochu,OLB,injured_reserve,new-york-jets,1221250,2018
31200,630000,58991,Brandon Shell,RT,injured_reserve,new-york-jets,688991,2018
31201,630000,0,Eric Tomlinson,TE,injured_reserve,new-york-jets,630000,2018
31202,555000,0,Doug Middleton,FS,injured_reserve,new-york-jets,555000,2018
31203,538235,0,Rishard Matthews,WR,injured_reserve,new-york-jets,538235,2018
31204,98800,0,Harvey Langi,ILB,injured_reserve,new-york-jets,98800,2018
31205,0,9000000,Muhammad Wilkerson,DE,dead_cap,new-york-jets,9000000,2018
31206,3000000,1187500,Terrelle Pryor,WR,dead_cap,new-york-jets,4187500,2018
31207,0,1500000,Eric Decker,WR,dead_cap,new-york-jets,1500000,2018
31208,0,1250000,Benjamin Ijalana,RT,dead_cap,new-york-jets,1250000,2018
31209,1000000,78125,J.J. Wilcox,FS,dead_cap,new-york-jets,1078125,2018
31210,0,1000000,Matt Forte,RB,dead_cap,new-york-jets,1000000,2018
31211,0,1000000,Teddy Bridgewater,QB,dead_cap,new-york-jets,1000000,2018
31212,0,794657,Christian Hackenberg,QB,dead_cap,new-york-jets,794657,2018
31213,0,632714,Devin Smith,WR,dead_cap,new-york-jets,632714,2018
31214,0,625000,Marcus Gilchrist,SS,dead_cap,new-york-jets,625000,2018
31215,0,500000,Cairo Santos,K,dead_cap,new-york-jets,500000,2018
31216,0,500000,Charles Johnson,WR,dead_cap,new-york-jets,500000,2018
31217,324072,137782,Juston Burris,CB,dead_cap,new-york-jets,461854,2018
31218,0,350000,Travis Swanson,C,dead_cap,new-york-jets,350000,2018
31219,338821,0,Benjamin Braden,T,dead_cap,new-york-jets,338821,2018
31220,320294,0,Davis Webb,QB,dead_cap,new-york-jets,320294,2018
31221,258247,0,De'Angelo Henderson,RB,dead_cap,new-york-jets,258247,2018
31222,15200,211581,ArDarius Stewart,WR,dead_cap,new-york-jets,226781,2018
31223,188800,0,Bronson Kaufusi,DE,dead_cap,new-york-jets,188800,2018
31224,171600,6666,Brandon Bryant,CB,dead_cap,new-york-jets,178266,2018
31225,0,168506,Lorenzo Mauldin,OLB,dead_cap,new-york-jets,168506,2018
31226,153235,0,NIco Falah,C,dead_cap,new-york-jets,153235,2018
31227,0,138425,Bryce Petty,QB,dead_cap,new-york-jets,138425,2018
31228,91200,37103,Jeremy Clark,CB,dead_cap,new-york-jets,128303,2018
31229,121600,0,Dieugot Joseph,T,dead_cap,new-york-jets,121600,2018
31230,114000,0,Anthony Wint,LB,dead_cap,new-york-jets,114000,2018
31231,0,104912,Chad Hansen,WR,dead_cap,new-york-jets,104912,2018
31232,98800,0,Harvey Langi,ILB,dead_cap,new-york-jets,98800,2018
31233,0,90000,David Bass,DE,dead_cap,new-york-jets,90000,2018
31234,0,90000,Kevin Minter,ILB,dead_cap,new-york-jets,90000,2018
31235,68400,0,J.J. Jones,WR,dead_cap,new-york-jets,68400,2018
31236,0,50484,Dylan Donahue,OLB,dead_cap,new-york-jets,50484,2018
31237,41471,0,Ibraheim Campbell,SS,dead_cap,new-york-jets,41471,2018
31238,38000,0,Mark Thompson,RB,dead_cap,new-york-jets,38000,2018
31239,38000,0,Destiny Vaeao,DT,dead_cap,new-york-jets,38000,2018
31240,38000,0,Deontay Burnett,WR,dead_cap,new-york-jets,38000,2018
31241,0,27000,Antonio Garcia,T,dead_cap,new-york-jets,27000,2018
31242,22800,0,Joel Bouganon,RB,dead_cap,new-york-jets,22800,2018
31243,22800,0,Jonathan Celestin,LB,dead_cap,new-york-jets,22800,2018
31244,15200,0,Charlie Miller,S,dead_cap,new-york-jets,15200,2018
31245,15200,0,DeAngelo Yancey,WR,dead_cap,new-york-jets,15200,2018
31246,0,5000,Lawrence Thomas,DE,dead_cap,new-york-jets,5000,2018
31247,0,3334,Brisly Estime,WR,dead_cap,new-york-jets,3334,2018
31248,0,2668,Jalin Marshall,WR,dead_cap,new-york-jets,2668,2018
31249,8000000,1500000,Kelvin Beachum,LT,active,new-york-jets,9500000,2019
31250,2000000,6968750,Le'Veon Bell,RB,active,new-york-jets,8968750,2019
31251,2000000,5833333,Henry Anderson,DE,active,new-york-jets,7833333,2019
31252,1500000,5500000,Jamison Crowder,WR,active,new-york-jets,7000000,2019
31253,570000,6304479,Sam Darnold,QB,active,new-york-jets,6874479,2019
31254,645000,5425566,Jamal Adams,SS,active,new-york-jets,6070566,2019
31255,495000,5419431,Quinnen Williams,DT,active,new-york-jets,5914431,2019
31256,1000000,3406250,Darryl Roberts,CB,active,new-york-jets,4406250,2019
31257,1000000,2500000,Brian Poole,CB,active,new-york-jets,3500000,2019
31258,3095000,0,Robby Anderson,WR,active,new-york-jets,3095000,2019
31259,1500000,1250000,Jonotthan Harrison,C,active,new-york-jets,2750000,2019
31260,1411765,1116625,Demaryius Thomas,WR,active,new-york-jets,2528390,2019
31261,1100000,1325000,Steve McLendon,DT,active,new-york-jets,2425000,2019
31262,2025000,180980,Jordan Jenkins,OLB,active,new-york-jets,2205980,2019
31263,2025000,58993,Brandon Shell,RT,active,new-york-jets,2083993,2019
31264,1060822,726643,Marcus Maye,FS,active,new-york-jets,1787465,2019
31265,1000000,500000,Neville Hewitt,ILB,active,new-york-jets,1500000,2019
31266,1147059,191176,Brandon Copeland,DE,active,new-york-jets,1338235,2019
31267,1000000,268750,Brent Qvale,RT,active,new-york-jets,1268750,2019
31268,645000,125000,Thomas Hennessy,LS,active,new-york-jets,770000,2019
31269,720000,18951,Lac Edwards,P,active,new-york-jets,738951,2019
31270,930000,90000,Bilal Powell,RB,active,new-york-jets,1020000,2019
31271,805000,90000,Daniel Brown,TE,active,new-york-jets,895000,2019
31272,805000,90000,Ty Montgomery,RB,active,new-york-jets,895000,2019
31273,720000,0,Matthias Farley,SS,active,new-york-jets,720000,2019
31274,710353,0,Jordan Willis,DE,active,new-york-jets,710353,2019
31275,687500,0,Tarell Basham,OLB,active,new-york-jets,687500,2019
31276,424472,246931,Nathan Shepherd,DE,active,new-york-jets,671403,2019
31277,495000,175971,Trevon Wesco,FB,active,new-york-jets,670971,2019
31278,645000,0,Nate Hairston,CB,active,new-york-jets,645000,2019
31279,570000,43563,Foley Fatukasi,DT,active,new-york-jets,613563,2019
31280,570000,0,Harvey Langi,ILB,active,new-york-jets,570000,2019
31281,495000,1666,Kyle Phillips,DE,active,new-york-jets,496666,2019
31282,495000,0,Braxton Berrios,WR,active,new-york-jets,495000,2019
31283,615588,0,David Fales,QB,active,new-york-jets,615588,2019
31284,493233,0,Conor McDermott,T,active,new-york-jets,493233,2019
31285,423529,65000,Blake Countess,S,active,new-york-jets,488529,2019
31286,469412,0,Vyncint Smith,WR,active,new-york-jets,469412,2019
31287,465882,0,Sam Ficken,K,active,new-york-jets,465882,2019
31288,402353,40743,Blessuan Austin,CB,active,new-york-jets,443096,2019
31289,379410,0,James Burgess,ILB,active,new-york-jets,379410,2019
31290,341471,0,Arthur Maulet,CB,active,new-york-jets,341471,2019
31291,338824,0,Maurice Canady,CB,active,new-york-jets,338824,2019
31292,378824,0,Paul Worrilow,OLB,active,new-york-jets,378824,2019
31293,301761,0,Frankie Luvu,LB,active,new-york-jets,301761,2019
31294,268235,0,Josh Adams,RB,active,new-york-jets,268235,2019
31295,265588,0,B.J. Bello,ILB,active,new-york-jets,265588,2019
31296,265588,0,Leo Koloamatangi,T,active,new-york-jets,265588,2019
31297,116471,0,Bennett Jackson,CB,active,new-york-jets,116471,2019
31298,75882,0,Josh Malone,WR,active,new-york-jets,75882,2019
31299,67059,0,Kenneth Dixon,RB,active,new-york-jets,67059,2019
31300,33529,0,Ross Travis,TE,active,new-york-jets,33529,2019
31301,29118,0,Benjamin Braden,T,active,new-york-jets,29118,2019
31302,1000000,12000000,C.J. Mosley,ILB,injured_reserve,new-york-jets,13000000,2019
31303,8000000,4000000,Trumaine Johnson,CB,injured_reserve,new-york-jets,12000000,2019
31304,6000000,2000000,Avery Williamson,ILB,injured_reserve,new-york-jets,8000000,2019
31305,2400000,4312500,Ryan Kalil,C,injured_reserve,new-york-jets,6712500,2019
31306,6000000,281250,Brian Winters,G,injured_reserve,new-york-jets,6281250,2019
31307,1000000,1800000,Quincy Enunwa,WR,injured_reserve,new-york-jets,2800000,2019
31308,930000,1820000,Josh Bellamy,WR,injured_reserve,new-york-jets,2750000,2019
31309,2025000,0,Alex Lewis,G,injured_reserve,new-york-jets,2025000,2019
31310,1907000,0,Rontez Miles,FS,injured_reserve,new-york-jets,1907000,2019
31311,1410000,427500,Tom Compton,G,injured_reserve,new-york-jets,1837500,2019
31312,1000000,796875,Trevor Siemian,QB,injured_reserve,new-york-jets,1796875,2019
31313,1000000,109375,Ryan Griffin,TE,injured_reserve,new-york-jets,1109375,2019
31314,495000,216750,Chuma Edoga,T,injured_reserve,new-york-jets,711750,2019
31315,805000,0,Albert McClellan,ILB,injured_reserve,new-york-jets,805000,2019
31316,415060,177841,Chris Herndon,TE,injured_reserve,new-york-jets,592901,2019
31317,570000,0,John Franklin-Myers,DE,injured_reserve,new-york-jets,570000,2019
31318,476291,34806,Trenton Cannon,RB,injured_reserve,new-york-jets,511097,2019
31319,433349,75773,Blake Cashman,LB,injured_reserve,new-york-jets,509122,2019
31320,183177,0,Kyron Brown,CB,injured_reserve,new-york-jets,183177,2019
31321,87353,0,Jeff Smith,WR,injured_reserve,new-york-jets,87353,2019
31322,32000,0,Brandon Hitner,T,injured_reserve,new-york-jets,32000,2019
31323,136500,2333,Jalin Moore,RB,non_fb_injury,new-york-jets,138833,2019
31324,645000,0,Charles Tapper,DE,non_fb_injury,new-york-jets,645000,2019
31325,10682353,0,Leonard Williams,DE,dead_cap,new-york-jets,10682353,2019
31326,4485294,500000,Kelechi Osemele,G,dead_cap,new-york-jets,4985294,2019
31327,0,2000000,Isaiah Crowell,RB,dead_cap,new-york-jets,2000000,2019
31328,0,1666667,Mike Pennel,DE,dead_cap,new-york-jets,1666667,2019
31329,0,1325630,Darron Lee,ILB,dead_cap,new-york-jets,1325630,2019
31330,645000,0,Bronson Kaufusi,DE,dead_cap,new-york-jets,645000,2019
31331,0,500000,Chandler Catanzaro,K,dead_cap,new-york-jets,500000,2019
31332,0,500000,Kevin Pierre-Louis,OLB,dead_cap,new-york-jets,500000,2019
31333,0,423162,ArDarius Stewart,WR,dead_cap,new-york-jets,423162,2019
31334,0,300000,Terrence Brooks,FS,dead_cap,new-york-jets,300000,2019
31335,200000,100000,Eric Tomlinson,TE,dead_cap,new-york-jets,300000,2019
31336,0,280618,Jachai Polite,OLB,dead_cap,new-york-jets,280618,2019
31337,256174,0,Frankie Luvu,LB,dead_cap,new-york-jets,256174,2019
31338,243646,12000,Arthur Maulet,CB,dead_cap,new-york-jets,255646,2019
31339,225000,0,Josh Adams,RB,dead_cap,new-york-jets,225000,2019
31340,223236,0,Bennett Jackson,CB,dead_cap,new-york-jets,223236,2019
31341,0,209824,Chad Hansen,WR,dead_cap,new-york-jets,209824,2019
31342,190000,3333,Tevaughn Campbell,CB,dead_cap,new-york-jets,193333,2019
31343,179647,0,Luke Falk,QB,dead_cap,new-york-jets,179647,2019
31344,155645,0,Mark Myers,CB,dead_cap,new-york-jets,155645,2019
31345,151765,0,David Fales,QB,dead_cap,new-york-jets,151765,2019
31346,60000,90000,Neal Sterling,TE,dead_cap,new-york-jets,150000,2019
31347,141176,0,Josh Malone,WR,dead_cap,new-york-jets,141176,2019
31348,0,141023,Jordan Leggett,TE,dead_cap,new-york-jets,141023,2019
31349,0,137782,Juston Burris,CB,dead_cap,new-york-jets,137782,2019
31350,120000,0,Jeff Smith,WR,dead_cap,new-york-jets,120000,2019
31351,112000,0,Mike White,QB,dead_cap,new-york-jets,112000,2019
31352,105000,0,Calvin Anderson,T,dead_cap,new-york-jets,105000,2019
31353,0,100968,Dylan Donahue,OLB,dead_cap,new-york-jets,100968,2019
31354,88000,0,Valentine Holmes,RB,dead_cap,new-york-jets,88000,2019
31355,88000,0,Corbin Kaufusi,DE,dead_cap,new-york-jets,88000,2019
31356,84000,0,Benjamin Braden,T,dead_cap,new-york-jets,84000,2019
31357,80000,0,Kyron Brown,CB,dead_cap,new-york-jets,80000,2019
31358,0,74206,Jeremy Clark,CB,dead_cap,new-york-jets,74206,2019
31359,72000,0,Jamey Mosley,LB,dead_cap,new-york-jets,72000,2019
31360,64000,0,Ukeme Eligwe,ILB,dead_cap,new-york-jets,64000,2019
31361,64000,0,Jimmy Murray,C,dead_cap,new-york-jets,64000,2019
31362,48000,0,James Burgess,ILB,dead_cap,new-york-jets,48000,2019
31363,48000,0,Greg Dortch,WR,dead_cap,new-york-jets,48000,2019
31364,0,44370,Parry Nickerson,CB,dead_cap,new-york-jets,44370,2019
31365,0,42126,Elijah McGuire,RB,dead_cap,new-york-jets,42126,2019
31366,40000,0,Wyatt Ray,DE,dead_cap,new-york-jets,40000,2019
31367,37941,0,B.J. Bello,ILB,dead_cap,new-york-jets,37941,2019
31368,0,36262,Derrick Jones,CB,dead_cap,new-york-jets,36262,2019
31369,22235,13334,Brandon Bryant,CB,dead_cap,new-york-jets,35569,2019
31370,33529,0,Kaare Vedvik,K,dead_cap,new-york-jets,33529,2019
31371,32000,0,Ryan Crozier,G,dead_cap,new-york-jets,32000,2019
31372,32000,0,Brandon Hitner,T,dead_cap,new-york-jets,32000,2019
31373,24000,0,Ian Bunting,TE,dead_cap,new-york-jets,24000,2019
31374,24000,0,Brad Lundblade,C,dead_cap,new-york-jets,24000,2019
31375,0,17097,Charone Peake,WR,dead_cap,new-york-jets,17097,2019
31376,16000,0,Ahmad Gooden,DE,dead_cap,new-york-jets,16000,2019
31377,16000,0,Keon Hatcher,WR,dead_cap,new-york-jets,16000,2019
31378,16000,0,Leo Koloamatangi,T,dead_cap,new-york-jets,16000,2019
31379,0,3333,Tim White,WR,dead_cap,new-york-jets,3333,2019
31380,6000000,11500000,C.J. Mosley,ILB,active,new-york-jets,17500000,2020
31381,8500000,6968750,Le'Veon Bell,RB,active,new-york-jets,15468750,2020
31382,11000000,4000000,Trumaine Johnson,CB,active,new-york-jets,15000000,2020
31383,8500000,1500000,Jamison Crowder,WR,active,new-york-jets,10000000,2020
31384,6500000,2000000,Avery Williamson,ILB,active,new-york-jets,8500000,2020
31385,7000000,1333333,Henry Anderson,DE,active,new-york-jets,8333333,2020
31386,660000,7589374,Sam Darnold,QB,active,new-york-jets,8249374,2020
31387,6000000,1800000,Quincy Enunwa,WR,active,new-york-jets,7800000,2020
31388,1973608,5419431,Quinnen Williams,DT,active,new-york-jets,7393039,2020
31389,7000000,281250,Brian Winters,G,active,new-york-jets,7281250,2020
31390,735000,6347332,Jamal Adams,SS,active,new-york-jets,7082332,2020
31391,5000000,812500,Darryl Roberts,CB,active,new-york-jets,5812500,2020
31392,1250000,1575000,Steve McLendon,DT,active,new-york-jets,2825000,2020
31393,2250000,0,Josh Bellamy,WR,active,new-york-jets,2250000,2020
31394,2000000,250000,Jonotthan Harrison,C,active,new-york-jets,2250000,2020
31395,1358733,726645,Marcus Maye,FS,active,new-york-jets,2085378,2020
31396,818000,246931,Nathan Shepherd,DE,active,new-york-jets,1064931,2020
31397,765000,125000,Thomas Hennessy,LS,active,new-york-jets,890000,2020
31398,820000,65000,Blake Countess,S,active,new-york-jets,885000,2020
31399,652000,216750,Chuma Edoga,T,active,new-york-jets,868750,2020
31400,865250,0,Jordan Willis,DE,active,new-york-jets,865250,2020
31401,660000,177841,Chris Herndon,TE,active,new-york-jets,837841,2020
31402,777500,0,Tarell Basham,OLB,active,new-york-jets,777500,2020
31403,585000,175971,Trevon Wesco,FB,active,new-york-jets,760971,2020
31404,735000,0,Nate Hairston,CB,active,new-york-jets,735000,2020
31405,735000,0,Conor McDermott,T,active,new-york-jets,735000,2020
31406,735000,0,Charles Tapper,DE,active,new-york-jets,735000,2020
31407,735000,0,Ross Travis,TE,active,new-york-jets,735000,2020
31408,660000,43563,Foley Fatukasi,DT,active,new-york-jets,703563,2020
31409,660000,34806,Trenton Cannon,RB,active,new-york-jets,694806,2020
31410,585000,75773,Blake Cashman,LB,active,new-york-jets,660773,2020
31411,660000,0,Josh Adams,RB,active,new-york-jets,660000,2020
31412,660000,0,Braxton Berrios,WR,active,new-york-jets,660000,2020
31413,660000,0,Kenneth Dixon,RB,active,new-york-jets,660000,2020
31414,660000,0,John Franklin-Myers,DE,active,new-york-jets,660000,2020
31415,660000,0,Harvey Langi,ILB,active,new-york-jets,660000,2020
31416,660000,0,Vyncint Smith,WR,active,new-york-jets,660000,2020
31417,585000,40743,Blessuan Austin,CB,active,new-york-jets,625743,2020
31418,585000,1666,Kyle Phillips,DE,active,new-york-jets,586666,2020
31419,585000,0,Benjamin Braden,T,active,new-york-jets,585000,2020
31420,585000,0,Kyron Brown,CB,active,new-york-jets,585000,2020
31421,510000,2333,Jalin Moore,RB,active,new-york-jets,512333,2020
31422,0,0,Ian Berryman,P,active,new-york-jets,0,2020
31423,0,0,Jehu Chesson,WR,active,new-york-jets,0,2020
31424,0,0,Ahmad Gooden,DE,active,new-york-jets,0,2020
31425,0,0,Ryan Griffin,TE,active,new-york-jets,0,2020
31426,0,0,Keon Hatcher,WR,active,new-york-jets,0,2020
31427,0,0,Bronson Kaufusi,DE,active,new-york-jets,0,2020
31428,0,0,Corbin Kaufusi,DE,active,new-york-jets,0,2020
31429,0,0,Brad Lundblade,C,active,new-york-jets,0,2020
31430,0,0,Brett Maher,K,active,new-york-jets,0,2020
31431,0,0,Jimmy Murray,C,active,new-york-jets,0,2020
31432,0,0,Wyatt Ray,DE,active,new-york-jets,0,2020
31433,0,0,Mike White,QB,active,new-york-jets,0,2020
31434,0,841854,Jachai Polite,OLB,dead_cap,new-york-jets,841854,2020
31435,0,88740,Parry Nickerson,CB,dead_cap,new-york-jets,88740,2020
31436,0,42128,Elijah McGuire,RB,dead_cap,new-york-jets,42128,2020
31437,0,36264,Derrick Jones,CB,dead_cap,new-york-jets,36264,2020
31438,0,6667,Tevaughn Campbell,CB,dead_cap,new-york-jets,6667,2020
31439,0,6667,Tim White,WR,dead_cap,new-york-jets,6667,2020
31440,2000000,6233336,Robert Gallery,T,active,oakland-raiders,8233336,2007
31441,4800000,750000,Warren Sapp,DT,active,oakland-raiders,5550000,2007
31442,1000000,1400000,Jerry Porter,WR,active,oakland-raiders,2400000,2007
31443,2976320,0,JaMarcus Russell,QB,active,oakland-raiders,2976320,2007
31444,360000,4740000,Michael Huff,S,active,oakland-raiders,5100000,2007
31445,595000,0,Gerard Warren,DT,active,oakland-raiders,595000,2007
31446,2000000,0,Josh McCown,QB,active,oakland-raiders,2000000,2007
31447,1500000,500000,Dominic Rhodes,RB,active,oakland-raiders,2000000,2007
31448,1350000,862833,Sebastian Janikowski,K,active,oakland-raiders,2212833,2007
31449,1000000,882857,Shane Lechler,P,active,oakland-raiders,1882857,2007
31450,1200000,175000,Cooper Carlisle,G,active,oakland-raiders,1375000,2007
31451,1230000,563333,Nnamdi Asomugha,CB,active,oakland-raiders,1793333,2007
31452,548375,1975150,Fabian Washington,CB,active,oakland-raiders,2523525,2007
31453,970000,640000,Tyler Brayton,DT,active,oakland-raiders,1610000,2007
31454,1500000,0,Jeremy Newberry,C,active,oakland-raiders,1500000,2007
31455,435000,762900,Stanford Routt,CB,active,oakland-raiders,1197900,2007
31456,360000,1100000,Thomas Howard,LB,active,oakland-raiders,1460000,2007
31457,720000,0,Travis Taylor,WR,active,oakland-raiders,720000,2007
31458,435000,197000,Andrew Walter,QB,active,oakland-raiders,632000,2007
31459,435000,177600,Kirk Morrison,LB,active,oakland-raiders,612600,2007
31460,360000,198750,Paul McQuistan,LT,active,oakland-raiders,558750,2007
31461,285000,241250,Zach Miller,TE,active,oakland-raiders,526250,2007
31462,285000,158500,Mario Henderson,T,active,oakland-raiders,443500,2007
31463,295000,145000,Johnnie Lee Higgins,WR,active,oakland-raiders,440000,2007
31464,435000,1667,Chris Carr,CB,active,oakland-raiders,436667,2007
31465,720000,0,Duane Starks,CB,active,oakland-raiders,720000,2007
31466,435000,0,Chris Clemons,DE,active,oakland-raiders,435000,2007
31467,435000,0,Chris Johnson,CB,active,oakland-raiders,435000,2007
31468,285000,125000,Michael Bush,RB,active,oakland-raiders,410000,2007
31469,285000,116250,John Bowie,CB,active,oakland-raiders,401250,2007
31470,385000,0,Ben Claxton,C,active,oakland-raiders,385000,2007
31471,360000,0,Jon Alston,LB,active,oakland-raiders,360000,2007
31472,360000,0,Ricky Brown,LB,active,oakland-raiders,360000,2007
31473,360000,0,Jon Condo,LS,active,oakland-raiders,360000,2007
31474,360000,0,Chris Morris,C,active,oakland-raiders,360000,2007
31475,285000,48500,Jay Richardson,DE,active,oakland-raiders,333500,2007
31476,285000,29000,Oren O'Neal,FB,active,oakland-raiders,314000,2007
31477,190000,8333,Johnathan Holland,WR,active,oakland-raiders,198333,2007
31478,1600000,1600000,Daunte Culpepper,QB,injured_reserve,oakland-raiders,3200000,2007
31479,1350000,500000,Tommy Kelly,DT,injured_reserve,oakland-raiders,1850000,2007
31480,800000,140000,Justin Fargas,RB,injured_reserve,oakland-raiders,940000,2007
31481,760000,40000,Cornell Green,T,injured_reserve,oakland-raiders,800000,2007
31482,0,4042500,Randy Moss,WR,dead_cap,oakland-raiders,4042500,2007
31483,0,1497000,Brad Badger,G,dead_cap,oakland-raiders,1497000,2007
31484,152500,0,Quentin Moses,DE,dead_cap,oakland-raiders,152500,2007
31485,117750,0,Darnell Bing,S,dead_cap,oakland-raiders,117750,2007
31486,100000,0,Chad Slaughter,T,dead_cap,oakland-raiders,100000,2007
31487,39000,0,Eric Frampton,S,dead_cap,oakland-raiders,39000,2007
31488,25250,0,Kevin Boothe,G,dead_cap,oakland-raiders,25250,2007
31489,16600,0,Kevin McMahan,WR,dead_cap,oakland-raiders,16600,2007
31490,9000,0,Courtney Anderson,TE,dead_cap,oakland-raiders,9000,2007
31491,9765000,0,Nnamdi Asomugha,CB,active,oakland-raiders,9765000,2008
31492,605000,5773335,Robert Gallery,T,active,oakland-raiders,6378335,2008
31493,4000000,0,Gerard Warren,DT,active,oakland-raiders,4000000,2008
31494,370000,3981000,JaMarcus Russell,QB,active,oakland-raiders,4351000,2008
31495,370000,2763250,Zach Miller,TE,active,oakland-raiders,3133250,2008
31496,445000,4740000,Michael Huff,S,active,oakland-raiders,5185000,2008
31497,1200000,2070000,Sebastian Janikowski,K,active,oakland-raiders,3270000,2008
31498,625000,2166666,Tommy Kelly,DT,active,oakland-raiders,2791666,2008
31499,295000,2330000,Darren McFadden,RB,active,oakland-raiders,2625000,2008
31500,605000,1798333,Justin Fargas,RB,active,oakland-raiders,2403333,2008
31501,1900000,175000,Cooper Carlisle,G,active,oakland-raiders,2075000,2008
31502,1000000,1166667,DeAngelo Hall,CB,active,oakland-raiders,2166667,2008
31503,1800000,200000,Drew Carter,WR,active,oakland-raiders,2000000,2008
31504,1710000,177600,Kirk Morrison,LB,active,oakland-raiders,1887600,2008
31505,1000000,882857,Shane Lechler,P,active,oakland-raiders,1882857,2008
31506,1150000,300000,Cornell Green,T,active,oakland-raiders,1450000,2008
31507,605000,798333,Kwame Harris,T,active,oakland-raiders,1403333,2008
31508,960000,197000,Andrew Walter,QB,active,oakland-raiders,1157000,2008
31509,520000,762900,Stanford Routt,CB,active,oakland-raiders,1282900,2008
31510,445000,1100000,Thomas Howard,LB,active,oakland-raiders,1545000,2008
31511,445000,198750,Paul McQuistan,LT,active,oakland-raiders,643750,2008
31512,370000,158500,Mario Henderson,T,active,oakland-raiders,528500,2008
31513,520000,0,Chris Johnson,CB,active,oakland-raiders,520000,2008
31514,370000,145000,Johnnie Lee Higgins,WR,active,oakland-raiders,515000,2008
31515,460000,29000,Oren O'Neal,FB,active,oakland-raiders,489000,2008
31516,605000,0,William Joseph,DT,active,oakland-raiders,605000,2008
31517,605000,40000,Ashley Lelie,WR,active,oakland-raiders,645000,2008
31518,445000,0,Jon Alston,LB,active,oakland-raiders,445000,2008
31519,445000,0,Ricky Brown,LB,active,oakland-raiders,445000,2008
31520,445000,0,Jon Condo,LS,active,oakland-raiders,445000,2008
31521,445000,0,Luke Lawton,RB,active,oakland-raiders,445000,2008
31522,445000,0,Chris Morris,C,active,oakland-raiders,445000,2008
31523,295000,128956,Tyvon Branch,SS,active,oakland-raiders,423956,2008
31524,295000,125000,Michael Bush,RB,active,oakland-raiders,420000,2008
31525,370000,48500,Jay Richardson,DE,active,oakland-raiders,418500,2008
31526,295000,106750,Arman Shields,WR,active,oakland-raiders,401750,2008
31527,370000,0,James Marten,T,active,oakland-raiders,370000,2008
31528,215000,116250,John Bowie,CB,active,oakland-raiders,331250,2008
31529,295000,28750,Trevor Scott,DE,active,oakland-raiders,323750,2008
31530,295000,12836,Chaz Schilens,WR,active,oakland-raiders,307836,2008
31531,295000,0,Johnathan Holland,WR,active,oakland-raiders,295000,2008
31532,34705,0,Marcel Reece,FB,active,oakland-raiders,34705,2008
31533,1000000,1833333,Javon Walker,WR,injured_reserve,oakland-raiders,2833333,2008
31534,88400,0,Marcel Reece,FB,practice_squad,oakland-raiders,88400,2008
31535,4300000,0,Jerry Porter,WR,dead_cap,oakland-raiders,4300000,2008
31536,2994000,0,Warren Sapp,DT,dead_cap,oakland-raiders,2994000,2008
31537,0,3950300,Fabian Washington,CB,dead_cap,oakland-raiders,3950300,2008
31538,0,500000,Dominic Rhodes,RB,dead_cap,oakland-raiders,500000,2008
31539,457500,0,Quentin Moses,DE,dead_cap,oakland-raiders,457500,2008
31540,235500,0,Darnell Bing,S,dead_cap,oakland-raiders,235500,2008
31541,200000,0,Chad Slaughter,T,dead_cap,oakland-raiders,200000,2008
31542,78000,0,Eric Frampton,S,dead_cap,oakland-raiders,78000,2008
31543,50500,0,Kevin Boothe,G,dead_cap,oakland-raiders,50500,2008
31544,9000,0,Courtney Anderson,TE,dead_cap,oakland-raiders,9000,2008
31545,7805880,5774200,JaMarcus Russell,QB,active,oakland-raiders,13580080,2009
31546,3685000,9430000,Richard Seymour,DT,active,oakland-raiders,13115000,2009
31547,2500000,4561866,Tommy Kelly,DT,active,oakland-raiders,7061866,2009
31548,4500000,1500000,Nnamdi Asomugha,CB,active,oakland-raiders,6000000,2009
31549,385000,4273000,Darren McFadden,RB,active,oakland-raiders,4658000,2009
31550,2000000,1833333,Javon Walker,WR,active,oakland-raiders,3833333,2009
31551,945000,4740000,Michael Huff,S,active,oakland-raiders,5685000,2009
31552,2000000,1100000,Shane Lechler,P,active,oakland-raiders,3100000,2009
31553,2000000,1000000,Chris Johnson,CB,active,oakland-raiders,3000000,2009
31554,2295000,177600,Kirk Morrison,LB,active,oakland-raiders,2472600,2009
31555,745000,930600,Gerard Warren,DT,active,oakland-raiders,1675600,2009
31556,1920000,500000,Darrius Heyward-Bey,WR,active,oakland-raiders,2420000,2009
31557,2000000,333333,Greg Ellis,LB,active,oakland-raiders,2333333,2009
31558,2000000,300000,Cooper Carlisle,G,active,oakland-raiders,2300000,2009
31559,1500000,775000,Sebastian Janikowski,K,active,oakland-raiders,2275000,2009
31560,1200000,500000,Cornell Green,T,active,oakland-raiders,1700000,2009
31561,1000000,200000,Khalif Barnes,LT,active,oakland-raiders,1200000,2009
31562,1000000,115000,Erik Pears,RT,active,oakland-raiders,1115000,2009
31563,620000,762900,Stanford Routt,CB,active,oakland-raiders,1382900,2009
31564,535000,1100000,Thomas Howard,LB,active,oakland-raiders,1635000,2009
31565,1010000,0,Jon Alston,LB,active,oakland-raiders,1010000,2009
31566,1010000,0,Jon Condo,LS,active,oakland-raiders,1010000,2009
31567,310000,400000,Mike Mitchell,FS,active,oakland-raiders,710000,2009
31568,460000,241250,Zach Miller,TE,active,oakland-raiders,701250,2009
31569,460000,205000,Samson Satele,C,active,oakland-raiders,665000,2009
31570,460000,158500,Mario Henderson,T,active,oakland-raiders,618500,2009
31571,460000,145000,Johnnie Lee Higgins,WR,active,oakland-raiders,605000,2009
31572,460000,125000,Michael Bush,RB,active,oakland-raiders,585000,2009
31573,550000,29000,Oren O'Neal,FB,active,oakland-raiders,579000,2009
31574,535000,0,Chris Morris,C,active,oakland-raiders,535000,2009
31575,530000,0,Bruce Gradkowski,QB,active,oakland-raiders,530000,2009
31576,310000,213062,Matt Shaughnessy,DE,active,oakland-raiders,523062,2009
31577,385000,128956,Tyvon Branch,SS,active,oakland-raiders,513956,2009
31578,460000,48500,Jay Richardson,DE,active,oakland-raiders,508500,2009
31579,298125,198750,Paul McQuistan,LT,active,oakland-raiders,496875,2009
31580,620000,0,Charlie Frye,QB,active,oakland-raiders,620000,2009
31581,620000,10000,William Joseph,DT,active,oakland-raiders,630000,2009
31582,620000,0,J.P. Losman,QB,active,oakland-raiders,620000,2009
31583,310000,112000,Louis Murphy,WR,active,oakland-raiders,422000,2009
31584,310000,110000,Slade Norris,LB,active,oakland-raiders,420000,2009
31585,385000,28750,Trevor Scott,DE,active,oakland-raiders,413750,2009
31586,385000,12836,Chaz Schilens,WR,active,oakland-raiders,397836,2009
31587,385000,0,Johnathan Holland,WR,active,oakland-raiders,385000,2009
31588,385000,0,Todd Watkins,WR,active,oakland-raiders,385000,2009
31589,310000,22750,Brandon Myers,TE,active,oakland-raiders,332750,2009
31590,310000,5000,Desmond Bryant,DE,active,oakland-raiders,315000,2009
31591,310000,0,Jerome Boyd,CB,active,oakland-raiders,310000,2009
31592,54705,0,Marcel Reece,FB,active,oakland-raiders,54705,2009
31593,1315000,6708835,Robert Gallery,T,injured_reserve,oakland-raiders,8023835,2009
31594,1545000,0,Ricky Brown,LB,injured_reserve,oakland-raiders,1545000,2009
31595,88400,0,Paul Hubbard,WR,practice_squad,oakland-raiders,88400,2009
31596,88400,0,Marcel Reece,FB,practice_squad,oakland-raiders,88400,2009
31597,0,1596668,Kwame Harris,T,dead_cap,oakland-raiders,1596668,2009
31598,1166667,0,DeAngelo Hall,CB,dead_cap,oakland-raiders,1166667,2009
31599,197000,0,Andrew Walter,QB,dead_cap,oakland-raiders,197000,2009
31600,116250,0,John Bowie,CB,dead_cap,oakland-raiders,116250,2009
31601,106750,0,Arman Shields,WR,dead_cap,oakland-raiders,106750,2009
31602,16666,0,Johnathan Holland,WR,dead_cap,oakland-raiders,16666,2009
31603,12975000,0,Richard Seymour,DT,active,oakland-raiders,12975000,2010
31604,4500000,3599866,Tommy Kelly,DT,active,oakland-raiders,8099866,2010
31605,755000,6234800,Nnamdi Asomugha,CB,active,oakland-raiders,6989800,2010
31606,470000,4273000,Darren McFadden,RB,active,oakland-raiders,4743000,2010
31607,635000,4924499,Robert Gallery,T,active,oakland-raiders,5559499,2010
31608,1445000,4740000,Michael Huff,S,active,oakland-raiders,6185000,2010
31609,2600000,1100000,Shane Lechler,P,active,oakland-raiders,3700000,2010
31610,2600000,1000000,Chris Johnson,CB,active,oakland-raiders,3600000,2010
31611,3268000,0,Stanford Routt,CB,active,oakland-raiders,3268000,2010
31612,3140000,0,Jason Campbell,QB,active,oakland-raiders,3140000,2010
31613,2000000,1475000,Sebastian Janikowski,K,active,oakland-raiders,3475000,2010
31614,395000,5260000,Darrius Heyward-Bey,WR,active,oakland-raiders,5655000,2010
31615,2600000,300000,Cooper Carlisle,G,active,oakland-raiders,2900000,2010
31616,1260000,1000000,Rolando McClain,ILB,active,oakland-raiders,2260000,2010
31617,1000000,825000,John Henderson,DT,active,oakland-raiders,1825000,2010
31618,1759000,0,Ricky Brown,LB,active,oakland-raiders,1759000,2010
31619,1759000,0,Thomas Howard,LB,active,oakland-raiders,1759000,2010
31620,1684000,0,Jon Condo,LS,active,oakland-raiders,1684000,2010
31621,1684000,0,Bruce Gradkowski,QB,active,oakland-raiders,1684000,2010
31622,1226000,0,Charlie Frye,QB,active,oakland-raiders,1226000,2010
31623,750000,476000,Khalif Barnes,LT,active,oakland-raiders,1226000,2010
31624,395000,828000,Mike Mitchell,FS,active,oakland-raiders,1223000,2010
31625,1065000,100000,Kamerion Wimbley,OLB,active,oakland-raiders,1165000,2010
31626,1101000,0,Chris Morris,C,active,oakland-raiders,1101000,2010
31627,1000000,0,Kyle Boller,QB,active,oakland-raiders,1000000,2010
31628,963375,8837,Chinedum Ndukwe,S,active,oakland-raiders,972212,2010
31629,470000,338750,Quentin Groves,OLB,active,oakland-raiders,808750,2010
31630,550000,241250,Zach Miller,TE,active,oakland-raiders,791250,2010
31631,355000,418750,Lamarr Houston,OLB,active,oakland-raiders,773750,2010
31632,755000,0,Rock Cartwright,RB,active,oakland-raiders,755000,2010
31633,550000,205000,Samson Satele,C,active,oakland-raiders,755000,2010
31634,550000,158500,Mario Henderson,T,active,oakland-raiders,708500,2010
31635,550000,145000,Johnnie Lee Higgins,WR,active,oakland-raiders,695000,2010
31636,550000,125000,Michael Bush,RB,active,oakland-raiders,675000,2010
31637,395000,213062,Matt Shaughnessy,DE,active,oakland-raiders,608062,2010
31638,470000,128956,Tyvon Branch,SS,active,oakland-raiders,598956,2010
31639,545000,0,Jarvis Moss,DE,active,oakland-raiders,545000,2010
31640,320000,223750,Jared Veldheer,RT,active,oakland-raiders,543750,2010
31641,395000,112000,Louis Murphy,WR,active,oakland-raiders,507000,2010
31642,470000,28750,Trevor Scott,DE,active,oakland-raiders,498750,2010
31643,470000,12836,Chaz Schilens,WR,active,oakland-raiders,482836,2010
31644,320000,130625,Bruce Campbell,RT,active,oakland-raiders,450625,2010
31645,320000,128871,Jacoby Ford,WR,active,oakland-raiders,448871,2010
31646,395000,22750,Brandon Myers,TE,active,oakland-raiders,417750,2010
31647,395000,5000,Desmond Bryant,DE,active,oakland-raiders,400000,2010
31648,320000,50000,Walter McFadden,CB,active,oakland-raiders,370000,2010
31649,320000,25787,Travis Goethel,LB,active,oakland-raiders,345787,2010
31650,320000,15500,Jeremy Ware,CB,active,oakland-raiders,335500,2010
31651,320000,0,Marcel Reece,FB,active,oakland-raiders,320000,2010
31652,137500,0,Jay Alford,DT,active,oakland-raiders,137500,2010
31653,58750,0,Johnathan Holland,WR,active,oakland-raiders,58750,2010
31654,3000000,17322600,JaMarcus Russell,QB,dead_cap,oakland-raiders,20322600,2010
31655,0,7333334,Javon Walker,WR,dead_cap,oakland-raiders,7333334,2010
31656,5833335,0,DeAngelo Hall,CB,dead_cap,oakland-raiders,5833335,2010
31657,3918333,0,Justin Fargas,RB,dead_cap,oakland-raiders,3918333,2010
31658,3722400,0,Gerard Warren,DT,dead_cap,oakland-raiders,3722400,2010
31659,0,666667,Greg Ellis,LB,dead_cap,oakland-raiders,666667,2010
31660,213500,0,Arman Shields,WR,dead_cap,oakland-raiders,213500,2010
31661,116250,0,John Bowie,CB,dead_cap,oakland-raiders,116250,2010
31662,93840,0,Alex Parsons,C,dead_cap,oakland-raiders,93840,2010
31663,48500,0,Jay Richardson,DE,dead_cap,oakland-raiders,48500,2010
31664,29000,0,Oren O'Neal,FB,dead_cap,oakland-raiders,29000,2010
31665,9437,0,Stevie Brown,SS,dead_cap,oakland-raiders,9437,2010
31666,1000000,13045000,Darrius Heyward-Bey,WR,active,oakland-raiders,14045000,2011
31667,7045000,3828833,Darren McFadden,RB,active,oakland-raiders,10873833,2011
31668,5500000,3599866,Tommy Kelly,DT,active,oakland-raiders,9099866,2011
31669,910000,10318000,Richard Seymour,DT,active,oakland-raiders,11228000,2011
31670,450000,8545000,Rolando McClain,ILB,active,oakland-raiders,8995000,2011
31671,4500000,100000,Jason Campbell,QB,active,oakland-raiders,4600000,2011
31672,3200000,1100000,Shane Lechler,P,active,oakland-raiders,4300000,2011
31673,685000,3529667,Stanford Routt,CB,active,oakland-raiders,4214667,2011
31674,3000000,750000,Kevin Boss,TE,active,oakland-raiders,3750000,2011
31675,2600000,1475000,Sebastian Janikowski,K,active,oakland-raiders,4075000,2011
31676,2500000,300000,Cooper Carlisle,G,active,oakland-raiders,2800000,2011
31677,2500000,750000,John Henderson,DT,active,oakland-raiders,3250000,2011
31678,2610000,0,Michael Bush,RB,active,oakland-raiders,2610000,2011
31679,685000,1828750,Michael Huff,S,active,oakland-raiders,2513750,2011
31680,2500000,0,Carson Palmer,QB,active,oakland-raiders,2500000,2011
31681,1300000,700000,Khalif Barnes,LT,active,oakland-raiders,2000000,2011
31682,1700000,0,Stephon Heyer,T,active,oakland-raiders,1700000,2011
31683,750000,850000,Kamerion Wimbley,OLB,active,oakland-raiders,1600000,2011
31684,1250000,0,Kyle Boller,QB,active,oakland-raiders,1250000,2011
31685,1000000,250000,Jarvis Moss,DE,active,oakland-raiders,1250000,2011
31686,850000,108333,Jon Condo,LS,active,oakland-raiders,958333,2011
31687,525000,400000,Mike Mitchell,FS,active,oakland-raiders,925000,2011
31688,810000,100000,Rock Cartwright,RB,active,oakland-raiders,910000,2011
31689,555000,338750,Quentin Groves,OLB,active,oakland-raiders,893750,2011
31690,450000,418750,Lamarr Houston,OLB,active,oakland-raiders,868750,2011
31691,375000,376891,Stefen Wisniewski,C,active,oakland-raiders,751891,2011
31692,480000,213062,Matt Shaughnessy,DE,active,oakland-raiders,693062,2011
31693,555000,128956,Tyvon Branch,SS,active,oakland-raiders,683956,2011
31694,405000,223750,Jared Veldheer,RT,active,oakland-raiders,628750,2011
31695,480000,112000,Louis Murphy,WR,active,oakland-raiders,592000,2011
31696,555000,28750,Trevor Scott,DE,active,oakland-raiders,583750,2011
31697,555000,12836,Chaz Schilens,WR,active,oakland-raiders,567836,2011
31698,405000,130625,Bruce Campbell,RT,active,oakland-raiders,535625,2011
31699,405000,128871,Jacoby Ford,WR,active,oakland-raiders,533871,2011
31700,685000,0,Darryl Blackstock,LB,active,oakland-raiders,685000,2011
31701,685000,0,Matt Giordano,S,active,oakland-raiders,685000,2011
31702,525000,0,Aaron Curry,OLB,active,oakland-raiders,525000,2011
31703,375000,147844,DeMarcus Van Dyke,CB,active,oakland-raiders,522844,2011
31704,375000,134950,Joe Barksdale,RT,active,oakland-raiders,509950,2011
31705,480000,22750,Brandon Myers,TE,active,oakland-raiders,502750,2011
31706,375000,111300,Chimdi Chekwa,CB,active,oakland-raiders,486300,2011
31707,480000,0,Nick Miller,WR,active,oakland-raiders,480000,2011
31708,375000,101250,Taiwan Jones,RB,active,oakland-raiders,476250,2011
31709,450000,0,Bryan McCann,CB,active,oakland-raiders,450000,2011
31710,450000,0,Marcel Reece,FB,active,oakland-raiders,450000,2011
31711,405000,25787,Travis Goethel,LB,active,oakland-raiders,430787,2011
31712,375000,47513,Denarius Moore,WR,active,oakland-raiders,422513,2011
31713,264705,146517,Terrelle Pryor,WR,active,oakland-raiders,411222,2011
31714,375000,26213,Richard Gordon,TE,active,oakland-raiders,401213,2011
31715,375000,11475,David Ausberry,TE,active,oakland-raiders,386475,2011
31716,375000,0,Derrick Jones,WR,active,oakland-raiders,375000,2011
31717,330000,0,Jerome Boyd,CB,active,oakland-raiders,330000,2011
31718,353000,0,Ricky Brown,LB,injured_reserve,oakland-raiders,353000,2011
31719,2823529,1000000,Chris Johnson,CB,non_fb_injury,oakland-raiders,3823529,2011
31720,96900,0,Lonyae Miller,RB,practice_squad,oakland-raiders,96900,2011
31721,115000,0,Erik Pears,RT,dead_cap,oakland-raiders,115000,2011
31722,101900,0,Alex Parsons,C,dead_cap,oakland-raiders,101900,2011
31723,0,50000,Walter McFadden,CB,dead_cap,oakland-raiders,50000,2011
31724,28311,0,Stevie Brown,SS,dead_cap,oakland-raiders,28311,2011
31725,0,15500,Jeremy Ware,CB,dead_cap,oakland-raiders,15500,2011
31726,5650000,3828833,Darren McFadden,RB,active,oakland-raiders,9478833,2012
31727,925000,11633000,Richard Seymour,DT,active,oakland-raiders,12558000,2012
31728,5279000,5510000,Darrius Heyward-Bey,WR,active,oakland-raiders,10789000,2012
31729,700000,4748750,Michael Huff,S,active,oakland-raiders,5448750,2012
31730,825000,5324866,Tommy Kelly,DT,active,oakland-raiders,6149866,2012
31731,3800000,1100000,Shane Lechler,P,active,oakland-raiders,4900000,2012
31732,1700000,3150000,Sebastian Janikowski,K,active,oakland-raiders,4850000,2012
31733,970000,5090000,Rolando McClain,ILB,active,oakland-raiders,6060000,2012
31734,825000,2335000,Carson Palmer,QB,active,oakland-raiders,3160000,2012
31735,612500,-108088,Ron Bartell,CB,active,oakland-raiders,504412,2012
31736,1000000,1400000,Tyvon Branch,SS,active,oakland-raiders,2400000,2012
31737,825000,1175000,Khalif Barnes,LT,active,oakland-raiders,2000000,2012
31738,1927000,0,Desmond Bryant,DE,active,oakland-raiders,1927000,2012
31739,700000,710000,Mike Brisiel,G,active,oakland-raiders,1410000,2012
31740,1175000,108333,Jon Condo,LS,active,oakland-raiders,1283333,2012
31741,615000,400000,Mike Mitchell,FS,active,oakland-raiders,1015000,2012
31742,615000,377000,Aaron Curry,OLB,active,oakland-raiders,992000,2012
31743,540000,448750,Lamarr Houston,OLB,active,oakland-raiders,988750,2012
31744,562973,376891,Stefen Wisniewski,C,active,oakland-raiders,939864,2012
31745,925000,0,Cooper Carlisle,G,active,oakland-raiders,925000,2012
31746,825000,0,Joselio Hanson,CB,active,oakland-raiders,825000,2012
31747,700000,25000,Dave Tollefson,DE,active,oakland-raiders,725000,2012
31748,565000,213062,Matt Shaughnessy,DE,active,oakland-raiders,778062,2012
31749,490000,223750,Jared Veldheer,RT,active,oakland-raiders,713750,2012
31750,490000,128871,Jacoby Ford,WR,active,oakland-raiders,618871,2012
31751,615000,0,Mike Goodson,RB,active,oakland-raiders,615000,2012
31752,465000,146517,Terrelle Pryor,WR,active,oakland-raiders,611517,2012
31753,565000,22750,Brandon Myers,TE,active,oakland-raiders,587750,2012
31754,465000,101250,Taiwan Jones,RB,active,oakland-raiders,566250,2012
31755,825000,0,Matt Giordano,S,active,oakland-raiders,825000,2012
31756,700000,0,Omar Gaither,ILB,active,oakland-raiders,700000,2012
31757,700000,0,Derek Hagan,WR,active,oakland-raiders,700000,2012
31758,700000,50000,Matt Leinart,QB,active,oakland-raiders,750000,2012
31759,700000,0,Owen Schmitt,FB,active,oakland-raiders,700000,2012
31760,700000,0,Philip Wheeler,OLB,active,oakland-raiders,700000,2012
31761,540000,0,Phillip Adams,CB,active,oakland-raiders,540000,2012
31762,540000,0,Coye Francies,CB,active,oakland-raiders,540000,2012
31763,540000,0,Marcel Reece,FB,active,oakland-raiders,540000,2012
31764,390000,126504,Tony Bergstrom,C,active,oakland-raiders,516504,2012
31765,490000,25787,Travis Goethel,LB,active,oakland-raiders,515787,2012
31766,465000,47513,Denarius Moore,WR,active,oakland-raiders,512513,2012
31767,465000,26213,Richard Gordon,TE,active,oakland-raiders,491213,2012
31768,490000,0,Keenan Clayton,OLB,active,oakland-raiders,490000,2012
31769,465000,11475,David Ausberry,TE,active,oakland-raiders,476475,2012
31770,390000,75146,Miles Burris,ILB,active,oakland-raiders,465146,2012
31771,465000,0,Brandon Bair,DE,active,oakland-raiders,465000,2012
31772,465000,0,Willie Smith,LT,active,oakland-raiders,465000,2012
31773,925000,0,Andre Carter,DE,active,oakland-raiders,925000,2012
31774,390000,45606,Jack Crawford,DE,active,oakland-raiders,435606,2012
31775,390000,36140,Juron Criner,WR,active,oakland-raiders,426140,2012
31776,390000,25966,Christo Bilukidi,DT,active,oakland-raiders,415966,2012
31777,615000,65000,Pat Lee,CB,active,oakland-raiders,680000,2012
31778,390000,4166,Lucas Nix,G,active,oakland-raiders,394166,2012
31779,390000,3333,Rod Streater,WR,active,oakland-raiders,393333,2012
31780,390000,333,Marquette King,P,active,oakland-raiders,390333,2012
31781,390000,0,Brandon Carswell,WR,active,oakland-raiders,390000,2012
31782,390000,0,Jamie Cumbie,DT,active,oakland-raiders,390000,2012
31783,390000,0,Rashawn Jackson,RB,active,oakland-raiders,390000,2012
31784,390000,0,Cory Nelms,S,active,oakland-raiders,390000,2012
31785,390000,0,Alex Parsons,C,active,oakland-raiders,390000,2012
31786,390000,0,Brandian Ross,CB,active,oakland-raiders,390000,2012
31787,390000,0,Jeremy Stewart,RB,active,oakland-raiders,390000,2012
31788,465000,0,Vic So'oto,OLB,active,oakland-raiders,465000,2012
31789,390000,0,Kaelin Burnett,OLB,active,oakland-raiders,390000,2012
31790,390000,0,Jamize Olawale,FB,active,oakland-raiders,390000,2012
31791,465000,0,Chimdi Chekwa,CB,active,oakland-raiders,465000,2012
31792,825000,0,Shawntae Spencer,CB,injured_reserve,oakland-raiders,825000,2012
31793,465000,0,Duke Calhoun,WR,injured_reserve,oakland-raiders,465000,2012
31794,390000,0,Zach Hurd,G,injured_reserve,oakland-raiders,390000,2012
31795,390000,0,Mario Kurn,LB,injured_reserve,oakland-raiders,390000,2012
31796,0,7452000,Stanford Routt,CB,dead_cap,oakland-raiders,7452000,2012
31797,6500000,0,Kamerion Wimbley,OLB,dead_cap,oakland-raiders,6500000,2012
31798,1500000,750000,John Henderson,DT,dead_cap,oakland-raiders,2250000,2012
31799,1225000,0,Hiram Eugene,S,dead_cap,oakland-raiders,1225000,2012
31800,1000000,0,Chris Johnson,CB,dead_cap,oakland-raiders,1000000,2012
31801,0,750000,Kevin Boss,TE,dead_cap,oakland-raiders,750000,2012
31802,600000,0,Cooper Carlisle,G,dead_cap,oakland-raiders,600000,2012
31803,0,377000,Aaron Curry,OLB,dead_cap,oakland-raiders,377000,2012
31804,300000,0,Daniel Loper,T,dead_cap,oakland-raiders,300000,2012
31805,261250,0,Bruce Campbell,RT,dead_cap,oakland-raiders,261250,2012
31806,147844,0,DeMarcus Van Dyke,CB,dead_cap,oakland-raiders,147844,2012
31807,0,134950,Joe Barksdale,RT,dead_cap,oakland-raiders,134950,2012
31808,112000,0,Louis Murphy,WR,dead_cap,oakland-raiders,112000,2012
31809,111300,0,Chimdi Chekwa,CB,dead_cap,oakland-raiders,111300,2012
31810,0,100000,Walter McFadden,CB,dead_cap,oakland-raiders,100000,2012
31811,0,31000,Jeremy Ware,CB,dead_cap,oakland-raiders,31000,2012
31812,12588,0,Nathan Stupar,OLB,dead_cap,oakland-raiders,12588,2012
31813,5856250,3828834,Darren McFadden,RB,active,oakland-raiders,9685084,2013
31814,3500000,1810000,Sebastian Janikowski,K,active,oakland-raiders,5310000,2013
31815,715000,3157000,Tyvon Branch,SS,active,oakland-raiders,3872000,2013
31816,1350000,1460000,Mike Brisiel,G,active,oakland-raiders,2810000,2013
31817,1300000,700000,Vance Walker,DE,active,oakland-raiders,2000000,2013
31818,405000,1472036,D.J. Hayden,CB,active,oakland-raiders,1877036,2013
31819,840000,1017500,Kevin Burnett,OLB,active,oakland-raiders,1857500,2013
31820,676647,1180838,Marcel Reece,FB,active,oakland-raiders,1857485,2013
31821,1000000,800000,Charles Woodson,SS,active,oakland-raiders,1800000,2013
31822,1000000,750000,Pat Sims,DT,active,oakland-raiders,1750000,2013
31823,715000,921250,Nick Roach,ILB,active,oakland-raiders,1636250,2013
31824,1323000,223750,Jared Veldheer,RT,active,oakland-raiders,1546750,2013
31825,800000,700000,Mike Jenkins,CB,active,oakland-raiders,1500000,2013
31826,1323000,128871,Jacoby Ford,WR,active,oakland-raiders,1451871,2013
31827,715000,135000,Tracy Porter,CB,active,oakland-raiders,850000,2013
31828,750946,376891,Stefen Wisniewski,C,active,oakland-raiders,1127837,2013
31829,840000,285833,Jon Condo,LS,active,oakland-raiders,1125833,2013
31830,630000,448750,Lamarr Houston,OLB,active,oakland-raiders,1078750,2013
31831,715000,285000,Jason Hunter,DE,active,oakland-raiders,1000000,2013
31832,840000,75000,Khalif Barnes,LT,active,oakland-raiders,915000,2013
31833,405000,466791,Menelik Watson,RT,active,oakland-raiders,871791,2013
31834,710000,65000,Phillip Adams,CB,active,oakland-raiders,775000,2013
31835,595000,146517,Terrelle Pryor,WR,active,oakland-raiders,741517,2013
31836,555000,101250,Taiwan Jones,RB,active,oakland-raiders,656250,2013
31837,630000,0,Rashad Jennings,RB,active,oakland-raiders,630000,2013
31838,630000,0,Jeron Mastrud,TE,active,oakland-raiders,630000,2013
31839,480000,126504,Tony Bergstrom,C,active,oakland-raiders,606504,2013
31840,555000,47513,Denarius Moore,WR,active,oakland-raiders,602513,2013
31841,940000,0,Andre Gurode,C,active,oakland-raiders,940000,2013
31842,405000,172708,Sio Moore,OLB,active,oakland-raiders,577708,2013
31843,555000,11475,David Ausberry,TE,active,oakland-raiders,566475,2013
31844,480000,75146,Miles Burris,ILB,active,oakland-raiders,555146,2013
31845,840000,0,Tony Pashos,RT,active,oakland-raiders,840000,2013
31846,555000,0,Chimdi Chekwa,CB,active,oakland-raiders,555000,2013
31847,480000,45606,Jack Crawford,DE,active,oakland-raiders,525606,2013
31848,480000,4166,Lucas Nix,G,active,oakland-raiders,484166,2013
31849,480000,3333,Rod Streater,WR,active,oakland-raiders,483333,2013
31850,480000,0,Kaelin Burnett,OLB,active,oakland-raiders,480000,2013
31851,480000,0,Jamize Olawale,FB,active,oakland-raiders,480000,2013
31852,480000,0,Brandian Ross,CB,active,oakland-raiders,480000,2013
31853,480000,0,Jeremy Stewart,RB,active,oakland-raiders,480000,2013
31854,405000,30150,Nick Kasa,TE,active,oakland-raiders,435150,2013
31855,405000,26213,Mychal Rivera,TE,active,oakland-raiders,431213,2013
31856,405000,19670,Stacy McGee,DT,active,oakland-raiders,424670,2013
31857,424412,0,Andre Holmes,WR,active,oakland-raiders,424412,2013
31858,405000,16875,Brice Butler,WR,active,oakland-raiders,421875,2013
31859,405000,333,Marquette King,P,active,oakland-raiders,405333,2013
31860,405000,333,Ryan Robinson,DE,active,oakland-raiders,405333,2013
31861,405000,0,Matt McCants,RT,active,oakland-raiders,405000,2013
31862,405000,0,Matt McGloin,QB,active,oakland-raiders,405000,2013
31863,715000,0,Daniel Muir,DT,active,oakland-raiders,715000,2013
31864,405000,0,Lamar Mady,G,active,oakland-raiders,405000,2013
31865,288000,26550,Latavius Murray,RB,active,oakland-raiders,314550,2013
31866,405000,0,Greg Jenkins,WR,active,oakland-raiders,405000,2013
31867,480000,0,Marshall McFadden,ILB,active,oakland-raiders,480000,2013
31868,405000,0,Chance Casey,CB,active,oakland-raiders,405000,2013
31869,405000,0,Shelton Johnson,S,active,oakland-raiders,405000,2013
31870,405000,0,Ricky Lumpkin,DT,active,oakland-raiders,405000,2013
31871,630000,778333,Kaluka Maiava,ILB,injured_reserve,oakland-raiders,1408333,2013
31872,720000,265000,Usama Young,S,injured_reserve,oakland-raiders,985000,2013
31873,480000,36140,Juron Criner,WR,injured_reserve,oakland-raiders,516140,2013
31874,78000,0,Chance Casey,CB,practice_squad,oakland-raiders,78000,2013
31875,78000,0,Shelton Johnson,S,practice_squad,oakland-raiders,78000,2013
31876,78000,0,Marshall McFadden,ILB,practice_squad,oakland-raiders,78000,2013
31877,60000,0,Andre Carter,DE,practice_squad,oakland-raiders,60000,2013
31878,18000,0,Jason Foster,G,practice_squad,oakland-raiders,18000,2013
31879,18000,0,Ricky Lumpkin,DT,practice_squad,oakland-raiders,18000,2013
31880,12000,0,Lamar Mady,G,practice_squad,oakland-raiders,12000,2013
31881,0,13714000,Richard Seymour,DT,dead_cap,oakland-raiders,13714000,2013
31882,9340000,0,Carson Palmer,QB,dead_cap,oakland-raiders,9340000,2013
31883,7260000,0,Rolando McClain,ILB,dead_cap,oakland-raiders,7260000,2013
31884,6324270,0,Tommy Kelly,DT,dead_cap,oakland-raiders,6324270,2013
31885,5260000,0,Darrius Heyward-Bey,WR,dead_cap,oakland-raiders,5260000,2013
31886,1250000,2625000,Matt Flynn,QB,dead_cap,oakland-raiders,3875000,2013
31887,3288750,0,Michael Huff,S,dead_cap,oakland-raiders,3288750,2013
31888,0,1500000,Kevin Boss,TE,dead_cap,oakland-raiders,1500000,2013
31889,0,1131000,Aaron Curry,OLB,dead_cap,oakland-raiders,1131000,2013
31890,625000,0,Dave Tollefson,DE,dead_cap,oakland-raiders,625000,2013
31891,492353,0,Brian Sanford,DE,dead_cap,oakland-raiders,492353,2013
31892,295688,0,DeMarcus Van Dyke,CB,dead_cap,oakland-raiders,295688,2013
31893,0,269900,Joe Barksdale,RT,dead_cap,oakland-raiders,269900,2013
31894,262196,0,Tyler Wilson,QB,dead_cap,oakland-raiders,262196,2013
31895,251848,0,Christo Bilukidi,DT,dead_cap,oakland-raiders,251848,2013
31896,228529,0,Willie Smith,LT,dead_cap,oakland-raiders,228529,2013
31897,225000,0,Joshua Cribbs,WR,dead_cap,oakland-raiders,225000,2013
31898,222600,0,Chimdi Chekwa,CB,dead_cap,oakland-raiders,222600,2013
31899,160000,0,Joselio Hanson,CB,dead_cap,oakland-raiders,160000,2013
31900,130588,0,Martez Wilson,OLB,dead_cap,oakland-raiders,130588,2013
31901,119118,0,Antoine McClain,G,dead_cap,oakland-raiders,119118,2013
31902,107472,0,Jack Cornell,G,dead_cap,oakland-raiders,107472,2013
31903,101647,0,Eddie Carmona,K,dead_cap,oakland-raiders,101647,2013
31904,50000,0,Chris Kluwe,P,dead_cap,oakland-raiders,50000,2013
31905,37764,0,Nathan Stupar,OLB,dead_cap,oakland-raiders,37764,2013
31906,26213,0,Richard Gordon,TE,dead_cap,oakland-raiders,26213,2013
31907,25787,0,Travis Goethel,LB,dead_cap,oakland-raiders,25787,2013
31908,12150,0,David Bass,DE,dead_cap,oakland-raiders,12150,2013
31909,12000,0,George Winn,RB,dead_cap,oakland-raiders,12000,2013
31910,6000,0,Sam Montgomery,DE,dead_cap,oakland-raiders,6000,2013
31911,4000,0,Kyle Padron,QB,dead_cap,oakland-raiders,4000,2013
31912,3333,0,John Wetzel,RT,dead_cap,oakland-raiders,3333,2013
31913,1500,0,Shelton Johnson,S,dead_cap,oakland-raiders,1500,2013
31914,1333,0,Lamar Mady,G,dead_cap,oakland-raiders,1333,2013
31915,1333,0,Conner Vernon,WR,dead_cap,oakland-raiders,1333,2013
31916,1000,0,Sam McGuffie,WR,dead_cap,oakland-raiders,1000,2013
31917,666,0,Mario Kurn,LB,dead_cap,oakland-raiders,666,2013
31918,666,0,Deonte Williams,RB,dead_cap,oakland-raiders,666,2013
31919,500,0,Billy Boyko,ILB,dead_cap,oakland-raiders,500,2013
31920,333,0,Chance Casey,CB,dead_cap,oakland-raiders,333,2013
31921,333,0,Eric Harper,OLB,dead_cap,oakland-raiders,333,2013
31922,333,0,Greg Jenkins,WR,dead_cap,oakland-raiders,333,2013
31923,333,0,Brian Leonhardt,TE,dead_cap,oakland-raiders,333,2013
31924,333,0,Andrew Robiskie,C,dead_cap,oakland-raiders,333,2013
31925,333,0,Kurt Taufa'asau,DT,dead_cap,oakland-raiders,333,2013
31926,333,0,Mitchell White,CB,dead_cap,oakland-raiders,333,2013
31927,4500000,3500000,Matt Schaub,QB,active,oakland-raiders,8000000,2014
31928,3000000,4157000,Tyvon Branch,SS,active,oakland-raiders,7157000,2014
31929,3000000,2000000,Justin Tuck,DE,active,oakland-raiders,5000000,2014
31930,2200000,2800000,Donald Penn,LT,active,oakland-raiders,5000000,2014
31931,2250000,2696875,Antonio Smith,DE,active,oakland-raiders,4946875,2014
31932,2900000,1500000,Austin Howard,RT,active,oakland-raiders,4400000,2014
31933,2950000,1030838,Marcel Reece,FB,active,oakland-raiders,3980838,2014
31934,1650000,2150000,James Jones,WR,active,oakland-raiders,3800000,2014
31935,1150000,2350000,Charles Woodson,SS,active,oakland-raiders,3500000,2014
31936,420000,2975818,Khalil Mack,DE,active,oakland-raiders,3395818,2014
31937,2700000,360000,Sebastian Janikowski,K,active,oakland-raiders,3060000,2014
31938,1200000,1300000,Maurice Jones-Drew,RB,active,oakland-raiders,2500000,2014
31939,495000,1851295,D.J. Hayden,CB,active,oakland-raiders,2346295,2014
31940,1000000,1000000,Pat Sims,DT,active,oakland-raiders,2000000,2014
31941,900000,950000,Khalif Barnes,LT,active,oakland-raiders,1850000,2014
31942,900000,825000,Kevin Boothe,G,active,oakland-raiders,1725000,2014
31943,1250000,468000,Darren McFadden,RB,active,oakland-raiders,1718000,2014
31944,645000,1006250,Taiwan Jones,RB,active,oakland-raiders,1651250,2014
31945,1431000,47513,Denarius Moore,WR,active,oakland-raiders,1478513,2014
31946,938919,376891,Stefen Wisniewski,C,active,oakland-raiders,1315810,2014
31947,622948,466791,Menelik Watson,RT,active,oakland-raiders,1089739,2014
31948,900000,177500,Jon Condo,LS,active,oakland-raiders,1077500,2014
31949,420000,556691,Derek Carr,QB,active,oakland-raiders,976691,2014
31950,963339,25000,Vincent Brown,WR,active,oakland-raiders,988339,2014
31951,521000,197708,Sio Moore,OLB,active,oakland-raiders,718708,2014
31952,570000,126504,Tony Bergstrom,C,active,oakland-raiders,696504,2014
31953,645000,11475,David Ausberry,TE,active,oakland-raiders,656475,2014
31954,570000,75146,Miles Burris,ILB,active,oakland-raiders,645146,2014
31955,645000,0,Chimdi Chekwa,CB,active,oakland-raiders,645000,2014
31956,645000,0,Andre Holmes,WR,active,oakland-raiders,645000,2014
31957,730000,65000,C.J. Wilson,DT,active,oakland-raiders,795000,2014
31958,570000,3333,Rod Streater,WR,active,oakland-raiders,573333,2014
31959,570000,334,Marquette King,P,active,oakland-raiders,570334,2014
31960,570000,0,Jamize Olawale,FB,active,oakland-raiders,570000,2014
31961,420000,147844,Gabe Jackson,G,active,oakland-raiders,567844,2014
31962,420000,118172,Justin Ellis,DT,active,oakland-raiders,538172,2014
31963,420000,111300,Keith McGill,S,active,oakland-raiders,531300,2014
31964,495000,26213,Mychal Rivera,TE,active,oakland-raiders,521213,2014
31965,495000,19670,Stacy McGee,DT,active,oakland-raiders,514670,2014
31966,495000,16875,Brice Butler,WR,active,oakland-raiders,511875,2014
31967,495000,0,Benson Mayowa,DE,active,oakland-raiders,495000,2014
31968,495000,0,Matt McCants,RT,active,oakland-raiders,495000,2014
31969,495000,0,Matt McGloin,QB,active,oakland-raiders,495000,2014
31970,495000,0,Neiko Thorpe,CB,active,oakland-raiders,495000,2014
31971,570000,0,Brandian Ross,CB,active,oakland-raiders,570000,2014
31972,420000,26550,Latavius Murray,RB,active,oakland-raiders,446550,2014
31973,420000,16741,Travis Carrie,CB,active,oakland-raiders,436741,2014
31974,420000,0,Brian Leonhardt,TE,active,oakland-raiders,420000,2014
31975,420000,11474,Jonathan Dowling,FS,active,oakland-raiders,431474,2014
31976,495000,0,Ray-Ray Armstrong,OLB,active,oakland-raiders,495000,2014
31977,495000,0,Kenbrell Thompkins,WR,active,oakland-raiders,495000,2014
31978,318000,30150,Nick Kasa,TE,active,oakland-raiders,348150,2014
31979,262058,0,Larry Asante,SS,active,oakland-raiders,262058,2014
31980,247058,0,Denico Autry,DE,active,oakland-raiders,247058,2014
31981,495000,0,Ricky Lumpkin,DT,active,oakland-raiders,495000,2014
31982,420000,0,George Atkinson,RB,active,oakland-raiders,420000,2014
31983,570000,0,Ras-I Dowling,CB,active,oakland-raiders,570000,2014
31984,420000,0,Scott Simonson,TE,active,oakland-raiders,420000,2014
31985,420000,0,Bojay Filimoeatu,ILB,active,oakland-raiders,420000,2014
31986,495000,0,Chance Casey,CB,active,oakland-raiders,495000,2014
31987,420000,0,Spencer Hadley,OLB,active,oakland-raiders,420000,2014
31988,420000,0,Shelby Harris,DE,active,oakland-raiders,420000,2014
31989,2500000,2343750,LaMarr Woodley,OLB,injured_reserve,oakland-raiders,4843750,2014
31990,2850000,921250,Nick Roach,ILB,injured_reserve,oakland-raiders,3771250,2014
31991,1400000,2100000,Tarell Brown,CB,injured_reserve,oakland-raiders,3500000,2014
31992,1050000,2450000,Carlos Rogers,CB,injured_reserve,oakland-raiders,3500000,2014
31993,855000,380000,Usama Young,S,injured_reserve,oakland-raiders,1235000,2014
31994,495000,30000,Kory Sheets,RB,injured_reserve,oakland-raiders,525000,2014
31995,107100,0,Danny Kistler,RT,practice_squad,oakland-raiders,107100,2014
31996,107100,0,Lamar Mady,G,practice_squad,oakland-raiders,107100,2014
31997,107100,0,Seth Roberts,WR,practice_squad,oakland-raiders,107100,2014
31998,31500,0,Jansen Watson,CB,practice_squad,oakland-raiders,31500,2014
31999,18900,0,Kenny Shaw,WR,practice_squad,oakland-raiders,18900,2014
32000,18900,0,Evan Wilson,TE,practice_squad,oakland-raiders,18900,2014
32001,12600,0,Greg Jenkins,WR,practice_squad,oakland-raiders,12600,2014
32002,12600,0,Vernon Kearney,CB,practice_squad,oakland-raiders,12600,2014
32003,6300,0,Justin Jackson,OLB,practice_squad,oakland-raiders,6300,2014
32004,6300,0,Michael Palardy,K,practice_squad,oakland-raiders,6300,2014
32005,6208750,0,Michael Huff,S,dead_cap,oakland-raiders,6208750,2014
32006,3930000,0,Mike Brisiel,G,dead_cap,oakland-raiders,3930000,2014
32007,0,2625000,Matt Flynn,QB,dead_cap,oakland-raiders,2625000,2014
32008,1535000,778333,Kaluka Maiava,ILB,dead_cap,oakland-raiders,2313333,2014
32009,0,767500,Kevin Burnett,OLB,dead_cap,oakland-raiders,767500,2014
32010,338175,0,Tyler Wilson,QB,dead_cap,oakland-raiders,338175,2014
32011,301765,0,Jamar Chaney,ILB,dead_cap,oakland-raiders,301765,2014
32012,217041,0,Bojay Filimoeatu,ILB,dead_cap,oakland-raiders,217041,2014
32013,162318,13403,Shelby Harris,DE,dead_cap,oakland-raiders,175721,2014
32014,146517,0,Terrelle Pryor,WR,dead_cap,oakland-raiders,146517,2014
32015,100589,0,Kaelin Burnett,OLB,dead_cap,oakland-raiders,100589,2014
32016,94500,0,Spencer Hadley,OLB,dead_cap,oakland-raiders,94500,2014
32017,88200,0,Ras-I Dowling,CB,dead_cap,oakland-raiders,88200,2014
32018,81900,333,Scott Simonson,TE,dead_cap,oakland-raiders,82233,2014
32019,75600,3333,George Atkinson,RB,dead_cap,oakland-raiders,78933,2014
32020,75600,0,Ricky Lumpkin,DT,dead_cap,oakland-raiders,75600,2014
32021,51932,0,Christo Bilukidi,DT,dead_cap,oakland-raiders,51932,2014
32022,0,45606,Jack Crawford,DE,dead_cap,oakland-raiders,45606,2014
32023,44100,0,Denico Autry,DE,dead_cap,oakland-raiders,44100,2014
32024,36450,0,David Bass,DE,dead_cap,oakland-raiders,36450,2014
32025,0,36140,Juron Criner,WR,dead_cap,oakland-raiders,36140,2014
32026,26213,0,Richard Gordon,TE,dead_cap,oakland-raiders,26213,2014
32027,6667,0,John Wetzel,RT,dead_cap,oakland-raiders,6667,2014
32028,0,5000,D.J. Coles,WR,dead_cap,oakland-raiders,5000,2014
32029,0,4168,Lucas Nix,G,dead_cap,oakland-raiders,4168,2014
32030,0,4166,Danny Kistler,RT,dead_cap,oakland-raiders,4166,2014
32031,0,3333,Carlos Fields,OLB,dead_cap,oakland-raiders,3333,2014
32032,3000,0,Shelton Johnson,S,dead_cap,oakland-raiders,3000,2014
32033,0,2700,Mike Davis,WR,dead_cap,oakland-raiders,2700,2014
32034,2667,0,Lamar Mady,G,dead_cap,oakland-raiders,2667,2014
32035,2667,0,Conner Vernon,WR,dead_cap,oakland-raiders,2667,2014
32036,0,2000,Seth Roberts,WR,dead_cap,oakland-raiders,2000,2014
32037,0,2000,Karl Williams,FB,dead_cap,oakland-raiders,2000,2014
32038,2000,0,Sam McGuffie,WR,dead_cap,oakland-raiders,2000,2014
32039,0,1666,Jake Murphy,TE,dead_cap,oakland-raiders,1666,2014
32040,1334,0,Deonte Williams,RB,dead_cap,oakland-raiders,1334,2014
32041,1000,0,Billy Boyko,ILB,dead_cap,oakland-raiders,1000,2014
32042,668,0,Mario Kurn,LB,dead_cap,oakland-raiders,668,2014
32043,667,0,Chance Casey,CB,dead_cap,oakland-raiders,667,2014
32044,667,0,Eric Harper,OLB,dead_cap,oakland-raiders,667,2014
32045,667,0,Greg Jenkins,WR,dead_cap,oakland-raiders,667,2014
32046,667,0,Brian Leonhardt,TE,dead_cap,oakland-raiders,667,2014
32047,667,0,Andrew Robiskie,C,dead_cap,oakland-raiders,667,2014
32048,667,0,Kurt Taufa'asau,DT,dead_cap,oakland-raiders,667,2014
32049,667,0,Mitchell White,CB,dead_cap,oakland-raiders,667,2014
32050,0,666,Erle Ladson,LT,dead_cap,oakland-raiders,666,2014
32051,0,333,Ryan Robinson,DE,dead_cap,oakland-raiders,333,2014
32052,5700000,7300000,Rodney Hudson,C,active,oakland-raiders,13000000,2015
32053,3850000,4150000,Dan Williams,DT,active,oakland-raiders,8000000,2015
32054,3000000,3500000,Curtis Lofton,ILB,active,oakland-raiders,6500000,2015
32055,4600000,800000,Donald Penn,LT,active,oakland-raiders,5400000,2015
32056,510000,3734773,Khalil Mack,DE,active,oakland-raiders,4244773,2015
32057,1800000,2400000,Charles Woodson,SS,active,oakland-raiders,4200000,2015
32058,435000,3685566,Amari Cooper,WR,active,oakland-raiders,4120566,2015
32059,1750000,2250000,Malcolm Smith,OLB,active,oakland-raiders,4000000,2015
32060,3250000,360000,Sebastian Janikowski,K,active,oakland-raiders,3610000,2015
32061,2550000,1030838,Marcel Reece,FB,active,oakland-raiders,3580838,2015
32062,1500000,1850000,Lee Smith,TE,active,oakland-raiders,3350000,2015
32063,1400000,1800000,Michael Crabtree,WR,active,oakland-raiders,3200000,2015
32064,585000,2230554,D.J. Hayden,CB,active,oakland-raiders,2815554,2015
32065,2356000,0,Rod Streater,WR,active,oakland-raiders,2356000,2015
32066,1000000,1100000,Roy Helu,RB,active,oakland-raiders,2100000,2015
32067,970000,780000,Khalif Barnes,LT,active,oakland-raiders,1750000,2015
32068,1542000,0,Larry Asante,SS,active,oakland-raiders,1542000,2015
32069,1542000,0,Andre Holmes,WR,active,oakland-raiders,1542000,2015
32070,1542000,0,Marquette King,P,active,oakland-raiders,1542000,2015
32071,790896,516791,Menelik Watson,RT,active,oakland-raiders,1307687,2015
32072,664173,556691,Derek Carr,QB,active,oakland-raiders,1220864,2015
32073,1100000,50000,Taiwan Jones,RB,active,oakland-raiders,1150000,2015
32074,870000,0,Lorenzo Alexander,OLB,active,oakland-raiders,870000,2015
32075,660000,190000,Jamize Olawale,FB,active,oakland-raiders,850000,2015
32076,660000,126504,Tony Bergstrom,C,active,oakland-raiders,786504,2015
32077,525000,147844,Gabe Jackson,G,active,oakland-raiders,672844,2015
32078,435000,198626,Clive Walford,TE,active,oakland-raiders,633626,2015
32079,510000,118172,Justin Ellis,DT,active,oakland-raiders,628172,2015
32080,622131,0,David Amerson,CB,active,oakland-raiders,622131,2015
32081,510000,111300,Keith McGill,S,active,oakland-raiders,621300,2015
32082,585000,26550,Latavius Murray,RB,active,oakland-raiders,611550,2015
32083,585000,26213,Mychal Rivera,TE,active,oakland-raiders,611213,2015
32084,585000,19670,Stacy McGee,DT,active,oakland-raiders,604670,2015
32085,745000,0,J'Marcus Webb,RT,active,oakland-raiders,745000,2015
32086,585000,0,Benson Mayowa,DE,active,oakland-raiders,585000,2015
32087,585000,0,Matt McCants,RT,active,oakland-raiders,585000,2015
32088,585000,0,Matt McGloin,QB,active,oakland-raiders,585000,2015
32089,585000,0,Neiko Thorpe,CB,active,oakland-raiders,585000,2015
32090,435000,115163,Jon Feliciano,G,active,oakland-raiders,550163,2015
32091,510000,16741,Travis Carrie,CB,active,oakland-raiders,526741,2015
32092,510000,0,Denico Autry,DE,active,oakland-raiders,510000,2015
32093,435000,60681,Ben Heeney,ILB,active,oakland-raiders,495681,2015
32094,435000,14212,Dexter McDonald,CB,active,oakland-raiders,449212,2015
32095,435000,0,Seth Roberts,WR,active,oakland-raiders,435000,2015
32096,482058,0,Taylor Mays,SS,active,oakland-raiders,482058,2015
32097,318000,6666,Jimmy Hall,ILB,active,oakland-raiders,324666,2015
32098,300000,0,Korey Toomer,ILB,active,oakland-raiders,300000,2015
32099,232941,0,Jeremy Ross,WR,active,oakland-raiders,232941,2015
32100,210000,0,Shelby Harris,DE,active,oakland-raiders,210000,2015
32101,204705,0,Gabe Holmes,TE,active,oakland-raiders,204705,2015
32102,153529,0,Thomas Gafford,LS,active,oakland-raiders,153529,2015
32103,102352,0,Leon Orr,DT,active,oakland-raiders,102352,2015
32104,76764,0,Tevin McDonald,FS,active,oakland-raiders,76764,2015
32105,60000,0,John Lotulelei,OLB,active,oakland-raiders,60000,2015
32106,30000,0,Dewey McDonald,OLB,active,oakland-raiders,30000,2015
32107,25588,0,SaQwan Edwards,CB,active,oakland-raiders,25588,2015
32108,2900000,4100000,Nate Allen,FS,injured_reserve,oakland-raiders,7000000,2015
32109,4900000,1500000,Austin Howard,RT,injured_reserve,oakland-raiders,6400000,2015
32110,3350000,1618750,Justin Tuck,DE,injured_reserve,oakland-raiders,4968750,2015
32111,950000,177500,Jon Condo,LS,injured_reserve,oakland-raiders,1127500,2015
32112,421235,659029,Mario Edwards,DE,injured_reserve,oakland-raiders,1080264,2015
32113,433058,51331,Neiron Ball,OLB,injured_reserve,oakland-raiders,484389,2015
32114,318000,19253,Andre Debose,WR,injured_reserve,oakland-raiders,337253,2015
32115,0,6671000,Tyvon Branch,SS,dead_cap,oakland-raiders,6671000,2015
32116,1356764,1250000,C.J. Wilson,DT,dead_cap,oakland-raiders,2606764,2015
32117,0,1592500,Nick Roach,ILB,dead_cap,oakland-raiders,1592500,2015
32118,0,1500000,Christian Ponder,QB,dead_cap,oakland-raiders,1500000,2015
32119,0,750000,Trent Richardson,RB,dead_cap,oakland-raiders,750000,2015
32120,0,678333,Kaluka Maiava,ILB,dead_cap,oakland-raiders,678333,2015
32121,378529,0,Ray-Ray Armstrong,OLB,dead_cap,oakland-raiders,378529,2015
32122,251717,1166,Tevin McDonald,FS,dead_cap,oakland-raiders,252883,2015
32123,0,197708,Sio Moore,OLB,dead_cap,oakland-raiders,197708,2015
32124,150000,0,Walter Powell,WR,dead_cap,oakland-raiders,150000,2015
32125,141141,0,Kennan Lambert,SS,dead_cap,oakland-raiders,141141,2015
32126,89400,40209,Shelby Harris,DE,dead_cap,oakland-raiders,129609,2015
32127,92400,35393,Max Valles,DE,dead_cap,oakland-raiders,127793,2015
32128,112200,0,Mitchell Bell,G,dead_cap,oakland-raiders,112200,2015
32129,112200,0,Garrett Gilbert,QB,dead_cap,oakland-raiders,112200,2015
32130,105600,0,SaQwan Edwards,CB,dead_cap,oakland-raiders,105600,2015
32131,131470,0,Taylor Mays,SS,dead_cap,oakland-raiders,131470,2015
32132,85800,2833,Leon Orr,DT,dead_cap,oakland-raiders,88633,2015
32133,78388,3333,Gabe Holmes,TE,dead_cap,oakland-raiders,81721,2015
32134,56118,19874,Anthony Morris,T,dead_cap,oakland-raiders,75992,2015
32135,75146,0,Miles Burris,ILB,dead_cap,oakland-raiders,75146,2015
32136,75000,0,Greg Little,WR,dead_cap,oakland-raiders,75000,2015
32137,72600,0,Deandre Carter,WR,dead_cap,oakland-raiders,72600,2015
32138,59400,6667,George Atkinson,RB,dead_cap,oakland-raiders,66067,2015
32139,61411,0,Chimdi Chekwa,CB,dead_cap,oakland-raiders,61411,2015
32140,0,60300,Nick Kasa,TE,dead_cap,oakland-raiders,60300,2015
32141,52800,0,Rajion Neal,RB,dead_cap,oakland-raiders,52800,2015
32142,34411,16875,Brice Butler,WR,dead_cap,oakland-raiders,51286,2015
32143,0,45606,Jack Crawford,DE,dead_cap,oakland-raiders,45606,2015
32144,38823,0,Marcus Thigpen,WR,dead_cap,oakland-raiders,38823,2015
32145,0,36140,Juron Criner,WR,dead_cap,oakland-raiders,36140,2015
32146,33000,0,Colton Underwood,DE,dead_cap,oakland-raiders,33000,2015
32147,26400,1666,Josh Shirley,OLB,dead_cap,oakland-raiders,28066,2015
32148,26400,0,John Lotulelei,OLB,dead_cap,oakland-raiders,26400,2015
32149,26400,0,Dewey McDonald,OLB,dead_cap,oakland-raiders,26400,2015
32150,19800,0,Larry Pinkard,WR,dead_cap,oakland-raiders,19800,2015
32151,0,15000,James Dockery,CB,dead_cap,oakland-raiders,15000,2015
32152,6600,8334,Danny Kistler,RT,dead_cap,oakland-raiders,14934,2015
32153,13200,0,Adam Gettis,G,dead_cap,oakland-raiders,13200,2015
32154,13200,0,Chris Hackett,FS,dead_cap,oakland-raiders,13200,2015
32155,0,11474,Jonathan Dowling,FS,dead_cap,oakland-raiders,11474,2015
32156,0,6667,Carlos Fields,OLB,dead_cap,oakland-raiders,6667,2015
32157,6600,0,Cole Manhart,G,dead_cap,oakland-raiders,6600,2015
32158,6600,0,Jeremy Ross,WR,dead_cap,oakland-raiders,6600,2015
32159,6600,0,Korey Toomer,ILB,dead_cap,oakland-raiders,6600,2015
32160,0,5400,Mike Davis,WR,dead_cap,oakland-raiders,5400,2015
32161,0,4667,Denico Autry,DE,dead_cap,oakland-raiders,4667,2015
32162,0,4166,Robertson Daniel,CB,dead_cap,oakland-raiders,4166,2015
32163,0,4166,Cody Fajardo,QB,dead_cap,oakland-raiders,4166,2015
32164,0,4000,Seth Roberts,WR,dead_cap,oakland-raiders,4000,2015
32165,0,4000,Karl Williams,FB,dead_cap,oakland-raiders,4000,2015
32166,0,3334,Jake Murphy,TE,dead_cap,oakland-raiders,3334,2015
32167,0,2500,Josh Harper,WR,dead_cap,oakland-raiders,2500,2015
32168,0,1334,Erle Ladson,LT,dead_cap,oakland-raiders,1334,2015
32169,0,667,Scott Simonson,TE,dead_cap,oakland-raiders,667,2015
32170,0,666,Quinterrius Eatmon,T,dead_cap,oakland-raiders,666,2015
32171,0,500,Michael Dyer,RB,dead_cap,oakland-raiders,500,2015
32172,0,334,Ryan Robinson,DE,dead_cap,oakland-raiders,334,2015
32173,6700000,6500000,Kelechi Osemele,G,active,oakland-raiders,13200000,2016
32174,6250000,6250000,Bruce Irvin,OLB,active,oakland-raiders,12500000,2016
32175,5750000,5250000,Sean Smith,CB,active,oakland-raiders,11000000,2016
32176,5000000,6000000,Michael Crabtree,WR,active,oakland-raiders,11000000,2016
32177,7350000,350000,Rodney Hudson,C,active,oakland-raiders,7700000,2016
32178,7350000,150000,Dan Williams,DT,active,oakland-raiders,7500000,2016
32179,3500000,2600000,Donald Penn,LT,active,oakland-raiders,6100000,2016
32180,2000000,4000000,Reggie Nelson,FS,active,oakland-raiders,6000000,2016
32181,4400000,1500000,Austin Howard,RT,active,oakland-raiders,5900000,2016
32182,525000,4625708,Amari Cooper,WR,active,oakland-raiders,5150708,2016
32183,600000,4493727,Khalil Mack,DE,active,oakland-raiders,5093727,2016
32184,1400000,3650000,Marquette King,P,active,oakland-raiders,5050000,2016
32185,1000000,3050000,David Amerson,CB,active,oakland-raiders,4050000,2016
32186,3600000,360000,Sebastian Janikowski,K,active,oakland-raiders,3960000,2016
32187,2750000,250000,Malcolm Smith,OLB,active,oakland-raiders,3000000,2016
32188,2400000,600000,Nate Allen,FS,active,oakland-raiders,3000000,2016
32189,2553000,0,Matt McGloin,QB,active,oakland-raiders,2553000,2016
32190,760000,1430000,Jamize Olawale,FB,active,oakland-raiders,2190000,2016
32191,450000,1710785,Karl Joseph,SS,active,oakland-raiders,2160785,2016
32192,1250000,750000,Andre Holmes,WR,active,oakland-raiders,2000000,2016
32193,1671000,26213,Mychal Rivera,TE,active,oakland-raiders,1697213,2016
32194,1008844,516791,Menelik Watson,RT,active,oakland-raiders,1525635,2016
32195,733346,731691,Derek Carr,QB,active,oakland-raiders,1465037,2016
32196,708508,659029,Mario Edwards,DE,active,oakland-raiders,1367537,2016
32197,1000000,177500,Jon Condo,LS,active,oakland-raiders,1177500,2016
32198,1100000,50000,Taiwan Jones,RB,active,oakland-raiders,1150000,2016
32199,450000,557236,Jihad Ward,DE,active,oakland-raiders,1007236,2016
32200,675000,175000,Daren Bates,ILB,active,oakland-raiders,850000,2016
32201,675000,150000,Brynden Trawick,SS,active,oakland-raiders,825000,2016
32202,582500,198626,Clive Walford,TE,active,oakland-raiders,781126,2016
32203,615000,147844,Gabe Jackson,G,active,oakland-raiders,762844,2016
32204,600000,118172,Justin Ellis,DT,active,oakland-raiders,718172,2016
32205,600000,111300,Keith McGill,S,active,oakland-raiders,711300,2016
32206,675000,26550,Latavius Murray,RB,active,oakland-raiders,701550,2016
32207,675000,19670,Stacy McGee,DT,active,oakland-raiders,694670,2016
32208,525000,115163,Jon Feliciano,G,active,oakland-raiders,640163,2016
32209,600000,16741,Travis Carrie,CB,active,oakland-raiders,616741,2016
32210,450000,154972,Connor Cook,QB,active,oakland-raiders,604972,2016
32211,600000,0,Denico Autry,DE,active,oakland-raiders,600000,2016
32212,581176,0,Perry Riley,ILB,active,oakland-raiders,581176,2016
32213,525000,14212,Dexter McDonald,CB,active,oakland-raiders,539212,2016
32214,525000,0,Seth Roberts,WR,active,oakland-raiders,525000,2016
32215,450000,67298,DeAndre Washington,RB,active,oakland-raiders,517298,2016
32216,450000,33119,Cory James,ILB,active,oakland-raiders,483119,2016
32217,450000,19211,Vadal Alexander,RT,active,oakland-raiders,469211,2016
32218,450000,2500,Darius Latham,DT,active,oakland-raiders,452500,2016
32219,450000,1833,Antonio Hamilton,S,active,oakland-raiders,451833,2016
32220,450000,1666,Johnny Holton,WR,active,oakland-raiders,451666,2016
32221,450000,0,Jalen Richard,RB,active,oakland-raiders,450000,2016
32222,370580,0,Denver Kirkland,G,active,oakland-raiders,370580,2016
32223,158820,0,Tyrell Adams,OLB,active,oakland-raiders,158820,2016
32224,158820,0,James Cowser,OLB,active,oakland-raiders,158820,2016
32225,132350,0,Branden Jackson,DE,active,oakland-raiders,132350,2016
32226,675000,2609813,D.J. Hayden,CB,injured_reserve,oakland-raiders,3284813,2016
32227,2500000,250000,Lee Smith,TE,injured_reserve,oakland-raiders,2750000,2016
32228,450000,197533,Shilique Calhoun,OLB,injured_reserve,oakland-raiders,647533,2016
32229,525000,0,Gabe Holmes,TE,injured_reserve,oakland-raiders,525000,2016
32230,389645,60681,Ben Heeney,ILB,injured_reserve,oakland-raiders,450326,2016
32231,348000,51331,Neiron Ball,OLB,injured_reserve,oakland-raiders,399331,2016
32232,333000,0,SaQwan Edwards,CB,injured_reserve,oakland-raiders,333000,2016
32233,3500000,0,Curtis Lofton,ILB,dead_cap,oakland-raiders,3500000,2016
32234,2141176,930838,Marcel Reece,FB,dead_cap,oakland-raiders,3072014,2016
32235,436766,325000,Matt McCants,RT,dead_cap,oakland-raiders,761766,2016
32236,247390,0,Ryan O'Malley,TE,dead_cap,oakland-raiders,247390,2016
32237,0,172708,Sio Moore,OLB,dead_cap,oakland-raiders,172708,2016
32238,117300,0,K.J. Brent,WR,dead_cap,oakland-raiders,117300,2016
32239,117300,0,Kenneth Durden,S,dead_cap,oakland-raiders,117300,2016
32240,117300,0,Jaydon Mickens,WR,dead_cap,oakland-raiders,117300,2016
32241,117300,0,Oni Omoile,G,dead_cap,oakland-raiders,117300,2016
32242,110400,0,Jimmy Bean,DE,dead_cap,oakland-raiders,110400,2016
32243,0,106179,Max Valles,DE,dead_cap,oakland-raiders,106179,2016
32244,0,100000,Roy Helu,RB,dead_cap,oakland-raiders,100000,2016
32245,82800,0,Cooper Helfet,TE,dead_cap,oakland-raiders,82800,2016
32246,82800,0,Branden Jackson,DE,dead_cap,oakland-raiders,82800,2016
32247,75900,0,Ian Silberman,G,dead_cap,oakland-raiders,75900,2016
32248,0,59623,Anthony Morris,T,dead_cap,oakland-raiders,59623,2016
32249,48300,0,Tyrell Adams,OLB,dead_cap,oakland-raiders,48300,2016
32250,48300,0,James Cowser,OLB,dead_cap,oakland-raiders,48300,2016
32251,41400,0,Demetrius Cherry,DT,dead_cap,oakland-raiders,41400,2016
32252,34500,0,Takoby Cofield,T,dead_cap,oakland-raiders,34500,2016
32253,0,22948,Jonathan Dowling,FS,dead_cap,oakland-raiders,22948,2016
32254,20700,0,Denver Kirkland,G,dead_cap,oakland-raiders,20700,2016
32255,20700,0,Korey Toomer,ILB,dead_cap,oakland-raiders,20700,2016
32256,0,19253,Andre Debose,WR,dead_cap,oakland-raiders,19253,2016
32257,0,16875,Brice Butler,WR,dead_cap,oakland-raiders,16875,2016
32258,13800,0,Curtis Grant,ILB,dead_cap,oakland-raiders,13800,2016
32259,13800,0,Darnell Sankey,ILB,dead_cap,oakland-raiders,13800,2016
32260,0,8334,Robertson Daniel,CB,dead_cap,oakland-raiders,8334,2016
32261,0,8334,Cody Fajardo,QB,dead_cap,oakland-raiders,8334,2016
32262,6900,0,Jason Fanaika,DE,dead_cap,oakland-raiders,6900,2016
32263,0,6667,Gabe Holmes,TE,dead_cap,oakland-raiders,6667,2016
32264,0,6666,Jimmy Hall,ILB,dead_cap,oakland-raiders,6666,2016
32265,0,5667,Leon Orr,DT,dead_cap,oakland-raiders,5667,2016
32266,0,5000,Josh Harper,WR,dead_cap,oakland-raiders,5000,2016
32267,0,3334,Josh Shirley,OLB,dead_cap,oakland-raiders,3334,2016
32268,0,2334,Tevin McDonald,FS,dead_cap,oakland-raiders,2334,2016
32269,0,1666,Kyrie Wilson,OLB,dead_cap,oakland-raiders,1666,2016
32270,0,1334,Quinterrius Eatmon,T,dead_cap,oakland-raiders,1334,2016
32271,0,1000,Michael Dyer,RB,dead_cap,oakland-raiders,1000,2016
32272,5000000,10731691,Derek Carr,QB,active,oakland-raiders,15731691,2017
32273,6700000,6800000,Kelechi Osemele,G,active,oakland-raiders,13500000,2017
32274,5250000,5397844,Gabe Jackson,G,active,oakland-raiders,10647844,2017
32275,5000000,4500000,Sean Smith,CB,active,oakland-raiders,9500000,2017
32276,6500000,2000000,David Amerson,CB,active,oakland-raiders,8500000,2017
32277,4500000,2500000,Bruce Irvin,OLB,active,oakland-raiders,7000000,2017
32278,6250000,718750,Michael Crabtree,WR,active,oakland-raiders,6968750,2017
32279,6500000,450000,Rodney Hudson,C,active,oakland-raiders,6950000,2017
32280,615000,5565850,Amari Cooper,WR,active,oakland-raiders,6180850,2017
32281,2750000,3250000,Reggie Nelson,FS,active,oakland-raiders,6000000,2017
32282,690000,5252682,Khalil Mack,DE,active,oakland-raiders,5942682,2017
32283,2500000,3100000,Cordarrelle Patterson,WR,active,oakland-raiders,5600000,2017
32284,2500000,2800000,Jared Cook,TE,active,oakland-raiders,5300000,2017
32285,990196,1710785,Karl Joseph,SS,active,oakland-raiders,2700981,2017
32286,1350000,1275000,Marshawn Lynch,RB,active,oakland-raiders,2625000,2017
32287,2400000,150000,Marquette King,P,active,oakland-raiders,2550000,2017
32288,1000000,1000000,Seth Roberts,WR,active,oakland-raiders,2000000,2017
32289,1797000,118172,Justin Ellis,DT,active,oakland-raiders,1915172,2017
32290,1797000,16741,Travis Carrie,CB,active,oakland-raiders,1813741,2017
32291,1797000,0,Denico Autry,DE,active,oakland-raiders,1797000,2017
32292,1500000,290000,Jamize Olawale,FB,active,oakland-raiders,1790000,2017
32293,1050000,700000,Marshall Newhouse,RT,active,oakland-raiders,1750000,2017
32294,982015,659029,Mario Edwards,DE,active,oakland-raiders,1641044,2017
32295,1000000,500000,Lee Smith,TE,active,oakland-raiders,1500000,2017
32296,701809,557236,Jihad Ward,DE,active,oakland-raiders,1259045,2017
32297,880000,120000,Navorro Bowman,ILB,active,oakland-raiders,1000000,2017
32298,690000,111300,Keith McGill,S,active,oakland-raiders,801300,2017
32299,1000000,80000,Jon Condo,LS,active,oakland-raiders,1080000,2017
32300,540000,154972,Connor Cook,QB,active,oakland-raiders,694972,2017
32301,465000,190303,Eddie Vanderdoes,DT,active,oakland-raiders,655303,2017
32302,775000,25000,E.J. Manuel,QB,active,oakland-raiders,800000,2017
32303,615000,14212,Dexter McDonald,CB,active,oakland-raiders,629212,2017
32304,465000,146603,David Sharpe,T,active,oakland-raiders,611603,2017
32305,540000,67298,DeAndre Washington,RB,active,oakland-raiders,607298,2017
32306,540000,19211,Vadal Alexander,RT,active,oakland-raiders,559211,2017
32307,540000,1666,Johnny Holton,WR,active,oakland-raiders,541666,2017
32308,540000,0,James Cowser,OLB,active,oakland-raiders,540000,2017
32309,540000,0,Jalen Richard,RB,active,oakland-raiders,540000,2017
32310,465000,63423,Marquel Lee,ILB,active,oakland-raiders,528423,2017
32311,465000,23603,Shalom Luani,S,active,oakland-raiders,488603,2017
32312,465000,21073,Jylan Ware,T,active,oakland-raiders,486073,2017
32313,465000,17150,Treyvon Hester,DT,active,oakland-raiders,482150,2017
32314,465000,2500,Nicholas Morrow,OLB,active,oakland-raiders,467500,2017
32315,465000,0,Erik Harris,CB,active,oakland-raiders,465000,2017
32316,465000,0,Giorgio Tavecchio,K,active,oakland-raiders,465000,2017
32317,446294,1833,Antonio Hamilton,S,active,oakland-raiders,448127,2017
32318,381176,0,Shilique Calhoun,OLB,active,oakland-raiders,381176,2017
32319,136765,0,Isaac Whitney,WR,active,oakland-raiders,136765,2017
32320,95294,0,Darius Latham,DT,active,oakland-raiders,95294,2017
32321,72353,0,Ian Silberman,G,active,oakland-raiders,72353,2017
32322,72353,0,James Stone,C,active,oakland-raiders,72353,2017
32323,54706,0,Pharaoh Brown,TE,active,oakland-raiders,54706,2017
32324,54706,0,Brady Sheldon,OLB,active,oakland-raiders,54706,2017
32325,5800000,1350000,Donald Penn,LT,injured_reserve,oakland-raiders,7150000,2017
32326,3000000,360000,Sebastian Janikowski,K,injured_reserve,oakland-raiders,3360000,2017
32327,416824,1438168,Gareon Conley,CB,injured_reserve,oakland-raiders,1854992,2017
32328,710646,198626,Clive Walford,TE,injured_reserve,oakland-raiders,909272,2017
32329,409937,354887,Obi Melifonwu,S,injured_reserve,oakland-raiders,764824,2017
32330,615000,115163,Jon Feliciano,G,injured_reserve,oakland-raiders,730163,2017
32331,508765,33119,Cory James,ILB,injured_reserve,oakland-raiders,541884,2017
32332,363000,0,Denver Kirkland,G,injured_reserve,oakland-raiders,363000,2017
32333,0,1500000,Austin Howard,RT,dead_cap,oakland-raiders,1500000,2017
32334,410295,0,Xavier Woodson-Luster,ILB,dead_cap,oakland-raiders,410295,2017
32335,293082,2500,Darius Latham,DT,dead_cap,oakland-raiders,295582,2017
32336,36000,222533,Shilique Calhoun,OLB,dead_cap,oakland-raiders,258533,2017
32337,190590,0,Tyrell Adams,OLB,dead_cap,oakland-raiders,190590,2017
32338,142553,17437,Elijah Hood,RB,dead_cap,oakland-raiders,159990,2017
32339,0,150000,Jelani Jenkins,OLB,dead_cap,oakland-raiders,150000,2017
32340,122400,0,Fadol Brown,DE,dead_cap,oakland-raiders,122400,2017
32341,122400,0,Keon Hatcher,WR,dead_cap,oakland-raiders,122400,2017
32342,122400,0,Jordan Simmons,T,dead_cap,oakland-raiders,122400,2017
32343,121765,0,Demetrius McCray,CB,dead_cap,oakland-raiders,121765,2017
32344,108000,0,Pharaoh Brown,TE,dead_cap,oakland-raiders,108000,2017
32345,108000,0,James Stone,C,dead_cap,oakland-raiders,108000,2017
32346,100800,0,Breon Borders,CB,dead_cap,oakland-raiders,100800,2017
32347,86400,0,Isaac Whitney,WR,dead_cap,oakland-raiders,86400,2017
32348,72000,0,Tevin Mitchel,CB,dead_cap,oakland-raiders,72000,2017
32349,0,60681,Ben Heeney,ILB,dead_cap,oakland-raiders,60681,2017
32350,0,51331,Neiron Ball,OLB,dead_cap,oakland-raiders,51331,2017
32351,0,50000,Giorgio Tavecchio,K,dead_cap,oakland-raiders,50000,2017
32352,0,50000,Taiwan Jones,RB,dead_cap,oakland-raiders,50000,2017
32353,0,38507,Andre Debose,WR,dead_cap,oakland-raiders,38507,2017
32354,36000,0,Boseko Lokombo,OLB,dead_cap,oakland-raiders,36000,2017
32355,28800,0,Brady Sheldon,OLB,dead_cap,oakland-raiders,28800,2017
32356,28800,0,Deontae Skinner,OLB,dead_cap,oakland-raiders,28800,2017
32357,21600,0,Joby Saint Fleur,DE,dead_cap,oakland-raiders,21600,2017
32358,21600,0,Max Valles,DE,dead_cap,oakland-raiders,21600,2017
32359,14400,0,Marcus Lucas,TE,dead_cap,oakland-raiders,14400,2017
32360,14400,0,Stefan McClure,S,dead_cap,oakland-raiders,14400,2017
32361,14400,0,Shakir Soto,DE,dead_cap,oakland-raiders,14400,2017
32362,0,13334,Jimmy Hall,ILB,dead_cap,oakland-raiders,13334,2017
32363,7200,0,Darius Hillary,CB,dead_cap,oakland-raiders,7200,2017
32364,7200,0,Tevaun Smith,WR,dead_cap,oakland-raiders,7200,2017
32365,0,3334,Kyrie Wilson,OLB,dead_cap,oakland-raiders,3334,2017
32366,7400000,17600000,Derek Carr,QB,active,oakland-raiders,25000000,2018
32367,9700000,800000,Kelechi Osemele,G,active,oakland-raiders,10500000,2018
32368,3400000,5768750,Jordy Nelson,WR,active,oakland-raiders,9168750,2018
32369,3100000,4316666,Tahir Whitehead,OLB,active,oakland-raiders,7416666,2018
32370,5000000,675000,Jared Cook,TE,active,oakland-raiders,5675000,2018
32371,1850000,3587500,Rashaan Melvin,CB,active,oakland-raiders,5437500,2018
32372,2000000,2500000,Marcus Gilchrist,FS,active,oakland-raiders,4500000,2018
32373,2250000,2200000,Seth Roberts,WR,active,oakland-raiders,4450000,2018
32374,2500000,1750000,Justin Ellis,DT,active,oakland-raiders,4250000,2018
32375,2000000,1616667,Lee Smith,TE,active,oakland-raiders,3616667,2018
32376,1530392,1710785,Karl Joseph,SS,active,oakland-raiders,3241177,2018
32377,880000,2120000,Johnathan Hankins,DT,active,oakland-raiders,3000000,2018
32378,915000,1867000,Rodney Hudson,C,active,oakland-raiders,2782000,2018
32379,480000,1969331,Kolton Miller,LT,active,oakland-raiders,2449331,2018
32380,940792,1438168,Gareon Conley,CB,active,oakland-raiders,2378960,2018
32381,1150000,850000,Derek Carrier,TE,active,oakland-raiders,2000000,2018
32382,880000,1070000,Clinton McDonald,DT,active,oakland-raiders,1950000,2018
32383,790000,710000,Keith Smith,FB,active,oakland-raiders,1500000,2018
32384,850000,625000,Doug Martin,RB,active,oakland-raiders,1475000,2018
32385,790000,460000,Kyle Wilber,OLB,active,oakland-raiders,1250000,2018
32386,900000,0,A.J. McCarron,QB,active,oakland-raiders,900000,2018
32387,480000,375324,P.J. Hall,DT,active,oakland-raiders,855324,2018
32388,480000,264606,Brandon Parker,T,active,oakland-raiders,744606,2018
32389,915000,90000,Dwayne Harris,WR,active,oakland-raiders,1005000,2018
32390,630000,67298,DeAndre Washington,RB,active,oakland-raiders,697298,2018
32391,480000,206594,Arden Key,DE,active,oakland-raiders,686594,2018
32392,1015000,25000,Frostee Rucker,DT,active,oakland-raiders,1040000,2018
32393,480000,174670,Nick Nelson,CB,active,oakland-raiders,654670,2018
32394,630000,0,Erik Harris,SS,active,oakland-raiders,630000,2018
32395,630000,0,Jalen Richard,RB,active,oakland-raiders,630000,2018
32396,555000,63423,Marquel Lee,ILB,active,oakland-raiders,618423,2018
32397,480000,79761,Maurice Hurst,DT,active,oakland-raiders,559761,2018
32398,555000,2500,Nicholas Morrow,OLB,active,oakland-raiders,557500,2018
32399,480000,54388,Johnny Townsend,P,active,oakland-raiders,534388,2018
32400,480000,0,Justin Murray,T,active,oakland-raiders,480000,2018
32401,451765,0,Ternt Sieg,LS,active,oakland-raiders,451765,2018
32402,310588,0,Jason Cabinda,LB,active,oakland-raiders,310588,2018
32403,293824,0,David Sharpe,T,active,oakland-raiders,293824,2018
32404,282353,0,Daniel Carlson,K,active,oakland-raiders,282353,2018
32405,282350,0,Marcell Ateman,WR,active,oakland-raiders,282350,2018
32406,207355,0,Chaz Green,G,active,oakland-raiders,207355,2018
32407,185882,0,Bene Benwikere,CB,active,oakland-raiders,185882,2018
32408,185882,0,Kony Ealy,DT,active,oakland-raiders,185882,2018
32409,185294,0,Darren Waller,TE,active,oakland-raiders,185294,2018
32410,169410,0,Keon Hatcher,WR,active,oakland-raiders,169410,2018
32411,165882,0,Denzelle Good,RT,active,oakland-raiders,165882,2018
32412,141175,0,Montrel Meander,S,active,oakland-raiders,141175,2018
32413,97941,0,Denver Kirkland,G,active,oakland-raiders,97941,2018
32414,84705,0,Cameron Hunt,G,active,oakland-raiders,84705,2018
32415,74118,0,Gabe Wright,DT,active,oakland-raiders,74118,2018
32416,56470,0,Paul Butler,TE,active,oakland-raiders,56470,2018
32417,56470,0,Rico Gafford,CB,active,oakland-raiders,56470,2018
32418,56470,0,Dallin Leavitt,S,active,oakland-raiders,56470,2018
32419,4250000,6250000,Gabe Jackson,G,injured_reserve,oakland-raiders,10500000,2018
32420,3000000,1350000,Donald Penn,RT,injured_reserve,oakland-raiders,4350000,2018
32421,2500000,1531250,Marshawn Lynch,RB,injured_reserve,oakland-raiders,4031250,2018
32422,1150000,1271875,Reggie Nelson,FS,injured_reserve,oakland-raiders,2421875,2018
32423,915000,1397500,Brandon LaFell,WR,injured_reserve,oakland-raiders,2312500,2018
32424,1907000,0,T.J. Clemmings,RT,injured_reserve,oakland-raiders,1907000,2018
32425,1458295,0,Martavis Bryant,WR,injured_reserve,oakland-raiders,1458295,2018
32426,790000,610000,Andrew DePaola,LS,injured_reserve,oakland-raiders,1400000,2018
32427,705000,115163,Jon Feliciano,G,injured_reserve,oakland-raiders,820163,2018
32428,915000,90000,Leon Hall,CB,injured_reserve,oakland-raiders,1005000,2018
32429,705000,14214,Dexter McDonald,CB,injured_reserve,oakland-raiders,719214,2018
32430,493058,0,Shilique Calhoun,OLB,injured_reserve,oakland-raiders,493058,2018
32431,453883,0,Daryl Worley,CB,injured_reserve,oakland-raiders,453883,2018
32432,597471,0,Mike Nugent,K,injured_reserve,oakland-raiders,597471,2018
32433,508000,0,Ahtyba Rubin,DT,injured_reserve,oakland-raiders,508000,2018
32434,363000,8333,Eddy Piniero,K,injured_reserve,oakland-raiders,371333,2018
32435,363000,0,Tevin Mitchel,CB,injured_reserve,oakland-raiders,363000,2018
32436,363000,0,Chris Warren,RB,injured_reserve,oakland-raiders,363000,2018
32437,331765,0,Jacquies Smith,OLB,injured_reserve,oakland-raiders,331765,2018
32438,8000000,250000,Bruce Irvin,DE,dead_cap,oakland-raiders,8250000,2018
32439,288235,6510993,Amari Cooper,WR,dead_cap,oakland-raiders,6799228,2018
32440,1300000,200000,Derrick Johnson,ILB,dead_cap,oakland-raiders,1500000,2018
32441,0,1400000,Austin Howard,RT,dead_cap,oakland-raiders,1400000,2018
32442,0,1300000,Breno Giacomini,RT,dead_cap,oakland-raiders,1300000,2018
32443,915000,335000,Cornellius Carradine,DE,dead_cap,oakland-raiders,1250000,2018
32444,0,1114473,Jihad Ward,DE,dead_cap,oakland-raiders,1114473,2018
32445,669972,354887,Obi Melifonwu,S,dead_cap,oakland-raiders,1024859,2018
32446,0,659031,Mario Edwards,DE,dead_cap,oakland-raiders,659031,2018
32447,697065,90000,Emmanuel Lamur,OLB,dead_cap,oakland-raiders,787065,2018
32448,40247,395066,Shilique Calhoun,OLB,dead_cap,oakland-raiders,435313,2018
32449,367055,0,Fadol Brown,DE,dead_cap,oakland-raiders,367055,2018
32450,333531,0,Ian Silberman,G,dead_cap,oakland-raiders,333531,2018
32451,296471,0,Dominique Rodgers-Cromartie,CB,dead_cap,oakland-raiders,296471,2018
32452,238495,0,Denver Kirkland,G,dead_cap,oakland-raiders,238495,2018
32453,170824,50000,Shaquille Richardson,CB,dead_cap,oakland-raiders,220824,2018
32454,206305,0,Saeed Blacknall,WR,dead_cap,oakland-raiders,206305,2018
32455,0,198626,Clive Walford,TE,dead_cap,oakland-raiders,198626,2018
32456,0,190000,Jamize Olawale,FB,dead_cap,oakland-raiders,190000,2018
32457,0,154972,Connor Cook,QB,dead_cap,oakland-raiders,154972,2018
32458,151059,1668,Johnny Holton,WR,dead_cap,oakland-raiders,152727,2018
32459,0,150000,Marquette King,P,dead_cap,oakland-raiders,150000,2018
32460,0,146603,David Sharpe,T,dead_cap,oakland-raiders,146603,2018
32461,129200,0,Ryan Yurachek,FB,dead_cap,oakland-raiders,129200,2018
32462,114000,0,Paul Butler,TE,dead_cap,oakland-raiders,114000,2018
32463,114000,0,Rico Gafford,CB,dead_cap,oakland-raiders,114000,2018
32464,114000,0,Dallin Leavitt,S,dead_cap,oakland-raiders,114000,2018
32465,112940,0,Matt McCrane,K,dead_cap,oakland-raiders,112940,2018
32466,139412,0,Damontre Moore,DE,dead_cap,oakland-raiders,139412,2018
32467,106400,0,Gabe Wright,DT,dead_cap,oakland-raiders,106400,2018
32468,0,100000,E.J. Manuel,QB,dead_cap,oakland-raiders,100000,2018
32469,90259,0,James Cowser,OLB,dead_cap,oakland-raiders,90259,2018
32470,0,90000,Shareece Wright,CB,dead_cap,oakland-raiders,90000,2018
32471,53200,23258,Marcell Ateman,WR,dead_cap,oakland-raiders,76458,2018
32472,76000,0,James Butler,RB,dead_cap,oakland-raiders,76000,2018
32473,74118,0,Brian Price,DT,dead_cap,oakland-raiders,74118,2018
32474,68400,0,Jamar McGloster,G,dead_cap,oakland-raiders,68400,2018
32475,0,66240,Cory James,ILB,dead_cap,oakland-raiders,66240,2018
32476,0,60681,Ben Heeney,ILB,dead_cap,oakland-raiders,60681,2018
32477,0,52313,Elijah Hood,RB,dead_cap,oakland-raiders,52313,2018
32478,0,51331,Neiron Ball,OLB,dead_cap,oakland-raiders,51331,2018
32479,46471,0,C.J. Anderson,RB,dead_cap,oakland-raiders,46471,2018
32480,45600,0,Jason Cabinda,LB,dead_cap,oakland-raiders,45600,2018
32481,46471,0,Kony Ealy,DT,dead_cap,oakland-raiders,46471,2018
32482,0,29602,Azeem Victor,ILB,dead_cap,oakland-raiders,29602,2018
32483,28235,0,Keon Hatcher,WR,dead_cap,oakland-raiders,28235,2018
32484,0,23603,Shalom Luani,S,dead_cap,oakland-raiders,23603,2018
32485,22800,0,Cayson Collins,LB,dead_cap,oakland-raiders,22800,2018
32486,0,21073,Jylan Ware,T,dead_cap,oakland-raiders,21073,2018
32487,0,19212,Vadal Alexander,RT,dead_cap,oakland-raiders,19212,2018
32488,0,17150,Treyvon Hester,DT,dead_cap,oakland-raiders,17150,2018
32489,15200,0,Nathan Peterman,QB,dead_cap,oakland-raiders,15200,2018
32490,15200,0,ArDarius Stewart,WR,dead_cap,oakland-raiders,15200,2018
32491,15200,0,Rashard Davis,WR,dead_cap,oakland-raiders,15200,2018
32492,7600,0,Makinton Dorleant,CB,dead_cap,oakland-raiders,7600,2018
32493,7600,0,Terrell Sinkfield,WR,dead_cap,oakland-raiders,7600,2018
32494,7600,0,Arrion Springs,S,dead_cap,oakland-raiders,7600,2018
32495,7600,0,Isaiah Williams,G,dead_cap,oakland-raiders,7600,2018
32496,0,2500,Darius Latham,DT,dead_cap,oakland-raiders,2500,2018
32497,0,1834,Antonio Hamilton,S,dead_cap,oakland-raiders,1834,2018
32498,19900000,2600000,Derek Carr,QB,active,oakland-raiders,22500000,2019
32499,8250000,1867000,Rodney Hudson,C,active,oakland-raiders,10117000,2019
32500,5000000,5100000,Tyrell Williams,WR,active,oakland-raiders,10100000,2019
32501,4700000,4350000,LaMarcus Joyner,FS,active,oakland-raiders,9050000,2019
32502,6750000,250000,Gabe Jackson,G,active,oakland-raiders,7000000,2019
32503,495000,5206966,Clelin Ferrell,DE,active,oakland-raiders,5701966,2019
32504,2950000,1341666,Tahir Whitehead,OLB,active,oakland-raiders,4291666,2019
32505,1000000,2875000,Johnathan Hankins,DT,active,oakland-raiders,3875000,2019
32506,3320004,0,Darren Waller,TE,active,oakland-raiders,3320004,2019
32507,3095000,0,Jalen Richard,RB,active,oakland-raiders,3095000,2019
32508,3095000,0,Daryl Worley,CB,active,oakland-raiders,3095000,2019
32509,1092333,1969331,Kolton Miller,RT,active,oakland-raiders,3061664,2019
32510,764706,2050000,Nevin Lawson,CB,active,oakland-raiders,2814706,2019
32511,1275000,1225000,Erik Harris,S,active,oakland-raiders,2500000,2019
32512,495000,1674709,Josh Jacobs,RB,active,oakland-raiders,2169709,2019
32513,1000000,865625,Mike Glennon,QB,active,oakland-raiders,1865625,2019
32514,1000000,800000,Denzelle Good,G,active,oakland-raiders,1800000,2019
32515,1600000,100000,Derek Carrier,TE,active,oakland-raiders,1700000,2019
32516,805000,895000,Benson Mayowa,DE,active,oakland-raiders,1700000,2019
32517,495000,824845,Trayvon Mullen,CB,active,oakland-raiders,1319845,2019
32518,1150000,0,Kyle Wilber,OLB,active,oakland-raiders,1150000,2019
32519,693830,375324,P.J. Hall,DT,active,oakland-raiders,1069154,2019
32520,666152,264606,Brandon Parker,T,active,oakland-raiders,930758,2019
32521,914856,0,DeShone Kizer,QB,active,oakland-raiders,914856,2019
32522,900000,0,Josh Mauro,DE,active,oakland-raiders,900000,2019
32523,720000,90000,Curtis Riley,FS,active,oakland-raiders,810000,2019
32524,495000,300000,Keelan Doss,WR,active,oakland-raiders,795000,2019
32525,720000,67302,DeAndre Washington,RB,active,oakland-raiders,787302,2019
32526,728009,0,Zay Jones,WR,active,oakland-raiders,728009,2019
32527,495000,195566,Maxx Crosby,DE,active,oakland-raiders,690566,2019
32528,570000,79761,Maurice Hurst,DT,active,oakland-raiders,649761,2019
32529,645000,2500,Nicholas Morrow,OLB,active,oakland-raiders,647500,2019
32530,645000,0,David Sharpe,T,active,oakland-raiders,645000,2019
32531,433056,165573,Isaiah Johnson,CB,active,oakland-raiders,598629,2019
32532,495000,78987,Hunter Renfrow,WR,active,oakland-raiders,573987,2019
32533,570000,0,Daniel Carlson,K,active,oakland-raiders,570000,2019
32534,570000,0,Trent Sieg,LS,active,oakland-raiders,570000,2019
32535,495000,5000,Keisean Nixon,CB,active,oakland-raiders,500000,2019
32536,495000,3333,Alec Ingold,FB,active,oakland-raiders,498333,2019
32537,495000,3333,Andre James,C,active,oakland-raiders,498333,2019
32538,495000,833,A.J. Cole,P,active,oakland-raiders,495833,2019
32539,495000,0,Dallin Leavitt,S,active,oakland-raiders,495000,2019
32540,402353,0,Marcell Ateman,WR,active,oakland-raiders,402353,2019
32541,426176,0,Will Compton,ILB,active,oakland-raiders,426176,2019
32542,331471,0,Dion Jordan,DE,active,oakland-raiders,331471,2019
32543,145588,0,Rico Gafford,CB,active,oakland-raiders,145588,2019
32544,127059,0,Olsen Pierre,DE,active,oakland-raiders,127059,2019
32545,127059,0,Eric Tomlinson,TE,active,oakland-raiders,127059,2019
32546,142059,0,Rod Smith,RB,active,oakland-raiders,142059,2019
32547,75882,0,Ukeme Eligwe,ILB,active,oakland-raiders,75882,2019
32548,58236,0,Lester Cotton,G,active,oakland-raiders,58236,2019
32549,33529,0,Jeremiah Valoaga,DE,active,oakland-raiders,33529,2019
32550,5000000,10250000,Trenton Brown,RT,injured_reserve,oakland-raiders,15250000,2019
32551,2070589,1710785,Karl Joseph,SS,injured_reserve,oakland-raiders,3781374,2019
32552,495000,1595035,Johnathan Abram,S,injured_reserve,oakland-raiders,2090035,2019
32553,930000,510000,Dwayne Harris,WR,injured_reserve,oakland-raiders,1440000,2019
32554,805000,445000,Isaiah Crowell,RB,injured_reserve,oakland-raiders,1250000,2019
32555,624250,206594,Arden Key,DE,injured_reserve,oakland-raiders,830844,2019
32556,805000,90000,Jordan Devey,G,injured_reserve,oakland-raiders,895000,2019
32557,645000,63423,Marquel Lee,ILB,injured_reserve,oakland-raiders,708423,2019
32558,474353,122098,Foster Moreau,TE,injured_reserve,oakland-raiders,596451,2019
32559,408000,0,Nathan Peterman,QB,injured_reserve,oakland-raiders,408000,2019
32560,393000,0,Makinton Dorleant,CB,injured_reserve,oakland-raiders,393000,2019
32561,393000,0,Cameron Hunt,G,injured_reserve,oakland-raiders,393000,2019
32562,378000,0,D.J. Killings,CB,injured_reserve,oakland-raiders,378000,2019
32563,100588,0,Nick Nelson,CB,injured_reserve,oakland-raiders,100588,2019
32564,88000,0,James Butler,RB,practice_squad,oakland-raiders,88000,2019
32565,32000,0,De'Mornay Pierson-El,WR,practice_squad,oakland-raiders,32000,2019
32566,24000,0,Te'Von Coney,LB,practice_squad,oakland-raiders,24000,2019
32567,2250000,2500000,Justin Ellis,DT,dead_cap,oakland-raiders,4750000,2019
32568,583299,1438168,Gareon Conley,CB,dead_cap,oakland-raiders,2021467,2019
32569,0,1800000,Jordy Nelson,WR,dead_cap,oakland-raiders,1800000,2019
32570,0,1750000,Donald Penn,RT,dead_cap,oakland-raiders,1750000,2019
32571,860294,333333,Antonio Brown,WR,dead_cap,oakland-raiders,1193627,2019
32572,805000,195000,Ryan Grant,WR,dead_cap,oakland-raiders,1000000,2019
32573,805000,195000,J.J. Nelson,WR,dead_cap,oakland-raiders,1000000,2019
32574,930000,70000,Corey Liuget,DT,dead_cap,oakland-raiders,1000000,2019
32575,500000,350000,Kyle Wilber,OLB,dead_cap,oakland-raiders,850000,2019
32576,786176,0,Jonathan Cooper,G,dead_cap,oakland-raiders,786176,2019
32577,0,733335,Lee Smith,TE,dead_cap,oakland-raiders,733335,2019
32578,0,709774,Obi Melifonwu,S,dead_cap,oakland-raiders,709774,2019
32579,247353,295000,Brandon Marshall,ILB,dead_cap,oakland-raiders,542353,2019
32580,508235,0,Trevor Davis,WR,dead_cap,oakland-raiders,508235,2019
32581,0,500000,Josh Mauro,DT,dead_cap,oakland-raiders,500000,2019
32582,159765,190303,Eddie Vanderdoes,DT,dead_cap,oakland-raiders,350068,2019
32583,0,293206,David Sharpe,T,dead_cap,oakland-raiders,293206,2019
32584,104000,174670,Nick Nelson,CB,dead_cap,oakland-raiders,278670,2019
32585,328235,0,Terrell McClain,DT,dead_cap,oakland-raiders,328235,2019
32586,221000,2500,Dylan Mabin,CB,dead_cap,oakland-raiders,223500,2019
32587,100000,90000,Luke Willson,TE,dead_cap,oakland-raiders,190000,2019
32588,236765,0,D.J. Swearinger,FS,dead_cap,oakland-raiders,236765,2019
32589,183765,0,Erik Magnunson,T,dead_cap,oakland-raiders,183765,2019
32590,0,154972,Connor Cook,QB,dead_cap,oakland-raiders,154972,2019
32591,145588,0,Dakota Allen,LB,dead_cap,oakland-raiders,145588,2019
32592,141118,2500,Lester Cotton,G,dead_cap,oakland-raiders,143618,2019
32593,65529,69777,Marcell Ateman,WR,dead_cap,oakland-raiders,135306,2019
32594,142059,0,Preston Brown,ILB,dead_cap,oakland-raiders,142059,2019
32595,96000,10300,Rico Gafford,CB,dead_cap,oakland-raiders,106300,2019
32596,101118,0,Quentin Poling,ILB,dead_cap,oakland-raiders,101118,2019
32597,0,100000,Keith Smith,FB,dead_cap,oakland-raiders,100000,2019
32598,96000,0,Eric Saubert,TE,dead_cap,oakland-raiders,96000,2019
32599,0,90000,Jordan Richards,SS,dead_cap,oakland-raiders,90000,2019
32600,0,88806,Azeem Victor,ILB,dead_cap,oakland-raiders,88806,2019
32601,88000,0,Kendall Donnerson,OLB,dead_cap,oakland-raiders,88000,2019
32602,88000,0,Anthony Ratliff-Williams,WR,dead_cap,oakland-raiders,88000,2019
32603,84000,0,Anthony Rush,DT,dead_cap,oakland-raiders,84000,2019
32604,48000,24035,Quinton Bell,OLB,dead_cap,oakland-raiders,72035,2019
32605,72000,0,Kyle Kalis,T,dead_cap,oakland-raiders,72000,2019
32606,0,70000,Doug Martin,RB,dead_cap,oakland-raiders,70000,2019
32607,0,54388,Johnny Townsend,P,dead_cap,oakland-raiders,54388,2019
32608,48000,0,Damarea Crockett,RB,dead_cap,oakland-raiders,48000,2019
32609,47353,0,Kasim Edebali,OLB,dead_cap,oakland-raiders,47353,2019
32610,0,47206,Shalom Luani,S,dead_cap,oakland-raiders,47206,2019
32611,42353,0,Juston Burris,CB,dead_cap,oakland-raiders,42353,2019
32612,0,42146,Jylan Ware,T,dead_cap,oakland-raiders,42146,2019
32613,30000,7500,Keelan Doss,WR,dead_cap,oakland-raiders,37500,2019
32614,0,34300,Treyvon Hester,DT,dead_cap,oakland-raiders,34300,2019
32615,32000,0,Jordan Brown,CB,dead_cap,oakland-raiders,32000,2019
32616,0,30000,Andrew DePaola,LS,dead_cap,oakland-raiders,30000,2019
32617,24000,0,Paul Butler,TE,dead_cap,oakland-raiders,24000,2019
32618,24000,0,Justin Phillips,LB,dead_cap,oakland-raiders,24000,2019
32619,0,19212,Vadal Alexander,RT,dead_cap,oakland-raiders,19212,2019
32620,0,16667,Eddy Piniero,K,dead_cap,oakland-raiders,16667,2019
32621,8000,0,Ade Aruna,DE,dead_cap,oakland-raiders,8000,2019
32622,8000,0,Cole Wick,TE,dead_cap,oakland-raiders,8000,2019
32623,0,3333,Koa Farmer,OLB,dead_cap,oakland-raiders,3333,2019
32624,0,3000,Te'Von Coney,LB,dead_cap,oakland-raiders,3000,2019
32625,0,1666,Lukayus McNeil,T,dead_cap,oakland-raiders,1666,2019
32626,0,833,Tyler Roemer,T,dead_cap,oakland-raiders,833,2019
32627,21250000,250000,Trenton Brown,RT,active,oakland-raiders,21500000,2020
32628,18900000,2600000,Derek Carr,QB,active,oakland-raiders,21500000,2020
32629,12650000,1767000,Rodney Hudson,C,active,oakland-raiders,14417000,2020
32630,4600000,8350000,LaMarcus Joyner,FS,active,oakland-raiders,12950000,2020
32631,11000000,100000,Tyrell Williams,WR,active,oakland-raiders,11100000,2020
32632,9350000,250000,Gabe Jackson,G,active,oakland-raiders,9600000,2020
32633,7280000,250000,Darren Waller,TE,active,oakland-raiders,7530000,2020
32634,5950000,1341666,Tahir Whitehead,OLB,active,oakland-raiders,7291666,2020
32635,1920492,5206966,Clelin Ferrell,DE,active,oakland-raiders,7127458,2020
32636,5000000,1812500,Richie Incognito,G,active,oakland-raiders,6812500,2020
32637,3750000,1375000,Johnathan Hankins,DT,active,oakland-raiders,5125000,2020
32638,1704666,1969331,Kolton Miller,RT,active,oakland-raiders,3673997,2020
32639,1037427,1674709,Josh Jacobs,RB,active,oakland-raiders,2712136,2020
32640,1017509,1595035,Johnathan Abram,S,active,oakland-raiders,2612544,2020
32641,2350000,150000,Erik Harris,S,active,oakland-raiders,2500000,2020
32642,1400000,1100000,Denzelle Good,RT,active,oakland-raiders,2500000,2020
32643,1750000,100000,Derek Carrier,TE,active,oakland-raiders,1850000,2020
32644,824961,824845,Trayvon Mullen,CB,active,oakland-raiders,1649806,2020
32645,1339522,50000,Zay Jones,WR,active,oakland-raiders,1389522,2020
32646,907660,375324,P.J. Hall,DT,active,oakland-raiders,1282984,2020
32647,1139784,0,DeShone Kizer,QB,active,oakland-raiders,1139784,2020
32648,852304,264606,Brandon Parker,T,active,oakland-raiders,1116910,2020
32649,715500,206594,Arden Key,DE,active,oakland-raiders,922094,2020
32650,735000,63424,Marquel Lee,ILB,active,oakland-raiders,798424,2020
32651,585000,195566,Maxx Crosby,DE,active,oakland-raiders,780566,2020
32652,585000,165573,Isaiah Johnson,CB,active,oakland-raiders,750573,2020
32653,660000,79761,Maurice Hurst,DT,active,oakland-raiders,739761,2020
32654,735000,0,David Sharpe,T,active,oakland-raiders,735000,2020
32655,585000,122098,Foster Moreau,TE,active,oakland-raiders,707098,2020
32656,585000,78987,Hunter Renfrow,WR,active,oakland-raiders,663987,2020
32657,660000,0,Marcell Ateman,WR,active,oakland-raiders,660000,2020
32658,660000,0,Nick Nelson,CB,active,oakland-raiders,660000,2020
32659,585000,5000,Keisean Nixon,CB,active,oakland-raiders,590000,2020
32660,585000,3333,Alec Ingold,FB,active,oakland-raiders,588333,2020
32661,585000,3333,Andre James,C,active,oakland-raiders,588333,2020
32662,585000,833,A.J. Cole,P,active,oakland-raiders,585833,2020
32663,585000,0,Rico Gafford,CB,active,oakland-raiders,585000,2020
32664,0,0,Ade Aruna,DE,active,oakland-raiders,0,2020
32665,0,0,Jordan Brown,CB,active,oakland-raiders,0,2020
32666,0,0,Kendall Donnerson,OLB,active,oakland-raiders,0,2020
32667,0,0,Kyle Kalis,T,active,oakland-raiders,0,2020
32668,0,0,Dylan Mabin,CB,active,oakland-raiders,0,2020
32669,0,0,Erik Magnunson,T,active,oakland-raiders,0,2020
32670,0,0,Derrick Moncrief,LB,active,oakland-raiders,0,2020
32671,0,0,Anthony Ratliff-Williams,WR,active,oakland-raiders,0,2020
32672,0,0,William Stanback,RB,active,oakland-raiders,0,2020
32673,0,0,Mark Thompson,RB,active,oakland-raiders,0,2020
32674,0,0,Nick Usher,OLB,active,oakland-raiders,0,2020
32675,0,1438168,Gareon Conley,CB,dead_cap,oakland-raiders,1438168,2020
32676,0,349340,Nick Nelson,CB,dead_cap,oakland-raiders,349340,2020
32677,0,190303,Eddie Vanderdoes,DT,dead_cap,oakland-raiders,190303,2020
32678,0,108776,Johnny Townsend,P,dead_cap,oakland-raiders,108776,2020
32679,0,72105,Quinton Bell,OLB,dead_cap,oakland-raiders,72105,2020
32680,0,15000,Keelan Doss,WR,dead_cap,oakland-raiders,15000,2020
32681,0,6667,Koa Farmer,OLB,dead_cap,oakland-raiders,6667,2020
32682,0,6000,Te'Von Coney,LB,dead_cap,oakland-raiders,6000,2020
32683,0,5000,Lester Cotton,G,dead_cap,oakland-raiders,5000,2020
32684,0,5000,Dylan Mabin,CB,dead_cap,oakland-raiders,5000,2020
32685,0,3334,Lukayus McNeil,T,dead_cap,oakland-raiders,3334,2020
32686,0,1667,Tyler Roemer,T,dead_cap,oakland-raiders,1667,2020
32687,5500000,4261903,Donovan McNabb,QB,active,philadelphia-eagles,9761903,2007
32688,2000000,5091666,Shawn Andrews,G,active,philadelphia-eagles,7091666,2007
32689,4500000,100000,Takeo Spikes,LB,active,philadelphia-eagles,4600000,2007
32690,1200000,1990476,Brian Dawkins,S,active,philadelphia-eagles,3190476,2007
32691,543750,2752500,Mike Patterson,DT,active,philadelphia-eagles,3296250,2007
32692,449625,1360000,Reggie Brown,WR,active,philadelphia-eagles,1809625,2007
32693,285000,1166,Akeem Jordan,ILB,active,philadelphia-eagles,286166,2007
32694,385000,2243250,Trent Cole,OLB,active,philadelphia-eagles,2628250,2007
32695,750000,1500000,Sheldon Brown,CB,active,philadelphia-eagles,2250000,2007
32696,790000,1565000,Jerome McDougle,DE,active,philadelphia-eagles,2355000,2007
32697,520000,1234083,Todd Herremans,G,active,philadelphia-eagles,1754083,2007
32698,800000,500000,A.J. Feeley,QB,active,philadelphia-eagles,1300000,2007
32699,360000,2570000,Brodrick Bunkley,DT,active,philadelphia-eagles,2930000,2007
32700,435000,150000,Jamaal Jackson,C,active,philadelphia-eagles,585000,2007
32701,600000,800000,Juqua Parker,DE,active,philadelphia-eagles,1400000,2007
32702,285000,1093500,Kevin Kolb,QB,active,philadelphia-eagles,1378500,2007
32703,800000,500000,David Akers,K,active,philadelphia-eagles,1300000,2007
32704,595000,653333,Jon Dorenbos,LS,active,philadelphia-eagles,1248333,2007
32705,600000,0,Correll Buckhalter,RB,active,philadelphia-eagles,600000,2007
32706,920000,254000,L.J. Smith,TE,active,philadelphia-eagles,1174000,2007
32707,134117,1000000,Marcus Paschal,CB,active,philadelphia-eagles,1134117,2007
32708,360000,878750,Winston Justice,LT,active,philadelphia-eagles,1238750,2007
32709,595000,250000,Quintin Mikell,S,active,philadelphia-eagles,845000,2007
32710,435000,177000,Ryan Moats,RB,active,philadelphia-eagles,612000,2007
32711,360000,193750,Chris Gocong,LB,active,philadelphia-eagles,553750,2007
32712,285000,200000,Victor Abiamiri,DE,active,philadelphia-eagles,485000,2007
32713,360000,118875,Max Jean-Giles,G,active,philadelphia-eagles,478875,2007
32714,360000,113250,Jason Avant,WR,active,philadelphia-eagles,473250,2007
32715,217500,250000,Matt McCoy,LB,active,philadelphia-eagles,467500,2007
32716,285000,165000,Stewart Bradley,ILB,active,philadelphia-eagles,450000,2007
32717,285000,157500,Tony Hunt,RB,active,philadelphia-eagles,442500,2007
32718,435000,0,Joselio Hanson,CB,active,philadelphia-eagles,435000,2007
32719,435000,0,Scott Young,G,active,philadelphia-eagles,435000,2007
32720,0,402857,Tra Thomas,LT,active,philadelphia-eagles,402857,2007
32721,360000,35125,Omar Gaither,ILB,active,philadelphia-eagles,395125,2007
32722,360000,18250,LaJuan Ramsey,DT,active,philadelphia-eagles,378250,2007
32723,285000,45450,Brent Celek,TE,active,philadelphia-eagles,330450,2007
32724,285000,0,Sav Rocca,P,active,philadelphia-eagles,285000,2007
32725,285000,0,Pago Togafu,LB,active,philadelphia-eagles,285000,2007
32726,127058,0,Pat McCoy,T,active,philadelphia-eagles,127058,2007
32727,385000,121000,Sean Considine,S,injured_reserve,philadelphia-eagles,506000,2007
32728,190000,0,Stefan Rodgers,T,injured_reserve,philadelphia-eagles,190000,2007
32729,221000,0,Pat McCoy,T,practice_squad,philadelphia-eagles,221000,2007
32730,79900,0,Marcus Paschal,CB,practice_squad,philadelphia-eagles,79900,2007
32731,250000,0,Matt McCoy,LB,dead_cap,philadelphia-eagles,250000,2007
32732,145000,0,Matt Ware,CB,dead_cap,philadelphia-eagles,145000,2007
32733,43000,0,Jeremy Bloom,CB,dead_cap,philadelphia-eagles,43000,2007
32734,35000,0,Calvin Armstrong,T,dead_cap,philadelphia-eagles,35000,2007
32735,21562,0,Rashad Barksdale,CB,dead_cap,philadelphia-eagles,21562,2007
32736,20750,0,Dexter Wynn,CB,dead_cap,philadelphia-eagles,20750,2007
32737,10625,0,Adrien Clarke,G,dead_cap,philadelphia-eagles,10625,2007
32738,10000,0,Nate Ilaoa,RB,dead_cap,philadelphia-eagles,10000,2007
32739,2500,0,Marcus Paschal,CB,dead_cap,philadelphia-eagles,2500,2007
32740,1167,0,Pat McCoy,T,dead_cap,philadelphia-eagles,1167,2007
32741,6300000,4261903,Donovan McNabb,QB,active,philadelphia-eagles,10561903,2008
32742,645000,8500000,Asante Samuel,CB,active,philadelphia-eagles,9145000,2008
32743,2500000,2966666,Shawn Andrews,G,active,philadelphia-eagles,5466666,2008
32744,4022000,500000,L.J. Smith,TE,active,philadelphia-eagles,4522000,2008
32745,2000000,2190476,Brian Dawkins,S,active,philadelphia-eagles,4190476,2008
32746,689000,4604000,Brodrick Bunkley,DT,active,philadelphia-eagles,5293000,2008
32747,1750000,1500000,Sheldon Brown,CB,active,philadelphia-eagles,3250000,2008
32748,927000,2318250,Trent Cole,OLB,active,philadelphia-eagles,3245250,2008
32749,585000,2827500,Mike Patterson,DT,active,philadelphia-eagles,3412500,2008
32750,547000,1360000,Reggie Brown,WR,active,philadelphia-eagles,1907000,2008
32751,1000000,1033333,Todd Herremans,G,active,philadelphia-eagles,2033333,2008
32752,1000000,800000,Juqua Parker,DE,active,philadelphia-eagles,1800000,2008
32753,1135000,500000,David Akers,K,active,philadelphia-eagles,1635000,2008
32754,550000,150000,Jamaal Jackson,C,active,philadelphia-eagles,700000,2008
32755,370000,1581250,Kevin Kolb,QB,active,philadelphia-eagles,1951250,2008
32756,600000,900000,Chris Clemons,DE,active,philadelphia-eagles,1500000,2008
32757,370000,1166,Akeem Jordan,ILB,active,philadelphia-eagles,371166,2008
32758,1417000,0,Joselio Hanson,CB,active,philadelphia-eagles,1417000,2008
32759,900000,500000,A.J. Feeley,QB,active,philadelphia-eagles,1400000,2008
32760,805000,400000,Quintin Mikell,S,active,philadelphia-eagles,1205000,2008
32761,927000,121000,Sean Considine,S,active,philadelphia-eagles,1048000,2008
32762,1000000,0,Correll Buckhalter,RB,active,philadelphia-eagles,1000000,2008
32763,445000,878750,Winston Justice,LT,active,philadelphia-eagles,1323750,2008
32764,605000,208333,Jon Dorenbos,LS,active,philadelphia-eagles,813333,2008
32765,769091,0,Tracy White,LB,active,philadelphia-eagles,769091,2008
32766,295000,362500,Trevor Laws,DT,active,philadelphia-eagles,657500,2008
32767,605000,40000,Dan Klecko,FB,active,philadelphia-eagles,645000,2008
32768,445000,193750,Chris Gocong,LB,active,philadelphia-eagles,638750,2008
32769,295000,338250,DeSean Jackson,WR,active,philadelphia-eagles,633250,2008
32770,370000,200000,Victor Abiamiri,DE,active,philadelphia-eagles,570000,2008
32771,445000,118875,Max Jean-Giles,G,active,philadelphia-eagles,563875,2008
32772,445000,113250,Jason Avant,WR,active,philadelphia-eagles,558250,2008
32773,360000,171720,Stewart Bradley,ILB,active,philadelphia-eagles,531720,2008
32774,295000,185244,Bryan Smith,DE,active,philadelphia-eagles,480244,2008
32775,445000,35125,Omar Gaither,ILB,active,philadelphia-eagles,480125,2008
32776,295000,120500,Mike McGlynn,G,active,philadelphia-eagles,415500,2008
32777,370000,45450,Brent Celek,TE,active,philadelphia-eagles,415450,2008
32778,295000,113750,Quintin Demps,SS,active,philadelphia-eagles,408750,2008
32779,0,402857,Tra Thomas,LT,active,philadelphia-eagles,402857,2008
32780,370000,0,Sav Rocca,P,active,philadelphia-eagles,370000,2008
32781,261471,99788,Jack Ikegwuonu,DE,active,philadelphia-eagles,361259,2008
32782,295000,19073,Joe Mays,ILB,active,philadelphia-eagles,314073,2008
32783,295000,11792,King Dunlap,LT,active,philadelphia-eagles,306792,2008
32784,138750,0,Tony Hunt,RB,active,philadelphia-eagles,138750,2008
32785,200000,24353,Mike Gibson,C,injured_reserve,philadelphia-eagles,224353,2008
32786,102000,0,Andy Studebaker,OLB,practice_squad,philadelphia-eagles,102000,2008
32787,0,1565000,Jerome McDougle,DE,dead_cap,philadelphia-eagles,1565000,2008
32788,250000,0,Matt McCoy,LB,dead_cap,philadelphia-eagles,250000,2008
32789,177000,0,Ryan Moats,RB,dead_cap,philadelphia-eagles,177000,2008
32790,157500,0,Tony Hunt,RB,dead_cap,philadelphia-eagles,157500,2008
32791,86000,0,Jeremy Bloom,CB,dead_cap,philadelphia-eagles,86000,2008
32792,64687,0,Rashad Barksdale,CB,dead_cap,philadelphia-eagles,64687,2008
32793,30000,0,Nate Ilaoa,RB,dead_cap,philadelphia-eagles,30000,2008
32794,18400,0,Andy Studebaker,OLB,dead_cap,philadelphia-eagles,18400,2008
32795,18250,0,LaJuan Ramsey,DT,dead_cap,philadelphia-eagles,18250,2008
32796,5000,0,Marcus Paschal,CB,dead_cap,philadelphia-eagles,5000,2008
32797,0,3333,Kyle Arrington,CB,dead_cap,philadelphia-eagles,3333,2008
32798,1167,0,Pat McCoy,T,dead_cap,philadelphia-eagles,1167,2008
32799,9000000,5570832,Donovan McNabb,QB,active,philadelphia-eagles,14570832,2009
32800,10500000,2200000,Jason Peters,LT,active,philadelphia-eagles,12700000,2009
32801,1900000,8000000,Asante Samuel,CB,active,philadelphia-eagles,9900000,2009
32802,1700000,2375000,Trent Cole,OLB,active,philadelphia-eagles,4075000,2009
32803,2500000,1500000,Will Witherspoon,OLB,active,philadelphia-eagles,4000000,2009
32804,2480000,1245450,Brent Celek,TE,active,philadelphia-eagles,3725450,2009
32805,1625000,2016000,Michael Vick,QB,active,philadelphia-eagles,3641000,2009
32806,2000000,1500000,Sheldon Brown,CB,active,philadelphia-eagles,3500000,2009
32807,715000,2827500,Mike Patterson,DT,active,philadelphia-eagles,3542500,2009
32808,769000,1360000,Reggie Brown,WR,active,philadelphia-eagles,2129000,2009
32809,2545000,0,Ellis Hobbs,CB,active,philadelphia-eagles,2545000,2009
32810,1300000,1033333,Todd Herremans,G,active,philadelphia-eagles,2333333,2009
32811,1200000,800000,Juqua Parker,DE,active,philadelphia-eagles,2000000,2009
32812,1400000,500000,David Akers,K,active,philadelphia-eagles,1900000,2009
32813,1000000,900000,Chris Clemons,DE,active,philadelphia-eagles,1900000,2009
32814,535000,2570000,Brodrick Bunkley,DT,active,philadelphia-eagles,3105000,2009
32815,1300000,400000,Quintin Mikell,S,active,philadelphia-eagles,1700000,2009
32816,460000,1581250,Kevin Kolb,QB,active,philadelphia-eagles,2041250,2009
32817,1100000,150000,Jamaal Jackson,C,active,philadelphia-eagles,1250000,2009
32818,535000,804000,Jeremy Maclin,WR,active,philadelphia-eagles,1339000,2009
32819,1010000,193750,Chris Gocong,LB,active,philadelphia-eagles,1203750,2009
32820,385000,362500,Trevor Laws,DT,active,philadelphia-eagles,747500,2009
32821,1010000,113250,Jason Avant,WR,active,philadelphia-eagles,1123250,2009
32822,385000,729585,DeSean Jackson,WR,active,philadelphia-eagles,1114585,2009
32823,620000,455000,Joselio Hanson,CB,active,philadelphia-eagles,1075000,2009
32824,1010000,35125,Omar Gaither,ILB,active,philadelphia-eagles,1045125,2009
32825,1000000,0,Sean Jones,S,active,philadelphia-eagles,1000000,2009
32826,750000,108333,Jon Dorenbos,LS,active,philadelphia-eagles,858333,2009
32827,525000,342530,LeSean McCoy,RB,active,philadelphia-eagles,867530,2009
32828,850000,0,Tracy White,LB,active,philadelphia-eagles,850000,2009
32829,460000,200000,Victor Abiamiri,DE,active,philadelphia-eagles,660000,2009
32830,535000,118875,Max Jean-Giles,G,active,philadelphia-eagles,653875,2009
32831,460000,172280,Stewart Bradley,ILB,active,philadelphia-eagles,632280,2009
32832,620000,0,Jason Babin,DE,active,philadelphia-eagles,620000,2009
32833,535000,20000,Dimitri Patterson,CB,active,philadelphia-eagles,555000,2009
32834,385000,120500,Mike McGlynn,G,active,philadelphia-eagles,505500,2009
32835,385000,113750,Quintin Demps,SS,active,philadelphia-eagles,498750,2009
32836,470000,0,Alex Hall,OLB,active,philadelphia-eagles,470000,2009
32837,460000,1166,Akeem Jordan,ILB,active,philadelphia-eagles,461166,2009
32838,460000,0,Ramzee Robinson,CB,active,philadelphia-eagles,460000,2009
32839,460000,0,Sav Rocca,P,active,philadelphia-eagles,460000,2009
32840,385000,19073,Joe Mays,ILB,active,philadelphia-eagles,404073,2009
32841,310000,45000,Macho Harris,CB,active,philadelphia-eagles,355000,2009
32842,310000,12438,Moise Fokou,ILB,active,philadelphia-eagles,322438,2009
32843,310000,11792,King Dunlap,LT,active,philadelphia-eagles,321792,2009
32844,310000,0,Antonio Dixon,DT,active,philadelphia-eagles,310000,2009
32845,310000,0,Brandon Gibson,WR,active,philadelphia-eagles,310000,2009
32846,310000,0,Jack Ikegwuonu,DE,active,philadelphia-eagles,310000,2009
32847,215000,44078,Fenuki Tupou,T,active,philadelphia-eagles,259078,2009
32848,36470,0,Dallas Reynolds,G,active,philadelphia-eagles,36470,2009
32849,1620000,0,Stacy Andrews,G,active,philadelphia-eagles,1620000,2009
32850,2750000,3416666,Shawn Andrews,G,injured_reserve,philadelphia-eagles,6166666,2009
32851,88400,0,Danny Amendola,WR,practice_squad,philadelphia-eagles,88400,2009
32852,88400,0,Paul Fanaika,G,practice_squad,philadelphia-eagles,88400,2009
32853,88400,0,Mike Gibson,C,practice_squad,philadelphia-eagles,88400,2009
32854,88400,0,Dallas Reynolds,G,practice_squad,philadelphia-eagles,88400,2009
32855,52000,0,Jordan Norwood,WR,practice_squad,philadelphia-eagles,52000,2009
32856,1000000,0,A.J. Feeley,QB,dead_cap,philadelphia-eagles,1000000,2009
32857,0,857143,Brian Dawkins,S,dead_cap,philadelphia-eagles,857143,2009
32858,315000,0,Tony Hunt,RB,dead_cap,philadelphia-eagles,315000,2009
32859,185244,0,Bryan Smith,DE,dead_cap,philadelphia-eagles,185244,2009
32860,99788,0,Jack Ikegwuonu,DE,dead_cap,philadelphia-eagles,99788,2009
32861,55200,0,Andy Studebaker,OLB,dead_cap,philadelphia-eagles,55200,2009
32862,25000,0,Brandon Gibson,WR,dead_cap,philadelphia-eagles,25000,2009
32863,24353,0,Mike Gibson,C,dead_cap,philadelphia-eagles,24353,2009
32864,18250,0,LaJuan Ramsey,DT,dead_cap,philadelphia-eagles,18250,2009
32865,16140,0,Paul Fanaika,G,dead_cap,philadelphia-eagles,16140,2009
32866,10000,0,Dan Klecko,FB,dead_cap,philadelphia-eagles,10000,2009
32867,0,6667,Kyle Arrington,CB,dead_cap,philadelphia-eagles,6667,2009
32868,12690000,2592000,Jason Peters,LT,active,philadelphia-eagles,15282000,2010
32869,8895000,1000000,Asante Samuel,CB,active,philadelphia-eagles,9895000,2010
32870,715000,6931250,Kevin Kolb,QB,active,philadelphia-eagles,7646250,2010
32871,3750000,2650000,Michael Vick,QB,active,philadelphia-eagles,6400000,2010
32872,3400000,2375000,Trent Cole,OLB,active,philadelphia-eagles,5775000,2010
32873,3910000,710000,Jason Avant,WR,active,philadelphia-eagles,4620000,2010
32874,423750,4957500,Jeremy Maclin,WR,active,philadelphia-eagles,5381250,2010
32875,2175000,1031000,Winston Justice,LT,active,philadelphia-eagles,3206000,2010
32876,2300000,800000,Juqua Parker,DE,active,philadelphia-eagles,3100000,2010
32877,1100000,1825000,Mike Patterson,DT,active,philadelphia-eagles,2925000,2010
32878,2799500,0,Ellis Hobbs,CB,active,philadelphia-eagles,2799500,2010
32879,1300000,1245450,Brent Celek,TE,active,philadelphia-eagles,2545450,2010
32880,1500000,1033333,Todd Herremans,G,active,philadelphia-eagles,2533333,2010
32881,1176000,1000000,Darryl Tapp,DE,active,philadelphia-eagles,2176000,2010
32882,1200000,900000,Chris Clemons,DE,active,philadelphia-eagles,2100000,2010
32883,1650000,400000,Quintin Mikell,S,active,philadelphia-eagles,2050000,2010
32884,800000,455000,Joselio Hanson,CB,active,philadelphia-eagles,1255000,2010
32885,625000,2570000,Brodrick Bunkley,DT,active,philadelphia-eagles,3195000,2010
32886,1650000,250000,David Akers,K,active,philadelphia-eagles,1900000,2010
32887,1800000,50000,Ernie Sims,OLB,active,philadelphia-eagles,1850000,2010
32888,1759000,0,Jerome Harrison,RB,active,philadelphia-eagles,1759000,2010
32889,1475000,150000,Jamaal Jackson,C,active,philadelphia-eagles,1625000,2010
32890,320000,1370000,Brandon Graham,DE,active,philadelphia-eagles,1690000,2010
32891,1684000,0,Akeem Jordan,ILB,active,philadelphia-eagles,1684000,2010
32892,470000,362500,Trevor Laws,DT,active,philadelphia-eagles,832500,2010
32893,1176000,0,Omar Gaither,ILB,active,philadelphia-eagles,1176000,2010
32894,1176000,0,Max Jean-Giles,G,active,philadelphia-eagles,1176000,2010
32895,1101000,0,Sav Rocca,P,active,philadelphia-eagles,1101000,2010
32896,395000,699530,LeSean McCoy,RB,active,philadelphia-eagles,1094530,2010
32897,320000,600000,Nate Allen,FS,active,philadelphia-eagles,920000,2010
32898,795000,108423,Jon Dorenbos,LS,active,philadelphia-eagles,903423,2010
32899,480000,338250,DeSean Jackson,WR,active,philadelphia-eagles,818250,2010
32900,550000,200000,Victor Abiamiri,DE,active,philadelphia-eagles,750000,2010
32901,550000,172280,Stewart Bradley,ILB,active,philadelphia-eagles,722280,2010
32902,630000,30000,Dimitri Patterson,CB,active,philadelphia-eagles,660000,2010
32903,630000,0,Bobby McCray,DE,active,philadelphia-eagles,630000,2010
32904,630000,0,Garrett Mills,TE,active,philadelphia-eagles,630000,2010
32905,470000,120500,Mike McGlynn,G,active,philadelphia-eagles,590500,2010
32906,470000,113750,Quintin Demps,SS,active,philadelphia-eagles,583750,2010
32907,470000,39500,Owen Schmitt,FB,active,philadelphia-eagles,509500,2010
32908,320000,185314,Daniel Te'o-Nesheim,DE,active,philadelphia-eagles,505314,2010
32909,470000,19073,Joe Mays,ILB,active,philadelphia-eagles,489073,2010
32910,320000,131302,Trevard Lindley,CB,active,philadelphia-eagles,451302,2010
32911,320000,116696,Keenan Clayton,OLB,active,philadelphia-eagles,436696,2010
32912,320000,116696,Mike Kafka,QB,active,philadelphia-eagles,436696,2010
32913,320000,113225,Clay Harbor,TE,active,philadelphia-eagles,433225,2010
32914,395000,12438,Moise Fokou,ILB,active,philadelphia-eagles,407438,2010
32915,395000,11792,King Dunlap,LT,active,philadelphia-eagles,406792,2010
32916,395000,0,Antonio Dixon,DT,active,philadelphia-eagles,395000,2010
32917,320000,53000,Ricky Sapp,OLB,active,philadelphia-eagles,373000,2010
32918,320000,44078,Fenuki Tupou,T,active,philadelphia-eagles,364078,2010
32919,320000,42871,Riley Cooper,WR,active,philadelphia-eagles,362871,2010
32920,320000,39724,Crezdon Butler,CB,active,philadelphia-eagles,359724,2010
32921,320000,15064,Jamar Chaney,ILB,active,philadelphia-eagles,335064,2010
32922,320000,11000,Jeff Owens,DT,active,philadelphia-eagles,331000,2010
32923,320000,10842,Kurt Coleman,FS,active,philadelphia-eagles,330842,2010
32924,320000,5000,Austin Howard,RT,active,philadelphia-eagles,325000,2010
32925,320000,0,Chad Hall,WR,active,philadelphia-eagles,320000,2010
32926,320000,0,Brandon Hughes,CB,active,philadelphia-eagles,320000,2010
32927,282352,0,Joique Bell,RB,active,philadelphia-eagles,282352,2010
32928,150588,0,Colt Anderson,SS,active,philadelphia-eagles,150588,2010
32929,500000,100000,Marlin Jackson,CB,injured_reserve,philadelphia-eagles,600000,2010
32930,320000,0,Jorrick Calvin,CB,injured_reserve,philadelphia-eagles,320000,2010
32931,93600,0,Dallas Reynolds,G,practice_squad,philadelphia-eagles,93600,2010
32932,93600,0,A.Q. Shipley,C,practice_squad,philadelphia-eagles,93600,2010
32933,3499999,0,Reggie Brown,WR,dead_cap,philadelphia-eagles,3499999,2010
32934,3100000,0,Donovan McNabb,QB,dead_cap,philadelphia-eagles,3100000,2010
32935,0,1000000,Shawn Andrews,G,dead_cap,philadelphia-eagles,1000000,2010
32936,370488,0,Bryan Smith,DE,dead_cap,philadelphia-eagles,370488,2010
32937,199576,0,Jack Ikegwuonu,DE,dead_cap,philadelphia-eagles,199576,2010
32938,75000,0,Brandon Gibson,WR,dead_cap,philadelphia-eagles,75000,2010
32939,48706,0,Mike Gibson,C,dead_cap,philadelphia-eagles,48706,2010
32940,48422,0,Paul Fanaika,G,dead_cap,philadelphia-eagles,48422,2010
32941,0,22750,Charles Scott,RB,dead_cap,philadelphia-eagles,22750,2010
32942,0,3000,A.Q. Shipley,C,dead_cap,philadelphia-eagles,3000,2010
32943,10000000,4400000,Michael Vick,QB,active,philadelphia-eagles,14400000,2011
32944,1000000,9000000,Nnamdi Asomugha,CB,active,philadelphia-eagles,10000000,2011
32945,5900000,1100000,Asante Samuel,CB,active,philadelphia-eagles,7000000,2011
32946,3875000,3000000,Cullen Jenkins,DE,active,philadelphia-eagles,6875000,2011
32947,5900000,934000,Jason Peters,LT,active,philadelphia-eagles,6834000,2011
32948,1000000,4300000,Jason Babin,DE,active,philadelphia-eagles,5300000,2011
32949,3900000,1100000,Trent Cole,OLB,active,philadelphia-eagles,5000000,2011
32950,450000,5897500,Brandon Graham,DE,active,philadelphia-eagles,6347500,2011
32951,3500000,800000,Juqua Parker,DE,active,philadelphia-eagles,4300000,2011
32952,4000000,0,Steve Smith,WR,active,philadelphia-eagles,4000000,2011
32953,1500000,2500000,Vince Young,QB,active,philadelphia-eagles,4000000,2011
32954,2503000,2600000,Jeremy Maclin,WR,active,philadelphia-eagles,5103000,2011
32955,2250000,1000000,Darryl Tapp,DE,active,philadelphia-eagles,3250000,2011
32956,2000000,1031000,Winston Justice,LT,active,philadelphia-eagles,3031000,2011
32957,1215000,1808000,Brent Celek,TE,active,philadelphia-eagles,3023000,2011
32958,1900000,533333,Todd Herremans,G,active,philadelphia-eagles,2433333,2011
32959,1400000,850000,Mike Patterson,DT,active,philadelphia-eagles,2250000,2011
32960,1250000,710000,Jason Avant,WR,active,philadelphia-eagles,1960000,2011
32961,450000,1309000,Nate Allen,FS,active,philadelphia-eagles,1759000,2011
32962,1575000,0,Jamaal Jackson,C,active,philadelphia-eagles,1575000,2011
32963,375000,1067900,Danny Watkins,G,active,philadelphia-eagles,1442900,2011
32964,950000,100000,Dominique Rodgers-Cromartie,CB,active,philadelphia-eagles,1050000,2011
32965,600000,338250,DeSean Jackson,WR,active,philadelphia-eagles,938250,2011
32966,810000,108333,Jon Dorenbos,LS,active,philadelphia-eagles,918333,2011
32967,555000,362500,Trevor Laws,DT,active,philadelphia-eagles,917500,2011
32968,525000,342530,LeSean McCoy,RB,active,philadelphia-eagles,867530,2011
32969,700000,50000,Joselio Hanson,CB,active,philadelphia-eagles,750000,2011
32970,685000,50000,Ryan Harris,LT,active,philadelphia-eagles,735000,2011
32971,685000,50000,Jarrad Page,S,active,philadelphia-eagles,735000,2011
32972,685000,0,Victor Abiamiri,DE,active,philadelphia-eagles,685000,2011
32973,375000,279318,Jaiquawn Jarrett,FS,active,philadelphia-eagles,654318,2011
32974,555000,39500,Owen Schmitt,FB,active,philadelphia-eagles,594500,2011
32975,685000,50000,Anthony Hargrove,DE,active,philadelphia-eagles,735000,2011
32976,685000,50000,Akeem Jordan,ILB,active,philadelphia-eagles,735000,2011
32977,685000,50000,Evan Mathis,G,active,philadelphia-eagles,735000,2011
32978,555000,19073,Joe Mays,ILB,active,philadelphia-eagles,574073,2011
32979,555000,11792,King Dunlap,LT,active,philadelphia-eagles,566792,2011
32980,685000,565000,Ronnie Brown,RB,active,philadelphia-eagles,1250000,2011
32981,685000,0,Ernie Sims,OLB,active,philadelphia-eagles,685000,2011
32982,525000,0,Tom Nelson,WR,active,philadelphia-eagles,525000,2011
32983,405000,116696,Keenan Clayton,OLB,active,philadelphia-eagles,521696,2011
32984,405000,116696,Mike Kafka,QB,active,philadelphia-eagles,521696,2011
32985,405000,113225,Clay Harbor,TE,active,philadelphia-eagles,518225,2011
32986,375000,135880,Curtis Marsh,CB,active,philadelphia-eagles,510880,2011
32987,480000,12438,Moise Fokou,ILB,active,philadelphia-eagles,492438,2011
32988,375000,108716,Casey Matthews,ILB,active,philadelphia-eagles,483716,2011
32989,375000,105027,Alex Henery,K,active,philadelphia-eagles,480027,2011
32990,480000,0,Antonio Dixon,DT,active,philadelphia-eagles,480000,2011
32991,450000,0,Colt Anderson,SS,active,philadelphia-eagles,450000,2011
32992,450000,0,Chad Hall,WR,active,philadelphia-eagles,450000,2011
32993,450000,0,Thomas Welch,RT,active,philadelphia-eagles,450000,2011
32994,405000,42871,Riley Cooper,WR,active,philadelphia-eagles,447871,2011
32995,375000,47220,Dion Lewis,RB,active,philadelphia-eagles,422220,2011
32996,405000,15064,Jamar Chaney,ILB,active,philadelphia-eagles,420064,2011
32997,375000,41200,Julian Vandervelde,C,active,philadelphia-eagles,416200,2011
32998,405000,10842,Kurt Coleman,FS,active,philadelphia-eagles,415842,2011
32999,405000,0,Brandon Hughes,CB,active,philadelphia-eagles,405000,2011
33000,523824,0,Derek Landri,DT,active,philadelphia-eagles,523824,2011
33001,375000,24385,Jason Kelce,C,active,philadelphia-eagles,399385,2011
33002,375000,24150,Brian Rolle,ILB,active,philadelphia-eagles,399150,2011
33003,375000,5833,Chas Henry,P,active,philadelphia-eagles,380833,2011
33004,375000,0,Ronald Johnson,WR,active,philadelphia-eagles,375000,2011
33005,320000,51666,Phillip Hunt,DE,active,philadelphia-eagles,371666,2011
33006,110294,0,Greg Lloyd,LB,active,philadelphia-eagles,110294,2011
33007,66176,0,Cedric Thornton,DT,active,philadelphia-eagles,66176,2011
33008,96900,0,Brett Brackett,TE,practice_squad,philadelphia-eagles,96900,2011
33009,96900,0,Stanley Havili,FB,practice_squad,philadelphia-eagles,96900,2011
33010,96900,0,Dallas Reynolds,G,practice_squad,philadelphia-eagles,96900,2011
33011,96900,0,Daniel Te'o-Nesheim,DE,practice_squad,philadelphia-eagles,96900,2011
33012,96900,0,Cedric Thornton,DT,practice_squad,philadelphia-eagles,96900,2011
33013,1783333,0,Kevin Kolb,QB,dead_cap,philadelphia-eagles,1783333,2011
33014,1600000,0,Chris Clemons,DE,dead_cap,philadelphia-eagles,1600000,2011
33015,1285000,0,Brodrick Bunkley,DT,dead_cap,philadelphia-eagles,1285000,2011
33016,910000,0,Joselio Hanson,CB,dead_cap,philadelphia-eagles,910000,2011
33017,0,185314,Daniel Te'o-Nesheim,DE,dead_cap,philadelphia-eagles,185314,2011
33018,0,131302,Trevard Lindley,CB,dead_cap,philadelphia-eagles,131302,2011
33019,113750,0,Quintin Demps,SS,dead_cap,philadelphia-eagles,113750,2011
33020,0,68250,Charles Scott,RB,dead_cap,philadelphia-eagles,68250,2011
33021,0,53000,Ricky Sapp,OLB,dead_cap,philadelphia-eagles,53000,2011
33022,0,11475,Stanley Havili,FB,dead_cap,philadelphia-eagles,11475,2011
33023,11000,0,Jeff Owens,DT,dead_cap,philadelphia-eagles,11000,2011
33024,10000,0,Austin Howard,RT,dead_cap,philadelphia-eagles,10000,2011
33025,0,7475,Greg Lloyd,LB,dead_cap,philadelphia-eagles,7475,2011
33026,0,6000,A.Q. Shipley,C,dead_cap,philadelphia-eagles,6000,2011
33027,2500,0,Cedric Thornton,DT,dead_cap,philadelphia-eagles,2500,2011
33028,833,0,Martell Webb,TE,dead_cap,philadelphia-eagles,833,2011
33029,12500000,1400000,Michael Vick,QB,active,philadelphia-eagles,13900000,2012
33030,11000000,0,Nnamdi Asomugha,CB,active,philadelphia-eagles,11000000,2012
33031,7900000,934000,Jason Peters,LT,active,philadelphia-eagles,8834000,2012
33032,3000000,2850000,Trent Cole,OLB,active,philadelphia-eagles,5850000,2012
33033,4450000,100000,DeMeco Ryans,ILB,active,philadelphia-eagles,4550000,2012
33034,2853000,2600000,Jeremy Maclin,WR,active,philadelphia-eagles,5453000,2012
33035,1909000,1878000,Brent Celek,TE,active,philadelphia-eagles,3787000,2012
33036,2575000,1000000,Darryl Tapp,DE,active,philadelphia-eagles,3575000,2012
33037,1150000,2100000,Demetress Bell,RT,active,philadelphia-eagles,3250000,2012
33038,750000,2250000,DeSean Jackson,WR,active,philadelphia-eagles,3000000,2012
33039,615000,2155030,LeSean McCoy,RB,active,philadelphia-eagles,2770030,2012
33040,827500,3415000,Brandon Graham,DE,active,philadelphia-eagles,4242500,2012
33041,1500000,710000,Jason Avant,WR,active,philadelphia-eagles,2210000,2012
33042,1963750,100000,Dominique Rodgers-Cromartie,CB,active,philadelphia-eagles,2063750,2012
33043,1000000,1000000,Evan Mathis,G,active,philadelphia-eagles,2000000,2012
33044,390000,1472036,Fletcher Cox,DT,active,philadelphia-eagles,1862036,2012
33045,735725,1067900,Danny Watkins,G,active,philadelphia-eagles,1803625,2012
33046,1230000,20000,Antonio Dixon,DT,active,philadelphia-eagles,1250000,2012
33047,925000,275000,King Dunlap,LT,active,philadelphia-eagles,1200000,2012
33048,557000,600000,Nate Allen,FS,active,philadelphia-eagles,1157000,2012
33049,1050000,100000,Mike Patterson,DT,active,philadelphia-eagles,1150000,2012
33050,1000000,0,Derek Landri,DT,active,philadelphia-eagles,1000000,2012
33051,825000,108333,Jon Dorenbos,LS,active,philadelphia-eagles,933333,2012
33052,825000,0,Cullen Jenkins,DE,active,philadelphia-eagles,825000,2012
33053,825000,0,Mat McBriar,P,active,philadelphia-eagles,825000,2012
33054,390000,418081,Mychal Kendricks,OLB,active,philadelphia-eagles,808081,2012
33055,700000,0,Evan Moore,TE,active,philadelphia-eagles,700000,2012
33056,540000,113225,Clay Harbor,TE,active,philadelphia-eagles,653225,2012
33057,615000,0,Domonique Johnson,CB,active,philadelphia-eagles,615000,2012
33058,500000,135880,Curtis Marsh,CB,active,philadelphia-eagles,635880,2012
33059,390000,224878,Vinny Curry,DE,active,philadelphia-eagles,614878,2012
33060,465000,108716,Casey Matthews,ILB,active,philadelphia-eagles,573716,2012
33061,465000,105027,Alex Henery,K,active,philadelphia-eagles,570027,2012
33062,700000,0,Trent Edwards,QB,active,philadelphia-eagles,700000,2012
33063,700000,0,Akeem Jordan,ILB,active,philadelphia-eagles,700000,2012
33064,540000,0,Colt Anderson,SS,active,philadelphia-eagles,540000,2012
33065,540000,0,Brandon Hughes,CB,active,philadelphia-eagles,540000,2012
33066,538580,0,Jaiquawn Jarrett,FS,active,philadelphia-eagles,538580,2012
33067,490000,42871,Riley Cooper,WR,active,philadelphia-eagles,532871,2012
33068,390000,135880,Nick Foles,QB,active,philadelphia-eagles,525880,2012
33069,465000,47220,Dion Lewis,RB,active,philadelphia-eagles,512220,2012
33070,490000,15064,Jamar Chaney,ILB,active,philadelphia-eagles,505064,2012
33071,490000,10842,Kurt Coleman,FS,active,philadelphia-eagles,500842,2012
33072,390000,101367,Brandon Boykin,CB,active,philadelphia-eagles,491367,2012
33073,465000,21666,Phillip Hunt,DE,active,philadelphia-eagles,486666,2012
33074,465000,0,Greg Salas,WR,active,philadelphia-eagles,465000,2012
33075,465000,0,Cedric Thornton,DT,active,philadelphia-eagles,465000,2012
33076,390000,47200,Dennis Kelly,RT,active,philadelphia-eagles,437200,2012
33077,390000,12720,Bryce Brown,RB,active,philadelphia-eagles,402720,2012
33078,390000,5000,Damaris Johnson,WR,active,philadelphia-eagles,395000,2012
33079,390000,3333,Chris Polk,RB,active,philadelphia-eagles,393333,2012
33080,390000,0,Graig Cooper,RB,active,philadelphia-eagles,390000,2012
33081,390000,0,Maurice Fountain,DE,active,philadelphia-eagles,390000,2012
33082,390000,0,Stanley Havili,FB,active,philadelphia-eagles,390000,2012
33083,390000,0,Ronald Johnson,WR,active,philadelphia-eagles,390000,2012
33084,390000,0,Marvin McNutt,WR,active,philadelphia-eagles,390000,2012
33085,390000,0,Dallas Reynolds,G,active,philadelphia-eagles,390000,2012
33086,390000,0,David Sims,S,active,philadelphia-eagles,390000,2012
33087,381176,0,Clifton Geathers,DE,active,philadelphia-eagles,381176,2012
33088,288000,24385,Jason Kelce,C,active,philadelphia-eagles,312385,2012
33089,825000,0,Jake Scott,G,active,philadelphia-eagles,825000,2012
33090,615000,0,Antonio Dixon,DT,active,philadelphia-eagles,615000,2012
33091,540000,0,Matt Tennant,G,active,philadelphia-eagles,540000,2012
33092,465000,4166,Matt Kopa,G,active,philadelphia-eagles,469166,2012
33093,390000,0,Ryan Rau,ILB,active,philadelphia-eagles,390000,2012
33094,68823,0,Emil Igwenagu,TE,active,philadelphia-eagles,68823,2012
33095,2600000,1533334,Todd Herremans,G,injured_reserve,philadelphia-eagles,4133334,2012
33096,96900,0,Chase Ford,TE,practice_squad,philadelphia-eagles,96900,2012
33097,96900,0,Emil Igwenagu,TE,practice_squad,philadelphia-eagles,96900,2012
33098,3566666,0,Kevin Kolb,QB,dead_cap,philadelphia-eagles,3566666,2012
33099,1912000,0,Winston Justice,LT,dead_cap,philadelphia-eagles,1912000,2012
33100,1200000,0,Asante Samuel,CB,dead_cap,philadelphia-eagles,1200000,2012
33101,0,370628,Daniel Te'o-Nesheim,DE,dead_cap,philadelphia-eagles,370628,2012
33102,306250,0,Steve Vallos,C,dead_cap,philadelphia-eagles,306250,2012
33103,300000,0,Jason Babin,DE,dead_cap,philadelphia-eagles,300000,2012
33104,279318,0,Jaiquawn Jarrett,FS,dead_cap,philadelphia-eagles,279318,2012
33105,0,262604,Trevard Lindley,CB,dead_cap,philadelphia-eagles,262604,2012
33106,225000,0,Joselio Hanson,CB,dead_cap,philadelphia-eagles,225000,2012
33107,145312,0,Adrian Moten,LB,dead_cap,philadelphia-eagles,145312,2012
33108,116696,0,Keenan Clayton,OLB,dead_cap,philadelphia-eagles,116696,2012
33109,116696,0,Mike Kafka,QB,dead_cap,philadelphia-eagles,116696,2012
33110,0,106000,Ricky Sapp,OLB,dead_cap,philadelphia-eagles,106000,2012
33111,100000,0,Oshiomogho Atogwe,S,dead_cap,philadelphia-eagles,100000,2012
33112,100000,0,Leonard Weaver,FB,dead_cap,philadelphia-eagles,100000,2012
33113,41200,0,Julian Vandervelde,C,dead_cap,philadelphia-eagles,41200,2012
33114,0,34425,Stanley Havili,FB,dead_cap,philadelphia-eagles,34425,2012
33115,0,24723,Marvin McNutt,WR,dead_cap,philadelphia-eagles,24723,2012
33116,0,24150,Brian Rolle,ILB,dead_cap,philadelphia-eagles,24150,2012
33117,22750,0,Brandon Washington,RT,dead_cap,philadelphia-eagles,22750,2012
33118,0,22425,Greg Lloyd,LB,dead_cap,philadelphia-eagles,22425,2012
33119,22000,0,Jeff Owens,DT,dead_cap,philadelphia-eagles,22000,2012
33120,11666,0,Chas Henry,P,dead_cap,philadelphia-eagles,11666,2012
33121,5000,0,Cedric Thornton,DT,dead_cap,philadelphia-eagles,5000,2012
33122,4166,0,Chase Ford,TE,dead_cap,philadelphia-eagles,4166,2012
33123,3667,0,Emil Igwenagu,TE,dead_cap,philadelphia-eagles,3667,2012
33124,1667,0,Martell Webb,TE,dead_cap,philadelphia-eagles,1667,2012
33125,1666,0,Brett Brackett,TE,dead_cap,philadelphia-eagles,1666,2012
33126,1666,0,Cliff Harris,CB,dead_cap,philadelphia-eagles,1666,2012
33127,666,0,Tevita Finau,FB,dead_cap,philadelphia-eagles,666,2012
33128,333,0,Matt Camilli,DT,dead_cap,philadelphia-eagles,333,2012
33129,333,0,Alfred McCullough,G,dead_cap,philadelphia-eagles,333,2012
33130,3500000,8700000,Michael Vick,QB,active,philadelphia-eagles,12200000,2013
33131,10400000,684000,Jason Peters,LT,active,philadelphia-eagles,11084000,2013
33132,6750000,2250000,DeSean Jackson,WR,active,philadelphia-eagles,9000000,2013
33133,6600000,100000,DeMeco Ryans,ILB,active,philadelphia-eagles,6700000,2013
33134,3500000,1850000,Trent Cole,OLB,active,philadelphia-eagles,5350000,2013
33135,3000000,1950000,LeSean McCoy,RB,active,philadelphia-eagles,4950000,2013
33136,3203000,2600000,Jeremy Maclin,WR,active,philadelphia-eagles,5803000,2013
33137,3256000,1275000,Brent Celek,TE,active,philadelphia-eagles,4531000,2013
33138,3000000,1200000,Todd Herremans,G,active,philadelphia-eagles,4200000,2013
33139,715000,3300000,James Casey,FB,active,philadelphia-eagles,4015000,2013
33140,2000000,2000000,Evan Mathis,G,active,philadelphia-eagles,4000000,2013
33141,405000,3204655,Lane Johnson,RT,active,philadelphia-eagles,3609655,2013
33142,715000,2285000,Patrick Chung,SS,active,philadelphia-eagles,3000000,2013
33143,1250000,3415000,Brandon Graham,DE,active,philadelphia-eagles,4665000,2013
33144,2000000,710000,Jason Avant,WR,active,philadelphia-eagles,2710000,2013
33145,750000,1666666,Cary Williams,CB,active,philadelphia-eagles,2416666,2013
33146,750000,1600000,Bradley Fletcher,CB,active,philadelphia-eagles,2350000,2013
33147,855509,1472036,Fletcher Cox,DT,active,philadelphia-eagles,2327545,2013
33148,700000,600000,Connor Barwin,OLB,active,philadelphia-eagles,1300000,2013
33149,697000,600000,Nate Allen,FS,active,philadelphia-eagles,1297000,2013
33150,1100000,10842,Kurt Coleman,FS,active,philadelphia-eagles,1110842,2013
33151,940000,100000,Jon Dorenbos,LS,active,philadelphia-eagles,1040000,2013
33152,542020,468081,Mychal Kendricks,OLB,active,philadelphia-eagles,1010101,2013
33153,900000,100000,Colt Anderson,SS,active,philadelphia-eagles,1000000,2013
33154,405000,573036,Zach Ertz,TE,active,philadelphia-eagles,978036,2013
33155,493720,274878,Vinny Curry,DE,active,philadelphia-eagles,768598,2013
33156,630000,100000,Arrelious Benn,WR,active,philadelphia-eagles,730000,2013
33157,715000,5000,Allen Barbre,G,active,philadelphia-eagles,720000,2013
33158,630000,42871,Riley Cooper,WR,active,philadelphia-eagles,672871,2013
33159,555000,108716,Casey Matthews,ILB,active,philadelphia-eagles,663716,2013
33160,555000,105027,Alex Henery,K,active,philadelphia-eagles,660027,2013
33161,500000,155880,Nick Foles,QB,active,philadelphia-eagles,655880,2013
33162,630000,0,Clifton Geathers,DE,active,philadelphia-eagles,630000,2013
33163,840000,65000,Donnie Jones,P,active,philadelphia-eagles,905000,2013
33164,480000,101367,Brandon Boykin,CB,active,philadelphia-eagles,581367,2013
33165,555000,24385,Jason Kelce,C,active,philadelphia-eagles,579385,2013
33166,405000,171023,Bennie Logan,DT,active,philadelphia-eagles,576023,2013
33167,1200000,0,Brad Smith,WR,active,philadelphia-eagles,1200000,2013
33168,555000,0,Cedric Thornton,DT,active,philadelphia-eagles,555000,2013
33169,405000,144257,Matt Barkley,QB,active,philadelphia-eagles,549257,2013
33170,480000,47200,Dennis Kelly,RT,active,philadelphia-eagles,527200,2013
33171,480000,12720,Bryce Brown,RB,active,philadelphia-eagles,492720,2013
33172,480000,5000,Damaris Johnson,WR,active,philadelphia-eagles,485000,2013
33173,480000,3333,Chris Polk,RB,active,philadelphia-eagles,483333,2013
33174,480000,0,Najee Goode,OLB,active,philadelphia-eagles,480000,2013
33175,480000,0,Jeff Maehl,WR,active,philadelphia-eagles,480000,2013
33176,480000,0,Julian Vandervelde,C,active,philadelphia-eagles,480000,2013
33177,405000,53000,Earl Wolff,SS,active,philadelphia-eagles,458000,2013
33178,480000,0,Rashad Carmichael,CB,active,philadelphia-eagles,480000,2013
33179,405000,4000,Jake Knott,ILB,active,philadelphia-eagles,409000,2013
33180,405000,2500,Damion Square,DT,active,philadelphia-eagles,407500,2013
33181,405000,1666,Matt Tobin,G,active,philadelphia-eagles,406666,2013
33182,405000,0,Matthew Tucker,RB,active,philadelphia-eagles,405000,2013
33183,555000,0,Curtis Marsh,CB,active,philadelphia-eagles,555000,2013
33184,405000,0,Keelan Johnson,SS,active,philadelphia-eagles,405000,2013
33185,630000,100000,Jason Phillips,ILB,injured_reserve,philadelphia-eagles,730000,2013
33186,318000,11668,Phillip Hunt,DE,injured_reserve,philadelphia-eagles,329668,2013
33187,288000,15933,Joe Kruger,DE,injured_reserve,philadelphia-eagles,303933,2013
33188,90000,0,Keelan Johnson,SS,practice_squad,philadelphia-eagles,90000,2013
33189,75000,0,Ifeanyi Momah,TE,practice_squad,philadelphia-eagles,75000,2013
33190,42000,0,Greg Salas,WR,practice_squad,philadelphia-eagles,42000,2013
33191,36000,0,Matthew Tucker,RB,practice_squad,philadelphia-eagles,36000,2013
33192,4000000,0,Nnamdi Asomugha,CB,dead_cap,philadelphia-eagles,4000000,2013
33193,3220588,0,Isaac Sopoaga,DT,dead_cap,philadelphia-eagles,3220588,2013
33194,1067900,0,Danny Watkins,G,dead_cap,philadelphia-eagles,1067900,2013
33195,900000,0,Jason Babin,DE,dead_cap,philadelphia-eagles,900000,2013
33196,558636,0,Jaiquawn Jarrett,FS,dead_cap,philadelphia-eagles,558636,2013
33197,247490,0,Michael Bamiro,RT,dead_cap,philadelphia-eagles,247490,2013
33198,190588,0,Emmanuel Acho,ILB,dead_cap,philadelphia-eagles,190588,2013
33199,181829,0,Jordan Poyer,FS,dead_cap,philadelphia-eagles,181829,2013
33200,176746,0,Emil Igwenagu,TE,dead_cap,philadelphia-eagles,176746,2013
33201,166765,0,Shaun Prater,CB,dead_cap,philadelphia-eagles,166765,2013
33202,0,150000,Kenny Phillips,FS,dead_cap,philadelphia-eagles,150000,2013
33203,135880,0,Curtis Marsh,CB,dead_cap,philadelphia-eagles,135880,2013
33204,116696,0,Keenan Clayton,OLB,dead_cap,philadelphia-eagles,116696,2013
33205,116696,0,Mike Kafka,QB,dead_cap,philadelphia-eagles,116696,2013
33206,113225,0,Clay Harbor,TE,dead_cap,philadelphia-eagles,113225,2013
33207,95294,0,B.J Cunningham,WR,dead_cap,philadelphia-eagles,95294,2013
33208,94440,0,Dion Lewis,RB,dead_cap,philadelphia-eagles,94440,2013
33209,82400,0,Julian Vandervelde,C,dead_cap,philadelphia-eagles,82400,2013
33210,0,74169,Marvin McNutt,WR,dead_cap,philadelphia-eagles,74169,2013
33211,68250,0,Brandon Washington,RT,dead_cap,philadelphia-eagles,68250,2013
33212,0,48300,Brian Rolle,ILB,dead_cap,philadelphia-eagles,48300,2013
33213,40000,0,Antonio Dixon,DT,dead_cap,philadelphia-eagles,40000,2013
33214,40000,0,Trenton Robinson,FS,dead_cap,philadelphia-eagles,40000,2013
33215,36000,0,Marcus Burley,CB,dead_cap,philadelphia-eagles,36000,2013
33216,32500,0,Felix Jones,RB,dead_cap,philadelphia-eagles,32500,2013
33217,19666,0,Issac Remington,DE,dead_cap,philadelphia-eagles,19666,2013
33218,15064,0,Jamar Chaney,ILB,dead_cap,philadelphia-eagles,15064,2013
33219,12500,0,Dennis Dixon,QB,dead_cap,philadelphia-eagles,12500,2013
33220,11474,0,David King,DE,dead_cap,philadelphia-eagles,11474,2013
33221,10000,0,Miguel Maysonet,RB,dead_cap,philadelphia-eagles,10000,2013
33222,8334,0,Jordan Ford,TE,dead_cap,philadelphia-eagles,8334,2013
33223,8333,0,Chase Ford,TE,dead_cap,philadelphia-eagles,8333,2013
33224,7500,0,Chris McCoy,OLB,dead_cap,philadelphia-eagles,7500,2013
33225,5834,0,Chas Henry,P,dead_cap,philadelphia-eagles,5834,2013
33226,4166,0,Matt Kopa,G,dead_cap,philadelphia-eagles,4166,2013
33227,4166,0,Brad Wing,P,dead_cap,philadelphia-eagles,4166,2013
33228,3334,0,Brett Brackett,TE,dead_cap,philadelphia-eagles,3334,2013
33229,3334,0,Cliff Harris,CB,dead_cap,philadelphia-eagles,3334,2013
33230,2500,0,Ifeanyi Momah,TE,dead_cap,philadelphia-eagles,2500,2013
33231,2500,0,Kyle Quinn,C,dead_cap,philadelphia-eagles,2500,2013
33232,2500,0,Russell Shepard,WR,dead_cap,philadelphia-eagles,2500,2013
33233,1334,0,Tevita Finau,FB,dead_cap,philadelphia-eagles,1334,2013
33234,833,0,Matthew Tucker,RB,dead_cap,philadelphia-eagles,833,2013
33235,667,0,Matt Camilli,DT,dead_cap,philadelphia-eagles,667,2013
33236,667,0,Alfred McCullough,G,dead_cap,philadelphia-eagles,667,2013
33237,7650000,2050000,LeSean McCoy,RB,active,philadelphia-eagles,9700000,2014
33238,1750000,6542000,Jason Peters,LT,active,philadelphia-eagles,8292000,2014
33239,5000000,1600000,Trent Cole,OLB,active,philadelphia-eagles,6600000,2014
33240,4750000,1666666,Cary Williams,CB,active,philadelphia-eagles,6416666,2014
33241,5150000,1000000,Evan Mathis,G,active,philadelphia-eagles,6150000,2014
33242,1750000,3718750,Jeremy Maclin,WR,active,philadelphia-eagles,5468750,2014
33243,4300000,600000,Connor Barwin,OLB,active,philadelphia-eagles,4900000,2014
33244,378529,4017069,Lane Johnson,RT,active,philadelphia-eagles,4395598,2014
33245,4000000,75000,Brent Celek,TE,active,philadelphia-eagles,4075000,2014
33246,3985000,0,James Casey,FB,active,philadelphia-eagles,3985000,2014
33247,3275000,375000,Bradley Fletcher,CB,active,philadelphia-eagles,3650000,2014
33248,1670500,3415000,Brandon Graham,DE,active,philadelphia-eagles,5085500,2014
33249,1250000,1750000,Nate Allen,FS,active,philadelphia-eagles,3000000,2014
33250,1321000,1472036,Fletcher Cox,DT,active,philadelphia-eagles,2793036,2014
33251,1000000,1666666,Malcolm Jenkins,FS,active,philadelphia-eagles,2666666,2014
33252,1398000,1224358,Jason Kelce,C,active,philadelphia-eagles,2622358,2014
33253,750000,1600000,Nolan Carroll,CB,active,philadelphia-eagles,2350000,2014
33254,1500000,750000,Mark Sanchez,QB,active,philadelphia-eagles,2250000,2014
33255,1000000,1000000,Darren Sproles,RB,active,philadelphia-eagles,2000000,2014
33256,1000000,800000,Riley Cooper,WR,active,philadelphia-eagles,1800000,2014
33257,420000,998016,Marcus Smith,DE,active,philadelphia-eagles,1418016,2014
33258,1000000,333333,Donnie Jones,P,active,philadelphia-eagles,1333333,2014
33259,649509,573036,Zach Ertz,TE,active,philadelphia-eagles,1222545,2014
33260,794040,418081,Mychal Kendricks,OLB,active,philadelphia-eagles,1212121,2014
33261,905000,245000,Brad Smith,WR,active,philadelphia-eagles,1150000,2014
33262,955000,100000,Jon Dorenbos,LS,active,philadelphia-eagles,1055000,2014
33263,700000,300000,Bryan Braman,OLB,active,philadelphia-eagles,1000000,2014
33264,750000,200000,Chris Maragos,FS,active,philadelphia-eagles,950000,2014
33265,697440,224878,Vinny Curry,DE,active,philadelphia-eagles,922318,2014
33266,420000,479867,Jordan Matthews,WR,active,philadelphia-eagles,899867,2014
33267,730000,155000,Allen Barbre,G,active,philadelphia-eagles,885000,2014
33268,615000,155880,Nick Foles,QB,active,philadelphia-eagles,770880,2014
33269,645000,113716,Casey Matthews,ILB,active,philadelphia-eagles,758716,2014
33270,730000,5000,Andrew Gardner,G,active,philadelphia-eagles,735000,2014
33271,530340,181023,Bennie Logan,DT,active,philadelphia-eagles,711363,2014
33272,570000,101367,Brandon Boykin,CB,active,philadelphia-eagles,671367,2014
33273,645000,0,Cedric Thornton,DT,active,philadelphia-eagles,645000,2014
33274,500000,144257,Matt Barkley,QB,active,philadelphia-eagles,644257,2014
33275,570000,47200,Dennis Kelly,RT,active,philadelphia-eagles,617200,2014
33276,570000,3334,Chris Polk,RB,active,philadelphia-eagles,573334,2014
33277,570000,0,Najee Goode,OLB,active,philadelphia-eagles,570000,2014
33278,570000,0,Jeff Maehl,WR,active,philadelphia-eagles,570000,2014
33279,420000,138986,Josh Huff,WR,active,philadelphia-eagles,558986,2014
33280,420000,124257,Jaylen Watkins,S,active,philadelphia-eagles,544257,2014
33281,495000,1666,Matt Tobin,G,active,philadelphia-eagles,496666,2014
33282,495000,0,Brandon Bair,DE,active,philadelphia-eagles,495000,2014
33283,495000,0,David Molk,C,active,philadelphia-eagles,495000,2014
33284,495000,53000,Earl Wolff,SS,active,philadelphia-eagles,548000,2014
33285,420000,53878,Taylor Hart,T,active,philadelphia-eagles,473878,2014
33286,495000,0,Emmanuel Acho,ILB,active,philadelphia-eagles,495000,2014
33287,420000,16666,Jerome Couplin,FS,active,philadelphia-eagles,436666,2014
33288,420000,15562,Beau Allen,DT,active,philadelphia-eagles,435562,2014
33289,420000,2500,Trey Burton,TE,active,philadelphia-eagles,422500,2014
33290,420000,0,Cody Parkey,K,active,philadelphia-eagles,420000,2014
33291,570000,0,Julian Vandervelde,C,active,philadelphia-eagles,570000,2014
33292,645000,0,Chris Prosinski,SS,active,philadelphia-eagles,645000,2014
33293,6800000,100000,DeMeco Ryans,ILB,injured_reserve,philadelphia-eagles,6900000,2014
33294,3000000,1200000,Todd Herremans,G,injured_reserve,philadelphia-eagles,4200000,2014
33295,303000,0,Travis Long,OLB,injured_reserve,philadelphia-eagles,303000,2014
33296,107100,0,Josh Andrews,C,practice_squad,philadelphia-eagles,107100,2014
33297,107100,0,Wade Keliikipi,DT,practice_squad,philadelphia-eagles,107100,2014
33298,107100,0,G.J. Kinne,QB,practice_squad,philadelphia-eagles,107100,2014
33299,107100,0,Will Murphy,WR,practice_squad,philadelphia-eagles,107100,2014
33300,107100,0,Quron Pratt,WR,practice_squad,philadelphia-eagles,107100,2014
33301,107100,0,Ed Reynolds,FS,practice_squad,philadelphia-eagles,107100,2014
33302,107100,0,Matthew Tucker,RB,practice_squad,philadelphia-eagles,107100,2014
33303,81900,0,Kevin Graf,RT,practice_squad,philadelphia-eagles,81900,2014
33304,75600,0,Brandon Hepburn,OLB,practice_squad,philadelphia-eagles,75600,2014
33305,50400,0,Kenjon Barner,RB,practice_squad,philadelphia-eagles,50400,2014
33306,6250000,0,DeSean Jackson,WR,dead_cap,philadelphia-eagles,6250000,2014
33307,1067900,0,Danny Watkins,G,dead_cap,philadelphia-eagles,1067900,2014
33308,1000000,0,Patrick Chung,SS,dead_cap,philadelphia-eagles,1000000,2014
33309,710000,0,Jason Avant,WR,dead_cap,philadelphia-eagles,710000,2014
33310,280882,0,Wade Smith,G,dead_cap,philadelphia-eagles,280882,2014
33311,135880,0,Curtis Marsh,CB,dead_cap,philadelphia-eagles,135880,2014
33312,0,105027,Alex Henery,K,dead_cap,philadelphia-eagles,105027,2014
33313,100588,0,Rashad Carmichael,CB,dead_cap,philadelphia-eagles,100588,2014
33314,100000,0,Arrelious Benn,WR,dead_cap,philadelphia-eagles,100000,2014
33315,90472,0,Kevin Graf,RT,dead_cap,philadelphia-eagles,90472,2014
33316,0,46048,Ed Reynolds,FS,dead_cap,philadelphia-eagles,46048,2014
33317,45192,0,Jordan Poyer,FS,dead_cap,philadelphia-eagles,45192,2014
33318,34422,0,David King,DE,dead_cap,philadelphia-eagles,34422,2014
33319,25440,0,Bryce Brown,RB,dead_cap,philadelphia-eagles,25440,2014
33320,25200,0,Cobi Hamilton,WR,dead_cap,philadelphia-eagles,25200,2014
33321,25200,0,Jordan Kovacs,SS,dead_cap,philadelphia-eagles,25200,2014
33322,20000,0,Joseph Anderson,WR,dead_cap,philadelphia-eagles,20000,2014
33323,18900,0,Brandon Hepburn,OLB,dead_cap,philadelphia-eagles,18900,2014
33324,18900,0,Tyler Hoover,DE,dead_cap,philadelphia-eagles,18900,2014
33325,18706,0,Kenjon Barner,RB,dead_cap,philadelphia-eagles,18706,2014
33326,0,15933,Joe Kruger,DE,dead_cap,philadelphia-eagles,15933,2014
33327,15000,0,Chris McCoy,OLB,dead_cap,philadelphia-eagles,15000,2014
33328,10000,3333,Henry Josey,RB,dead_cap,philadelphia-eagles,13333,2014
33329,10000,3333,Daytawion Lowe,S,dead_cap,philadelphia-eagles,13333,2014
33330,0,12500,Josh Kaddu,OLB,dead_cap,philadelphia-eagles,12500,2014
33331,12500,0,Dennis Dixon,QB,dead_cap,philadelphia-eagles,12500,2014
33332,10000,400,Blake Annen,TE,dead_cap,philadelphia-eagles,10400,2014
33333,6300,4000,Jake Knott,ILB,dead_cap,philadelphia-eagles,10300,2014
33334,8334,0,Matt Kopa,G,dead_cap,philadelphia-eagles,8334,2014
33335,8334,0,Brad Wing,P,dead_cap,philadelphia-eagles,8334,2014
33336,5000,1666,Wade Keliikipi,DT,dead_cap,philadelphia-eagles,6666,2014
33337,6300,0,Emmanuel Acho,ILB,dead_cap,philadelphia-eagles,6300,2014
33338,6300,0,Colton Underwood,DE,dead_cap,philadelphia-eagles,6300,2014
33339,0,5000,Damaris Johnson,WR,dead_cap,philadelphia-eagles,5000,2014
33340,5000,0,Ifeanyi Momah,TE,dead_cap,philadelphia-eagles,5000,2014
33341,5000,0,Kyle Quinn,C,dead_cap,philadelphia-eagles,5000,2014
33342,5000,0,Russell Shepard,WR,dead_cap,philadelphia-eagles,5000,2014
33343,3334,0,Issac Remington,DE,dead_cap,philadelphia-eagles,3334,2014
33344,0,3333,Josh Andrews,C,dead_cap,philadelphia-eagles,3333,2014
33345,0,3333,Karim Barton,G,dead_cap,philadelphia-eagles,3333,2014
33346,0,3000,John Fulton,CB,dead_cap,philadelphia-eagles,3000,2014
33347,0,2500,David Fluellen,RB,dead_cap,philadelphia-eagles,2500,2014
33348,0,2500,Damion Square,DT,dead_cap,philadelphia-eagles,2500,2014
33349,1667,0,Matthew Tucker,RB,dead_cap,philadelphia-eagles,1667,2014
33350,0,1666,Casey Spear,K,dead_cap,philadelphia-eagles,1666,2014
33351,0,1333,Frank Mays,DE,dead_cap,philadelphia-eagles,1333,2014
33352,0,1166,Donald Hawkins,G,dead_cap,philadelphia-eagles,1166,2014
33353,0,833,Quron Pratt,WR,dead_cap,philadelphia-eagles,833,2014
33354,780,0,Michael Bamiro,RT,dead_cap,philadelphia-eagles,780,2014
33355,0,333,Kadron Boone,WR,dead_cap,philadelphia-eagles,333,2014
33356,12985000,0,Sam Bradford,QB,active,philadelphia-eagles,12985000,2015
33357,7300000,1750000,Jason Peters,LT,active,philadelphia-eagles,9050000,2015
33358,1000000,7700000,Byron Maxwell,CB,active,philadelphia-eagles,8700000,2015
33359,6400000,600000,Connor Barwin,OLB,active,philadelphia-eagles,7000000,2015
33360,3000000,3000000,Brandon Graham,DE,active,philadelphia-eagles,6000000,2015
33361,4000000,1666666,Malcolm Jenkins,FS,active,philadelphia-eagles,5666666,2015
33362,585000,4640974,Lane Johnson,RT,active,philadelphia-eagles,5225974,2015
33363,1000000,4000000,DeMarco Murray,RB,active,philadelphia-eagles,5000000,2015
33364,4725000,75000,Brent Celek,TE,active,philadelphia-eagles,4800000,2015
33365,4000000,800000,Riley Cooper,WR,active,philadelphia-eagles,4800000,2015
33366,3200000,1200000,Jason Kelce,C,active,philadelphia-eagles,4400000,2015
33367,3000000,1100000,Darren Sproles,RB,active,philadelphia-eagles,4100000,2015
33368,2500000,1250000,Mark Sanchez,QB,active,philadelphia-eagles,3750000,2015
33369,1786000,1472036,Fletcher Cox,DT,active,philadelphia-eagles,3258036,2015
33370,1250000,2000000,Walter Thurmond,FS,active,philadelphia-eagles,3250000,2015
33371,896060,2118081,Mychal Kendricks,OLB,active,philadelphia-eagles,3014141,2015
33372,2000000,1000000,DeMeco Ryans,ILB,active,philadelphia-eagles,3000000,2015
33373,2356000,0,Cedric Thornton,DT,active,philadelphia-eagles,2356000,2015
33374,1750000,333333,Donnie Jones,P,active,philadelphia-eagles,2083333,2015
33375,1000000,1000000,Ryan Mathews,RB,active,philadelphia-eagles,2000000,2015
33376,774504,998016,Marcus Smith,DE,active,philadelphia-eagles,1772520,2015
33377,435000,1269977,Nelson Agholor,WR,active,philadelphia-eagles,1704977,2015
33378,894018,573036,Zach Ertz,TE,active,philadelphia-eagles,1467054,2015
33379,1250000,200000,Allen Barbre,G,active,philadelphia-eagles,1450000,2015
33380,1200000,200000,Chris Maragos,FS,active,philadelphia-eagles,1400000,2015
33381,644967,479867,Jordan Matthews,WR,active,philadelphia-eagles,1124834,2015
33382,745000,375000,Bryan Braman,OLB,active,philadelphia-eagles,1120000,2015
33383,751160,324878,Vinny Curry,DE,active,philadelphia-eagles,1076038,2015
33384,970000,100000,Jon Dorenbos,LS,active,philadelphia-eagles,1070000,2015
33385,795000,136045,Andrew Gardner,G,active,philadelphia-eagles,931045,2015
33386,435000,452248,Eric Rowe,CB,active,philadelphia-eagles,887248,2015
33387,745946,50000,Kiko Alonso,OLB,active,philadelphia-eagles,795946,2015
33388,660000,47200,Dennis Kelly,RT,active,philadelphia-eagles,707200,2015
33389,745000,80000,Seyi Ajirotutu,WR,active,philadelphia-eagles,825000,2015
33390,525000,138986,Josh Huff,WR,active,philadelphia-eagles,663986,2015
33391,585000,50000,Brandon Bair,DE,active,philadelphia-eagles,635000,2015
33392,585000,1668,Matt Tobin,G,active,philadelphia-eagles,586668,2015
33393,745000,0,E.J. Biggers,CB,active,philadelphia-eagles,745000,2015
33394,510000,53878,Taylor Hart,T,active,philadelphia-eagles,563878,2015
33395,510000,15562,Beau Allen,DT,active,philadelphia-eagles,525562,2015
33396,657352,0,Thaddeus Lewis,QB,active,philadelphia-eagles,657352,2015
33397,516176,0,Najee Goode,OLB,active,philadelphia-eagles,516176,2015
33398,510000,2500,Trey Burton,TE,active,philadelphia-eagles,512500,2015
33399,510000,0,Kenjon Barner,RB,active,philadelphia-eagles,510000,2015
33400,481764,0,Caleb Sturgis,K,active,philadelphia-eagles,481764,2015
33401,435000,0,Josh Andrews,C,active,philadelphia-eagles,435000,2015
33402,435000,0,Denzel Rice,CB,active,philadelphia-eagles,435000,2015
33403,412941,0,Tanner Hawkinson,G,active,philadelphia-eagles,412941,2015
33404,364235,0,Cody Parkey,K,active,philadelphia-eagles,364235,2015
33405,361941,0,David Molk,C,active,philadelphia-eagles,361941,2015
33406,318000,30277,JaCorey Shepherd,CB,active,philadelphia-eagles,348277,2015
33407,180000,0,Jaylen Watkins,S,active,philadelphia-eagles,180000,2015
33408,179117,0,Ed Reynolds,FS,active,philadelphia-eagles,179117,2015
33409,172058,0,Barrett Jones,G,active,philadelphia-eagles,172058,2015
33410,153529,0,Jonathan Krause,WR,active,philadelphia-eagles,153529,2015
33411,120000,0,Steven Means,DE,active,philadelphia-eagles,120000,2015
33412,25588,0,Randall Evans,CB,active,philadelphia-eagles,25588,2015
33413,2900000,0,Nolan Carroll,CB,injured_reserve,philadelphia-eagles,2900000,2015
33414,637500,181023,Bennie Logan,DT,injured_reserve,philadelphia-eagles,818523,2015
33415,379941,163183,Jordan Hicks,ILB,injured_reserve,philadelphia-eagles,543124,2015
33416,437117,16666,Jerome Couplin,FS,injured_reserve,philadelphia-eagles,453783,2015
33417,318000,0,Travis Long,OLB,injured_reserve,philadelphia-eagles,318000,2015
33418,0,3400000,LeSean McCoy,RB,dead_cap,philadelphia-eagles,3400000,2015
33419,0,3200000,Trent Cole,OLB,dead_cap,philadelphia-eagles,3200000,2015
33420,0,2400000,Todd Herremans,G,dead_cap,philadelphia-eagles,2400000,2015
33421,1500000,743750,Miles Austin,WR,dead_cap,philadelphia-eagles,2243750,2015
33422,0,3415000,Brandon Graham,DE,dead_cap,philadelphia-eagles,3415000,2015
33423,0,1666667,Cary Williams,CB,dead_cap,philadelphia-eagles,1666667,2015
33424,850000,300000,Brad Jones,ILB,dead_cap,philadelphia-eagles,1150000,2015
33425,0,1000000,Evan Mathis,G,dead_cap,philadelphia-eagles,1000000,2015
33426,232940,0,Julian Vandervelde,C,dead_cap,philadelphia-eagles,232940,2015
33427,66000,138144,Ed Reynolds,FS,dead_cap,philadelphia-eagles,204144,2015
33428,187058,3334,Wade Keliikipi,DT,dead_cap,philadelphia-eagles,190392,2015
33429,0,154257,Matt Barkley,QB,dead_cap,philadelphia-eagles,154257,2015
33430,136976,0,Stephen Morris,QB,dead_cap,philadelphia-eagles,136976,2015
33431,0,135880,Nick Foles,QB,dead_cap,philadelphia-eagles,135880,2015
33432,105600,29840,Randall Evans,CB,dead_cap,philadelphia-eagles,135440,2015
33433,130235,0,Emmanuel Acho,ILB,dead_cap,philadelphia-eagles,130235,2015
33434,122200,3333,Brett Boyko,G,dead_cap,philadelphia-eagles,125533,2015
33435,0,124257,Jaylen Watkins,S,dead_cap,philadelphia-eagles,124257,2015
33436,112200,2500,Malcolm Bunche,T,dead_cap,philadelphia-eagles,114700,2015
33437,112200,0,Freddie Martino,WR,dead_cap,philadelphia-eagles,112200,2015
33438,112200,0,Chris Pantale,TE,dead_cap,philadelphia-eagles,112200,2015
33439,112200,0,Deontae Skinner,OLB,dead_cap,philadelphia-eagles,112200,2015
33440,105600,2500,Travis Raciti,DT,dead_cap,philadelphia-eagles,108100,2015
33441,0,101367,Brandon Boykin,CB,dead_cap,philadelphia-eagles,101367,2015
33442,13200,53000,Earl Wolff,SS,dead_cap,philadelphia-eagles,66200,2015
33443,59400,0,Jonathan Krause,WR,dead_cap,philadelphia-eagles,59400,2015
33444,33000,0,Brandon Hepburn,OLB,dead_cap,philadelphia-eagles,33000,2015
33445,33000,0,Michael Lee,CB,dead_cap,philadelphia-eagles,33000,2015
33446,0,31866,Joe Kruger,DE,dead_cap,philadelphia-eagles,31866,2015
33447,6600,15414,Brian Mihalik,T,dead_cap,philadelphia-eagles,22014,2015
33448,19800,0,Kevin Monangai,RB,dead_cap,philadelphia-eagles,19800,2015
33449,13200,1667,Quron Pratt,WR,dead_cap,philadelphia-eagles,14867,2015
33450,0,12500,Josh Kaddu,OLB,dead_cap,philadelphia-eagles,12500,2015
33451,10000,1666,Cole Manhart,G,dead_cap,philadelphia-eagles,11666,2015
33452,6600,1666,Raheem Mostert,RB,dead_cap,philadelphia-eagles,8266,2015
33453,6600,666,Andrew Gleichert,TE,dead_cap,philadelphia-eagles,7266,2015
33454,0,6667,Josh Andrews,C,dead_cap,philadelphia-eagles,6667,2015
33455,0,6667,Karim Barton,G,dead_cap,philadelphia-eagles,6667,2015
33456,0,6667,Henry Josey,RB,dead_cap,philadelphia-eagles,6667,2015
33457,0,6667,Daytawion Lowe,S,dead_cap,philadelphia-eagles,6667,2015
33458,6600,0,Craig Bills,S,dead_cap,philadelphia-eagles,6600,2015
33459,6600,0,Connor Hamlett,TE,dead_cap,philadelphia-eagles,6600,2015
33460,0,5000,David Fluellen,RB,dead_cap,philadelphia-eagles,5000,2015
33461,0,4000,Jake Knott,ILB,dead_cap,philadelphia-eagles,4000,2015
33462,0,3334,Casey Spear,K,dead_cap,philadelphia-eagles,3334,2015
33463,0,3333,Mike Coccia,T,dead_cap,philadelphia-eagles,3333,2015
33464,0,3333,Eric Tomlinson,TE,dead_cap,philadelphia-eagles,3333,2015
33465,0,2667,Frank Mays,DE,dead_cap,philadelphia-eagles,2667,2015
33466,0,2500,Damion Square,DT,dead_cap,philadelphia-eagles,2500,2015
33467,0,2334,Donald Hawkins,G,dead_cap,philadelphia-eagles,2334,2015
33468,0,2333,Devante Davis,WR,dead_cap,philadelphia-eagles,2333,2015
33469,0,2000,John Harris,WR,dead_cap,philadelphia-eagles,2000,2015
33470,0,2000,Justin Tukes,TE,dead_cap,philadelphia-eagles,2000,2015
33471,0,1666,Jordan Dewalt-Ondijo,DE,dead_cap,philadelphia-eagles,1666,2015
33472,0,1666,B.J. McBryde,DE,dead_cap,philadelphia-eagles,1666,2015
33473,0,800,Blake Annen,TE,dead_cap,philadelphia-eagles,800,2015
33474,0,667,Kadron Boone,WR,dead_cap,philadelphia-eagles,667,2015
33475,0,166,Kip Smith,P,dead_cap,philadelphia-eagles,166,2015
33476,0,108,Kevin Graf,RT,dead_cap,philadelphia-eagles,108,2015
33477,8050000,1687500,Jason Peters,LT,active,philadelphia-eagles,9737500,2016
33478,277941,7453388,Lane Johnson,RT,active,philadelphia-eagles,7731329,2016
33479,6750000,600000,Connor Barwin,OLB,active,philadelphia-eagles,7350000,2016
33480,1299000,5200000,Fletcher Cox,DT,active,philadelphia-eagles,6499000,2016
33481,2500000,3166668,Malcolm Jenkins,FS,active,philadelphia-eagles,5666668,2016
33482,4000000,1200000,Jason Kelce,C,active,philadelphia-eagles,5200000,2016
33483,3500000,1600000,Darren Sproles,RB,active,philadelphia-eagles,5100000,2016
33484,4000000,1000000,Brandon Graham,DE,active,philadelphia-eagles,5000000,2016
33485,1000000,4000000,Chase Daniel,QB,active,philadelphia-eagles,5000000,2016
33486,450000,4400243,Carson Wentz,QB,active,philadelphia-eagles,4850243,2016
33487,2850000,1750000,Mychal Kendricks,OLB,active,philadelphia-eagles,4600000,2016
33488,1138527,2173036,Zach Ertz,TE,active,philadelphia-eagles,3311563,2016
33489,1000000,2200000,Brandon Brooks,G,active,philadelphia-eagles,3200000,2016
33490,1000000,2000000,Vinny Curry,DE,active,philadelphia-eagles,3000000,2016
33491,760000,2000000,Stefen Wisniewski,C,active,philadelphia-eagles,2760000,2016
33492,2500000,250000,Leodis McKelvin,CB,active,philadelphia-eagles,2750000,2016
33493,2000000,750000,Nigel Bradham,OLB,active,philadelphia-eagles,2750000,2016
33494,1000000,1600000,Rodney McLeod,FS,active,philadelphia-eagles,2600000,2016
33495,1750000,750000,Stephen Tulloch,ILB,active,philadelphia-eagles,2500000,2016
33496,1750000,458334,Donnie Jones,P,active,philadelphia-eagles,2208334,2016
33497,861244,1269977,Nelson Agholor,WR,active,philadelphia-eagles,2131221,2016
33498,1129008,998016,Marcus Smith,DE,active,philadelphia-eagles,2127024,2016
33499,760000,1287500,Nolan Carroll,CB,active,philadelphia-eagles,2047500,2016
33500,1000000,1000000,Brent Celek,TE,active,philadelphia-eagles,2000000,2016
33501,1750000,200000,Allen Barbre,G,active,philadelphia-eagles,1950000,2016
33502,1500000,450000,Chris Maragos,FS,active,philadelphia-eagles,1950000,2016
33503,1661000,181023,Bennie Logan,DT,active,philadelphia-eagles,1842023,2016
33504,869934,479867,Jordan Matthews,WR,active,philadelphia-eagles,1349801,2016
33505,900000,75000,Bryan Braman,OLB,active,philadelphia-eagles,975000,2016
33506,543000,163183,Jordan Hicks,ILB,active,philadelphia-eagles,706183,2016
33507,689709,0,Dorial Green-Beckham,WR,active,philadelphia-eagles,689709,2016
33508,675000,0,Najee Goode,OLB,active,philadelphia-eagles,675000,2016
33509,675000,0,Caleb Sturgis,K,active,philadelphia-eagles,675000,2016
33510,450000,190966,Isaac Seumalo,G,active,philadelphia-eagles,640966,2016
33511,600000,15562,Beau Allen,DT,active,philadelphia-eagles,615562,2016
33512,615000,0,Terrence Brooks,FS,active,philadelphia-eagles,615000,2016
33513,600000,2500,Trey Burton,TE,active,philadelphia-eagles,602500,2016
33514,600000,0,Steven Means,DE,active,philadelphia-eagles,600000,2016
33515,600000,0,Jaylen Watkins,S,active,philadelphia-eagles,600000,2016
33516,525000,0,Josh Andrews,C,active,philadelphia-eagles,525000,2016
33517,450000,56281,Halapoulivaati Vaitai,T,active,philadelphia-eagles,506281,2016
33518,450000,19214,Jalen Mills,S,active,philadelphia-eagles,469214,2016
33519,450000,3333,Dillon Gordon,TE,active,philadelphia-eagles,453333,2016
33520,450000,2666,Destiny Vaeao,DT,active,philadelphia-eagles,452666,2016
33521,450000,0,Kamu Grugier-Hill,OLB,active,philadelphia-eagles,450000,2016
33522,450000,0,Bryce Treggs,WR,active,philadelphia-eagles,450000,2016
33523,352940,0,Taylor Hart,T,active,philadelphia-eagles,352940,2016
33524,317640,0,C.J. Smith,CB,active,philadelphia-eagles,317640,2016
33525,158820,0,Paul Turner,WR,active,philadelphia-eagles,158820,2016
33526,119117,0,Dwayne Gratz,CB,active,philadelphia-eagles,119117,2016
33527,79410,0,Rick Lovato,LS,active,philadelphia-eagles,79410,2016
33528,79410,0,Byron Marshall,RB,active,philadelphia-eagles,79410,2016
33529,3000000,1000000,Ryan Mathews,RB,injured_reserve,philadelphia-eagles,4000000,2016
33530,985000,187500,Jon Dorenbos,LS,injured_reserve,philadelphia-eagles,1172500,2016
33531,800000,250000,Ron Brooks,CB,injured_reserve,philadelphia-eagles,1050000,2016
33532,675000,50000,Matt Tobin,G,injured_reserve,philadelphia-eagles,725000,2016
33533,600000,0,Kenjon Barner,RB,injured_reserve,philadelphia-eagles,600000,2016
33534,450000,61144,Wendell Smallwood,RB,injured_reserve,philadelphia-eagles,511144,2016
33535,333000,17841,Alex McCalister,DE,injured_reserve,philadelphia-eagles,350841,2016
33536,333000,15034,Joe Walker,ILB,injured_reserve,philadelphia-eagles,348034,2016
33537,0,5500000,Sam Bradford,QB,dead_cap,philadelphia-eagles,5500000,2016
33538,0,4800000,Byron Maxwell,CB,dead_cap,philadelphia-eagles,4800000,2016
33539,0,4000000,DeMarco Murray,RB,dead_cap,philadelphia-eagles,4000000,2016
33540,0,2400000,Riley Cooper,WR,dead_cap,philadelphia-eagles,2400000,2016
33541,0,1000000,Evan Mathis,G,dead_cap,philadelphia-eagles,1000000,2016
33542,0,1000000,DeMeco Ryans,ILB,dead_cap,philadelphia-eagles,1000000,2016
33543,0,1000000,Mark Sanchez,QB,dead_cap,philadelphia-eagles,1000000,2016
33544,500000,25000,Rueben Randle,WR,dead_cap,philadelphia-eagles,525000,2016
33545,0,452248,Eric Rowe,CB,dead_cap,philadelphia-eagles,452248,2016
33546,289411,138986,Josh Huff,WR,dead_cap,philadelphia-eagles,428397,2016
33547,0,250000,Brad Jones,ILB,dead_cap,philadelphia-eagles,250000,2016
33548,0,248514,Jaylen Watkins,S,dead_cap,philadelphia-eagles,248514,2016
33549,210400,1666,Darrell Greene,G,dead_cap,philadelphia-eagles,212066,2016
33550,0,175000,Andrew Gardner,G,dead_cap,philadelphia-eagles,175000,2016
33551,136000,0,Aaron Neary,T,dead_cap,philadelphia-eagles,136000,2016
33552,124000,1000,Paul Turner,WR,dead_cap,philadelphia-eagles,125000,2016
33553,0,124257,Matt Barkley,QB,dead_cap,philadelphia-eagles,124257,2016
33554,117300,1666,Aziz Shittu,DT,dead_cap,philadelphia-eagles,118966,2016
33555,117300,0,David Watford,WR,dead_cap,philadelphia-eagles,117300,2016
33556,109100,2500,Byron Marshall,RB,dead_cap,philadelphia-eagles,111600,2016
33557,110400,0,Aaron Murray,QB,dead_cap,philadelphia-eagles,110400,2016
33558,108140,0,Aaron Grymes,CB,dead_cap,philadelphia-eagles,108140,2016
33559,103500,0,Don Cherry,ILB,dead_cap,philadelphia-eagles,103500,2016
33560,90000,1666,Myke Tavarres,OLB,dead_cap,philadelphia-eagles,91666,2016
33561,0,89521,Randall Evans,CB,dead_cap,philadelphia-eagles,89521,2016
33562,0,80000,Chris Givens,WR,dead_cap,philadelphia-eagles,80000,2016
33563,0,75000,Najee Goode,OLB,dead_cap,philadelphia-eagles,75000,2016
33564,69000,0,Anthony Denham,TE,dead_cap,philadelphia-eagles,69000,2016
33565,55000,2000,C.J. Smith,CB,dead_cap,philadelphia-eagles,57000,2016
33566,0,53878,Taylor Hart,T,dead_cap,philadelphia-eagles,53878,2016
33567,0,53000,Earl Wolff,SS,dead_cap,philadelphia-eagles,53000,2016
33568,50000,1666,Connor Wujciak,DT,dead_cap,philadelphia-eagles,51666,2016
33569,0,50000,Brandon Bair,DE,dead_cap,philadelphia-eagles,50000,2016
33570,48900,833,Marcus Johnson,WR,dead_cap,philadelphia-eagles,49733,2016
33571,0,46242,Brian Mihalik,T,dead_cap,philadelphia-eagles,46242,2016
33572,6900,30278,JaCorey Shepherd,CB,dead_cap,philadelphia-eagles,37178,2016
33573,34500,0,Andrew Bonnet,FB,dead_cap,philadelphia-eagles,34500,2016
33574,34500,0,Marcel Jensen,TE,dead_cap,philadelphia-eagles,34500,2016
33575,0,32892,Blake Countess,S,dead_cap,philadelphia-eagles,32892,2016
33576,0,30000,Dennis Kelly,RT,dead_cap,philadelphia-eagles,30000,2016
33577,23750,1166,Hunter Sharp,WR,dead_cap,philadelphia-eagles,24916,2016
33578,15000,3500,John DePalma,LS,dead_cap,philadelphia-eagles,18500,2016
33579,0,16668,Jerome Couplin,FS,dead_cap,philadelphia-eagles,16668,2016
33580,15000,1666,Bruce Johnson,C,dead_cap,philadelphia-eagles,16666,2016
33581,13800,0,Matt Rotheram,G,dead_cap,philadelphia-eagles,13800,2016
33582,11900,1666,Quentin Gause,ILB,dead_cap,philadelphia-eagles,13566,2016
33583,10000,3333,Cayleb Jones,WR,dead_cap,philadelphia-eagles,13333,2016
33584,6900,0,Duke Thomas,S,dead_cap,philadelphia-eagles,6900,2016
33585,6900,0,Terrell Watson,RB,dead_cap,philadelphia-eagles,6900,2016
33586,0,6667,Brett Boyko,G,dead_cap,philadelphia-eagles,6667,2016
33587,0,6667,Mike Coccia,T,dead_cap,philadelphia-eagles,6667,2016
33588,0,6667,Eric Tomlinson,TE,dead_cap,philadelphia-eagles,6667,2016
33589,5000,333,Cedric O'Neal,RB,dead_cap,philadelphia-eagles,5333,2016
33590,0,5000,Malcolm Bunche,T,dead_cap,philadelphia-eagles,5000,2016
33591,0,5000,Travis Raciti,DT,dead_cap,philadelphia-eagles,5000,2016
33592,0,4667,Devante Davis,WR,dead_cap,philadelphia-eagles,4667,2016
33593,0,4000,John Harris,WR,dead_cap,philadelphia-eagles,4000,2016
33594,0,4000,Justin Tukes,TE,dead_cap,philadelphia-eagles,4000,2016
33595,0,3334,Jordan Dewalt-Ondijo,DE,dead_cap,philadelphia-eagles,3334,2016
33596,0,3334,Cole Manhart,G,dead_cap,philadelphia-eagles,3334,2016
33597,0,3334,B.J. McBryde,DE,dead_cap,philadelphia-eagles,3334,2016
33598,0,3334,Raheem Mostert,RB,dead_cap,philadelphia-eagles,3334,2016
33599,0,3000,Terrence Magee,RT,dead_cap,philadelphia-eagles,3000,2016
33600,0,1334,Andrew Gleichert,TE,dead_cap,philadelphia-eagles,1334,2016
33601,0,334,Kip Smith,P,dead_cap,philadelphia-eagles,334,2016
33602,1000000,9750000,Alshon Jeffery,WR,active,philadelphia-eagles,10750000,2017
33603,7750000,2093750,Lane Johnson,RT,active,philadelphia-eagles,9843750,2017
33604,3000000,7600000,Fletcher Cox,DT,active,philadelphia-eagles,10600000,2017
33605,7000000,2000000,Vinny Curry,DE,active,philadelphia-eagles,9000000,2017
33606,6500000,1000000,Brandon Graham,DE,active,philadelphia-eagles,7500000,2017
33607,6000000,1500000,Malcolm Jenkins,FS,active,philadelphia-eagles,7500000,2017
33608,4254412,2386397,Brandon Brooks,G,active,philadelphia-eagles,6640809,2017
33609,4850000,1750000,Mychal Kendricks,OLB,active,philadelphia-eagles,6600000,2017
33610,5000000,1200000,Jason Kelce,C,active,philadelphia-eagles,6200000,2017
33611,4000000,875000,Torrey Smith,WR,active,philadelphia-eagles,4875000,2017
33612,4000000,750000,Nigel Bradham,OLB,active,philadelphia-eagles,4750000,2017
33613,3000000,1000000,Brent Celek,TE,active,philadelphia-eagles,4000000,2017
33614,775000,2406250,Rodney McLeod,FS,active,philadelphia-eagles,3181250,2017
33615,775000,2245000,Zach Ertz,TE,active,philadelphia-eagles,3020000,2017
33616,1017284,2000000,Timmy Jernigan,DT,active,philadelphia-eagles,3017284,2017
33617,2746000,0,Trey Burton,TE,active,philadelphia-eagles,2746000,2017
33618,1287489,1269977,Nelson Agholor,WR,active,philadelphia-eagles,2557466,2017
33619,465000,1871504,Derek Barnett,DE,active,philadelphia-eagles,2336504,2017
33620,1000000,850000,Chris Long,DE,active,philadelphia-eagles,1850000,2017
33621,1000000,800000,Corey Graham,FS,active,philadelphia-eagles,1800000,2017
33622,760000,937500,Chance Warmack,G,active,philadelphia-eagles,1697500,2017
33623,1000000,600000,Nick Foles,QB,active,philadelphia-eagles,1600000,2017
33624,1250000,125000,Donnie Jones,P,active,philadelphia-eagles,1375000,2017
33625,775000,583333,Stefen Wisniewski,C,active,philadelphia-eagles,1358333,2017
33626,900000,350000,LeGarrette Blount,RB,active,philadelphia-eagles,1250000,2017
33627,465000,651380,Sidney Jones,CB,active,philadelphia-eagles,1116380,2017
33628,775000,100000,Najee Goode,OLB,active,philadelphia-eagles,875000,2017
33629,800426,0,Ronald Darby,CB,active,philadelphia-eagles,800426,2017
33630,775000,0,Patrick Robinson,CB,active,philadelphia-eagles,775000,2017
33631,574000,190966,Isaac Seumalo,G,active,philadelphia-eagles,764966,2017
33632,690000,55000,Steven Means,DE,active,philadelphia-eagles,745000,2017
33633,690000,15562,Beau Allen,DT,active,philadelphia-eagles,705562,2017
33634,690000,0,Jaylen Watkins,S,active,philadelphia-eagles,690000,2017
33635,465000,176572,Rasul Douglas,CB,active,philadelphia-eagles,641572,2017
33636,465000,158917,Mack Hollins,WR,active,philadelphia-eagles,623917,2017
33637,540000,61144,Wendell Smallwood,RB,active,philadelphia-eagles,601144,2017
33638,540000,56281,Halapoulivaati Vaitai,T,active,philadelphia-eagles,596281,2017
33639,568235,0,Kenjon Barner,RB,active,philadelphia-eagles,568235,2017
33640,540000,19214,Jalen Mills,S,active,philadelphia-eagles,559214,2017
33641,540000,2666,Destiny Vaeao,DT,active,philadelphia-eagles,542666,2017
33642,540000,0,Kamu Grugier-Hill,OLB,active,philadelphia-eagles,540000,2017
33643,540000,0,Rick Lovato,LS,active,philadelphia-eagles,540000,2017
33644,465000,64309,Shelton Gibson,WR,active,philadelphia-eagles,529309,2017
33645,465000,31801,Elijah Qualls,DT,active,philadelphia-eagles,496801,2017
33646,465000,3333,Corey Clement,RB,active,philadelphia-eagles,468333,2017
33647,465000,0,Marcus Johnson,WR,active,philadelphia-eagles,465000,2017
33648,465000,0,Jake Elliott,K,active,philadelphia-eagles,465000,2017
33649,370588,0,Dannell Ellerbe,OLB,active,philadelphia-eagles,370588,2017
33650,325588,0,Jay Ajayi,RB,active,philadelphia-eagles,325588,2017
33651,300883,0,Nate Gerry,OLB,active,philadelphia-eagles,300883,2017
33652,285882,0,Nate Sudfeld,QB,active,philadelphia-eagles,285882,2017
33653,370588,0,William Beatty,LT,active,philadelphia-eagles,370588,2017
33654,158824,0,Bryan Braman,OLB,active,philadelphia-eagles,158824,2017
33655,3000000,3916666,Jason Peters,LT,injured_reserve,philadelphia-eagles,6916666,2017
33656,1662561,4400243,Carson Wentz,QB,injured_reserve,philadelphia-eagles,6062804,2017
33657,4000000,0,Darren Sproles,RB,injured_reserve,philadelphia-eagles,4000000,2017
33658,1250000,250000,Chris Maragos,FS,injured_reserve,philadelphia-eagles,1500000,2017
33659,900000,150000,Caleb Sturgis,K,injured_reserve,philadelphia-eagles,1050000,2017
33660,633000,163183,Jordan Hicks,ILB,injured_reserve,philadelphia-eagles,796183,2017
33661,354873,143972,Donnel Pumphrey,RB,injured_reserve,philadelphia-eagles,498845,2017
33662,465000,15034,Joe Walker,ILB,injured_reserve,philadelphia-eagles,480034,2017
33663,348000,5000,Dominique Williams,WR,injured_reserve,philadelphia-eagles,353000,2017
33664,348000,3750,Aziz Shittu,DT,injured_reserve,philadelphia-eagles,351750,2017
33665,348000,666,Randall Goforth,S,injured_reserve,philadelphia-eagles,348666,2017
33666,4100000,2000000,Chase Daniel,QB,dead_cap,philadelphia-eagles,6100000,2017
33667,0,5500000,Sam Bradford,QB,dead_cap,philadelphia-eagles,5500000,2017
33668,0,1000000,Ryan Mathews,RB,dead_cap,philadelphia-eagles,1000000,2017
33669,0,998016,Marcus Smith,DE,dead_cap,philadelphia-eagles,998016,2017
33670,0,904496,Eric Rowe,CB,dead_cap,philadelphia-eagles,904496,2017
33671,0,600000,Connor Barwin,OLB,dead_cap,philadelphia-eagles,600000,2017
33672,0,479867,Jordan Matthews,WR,dead_cap,philadelphia-eagles,479867,2017
33673,361765,0,Dexter McDougle,CB,dead_cap,philadelphia-eagles,361765,2017
33674,323930,0,Justin Hamilton,DT,dead_cap,philadelphia-eagles,323930,2017
33675,254118,0,Nate Sudfeld,QB,dead_cap,philadelphia-eagles,254118,2017
33676,0,250000,Ron Brooks,CB,dead_cap,philadelphia-eagles,250000,2017
33677,0,250000,Andrew Gardner,G,dead_cap,philadelphia-eagles,250000,2017
33678,0,250000,Leodis McKelvin,CB,dead_cap,philadelphia-eagles,250000,2017
33679,247624,0,D.J. Killings,CB,dead_cap,philadelphia-eagles,247624,2017
33680,0,200000,Allen Barbre,G,dead_cap,philadelphia-eagles,200000,2017
33681,121765,53878,Taylor Hart,T,dead_cap,philadelphia-eagles,175643,2017
33682,0,138986,Josh Huff,WR,dead_cap,philadelphia-eagles,138986,2017
33683,129900,3333,Billy Brown,TE,dead_cap,philadelphia-eagles,133233,2017
33684,130200,1666,Greg Ward,QB,dead_cap,philadelphia-eagles,131866,2017
33685,122400,0,Josh Andrews,C,dead_cap,philadelphia-eagles,122400,2017
33686,115200,0,DeVante Bausby,CB,dead_cap,philadelphia-eagles,115200,2017
33687,0,98678,Blake Countess,S,dead_cap,philadelphia-eagles,98678,2017
33688,93600,3333,Dillon Gordon,TE,dead_cap,philadelphia-eagles,96933,2017
33689,43200,50484,Nate Gerry,OLB,dead_cap,philadelphia-eagles,93684,2017
33690,0,87500,Jon Dorenbos,LS,dead_cap,philadelphia-eagles,87500,2017
33691,72000,5000,Byron Marshall,RB,dead_cap,philadelphia-eagles,77000,2017
33692,72000,0,Rashard Davis,WR,dead_cap,philadelphia-eagles,72000,2017
33693,65100,2500,Tre' Sullivan,S,dead_cap,philadelphia-eagles,67600,2017
33694,0,60556,JaCorey Shepherd,CB,dead_cap,philadelphia-eagles,60556,2017
33695,50400,0,Bryce Treggs,WR,dead_cap,philadelphia-eagles,50400,2017
33696,0,50000,Matt Tobin,G,dead_cap,philadelphia-eagles,50000,2017
33697,43800,1666,Winston Craig,DT,dead_cap,philadelphia-eagles,45466,2017
33698,14400,17841,Alex McCalister,DE,dead_cap,philadelphia-eagles,32241,2017
33699,28800,3334,Darrell Greene,G,dead_cap,philadelphia-eagles,32134,2017
33700,28800,0,Jon Toth,C,dead_cap,philadelphia-eagles,28800,2017
33701,27353,0,Trae Elston,S,dead_cap,philadelphia-eagles,27353,2017
33702,0,25000,Matt McGloin,QB,dead_cap,philadelphia-eagles,25000,2017
33703,21600,0,Harold Jones-Quartey,SS,dead_cap,philadelphia-eagles,21600,2017
33704,14400,0,Don Cherry,ILB,dead_cap,philadelphia-eagles,14400,2017
33705,7200,4000,C.J. Smith,CB,dead_cap,philadelphia-eagles,11200,2017
33706,0,8750,Mitchell White,CB,dead_cap,philadelphia-eagles,8750,2017
33707,7200,0,Victor Salako,T,dead_cap,philadelphia-eagles,7200,2017
33708,0,7000,John DePalma,LS,dead_cap,philadelphia-eagles,7000,2017
33709,0,6667,Cayleb Jones,WR,dead_cap,philadelphia-eagles,6667,2017
33710,0,3334,Quentin Gause,ILB,dead_cap,philadelphia-eagles,3334,2017
33711,0,3334,Bruce Johnson,C,dead_cap,philadelphia-eagles,3334,2017
33712,0,3334,Aziz Shittu,DT,dead_cap,philadelphia-eagles,3334,2017
33713,0,3334,Myke Tavarres,OLB,dead_cap,philadelphia-eagles,3334,2017
33714,0,3334,Connor Wujciak,DT,dead_cap,philadelphia-eagles,3334,2017
33715,0,2334,Hunter Sharp,WR,dead_cap,philadelphia-eagles,2334,2017
33716,0,2000,Paul Turner,WR,dead_cap,philadelphia-eagles,2000,2017
33717,0,1667,Marcus Johnson,WR,dead_cap,philadelphia-eagles,1667,2017
33718,0,667,Cedric O'Neal,RB,dead_cap,philadelphia-eagles,667,2017
33719,4000000,9600000,Nick Foles,QB,active,philadelphia-eagles,13600000,2018
33720,3310000,9238000,Fletcher Cox,DT,active,philadelphia-eagles,12548000,2018
33721,6750000,3916666,Jason Peters,LT,active,philadelphia-eagles,10666666,2018
33722,7000000,1000000,Brandon Graham,DE,active,philadelphia-eagles,8000000,2018
33723,630000,6645365,Carson Wentz,QB,active,philadelphia-eagles,7275365,2018
33724,6000000,1200000,Jason Kelce,C,active,philadelphia-eagles,7200000,2018
33725,1650000,4000000,Michael Bennett,DE,active,philadelphia-eagles,5650000,2018
33726,3000000,2000000,Timmy Jernigan,DT,active,philadelphia-eagles,5000000,2018
33727,790000,4192206,Lane Johnson,RT,active,philadelphia-eagles,4982206,2018
33728,790000,4147500,Zach Ertz,TE,active,philadelphia-eagles,4937500,2018
33729,790000,3978397,Brandon Brooks,G,active,philadelphia-eagles,4768397,2018
33730,915000,3085000,Mike Wallace,WR,active,philadelphia-eagles,4000000,2018
33731,1000000,4700000,Alshon Jeffery,WR,active,philadelphia-eagles,5700000,2018
33732,915000,3037000,Malcolm Jenkins,FS,active,philadelphia-eagles,3952000,2018
33733,3705882,0,Golden Tate,WR,active,philadelphia-eagles,3705882,2018
33734,2500000,708333,Stefen Wisniewski,G,active,philadelphia-eagles,3208333,2018
33735,2500000,600000,Chris Long,DE,active,philadelphia-eagles,3100000,2018
33736,1713733,1269977,Nelson Agholor,WR,active,philadelphia-eagles,2983710,2018
33737,1015000,1910000,Haloti Ngata,DT,active,philadelphia-eagles,2925000,2018
33738,1907000,163183,Jordan Hicks,ILB,active,philadelphia-eagles,2070183,2018
33739,941176,1000000,Nigel Bradham,OLB,active,philadelphia-eagles,1941176,2018
33740,1000000,796875,Chance Warmack,G,active,philadelphia-eagles,1796875,2018
33741,1015000,662500,Corey Graham,SS,active,philadelphia-eagles,1677500,2018
33742,1015000,418000,Darren Sproles,RB,active,philadelphia-eagles,1433000,2018
33743,744095,651380,Sidney Jones,CB,active,philadelphia-eagles,1395475,2018
33744,480000,542594,Dallas Goedert,TE,active,philadelphia-eagles,1022594,2018
33745,664000,190966,Isaac Seumalo,G,active,philadelphia-eagles,854966,2018
33746,580000,176572,Rasul Douglas,CB,active,philadelphia-eagles,756572,2018
33747,790000,90000,Richard Rodgers,TE,active,philadelphia-eagles,880000,2018
33748,705000,0,D.J. Alexander,ILB,active,philadelphia-eagles,705000,2018
33749,697059,0,Jordan Matthews,WR,active,philadelphia-eagles,697059,2018
33750,630000,61144,Wendell Smallwood,RB,active,philadelphia-eagles,691144,2018
33751,630000,56281,Halapoulivaati Vaitai,T,active,philadelphia-eagles,686281,2018
33752,480000,156478,Avonte Maddox,CB,active,philadelphia-eagles,636478,2018
33753,790000,90000,LaRoy Reynolds,ILB,active,philadelphia-eagles,880000,2018
33754,630000,0,Kamu Grugier-Hill,OLB,active,philadelphia-eagles,630000,2018
33755,630000,0,Rick Lovato,LS,active,philadelphia-eagles,630000,2018
33756,630000,0,Nate Sudfeld,QB,active,philadelphia-eagles,630000,2018
33757,555000,64309,Shelton Gibson,WR,active,philadelphia-eagles,619309,2018
33758,592944,0,Deiondre' Hall,CB,active,philadelphia-eagles,592944,2018
33759,555000,0,Jake Elliott,K,active,philadelphia-eagles,555000,2018
33760,555000,0,Nate Gerry,OLB,active,philadelphia-eagles,555000,2018
33761,480000,33195,Matt Pryor,T,active,philadelphia-eagles,513195,2018
33762,480000,7500,Cameron Johnston,P,active,philadelphia-eagles,487500,2018
33763,424412,0,Treyvon Hester,DT,active,philadelphia-eagles,424412,2018
33764,423529,0,Josh Adams,RB,active,philadelphia-eagles,423529,2018
33765,338820,0,Tre' Sullivan,S,active,philadelphia-eagles,338820,2018
33766,296472,0,Crevon LeBlanc,CB,active,philadelphia-eagles,296472,2018
33767,112940,0,Bruce Hector,DT,active,philadelphia-eagles,112940,2018
33768,97941,0,B.J. Bello,ILB,active,philadelphia-eagles,97941,2018
33769,97941,0,Daeshon Hall,DE,active,philadelphia-eagles,97941,2018
33770,84705,0,Boston Scott,RB,active,philadelphia-eagles,84705,2018
33771,37059,0,Josh Hawkins,CB,active,philadelphia-eagles,37059,2018
33772,6000000,2406250,Rodney McLeod,SS,injured_reserve,philadelphia-eagles,8406250,2018
33773,1049126,1871504,Derek Barnett,DE,injured_reserve,philadelphia-eagles,2920630,2018
33774,1907000,0,Jay Ajayi,RB,injured_reserve,philadelphia-eagles,1907000,2018
33775,1008139,50000,Ronald Darby,CB,injured_reserve,philadelphia-eagles,1058139,2018
33776,790000,90000,Paul Worrilow,OLB,injured_reserve,philadelphia-eagles,880000,2018
33777,459346,149397,Josh Sweat,DE,injured_reserve,philadelphia-eagles,608743,2018
33778,574235,19214,Jalen Mills,CB,injured_reserve,philadelphia-eagles,593449,2018
33779,378000,158917,Mack Hollins,WR,injured_reserve,philadelphia-eagles,536917,2018
33780,523764,3333,Corey Clement,RB,injured_reserve,philadelphia-eagles,527097,2018
33781,482118,0,Joshua Perkins,TE,injured_reserve,philadelphia-eagles,482118,2018
33782,459346,22348,Jordan Mailata,T,injured_reserve,philadelphia-eagles,481694,2018
33783,363000,0,Elie Bouka,CB,injured_reserve,philadelphia-eagles,363000,2018
33784,0,6000000,Vinny Curry,DE,dead_cap,philadelphia-eagles,6000000,2018
33785,0,1600000,Mychal Kendricks,OLB,dead_cap,philadelphia-eagles,1600000,2018
33786,0,1000000,Brent Celek,TE,dead_cap,philadelphia-eagles,1000000,2018
33787,790000,90000,Markus Wheaton,WR,dead_cap,philadelphia-eagles,880000,2018
33788,0,600000,Corey Nelson,ILB,dead_cap,philadelphia-eagles,600000,2018
33789,400000,0,Josh Andrews,C,dead_cap,philadelphia-eagles,400000,2018
33790,349915,5333,Chandon Sullivan,CB,dead_cap,philadelphia-eagles,355248,2018
33791,326470,0,Joshua Perkins,TE,dead_cap,philadelphia-eagles,326470,2018
33792,268588,2668,Destiny Vaeao,DT,dead_cap,philadelphia-eagles,271256,2018
33793,0,250000,Ron Brooks,CB,dead_cap,philadelphia-eagles,250000,2018
33794,0,250000,Donnie Jones,P,dead_cap,philadelphia-eagles,250000,2018
33795,233480,0,Deandre Carter,WR,dead_cap,philadelphia-eagles,233480,2018
33796,232353,0,Kamar Aiken,WR,dead_cap,philadelphia-eagles,232353,2018
33797,222610,1666,Bruce Hector,DT,dead_cap,philadelphia-eagles,224276,2018
33798,76000,143972,Donnel Pumphrey,RB,dead_cap,philadelphia-eagles,219972,2018
33799,211082,0,DeVante Bausby,CB,dead_cap,philadelphia-eagles,211082,2018
33800,0,175000,Jon Dorenbos,LS,dead_cap,philadelphia-eagles,175000,2018
33801,0,151453,Nate Gerry,OLB,dead_cap,philadelphia-eagles,151453,2018
33802,129200,0,Joe Ostman,DE,dead_cap,philadelphia-eagles,129200,2018
33803,124412,0,T.Y. McGill,DT,dead_cap,philadelphia-eagles,124412,2018
33804,124412,0,Dexter McDougle,CB,dead_cap,philadelphia-eagles,124412,2018
33805,121600,0,Braxton Miller,WR,dead_cap,philadelphia-eagles,121600,2018
33806,121600,0,Dorren Miller,WR,dead_cap,philadelphia-eagles,121600,2018
33807,114000,0,Asantay Brown,LB,dead_cap,philadelphia-eagles,114000,2018
33808,0,105000,Steven Means,DE,dead_cap,philadelphia-eagles,105000,2018
33809,85412,3333,Toby Weathersby,T,dead_cap,philadelphia-eagles,88745,2018
33810,68400,16667,Billy Brown,TE,dead_cap,philadelphia-eagles,85067,2018
33811,60800,0,B.J. Bello,ILB,dead_cap,philadelphia-eagles,60800,2018
33812,45200,8333,Josh Adams,RB,dead_cap,philadelphia-eagles,53533,2018
33813,53200,0,Will Tye,TE,dead_cap,philadelphia-eagles,53200,2018
33814,52000,0,Stephen Roberts,S,dead_cap,philadelphia-eagles,52000,2018
33815,45600,0,Anthony Fabiano,T,dead_cap,philadelphia-eagles,45600,2018
33816,45600,0,Jeremiah McKinnon,CB,dead_cap,philadelphia-eagles,45600,2018
33817,0,35682,Alex McCalister,DE,dead_cap,philadelphia-eagles,35682,2018
33818,30400,5000,Tre' Sullivan,S,dead_cap,philadelphia-eagles,35400,2018
33819,0,31801,Elijah Qualls,DT,dead_cap,philadelphia-eagles,31801,2018
33820,15200,15034,Joe Walker,ILB,dead_cap,philadelphia-eagles,30234,2018
33821,22800,3334,Winston Craig,DT,dead_cap,philadelphia-eagles,26134,2018
33822,20000,3333,Jeremy Reaves,S,dead_cap,philadelphia-eagles,23333,2018
33823,22800,0,Kaleb Johnson,T,dead_cap,philadelphia-eagles,22800,2018
33824,22800,0,Jon Toth,C,dead_cap,philadelphia-eagles,22800,2018
33825,21353,0,Gannon Sinclair,TE,dead_cap,philadelphia-eagles,21353,2018
33826,0,20000,Taylor Hart,T,dead_cap,philadelphia-eagles,20000,2018
33827,15200,0,Josh Hawkins,CB,dead_cap,philadelphia-eagles,15200,2018
33828,15200,0,Kyle Wilson,LB,dead_cap,philadelphia-eagles,15200,2018
33829,7600,7084,Greg Ward,QB,dead_cap,philadelphia-eagles,14684,2018
33830,0,10000,Bryce Treggs,WR,dead_cap,philadelphia-eagles,10000,2018
33831,0,8750,Mitchell White,CB,dead_cap,philadelphia-eagles,8750,2018
33832,7600,0,Rashard Davis,WR,dead_cap,philadelphia-eagles,7600,2018
33833,7600,0,Reggie Davis,WR,dead_cap,philadelphia-eagles,7600,2018
33834,0,5000,Dominique Williams,WR,dead_cap,philadelphia-eagles,5000,2018
33835,0,3750,Aziz Shittu,DT,dead_cap,philadelphia-eagles,3750,2018
33836,0,3334,Dillon Gordon,TE,dead_cap,philadelphia-eagles,3334,2018
33837,0,833,Adam Zaruba,TE,dead_cap,philadelphia-eagles,833,2018
33838,0,666,Randall Goforth,S,dead_cap,philadelphia-eagles,666,2018
33839,930000,15106000,Fletcher Cox,DT,active,philadelphia-eagles,16036000,2019
33840,8100000,3287000,Malcolm Jenkins,FS,active,philadelphia-eagles,11387000,2019
33841,9387000,0,Nelson Agholor,WR,active,philadelphia-eagles,9387000,2019
33842,3500000,5166668,Jason Peters,LT,active,philadelphia-eagles,8666668,2019
33843,720000,7673782,Carson Wentz,QB,active,philadelphia-eagles,8393782,2019
33844,805000,6851911,Lane Johnson,RT,active,philadelphia-eagles,7656911,2019
33845,805000,5486500,Zach Ertz,TE,active,philadelphia-eagles,6291500,2019
33846,1500000,4156250,Rodney McLeod,FS,active,philadelphia-eagles,5656250,2019
33847,930000,3517500,Nigel Bradham,OLB,active,philadelphia-eagles,4447500,2019
33848,1633252,1871504,Derek Barnett,DE,active,philadelphia-eagles,3504756,2019
33849,1000000,2500000,Brandon Graham,DE,active,philadelphia-eagles,3500000,2019
33850,3095000,0,Nate Sudfeld,QB,active,philadelphia-eagles,3095000,2019
33851,930000,1514000,Jason Kelce,C,active,philadelphia-eagles,2444000,2019
33852,1000000,1250000,Vinny Curry,DE,active,philadelphia-eagles,2250000,2019
33853,495000,1754197,Andre Dillard,T,active,philadelphia-eagles,2249197,2019
33854,2025000,56282,Halapoulivaati Vaitai,G,active,philadelphia-eagles,2081282,2019
33855,2025000,19214,Jalen Mills,CB,active,philadelphia-eagles,2044214,2019
33856,2025000,0,Jordan Howard,RB,active,philadelphia-eagles,2025000,2019
33857,2000000,0,Josh McCown,QB,active,philadelphia-eagles,2000000,2019
33858,1000000,812500,Timmy Jernigan,DT,active,philadelphia-eagles,1812500,2019
33859,749000,990966,Isaac Seumalo,G,active,philadelphia-eagles,1739966,2019
33860,1023190,651380,Sidney Jones,CB,active,philadelphia-eagles,1674570,2019
33861,735649,542594,Dallas Goedert,TE,active,philadelphia-eagles,1278243,2019
33862,495000,477759,Miles Sanders,RB,active,philadelphia-eagles,972759,2019
33863,495000,403678,J.J. Arcega-Whiteside,WR,active,philadelphia-eagles,898678,2019
33864,670000,176572,Rasul Douglas,CB,active,philadelphia-eagles,846572,2019
33865,720000,75000,Crevon LeBlanc,CB,active,philadelphia-eagles,795000,2019
33866,570000,156478,Avonte Maddox,CB,active,philadelphia-eagles,726478,2019
33867,720000,0,Rick Lovato,LS,active,philadelphia-eagles,720000,2019
33868,570000,149397,Josh Sweat,DE,active,philadelphia-eagles,719397,2019
33869,645000,0,Jake Elliott,K,active,philadelphia-eagles,645000,2019
33870,645000,0,Nate Gerry,OLB,active,philadelphia-eagles,645000,2019
33871,495000,121632,Shareef Miller,DE,active,philadelphia-eagles,616632,2019
33872,570000,33195,Matt Pryor,T,active,philadelphia-eagles,603195,2019
33873,570000,7500,Cameron Johnston,P,active,philadelphia-eagles,577500,2019
33874,555559,0,Duke Riley,LB,active,philadelphia-eagles,555559,2019
33875,495000,4166,T.J. Edwards,LB,active,philadelphia-eagles,499166,2019
33876,495000,4166,Nate Herbig,G,active,philadelphia-eagles,499166,2019
33877,469412,0,Craig James,CB,active,philadelphia-eagles,469412,2019
33878,402353,0,Boston Scott,RB,active,philadelphia-eagles,402353,2019
33879,320298,0,Alex Singleton,LB,active,philadelphia-eagles,320298,2019
33880,301761,0,Genard Avery,ILB,active,philadelphia-eagles,301761,2019
33881,291180,0,Anthony Rush,DT,active,philadelphia-eagles,291180,2019
33882,232944,0,Marcus Epps,S,active,philadelphia-eagles,232944,2019
33883,189705,0,Joshua Perkins,TE,active,philadelphia-eagles,189705,2019
33884,174706,0,Greg Ward,WR,active,philadelphia-eagles,174706,2019
33885,116471,0,Iosua Opeta,G,active,philadelphia-eagles,116471,2019
33886,100588,0,Robert Davis,WR,active,philadelphia-eagles,100588,2019
33887,67059,0,Bruce Hector,DT,active,philadelphia-eagles,67059,2019
33888,47353,0,Richard Rodgers,TE,active,philadelphia-eagles,47353,2019
33889,33529,0,Deontay Burnett,WR,active,philadelphia-eagles,33529,2019
33890,0,0,Shelton Gibson,WR,active,philadelphia-eagles,0,2019
33891,0,0,Elijah Holyfield,RB,active,philadelphia-eagles,0,2019
33892,5088822,4760632,Brandon Brooks,G,injured_reserve,philadelphia-eagles,9849454,2019
33893,930000,6864000,Alshon Jeffery,WR,injured_reserve,philadelphia-eagles,7794000,2019
33894,1030000,1909000,DeSean Jackson,WR,injured_reserve,philadelphia-eagles,2939000,2019
33895,1000000,1825000,Ronald Darby,CB,injured_reserve,philadelphia-eagles,2825000,2019
33896,1000000,1800000,Malik Jackson,DT,injured_reserve,philadelphia-eagles,2800000,2019
33897,1030000,300000,Darren Sproles,RB,injured_reserve,philadelphia-eagles,1330000,2019
33898,720000,0,Kamu Grugier-Hill,OLB,injured_reserve,philadelphia-eagles,720000,2019
33899,720000,0,Hassan Ridgeway,DT,injured_reserve,philadelphia-eagles,720000,2019
33900,645000,3334,Corey Clement,RB,injured_reserve,philadelphia-eagles,648334,2019
33901,645000,0,Johnathan Ford,S,injured_reserve,philadelphia-eagles,645000,2019
33902,645000,0,Daeshon Hall,DE,injured_reserve,philadelphia-eagles,645000,2019
33903,413823,22348,Jordan Mailata,T,injured_reserve,philadelphia-eagles,436171,2019
33904,385500,7500,Joe Ostman,DE,injured_reserve,philadelphia-eagles,393000,2019
33905,88000,0,De'Angelo Henderson,RB,practice_squad,philadelphia-eagles,88000,2019
33906,16000,0,Deshaun Davis,LB,practice_squad,philadelphia-eagles,16000,2019
33907,0,6000000,Timmy Jernigan,DT,dead_cap,philadelphia-eagles,6000000,2019
33908,0,2800000,Nick Foles,QB,dead_cap,philadelphia-eagles,2800000,2019
33909,0,1600000,Mychal Kendricks,OLB,dead_cap,philadelphia-eagles,1600000,2019
33910,1000000,500000,Zach Brown,ILB,dead_cap,philadelphia-eagles,1500000,2019
33911,1025000,310417,L.J. Fort,ILB,dead_cap,philadelphia-eagles,1335417,2019
33912,0,1300000,Chris Long,DE,dead_cap,philadelphia-eagles,1300000,2019
33913,250000,708334,Stefen Wisniewski,C,dead_cap,philadelphia-eagles,958334,2019
33914,492353,370000,Andrew Sendejo,SS,dead_cap,philadelphia-eagles,862353,2019
33915,493233,158917,Mack Hollins,WR,dead_cap,philadelphia-eagles,652150,2019
33916,200000,150000,Richard Rodgers,TE,dead_cap,philadelphia-eagles,350000,2019
33917,340000,0,Kyle Lauletta,QB,dead_cap,philadelphia-eagles,340000,2019
33918,331250,8333,Iosua Opeta,G,dead_cap,philadelphia-eagles,339583,2019
33919,0,287944,Donnel Pumphrey,RB,dead_cap,philadelphia-eagles,287944,2019
33920,0,250000,Chris Maragos,FS,dead_cap,philadelphia-eagles,250000,2019
33921,241765,0,John Cyprien,SS,dead_cap,philadelphia-eagles,241765,2019
33922,227647,0,Akeem Spence,DT,dead_cap,philadelphia-eagles,227647,2019
33923,284118,0,Jay Ajayi,RB,dead_cap,philadelphia-eagles,284118,2019
33924,199765,0,Alex Ellis,TE,dead_cap,philadelphia-eagles,199765,2019
33925,181765,0,Orlando Scandrick,CB,dead_cap,philadelphia-eagles,181765,2019
33926,180000,0,Blake Countess,S,dead_cap,philadelphia-eagles,180000,2019
33927,169588,0,Albert Huggins,DT,dead_cap,philadelphia-eagles,169588,2019
33928,145529,3334,Bruce Hector,DT,dead_cap,philadelphia-eagles,148863,2019
33929,136000,0,Marcus Green,WR,dead_cap,philadelphia-eagles,136000,2019
33930,113118,3750,Greg Ward,QB,dead_cap,philadelphia-eagles,116868,2019
33931,111176,0,Aziz Shittu,DT,dead_cap,philadelphia-eagles,111176,2019
33932,96000,0,Joshua Perkins,TE,dead_cap,philadelphia-eagles,96000,2019
33933,94706,0,Jordan Matthews,WR,dead_cap,philadelphia-eagles,94706,2019
33934,88000,0,Keegan Render,C,dead_cap,philadelphia-eagles,88000,2019
33935,75000,0,Boston Scott,RB,dead_cap,philadelphia-eagles,75000,2019
33936,72000,0,Robert Davis,WR,dead_cap,philadelphia-eagles,72000,2019
33937,0,68330,Clayton Thorson,QB,dead_cap,philadelphia-eagles,68330,2019
33938,67059,0,Ryan Lewis,CB,dead_cap,philadelphia-eagles,67059,2019
33939,0,64309,Shelton Gibson,WR,dead_cap,philadelphia-eagles,64309,2019
33940,0,63602,Elijah Qualls,DT,dead_cap,philadelphia-eagles,63602,2019
33941,0,61146,Wendell Smallwood,RB,dead_cap,philadelphia-eagles,61146,2019
33942,56000,0,Scott Orndoff,TE,dead_cap,philadelphia-eagles,56000,2019
33943,0,50000,Charles Johnson,WR,dead_cap,philadelphia-eagles,50000,2019
33944,49529,0,Craig James,CB,dead_cap,philadelphia-eagles,49529,2019
33945,48000,0,Alex Singleton,LB,dead_cap,philadelphia-eagles,48000,2019
33946,48000,0,Ajene Harris,CB,dead_cap,philadelphia-eagles,48000,2019
33947,32000,0,Marken Michel,WR,dead_cap,philadelphia-eagles,32000,2019
33948,32000,0,Tremon Smith,RB,dead_cap,philadelphia-eagles,32000,2019
33949,0,16667,Josh Adams,RB,dead_cap,philadelphia-eagles,16667,2019
33950,16000,0,Deontay Burnett,WR,dead_cap,philadelphia-eagles,16000,2019
33951,0,15034,Joe Walker,ILB,dead_cap,philadelphia-eagles,15034,2019
33952,0,10667,Chandon Sullivan,CB,dead_cap,philadelphia-eagles,10667,2019
33953,0,10000,Billy Brown,TE,dead_cap,philadelphia-eagles,10000,2019
33954,0,10000,Bryce Treggs,WR,dead_cap,philadelphia-eagles,10000,2019
33955,8000,0,River Cracraft,WR,dead_cap,philadelphia-eagles,8000,2019
33956,8000,0,Chris Johnson,S,dead_cap,philadelphia-eagles,8000,2019
33957,8000,0,D.J. White,CB,dead_cap,philadelphia-eagles,8000,2019
33958,8000,0,Kevin Wilkins,DT,dead_cap,philadelphia-eagles,8000,2019
33959,0,6667,Jeremy Reaves,S,dead_cap,philadelphia-eagles,6667,2019
33960,0,6667,Toby Weathersby,T,dead_cap,philadelphia-eagles,6667,2019
33961,0,1667,Adam Zaruba,TE,dead_cap,philadelphia-eagles,1667,2019
33962,0,668,Randall Goforth,S,dead_cap,philadelphia-eagles,668,2019
33963,11200000,16781000,Fletcher Cox,DT,active,philadelphia-eagles,27981000,2020
33964,1383000,23273536,Carson Wentz,QB,active,philadelphia-eagles,24656536,2020
33965,7785000,8376500,Lane Johnson,RT,active,philadelphia-eagles,16161500,2020
33966,9910000,7511500,Alshon Jeffery,WR,active,philadelphia-eagles,17421500,2020
33967,6660000,5821500,Zach Ertz,TE,active,philadelphia-eagles,12481500,2020
33968,7600000,3287000,Malcolm Jenkins,FS,active,philadelphia-eagles,10887000,2020
33969,7600000,3000000,Malik Jackson,DT,active,philadelphia-eagles,10600000,2020
33970,8000000,1767500,Nigel Bradham,OLB,active,philadelphia-eagles,9767500,2020
33971,6200000,2909000,DeSean Jackson,WR,active,philadelphia-eagles,9109000,2020
33972,2000000,6314000,Jason Kelce,C,active,philadelphia-eagles,8314000,2020
33973,1250000,7120632,Brandon Brooks,G,active,philadelphia-eagles,8370632,2020
33974,1396000,4928000,Brandon Graham,DE,active,philadelphia-eagles,6324000,2020
33975,2217378,1871504,Derek Barnett,DE,active,philadelphia-eagles,4088882,2020
33976,1057299,1754197,Andre Dillard,T,active,philadelphia-eagles,2811496,2020
33977,0,700000,Ronald Darby,CB,active,philadelphia-eagles,700000,2020
33978,755000,2578000,Jake Elliott,K,active,philadelphia-eagles,3333000,2020
33979,820000,1576000,Isaac Seumalo,G,active,philadelphia-eagles,2396000,2020
33980,1302285,651380,Sidney Jones,CB,active,philadelphia-eagles,1953665,2020
33981,991297,542594,Dallas Goedert,TE,active,philadelphia-eagles,1533891,2020
33982,738190,477759,Miles Sanders,RB,active,philadelphia-eagles,1215949,2020
33983,719670,403678,J.J. Arcega-Whiteside,WR,active,philadelphia-eagles,1123348,2020
33984,900000,221875,Crevon LeBlanc,CB,active,philadelphia-eagles,1121875,2020
33985,820000,375000,Rick Lovato,LS,active,philadelphia-eagles,1195000,2020
33986,754750,176572,Rasul Douglas,CB,active,philadelphia-eagles,931322,2020
33987,820000,0,Duke Riley,LB,active,philadelphia-eagles,820000,2020
33988,660000,156478,Avonte Maddox,CB,active,philadelphia-eagles,816478,2020
33989,660000,149397,Josh Sweat,DE,active,philadelphia-eagles,809397,2020
33990,735000,0,Johnathan Ford,S,active,philadelphia-eagles,735000,2020
33991,735000,0,Nate Gerry,OLB,active,philadelphia-eagles,735000,2020
33992,735000,0,Daeshon Hall,DE,active,philadelphia-eagles,735000,2020
33993,735000,0,Joshua Perkins,TE,active,philadelphia-eagles,735000,2020
33994,585000,121632,Shareef Miller,DE,active,philadelphia-eagles,706632,2020
33995,660000,33195,Matt Pryor,T,active,philadelphia-eagles,693195,2020
33996,660000,0,Genard Avery,ILB,active,philadelphia-eagles,660000,2020
33997,660000,0,Robert Davis,WR,active,philadelphia-eagles,660000,2020
33998,660000,0,Bruce Hector,DT,active,philadelphia-eagles,660000,2020
33999,660000,0,Boston Scott,RB,active,philadelphia-eagles,660000,2020
34000,585000,22348,Jordan Mailata,T,active,philadelphia-eagles,607348,2020
34001,585000,4166,T.J. Edwards,LB,active,philadelphia-eagles,589166,2020
34002,585000,4166,Nate Herbig,G,active,philadelphia-eagles,589166,2020
34003,585000,0,Marcus Epps,S,active,philadelphia-eagles,585000,2020
34004,585000,0,Iosua Opeta,G,active,philadelphia-eagles,585000,2020
34005,585000,0,Anthony Rush,DT,active,philadelphia-eagles,585000,2020
34006,585000,0,Alex Singleton,LB,active,philadelphia-eagles,585000,2020
34007,585000,0,Greg Ward,WR,active,philadelphia-eagles,585000,2020
34008,510000,7500,Joe Ostman,DE,active,philadelphia-eagles,517500,2020
34009,0,0,River Cracraft,WR,active,philadelphia-eagles,0,2020
34010,0,0,Alex Ellis,TE,active,philadelphia-eagles,0,2020
34011,0,0,Marcus Green,WR,active,philadelphia-eagles,0,2020
34012,0,0,Albert Huggins,DT,active,philadelphia-eagles,0,2020
34013,0,0,Kyle Lauletta,QB,active,philadelphia-eagles,0,2020
34014,0,0,Keegan Render,C,active,philadelphia-eagles,0,2020
34015,0,0,Tremon Smith,RB,active,philadelphia-eagles,0,2020
34016,0,0,Trevor Williams,CB,active,philadelphia-eagles,0,2020
34017,0,583334,L.J. Fort,ILB,dead_cap,philadelphia-eagles,583334,2020
34018,0,204990,Clayton Thorson,QB,dead_cap,philadelphia-eagles,204990,2020
34019,0,158917,Mack Hollins,WR,dead_cap,philadelphia-eagles,158917,2020
34020,0,150000,Richard Rodgers,TE,dead_cap,philadelphia-eagles,150000,2020
34021,0,64309,Shelton Gibson,WR,dead_cap,philadelphia-eagles,64309,2020
34022,0,16667,Iosua Opeta,G,dead_cap,philadelphia-eagles,16667,2020
34023,3375000,2597750,Alan Faneca,G,active,pittsburgh-steelers,5972750,2007
34024,3325000,2000000,Ike Taylor,CB,active,pittsburgh-steelers,5325000,2007
34025,3585000,1250000,Hines Ward,WR,active,pittsburgh-steelers,4835000,2007
34026,1760000,800000,Casey Hampton,DT,active,pittsburgh-steelers,2560000,2007
34027,3000000,1125000,James Farrior,LB,active,pittsburgh-steelers,4125000,2007
34028,600000,3284000,Troy Polamalu,S,active,pittsburgh-steelers,3884000,2007
34029,2465000,750000,Clark Haggans,LB,active,pittsburgh-steelers,3215000,2007
34030,2650000,822500,Brett Keisel,DE,active,pittsburgh-steelers,3472500,2007
34031,2325000,650000,Larry Foote,ILB,active,pittsburgh-steelers,2975000,2007
34032,1006000,3568500,Ben Roethlisberger,QB,active,pittsburgh-steelers,4574500,2007
34033,1500000,1600000,Aaron Smith,DE,active,pittsburgh-steelers,3100000,2007
34034,850000,2191667,Jerricho Cotchery,WR,active,pittsburgh-steelers,3041667,2007
34035,650000,1570000,Kendall Simmons,G,active,pittsburgh-steelers,2220000,2007
34036,360000,2420000,Santonio Holmes,WR,active,pittsburgh-steelers,2780000,2007
34037,1850000,0,Max Starks,LT,active,pittsburgh-steelers,1850000,2007
34038,517500,1575000,Heath Miller,TE,active,pittsburgh-steelers,2092500,2007
34039,1355000,266667,Charlie Batch,QB,active,pittsburgh-steelers,1621667,2007
34040,1100000,343750,James Harrison,OLB,active,pittsburgh-steelers,1443750,2007
34041,900000,535664,Kendall Simmons,G,active,pittsburgh-steelers,1435664,2007
34042,285000,1114000,Lawrence Timmons,ILB,active,pittsburgh-steelers,1399000,2007
34043,600000,712500,Ryan Clark,S,active,pittsburgh-steelers,1312500,2007
34044,285000,815000,LaMarr Woodley,OLB,active,pittsburgh-steelers,1100000,2007
34045,850000,0,Brian St. Pierre,QB,active,pittsburgh-steelers,850000,2007
34046,435000,269750,Bryant McFadden,CB,active,pittsburgh-steelers,704750,2007
34047,435000,153333,Trai Essex,T,active,pittsburgh-steelers,588333,2007
34048,360000,173833,Anthony Smith,S,active,pittsburgh-steelers,533833,2007
34049,360000,151033,Willie Reid,WR,active,pittsburgh-steelers,511033,2007
34050,510000,0,Nick Eason,DE,active,pittsburgh-steelers,510000,2007
34051,285000,188063,Matt Spaeth,TE,active,pittsburgh-steelers,473063,2007
34052,435000,20583,Chris Kemoeatu,G,active,pittsburgh-steelers,455583,2007
34053,360000,94500,Willie Colon,G,active,pittsburgh-steelers,454500,2007
34054,435000,0,Greg Warren,LS,active,pittsburgh-steelers,435000,2007
34055,435000,0,Nate Washington,WR,active,pittsburgh-steelers,435000,2007
34056,285000,115000,Daniel Sepulveda,P,active,pittsburgh-steelers,400000,2007
34057,385000,0,Shaun Nua,DE,active,pittsburgh-steelers,385000,2007
34058,285000,35466,William Gay,CB,active,pittsburgh-steelers,320466,2007
34059,50294,0,Ryan McBean,DE,active,pittsburgh-steelers,50294,2007
34060,35000,0,Verron Haynes,RB,active,pittsburgh-steelers,35000,2007
34061,2425000,937500,Willie Parker,RB,injured_reserve,pittsburgh-steelers,3362500,2007
34062,1200000,300000,Jerame Tuman,TE,injured_reserve,pittsburgh-steelers,1500000,2007
34063,950000,210000,Dan Kreider,RB,injured_reserve,pittsburgh-steelers,1160000,2007
34064,79900,0,Marvin Philip,C,practice_squad,pittsburgh-steelers,79900,2007
34065,1387084,0,Joey Porter,LB,dead_cap,pittsburgh-steelers,1387084,2007
34066,371666,0,Rian Wallace,LB,dead_cap,pittsburgh-steelers,371666,2007
34067,185334,0,Orien Harris,DT,dead_cap,pittsburgh-steelers,185334,2007
34068,157500,0,Verron Haynes,RB,dead_cap,pittsburgh-steelers,157500,2007
34069,98229,0,Ryan McBean,DE,dead_cap,pittsburgh-steelers,98229,2007
34070,76666,0,Omar Jacobs,QB,dead_cap,pittsburgh-steelers,76666,2007
34071,69334,0,Charles Davis,TE,dead_cap,pittsburgh-steelers,69334,2007
34072,42000,0,Cameron Stephenson,G,dead_cap,pittsburgh-steelers,42000,2007
34073,20000,0,Cedric Humes,RB,dead_cap,pittsburgh-steelers,20000,2007
34074,19716,0,Marvin Philip,C,dead_cap,pittsburgh-steelers,19716,2007
34075,13250,0,Dallas Baker,WR,dead_cap,pittsburgh-steelers,13250,2007
34076,2333,0,Jason Capizzi,T,dead_cap,pittsburgh-steelers,2333,2007
34077,2500000,7195000,Ben Roethlisberger,QB,active,pittsburgh-steelers,9695000,2008
34078,6895000,0,Max Starks,LT,active,pittsburgh-steelers,6895000,2008
34079,1625000,5195000,Troy Polamalu,S,active,pittsburgh-steelers,6820000,2008
34080,4700000,1250000,Hines Ward,WR,active,pittsburgh-steelers,5950000,2008
34081,1800000,800000,Casey Hampton,DT,active,pittsburgh-steelers,2600000,2008
34082,3150000,1600000,Aaron Smith,DE,active,pittsburgh-steelers,4750000,2008
34083,2900000,937500,Willie Parker,RB,active,pittsburgh-steelers,3837500,2008
34084,1090000,3000000,Ike Taylor,CB,active,pittsburgh-steelers,4090000,2008
34085,2340000,650000,Larry Foote,ILB,active,pittsburgh-steelers,2990000,2008
34086,370000,4181500,Lawrence Timmons,ILB,active,pittsburgh-steelers,4551500,2008
34087,1400000,1747500,Brett Keisel,DE,active,pittsburgh-steelers,3147500,2008
34088,1500000,712500,Ryan Clark,S,active,pittsburgh-steelers,2212500,2008
34089,600000,2470000,Santonio Holmes,WR,active,pittsburgh-steelers,3070000,2008
34090,657500,1775000,Heath Miller,TE,active,pittsburgh-steelers,2432500,2008
34091,1355000,266667,Charlie Batch,QB,active,pittsburgh-steelers,1621667,2008
34092,1100000,500000,Chris Hoke,T,active,pittsburgh-steelers,1600000,2008
34093,1200000,343750,James Harrison,OLB,active,pittsburgh-steelers,1543750,2008
34094,1417000,0,Chris Kemoeatu,G,active,pittsburgh-steelers,1417000,2008
34095,1417000,0,Nate Washington,WR,active,pittsburgh-steelers,1417000,2008
34096,650000,450000,Mewelde Moore,RB,active,pittsburgh-steelers,1100000,2008
34097,927000,0,Trai Essex,T,active,pittsburgh-steelers,927000,2008
34098,520000,269750,Bryant McFadden,CB,active,pittsburgh-steelers,789750,2008
34099,620000,131667,Greg Warren,LS,active,pittsburgh-steelers,751667,2008
34100,370000,350000,LaMarr Woodley,OLB,active,pittsburgh-steelers,720000,2008
34101,605000,57500,Nick Eason,DE,active,pittsburgh-steelers,662500,2008
34102,445000,173833,Anthony Smith,S,active,pittsburgh-steelers,618833,2008
34103,370000,188063,Matt Spaeth,TE,active,pittsburgh-steelers,558063,2008
34104,445000,94500,Willie Colon,G,active,pittsburgh-steelers,539500,2008
34105,370000,115000,Daniel Sepulveda,P,active,pittsburgh-steelers,485000,2008
34106,427352,40000,Mitch Berger,P,active,pittsburgh-steelers,467352,2008
34107,605000,40000,Keyaron Fox,ILB,active,pittsburgh-steelers,645000,2008
34108,605000,40000,Byron Leftwich,QB,active,pittsburgh-steelers,645000,2008
34109,605000,0,Sean McHugh,TE,active,pittsburgh-steelers,605000,2008
34110,370000,35466,William Gay,CB,active,pittsburgh-steelers,405466,2008
34111,295000,101500,Tony Hills,LT,active,pittsburgh-steelers,396500,2008
34112,295000,43333,Dennis Dixon,QB,active,pittsburgh-steelers,338333,2008
34113,295000,22533,Ryan Mundy,SS,active,pittsburgh-steelers,317533,2008
34114,200000,23858,Mike Humpal,LB,active,pittsburgh-steelers,223858,2008
34115,208235,0,Patrick Bailey,OLB,active,pittsburgh-steelers,208235,2008
34116,202812,0,Dallas Baker,WR,active,pittsburgh-steelers,202812,2008
34117,156176,0,Donovan Woods,LB,active,pittsburgh-steelers,156176,2008
34118,3400000,1570000,Kendall Simmons,G,injured_reserve,pittsburgh-steelers,4970000,2008
34119,295000,895000,Rashard Mendenhall,RB,injured_reserve,pittsburgh-steelers,1190000,2008
34120,176800,0,Patrick Bailey,OLB,practice_squad,pittsburgh-steelers,176800,2008
34121,88400,0,Donovan Woods,LB,practice_squad,pittsburgh-steelers,88400,2008
34122,300000,0,Jerame Tuman,TE,dead_cap,pittsburgh-steelers,300000,2008
34123,196458,0,Ryan McBean,DE,dead_cap,pittsburgh-steelers,196458,2008
34124,151033,0,Willie Reid,WR,dead_cap,pittsburgh-steelers,151033,2008
34125,89066,0,Doug Legursky,C,dead_cap,pittsburgh-steelers,89066,2008
34126,84000,0,Cameron Stephenson,G,dead_cap,pittsburgh-steelers,84000,2008
34127,52175,0,Jason Capizzi,T,dead_cap,pittsburgh-steelers,52175,2008
34128,26500,0,Dallas Baker,WR,dead_cap,pittsburgh-steelers,26500,2008
34129,19716,0,Marvin Philip,C,dead_cap,pittsburgh-steelers,19716,2008
34130,5000,0,Patrick Bailey,OLB,dead_cap,pittsburgh-steelers,5000,2008
34131,1750,0,Donovan Woods,LB,dead_cap,pittsburgh-steelers,1750,2008
34132,4750000,10195000,Ben Roethlisberger,QB,active,pittsburgh-steelers,14945000,2009
34133,3075000,800000,Casey Hampton,DT,active,pittsburgh-steelers,3875000,2009
34134,2900000,3595000,Troy Polamalu,S,active,pittsburgh-steelers,6495000,2009
34135,800000,4893750,James Harrison,OLB,active,pittsburgh-steelers,5693750,2009
34136,2640000,3380000,Ike Taylor,CB,active,pittsburgh-steelers,6020000,2009
34137,1400000,4000000,Max Starks,LT,active,pittsburgh-steelers,5400000,2009
34138,2250000,2747500,Brett Keisel,DE,active,pittsburgh-steelers,4997500,2009
34139,1460000,3575000,Heath Miller,TE,active,pittsburgh-steelers,5035000,2009
34140,3350000,937500,Willie Parker,RB,active,pittsburgh-steelers,4287500,2009
34141,2350000,1600000,Aaron Smith,DE,active,pittsburgh-steelers,3950000,2009
34142,2885000,650000,Larry Foote,ILB,active,pittsburgh-steelers,3535000,2009
34143,2750000,610000,Hines Ward,WR,active,pittsburgh-steelers,3360000,2009
34144,385000,3730000,Rashard Mendenhall,RB,active,pittsburgh-steelers,4115000,2009
34145,1765000,777000,Chris Kemoeatu,G,active,pittsburgh-steelers,2542000,2009
34146,1700000,712500,Ryan Clark,S,active,pittsburgh-steelers,2412500,2009
34147,700000,2570000,Santonio Holmes,WR,active,pittsburgh-steelers,3270000,2009
34148,2198000,0,Willie Colon,G,active,pittsburgh-steelers,2198000,2009
34149,460000,3067250,Lawrence Timmons,ILB,active,pittsburgh-steelers,3527250,2009
34150,1475000,450000,Mewelde Moore,RB,active,pittsburgh-steelers,1925000,2009
34151,1300000,500000,Chris Hoke,T,active,pittsburgh-steelers,1800000,2009
34152,1100000,18353,Evander Hood,DE,active,pittsburgh-steelers,1118353,2009
34153,1010000,0,Shaun Suisham,K,active,pittsburgh-steelers,1010000,2009
34154,620000,250000,Trai Essex,T,active,pittsburgh-steelers,870000,2009
34155,620000,190000,Keyaron Fox,ILB,active,pittsburgh-steelers,810000,2009
34156,460000,350000,LaMarr Woodley,OLB,active,pittsburgh-steelers,810000,2009
34157,635000,131667,Greg Warren,LS,active,pittsburgh-steelers,766667,2009
34158,620000,57500,Nick Eason,DE,active,pittsburgh-steelers,677500,2009
34159,460000,188063,Matt Spaeth,TE,active,pittsburgh-steelers,648063,2009
34160,460000,115000,Daniel Sepulveda,P,active,pittsburgh-steelers,575000,2009
34161,310000,197667,Kraig Urbik,G,active,pittsburgh-steelers,507667,2009
34162,310000,185813,Mike Wallace,WR,active,pittsburgh-steelers,495813,2009
34163,460000,35466,William Gay,CB,active,pittsburgh-steelers,495466,2009
34164,385000,101500,Tony Hills,LT,active,pittsburgh-steelers,486500,2009
34165,310000,160000,Keenan Lewis,CB,active,pittsburgh-steelers,470000,2009
34166,745000,50000,Charlie Batch,QB,active,pittsburgh-steelers,795000,2009
34167,460000,0,Jeremy Parquet,T,active,pittsburgh-steelers,460000,2009
34168,385000,43333,Dennis Dixon,QB,active,pittsburgh-steelers,428333,2009
34169,385000,0,Patrick Bailey,OLB,active,pittsburgh-steelers,385000,2009
34170,385000,0,Scott Paxson,DT,active,pittsburgh-steelers,385000,2009
34171,310000,45066,Ryan Mundy,SS,active,pittsburgh-steelers,355066,2009
34172,310000,11066,David Johnson,TE,active,pittsburgh-steelers,321066,2009
34173,310000,2667,Ramon Foster,G,active,pittsburgh-steelers,312667,2009
34174,310000,666,Issac Redman,RB,active,pittsburgh-steelers,310666,2009
34175,310000,0,Joe Burnett,CB,active,pittsburgh-steelers,310000,2009
34176,310000,0,Ra'Shon Harris,DT,active,pittsburgh-steelers,310000,2009
34177,310000,0,Doug Legursky,C,active,pittsburgh-steelers,310000,2009
34178,310000,0,Stefan Logan,WR,active,pittsburgh-steelers,310000,2009
34179,310000,0,Steve McLendon,DT,active,pittsburgh-steelers,310000,2009
34180,27059,0,Dallas Baker,WR,active,pittsburgh-steelers,27059,2009
34181,620000,130000,Sean McHugh,TE,injured_reserve,pittsburgh-steelers,750000,2009
34182,310000,38416,Frank Summers,FB,injured_reserve,pittsburgh-steelers,348416,2009
34183,176800,0,Steve McLendon,DT,practice_squad,pittsburgh-steelers,176800,2009
34184,4710000,0,Kendall Simmons,G,dead_cap,pittsburgh-steelers,4710000,2009
34185,1047500,0,Larry Foote,ILB,dead_cap,pittsburgh-steelers,1047500,2009
34186,47716,0,Mike Humpal,LB,dead_cap,pittsburgh-steelers,47716,2009
34187,21333,0,Ra'Shon Harris,DT,dead_cap,pittsburgh-steelers,21333,2009
34188,14000,0,A.Q. Shipley,C,dead_cap,pittsburgh-steelers,14000,2009
34189,10000,0,Patrick Bailey,OLB,dead_cap,pittsburgh-steelers,10000,2009
34190,4250,0,Donovan Woods,LB,dead_cap,pittsburgh-steelers,4250,2009
34191,2000,0,Doug Legursky,C,dead_cap,pittsburgh-steelers,2000,2009
34192,333,0,Steve McLendon,DT,dead_cap,pittsburgh-steelers,333,2009
34193,6155882,4200000,Ben Roethlisberger,QB,active,pittsburgh-steelers,10355882,2010
34194,6100000,2195000,Troy Polamalu,S,active,pittsburgh-steelers,8295000,2010
34195,4000000,2166667,Casey Hampton,DT,active,pittsburgh-steelers,6166667,2010
34196,5000000,1600000,Aaron Smith,DE,active,pittsburgh-steelers,6600000,2010
34197,3500000,3380000,Ike Taylor,CB,active,pittsburgh-steelers,6880000,2010
34198,755000,6400000,James Harrison,OLB,active,pittsburgh-steelers,7155000,2010
34199,2498000,3550000,Heath Miller,TE,active,pittsburgh-steelers,6048000,2010
34200,4000000,610000,Hines Ward,WR,active,pittsburgh-steelers,4610000,2010
34201,2925000,1000000,Brett Keisel,DE,active,pittsburgh-steelers,3925000,2010
34202,3300000,600000,Larry Foote,ILB,active,pittsburgh-steelers,3900000,2010
34203,2369000,777000,Chris Kemoeatu,G,active,pittsburgh-steelers,3146000,2010
34204,2000000,750000,Ryan Clark,S,active,pittsburgh-steelers,2750000,2010
34205,2521000,0,Willie Colon,G,active,pittsburgh-steelers,2521000,2010
34206,550000,3277000,Lawrence Timmons,ILB,active,pittsburgh-steelers,3827000,2010
34207,395000,2973353,Evander Hood,DE,active,pittsburgh-steelers,3368353,2010
34208,2000000,166667,Bryant McFadden,CB,active,pittsburgh-steelers,2166667,2010
34209,1500000,500000,Chris Hoke,T,active,pittsburgh-steelers,2000000,2010
34210,1475000,450000,Mewelde Moore,RB,active,pittsburgh-steelers,1925000,2010
34211,1600000,300000,Antwaan Randle El,WR,active,pittsburgh-steelers,1900000,2010
34212,1800000,0,Byron Leftwich,QB,active,pittsburgh-steelers,1800000,2010
34213,527500,2317500,Rashard Mendenhall,RB,active,pittsburgh-steelers,2845000,2010
34214,320000,1124500,Maurkice Pouncey,C,active,pittsburgh-steelers,1444500,2010
34215,975000,325000,Will Allen,SS,active,pittsburgh-steelers,1300000,2010
34216,925000,325000,Arnaz Battle,WR,active,pittsburgh-steelers,1250000,2010
34217,1101000,0,William Gay,CB,active,pittsburgh-steelers,1101000,2010
34218,1101000,0,Daniel Sepulveda,P,active,pittsburgh-steelers,1101000,2010
34219,1101000,0,Matt Spaeth,TE,active,pittsburgh-steelers,1101000,2010
34220,806000,250000,Trai Essex,T,active,pittsburgh-steelers,1056000,2010
34221,800000,190000,Keyaron Fox,ILB,active,pittsburgh-steelers,990000,2010
34222,855000,25000,Charlie Batch,QB,active,pittsburgh-steelers,880000,2010
34223,550000,350000,LaMarr Woodley,OLB,active,pittsburgh-steelers,900000,2010
34224,700000,131667,Greg Warren,LS,active,pittsburgh-steelers,831667,2010
34225,320000,355000,Jason Worilds,OLB,active,pittsburgh-steelers,675000,2010
34226,630000,0,Nick Eason,DE,active,pittsburgh-steelers,630000,2010
34227,395000,185813,Mike Wallace,WR,active,pittsburgh-steelers,580813,2010
34228,470000,101500,Tony Hills,LT,active,pittsburgh-steelers,571500,2010
34229,395000,160000,Keenan Lewis,CB,active,pittsburgh-steelers,555000,2010
34230,545000,0,Jonathan Scott,LT,active,pittsburgh-steelers,545000,2010
34231,320000,195356,Emmanuel Sanders,WR,active,pittsburgh-steelers,515356,2010
34232,470000,43333,Dennis Dixon,QB,active,pittsburgh-steelers,513333,2010
34233,470000,2500,Donovan Woods,LB,active,pittsburgh-steelers,472500,2010
34234,395000,11066,David Johnson,TE,active,pittsburgh-steelers,406066,2010
34235,395000,2667,Ramon Foster,G,active,pittsburgh-steelers,397667,2010
34236,395000,0,Doug Legursky,C,active,pittsburgh-steelers,395000,2010
34237,395000,0,Ryan Mundy,SS,active,pittsburgh-steelers,395000,2010
34238,320000,46686,Chris Scott,G,active,pittsburgh-steelers,366686,2010
34239,320000,38853,Stevenson Sylvester,ILB,active,pittsburgh-steelers,358853,2010
34240,320000,25946,Jonathan Dwyer,RB,active,pittsburgh-steelers,345946,2010
34241,320000,24358,Antonio Brown,WR,active,pittsburgh-steelers,344358,2010
34242,320000,666,Issac Redman,RB,active,pittsburgh-steelers,320666,2010
34243,259411,50000,Shaun Suisham,K,active,pittsburgh-steelers,309411,2010
34244,225882,0,Steve McLendon,DT,active,pittsburgh-steelers,225882,2010
34245,4320000,2100000,Max Starks,LT,injured_reserve,pittsburgh-steelers,6420000,2010
34246,176800,0,Steve McLendon,DT,practice_squad,pittsburgh-steelers,176800,2010
34247,88400,0,Al Woods,DT,practice_squad,pittsburgh-steelers,88400,2010
34248,890000,0,Santonio Holmes,WR,dead_cap,pittsburgh-steelers,890000,2010
34249,395334,0,Kraig Urbik,G,dead_cap,pittsburgh-steelers,395334,2010
34250,200750,0,Chris Ellis,DE,dead_cap,pittsburgh-steelers,200750,2010
34251,152816,0,Frank Summers,FB,dead_cap,pittsburgh-steelers,152816,2010
34252,130000,0,Sean McHugh,TE,dead_cap,pittsburgh-steelers,130000,2010
34253,0,122005,Thaddeus Gibson,DE,dead_cap,pittsburgh-steelers,122005,2010
34254,42666,0,Ra'Shon Harris,DT,dead_cap,pittsburgh-steelers,42666,2010
34255,38875,0,Joe Burnett,CB,dead_cap,pittsburgh-steelers,38875,2010
34256,28000,0,A.Q. Shipley,C,dead_cap,pittsburgh-steelers,28000,2010
34257,0,8328,Doug Worthington,DE,dead_cap,pittsburgh-steelers,8328,2010
34258,2500,0,Donovan Woods,LB,dead_cap,pittsburgh-steelers,2500,2010
34259,0,1666,Da'Mon Cromartie-Smith,CB,dead_cap,pittsburgh-steelers,1666,2010
34260,667,0,Steve McLendon,DT,dead_cap,pittsburgh-steelers,667,2010
34261,6000000,5320000,Ben Roethlisberger,QB,active,pittsburgh-steelers,11320000,2011
34262,3450000,4832500,Troy Polamalu,S,active,pittsburgh-steelers,8282500,2011
34263,1100000,6600000,LaMarr Woodley,OLB,active,pittsburgh-steelers,7700000,2011
34264,3910000,2166667,Casey Hampton,DT,active,pittsburgh-steelers,6076667,2011
34265,4500000,1600000,Aaron Smith,DE,active,pittsburgh-steelers,6100000,2011
34266,450000,6424250,Maurkice Pouncey,C,active,pittsburgh-steelers,6874250,2011
34267,1000000,5757500,Lawrence Timmons,ILB,active,pittsburgh-steelers,6757500,2011
34268,1176470,4915000,James Harrison,OLB,active,pittsburgh-steelers,6091470,2011
34269,1250000,2562500,Ike Taylor,CB,active,pittsburgh-steelers,3812500,2011
34270,1000000,4146500,Heath Miller,TE,active,pittsburgh-steelers,5146500,2011
34271,2937000,777000,Chris Kemoeatu,G,active,pittsburgh-steelers,3714000,2011
34272,3000000,610000,Hines Ward,WR,active,pittsburgh-steelers,3610000,2011
34273,1000000,2350000,Brett Keisel,DE,active,pittsburgh-steelers,3350000,2011
34274,2400000,600000,Larry Foote,ILB,active,pittsburgh-steelers,3000000,2011
34275,1500000,1200000,Willie Colon,G,active,pittsburgh-steelers,2700000,2011
34276,2500000,166667,Bryant McFadden,CB,active,pittsburgh-steelers,2666667,2011
34277,1000000,1250000,Ryan Clark,S,active,pittsburgh-steelers,2250000,2011
34278,600000,2008353,Evander Hood,DE,active,pittsburgh-steelers,2608353,2011
34279,1265000,325000,Will Allen,SS,active,pittsburgh-steelers,1590000,2011
34280,1037500,325000,Arnaz Battle,WR,active,pittsburgh-steelers,1362500,2011
34281,800000,500000,Jonathan Scott,LT,active,pittsburgh-steelers,1300000,2011
34282,450000,820000,Jason Worilds,OLB,active,pittsburgh-steelers,1270000,2011
34283,375000,844096,Cameron Heyward,DE,active,pittsburgh-steelers,1219096,2011
34284,1200000,0,Dennis Dixon,QB,active,pittsburgh-steelers,1200000,2011
34285,1200000,0,Tony Hills,LT,active,pittsburgh-steelers,1200000,2011
34286,810000,337500,Shaun Suisham,K,active,pittsburgh-steelers,1147500,2011
34287,910000,25000,Charlie Batch,QB,active,pittsburgh-steelers,935000,2011
34288,810000,50000,Jerricho Cotchery,WR,active,pittsburgh-steelers,860000,2011
34289,685000,100000,Leonard Pope,TE,active,pittsburgh-steelers,785000,2011
34290,685000,100000,Greg Warren,LS,active,pittsburgh-steelers,785000,2011
34291,525000,185813,Mike Wallace,WR,active,pittsburgh-steelers,710813,2011
34292,525000,160000,Keenan Lewis,CB,active,pittsburgh-steelers,685000,2011
34293,810000,0,Max Starks,LT,active,pittsburgh-steelers,810000,2011
34294,405000,195356,Emmanuel Sanders,WR,active,pittsburgh-steelers,600356,2011
34295,600000,0,Macho Harris,CB,active,pittsburgh-steelers,600000,2011
34296,600000,0,Jeremy Kapinos,P,active,pittsburgh-steelers,600000,2011
34297,375000,211802,Marcus Gilbert,RT,active,pittsburgh-steelers,586802,2011
34298,810000,50000,Chris Hoke,T,active,pittsburgh-steelers,860000,2011
34299,810000,50000,Mewelde Moore,RB,active,pittsburgh-steelers,860000,2011
34300,525000,11066,David Johnson,TE,active,pittsburgh-steelers,536066,2011
34301,525000,2667,Ramon Foster,G,active,pittsburgh-steelers,527667,2011
34302,685000,0,Trai Essex,T,active,pittsburgh-steelers,685000,2011
34303,685000,50000,William Gay,CB,active,pittsburgh-steelers,735000,2011
34304,525000,0,Baraka Atkins,OLB,active,pittsburgh-steelers,525000,2011
34305,525000,0,Doug Legursky,C,active,pittsburgh-steelers,525000,2011
34306,525000,0,Jamon Meredith,RT,active,pittsburgh-steelers,525000,2011
34307,525000,0,Ryan Mundy,SS,active,pittsburgh-steelers,525000,2011
34308,375000,130300,Curtis Brown,CB,active,pittsburgh-steelers,505300,2011
34309,450000,38853,Stevenson Sylvester,ILB,active,pittsburgh-steelers,488853,2011
34310,450000,25946,Jonathan Dwyer,RB,active,pittsburgh-steelers,475946,2011
34311,450000,24358,Antonio Brown,WR,active,pittsburgh-steelers,474358,2011
34312,375000,97875,Cortez Allen,CB,active,pittsburgh-steelers,472875,2011
34313,450000,668,Issac Redman,RB,active,pittsburgh-steelers,450668,2011
34314,450000,0,Steve McLendon,DT,active,pittsburgh-steelers,450000,2011
34315,375000,40700,Chris Carter,ILB,active,pittsburgh-steelers,415700,2011
34316,375000,11628,Baron Batch,RB,active,pittsburgh-steelers,386628,2011
34317,375000,3333,John Clay,RB,active,pittsburgh-steelers,378333,2011
34318,375000,3333,Anthony Gray,DT,active,pittsburgh-steelers,378333,2011
34319,375000,2000,Terrence McCrae,WR,active,pittsburgh-steelers,377000,2011
34320,375000,1667,Niles Brinkley,CB,active,pittsburgh-steelers,376667,2011
34321,375000,1333,Miguel Chavis,TE,active,pittsburgh-steelers,376333,2011
34322,375000,1333,Weslye Saunders,WR,active,pittsburgh-steelers,376333,2011
34323,375000,1000,Vaughn Charlton,TE,active,pittsburgh-steelers,376000,2011
34324,375000,667,Erik Clanton,LB,active,pittsburgh-steelers,375667,2011
34325,375000,667,Brett Greenwood,CB,active,pittsburgh-steelers,375667,2011
34326,375000,667,Eric Greenwood,WR,active,pittsburgh-steelers,375667,2011
34327,375000,667,Colin Miller,C,active,pittsburgh-steelers,375667,2011
34328,375000,667,Adam Mims,WR,active,pittsburgh-steelers,375667,2011
34329,375000,667,Armand Robinson,WR,active,pittsburgh-steelers,375667,2011
34330,375000,333,Aaron Bates,P,active,pittsburgh-steelers,375333,2011
34331,375000,333,Ty Boyle,DE,active,pittsburgh-steelers,375333,2011
34332,375000,333,Derek Chard,C,active,pittsburgh-steelers,375333,2011
34333,375000,333,Chris Dieker,QB,active,pittsburgh-steelers,375333,2011
34334,375000,333,Josh Harrison,T,active,pittsburgh-steelers,375333,2011
34335,375000,0,Da'Mon Cromartie-Smith,CB,active,pittsburgh-steelers,375000,2011
34336,375000,0,Mortty Ivy,LB,active,pittsburgh-steelers,375000,2011
34337,325000,50000,Daniel Sepulveda,P,active,pittsburgh-steelers,375000,2011
34338,1750000,250000,Byron Leftwich,QB,injured_reserve,pittsburgh-steelers,2000000,2011
34339,612500,2372500,Rashard Mendenhall,RB,injured_reserve,pittsburgh-steelers,2985000,2011
34340,0,2000000,Max Starks,LT,dead_cap,pittsburgh-steelers,2000000,2011
34341,0,300000,Antwaan Randle El,WR,dead_cap,pittsburgh-steelers,300000,2011
34342,0,244010,Thaddeus Gibson,DE,dead_cap,pittsburgh-steelers,244010,2011
34343,200750,0,Chris Ellis,DE,dead_cap,pittsburgh-steelers,200750,2011
34344,130000,0,Sean McHugh,TE,dead_cap,pittsburgh-steelers,130000,2011
34345,0,46685,Chris Scott,G,dead_cap,pittsburgh-steelers,46685,2011
34346,0,39724,Crezdon Butler,CB,dead_cap,pittsburgh-steelers,39724,2011
34347,38875,0,Joe Burnett,CB,dead_cap,pittsburgh-steelers,38875,2011
34348,38416,0,Frank Summers,FB,dead_cap,pittsburgh-steelers,38416,2011
34349,0,24984,Doug Worthington,DE,dead_cap,pittsburgh-steelers,24984,2011
34350,0,22750,Keith Williams,G,dead_cap,pittsburgh-steelers,22750,2011
34351,0,3334,Da'Mon Cromartie-Smith,CB,dead_cap,pittsburgh-steelers,3334,2011
34352,3333,0,Mario Harvey,FB,dead_cap,pittsburgh-steelers,3333,2011
34353,6250000,2887500,Troy Polamalu,S,active,pittsburgh-steelers,9137500,2012
34354,5565000,4265000,James Harrison,OLB,active,pittsburgh-steelers,9830000,2012
34355,900000,7995000,Ben Roethlisberger,QB,active,pittsburgh-steelers,8895000,2012
34356,2825000,2350000,Brett Keisel,DE,active,pittsburgh-steelers,5175000,2012
34357,2800000,2166667,Casey Hampton,DT,active,pittsburgh-steelers,4966667,2012
34358,700000,4240000,LaMarr Woodley,OLB,active,pittsburgh-steelers,4940000,2012
34359,3000000,1250000,Ryan Clark,S,active,pittsburgh-steelers,4250000,2012
34360,700000,3285000,Lawrence Timmons,ILB,active,pittsburgh-steelers,3985000,2012
34361,3000000,600000,Larry Foote,ILB,active,pittsburgh-steelers,3600000,2012
34362,700000,3880000,Rashard Mendenhall,RB,active,pittsburgh-steelers,4580000,2012
34363,700000,2150000,Willie Colon,G,active,pittsburgh-steelers,2850000,2012
34364,2742000,0,Mike Wallace,WR,active,pittsburgh-steelers,2742000,2012
34365,540000,1724358,Antonio Brown,WR,active,pittsburgh-steelers,2264358,2012
34366,666125,2901250,Maurkice Pouncey,C,active,pittsburgh-steelers,3567375,2012
34367,615000,2108353,Evander Hood,DE,active,pittsburgh-steelers,2723353,2012
34368,1350000,337500,Shaun Suisham,K,active,pittsburgh-steelers,1687500,2012
34369,1280000,325000,Will Allen,SS,active,pittsburgh-steelers,1605000,2012
34370,679774,844096,Cameron Heyward,DE,active,pittsburgh-steelers,1523870,2012
34371,1000000,500000,Jerricho Cotchery,WR,active,pittsburgh-steelers,1500000,2012
34372,390000,1030709,David DeCastro,G,active,pittsburgh-steelers,1420709,2012
34373,1260000,0,Ramon Foster,G,active,pittsburgh-steelers,1260000,2012
34374,1260000,0,Doug Legursky,C,active,pittsburgh-steelers,1260000,2012
34375,1260000,0,Keenan Lewis,CB,active,pittsburgh-steelers,1260000,2012
34376,1260000,0,Ryan Mundy,SS,active,pittsburgh-steelers,1260000,2012
34377,925000,0,Plaxico Burress,WR,active,pittsburgh-steelers,925000,2012
34378,825000,100000,Greg Warren,LS,active,pittsburgh-steelers,925000,2012
34379,540000,355000,Jason Worilds,OLB,active,pittsburgh-steelers,895000,2012
34380,490000,195356,Emmanuel Sanders,WR,active,pittsburgh-steelers,685356,2012
34381,465000,211802,Marcus Gilbert,RT,active,pittsburgh-steelers,676802,2012
34382,390000,254300,Mike Adams,LT,active,pittsburgh-steelers,644300,2012
34383,630000,0,David Johnson,TE,active,pittsburgh-steelers,630000,2012
34384,615000,0,Justin King,CB,active,pittsburgh-steelers,615000,2012
34385,465000,130300,Curtis Brown,CB,active,pittsburgh-steelers,595300,2012
34386,540000,38853,Stevenson Sylvester,ILB,active,pittsburgh-steelers,578853,2012
34387,540000,25946,Jonathan Dwyer,RB,active,pittsburgh-steelers,565946,2012
34388,465000,97875,Cortez Allen,CB,active,pittsburgh-steelers,562875,2012
34389,925000,65000,Charlie Batch,QB,active,pittsburgh-steelers,990000,2012
34390,825000,65000,Byron Leftwich,QB,active,pittsburgh-steelers,890000,2012
34391,825000,65000,Max Starks,LT,active,pittsburgh-steelers,890000,2012
34392,700000,0,Brandon Johnson,LB,active,pittsburgh-steelers,700000,2012
34393,540000,0,Steve McLendon,DT,active,pittsburgh-steelers,540000,2012
34394,540000,0,Issac Redman,RB,active,pittsburgh-steelers,540000,2012
34395,540000,0,Al Woods,DT,active,pittsburgh-steelers,540000,2012
34396,390000,136345,Sean Spence,ILB,active,pittsburgh-steelers,526345,2012
34397,465000,40700,Chris Carter,ILB,active,pittsburgh-steelers,505700,2012
34398,465000,0,Baron Batch,RB,active,pittsburgh-steelers,465000,2012
34399,465000,0,DeMarcus Van Dyke,CB,active,pittsburgh-steelers,465000,2012
34400,344188,108328,Alameda Ta'amu,DT,active,pittsburgh-steelers,452516,2012
34401,390000,45413,Chris Rainey,RB,active,pittsburgh-steelers,435413,2012
34402,390000,11474,Kelvin Beachum,LT,active,pittsburgh-steelers,401474,2012
34403,390000,11474,David Paulson,TE,active,pittsburgh-steelers,401474,2012
34404,390000,1667,Robert Golden,FS,active,pittsburgh-steelers,391667,2012
34405,390000,1667,Adrian Robinson,OLB,active,pittsburgh-steelers,391667,2012
34406,390000,1666,Drew Butler,P,active,pittsburgh-steelers,391666,2012
34407,390000,833,Grant Ressel,K,active,pittsburgh-steelers,390833,2012
34408,390000,0,Hebron Fangupo,DT,active,pittsburgh-steelers,390000,2012
34409,390000,0,David Gilreath,WR,active,pittsburgh-steelers,390000,2012
34410,390000,0,Will Johnson,FB,active,pittsburgh-steelers,390000,2012
34411,390000,0,Brandon Lindsey,LB,active,pittsburgh-steelers,390000,2012
34412,390000,0,Wes Lyons,WR,active,pittsburgh-steelers,390000,2012
34413,390000,0,Jamie McCoy,TE,active,pittsburgh-steelers,390000,2012
34414,390000,0,Alameda Ta'amu,DT,active,pittsburgh-steelers,390000,2012
34415,390000,0,Trevis Turner,T,active,pittsburgh-steelers,390000,2012
34416,465000,0,Da'Mon Cromartie-Smith,CB,active,pittsburgh-steelers,465000,2012
34417,390000,0,John Malecki,C,active,pittsburgh-steelers,390000,2012
34418,390000,0,Marshall McFadden,ILB,active,pittsburgh-steelers,390000,2012
34419,4274000,4146500,Heath Miller,TE,injured_reserve,pittsburgh-steelers,8420500,2012
34420,825000,3454168,Ike Taylor,CB,injured_reserve,pittsburgh-steelers,4279168,2012
34421,145312,0,Weslye Saunders,WR,practice_squad,pittsburgh-steelers,145312,2012
34422,34200,0,Alameda Ta'amu,DT,practice_squad,pittsburgh-steelers,34200,2012
34423,2869334,0,Chris Kemoeatu,G,dead_cap,pittsburgh-steelers,2869334,2012
34424,0,2000000,Max Starks,LT,dead_cap,pittsburgh-steelers,2000000,2012
34425,1220000,0,Hines Ward,WR,dead_cap,pittsburgh-steelers,1220000,2012
34426,1000000,0,James Farrior,LB,dead_cap,pittsburgh-steelers,1000000,2012
34427,875000,0,Aaron Smith,DE,dead_cap,pittsburgh-steelers,875000,2012
34428,500000,0,Jonathan Scott,LT,dead_cap,pittsburgh-steelers,500000,2012
34429,325000,0,Arnaz Battle,WR,dead_cap,pittsburgh-steelers,325000,2012
34430,0,300000,Antwaan Randle El,WR,dead_cap,pittsburgh-steelers,300000,2012
34431,166667,0,Bryant McFadden,CB,dead_cap,pittsburgh-steelers,166667,2012
34432,162492,0,Alameda Ta'amu,DT,dead_cap,pittsburgh-steelers,162492,2012
34433,0,68250,Keith Williams,G,dead_cap,pittsburgh-steelers,68250,2012
34434,68119,0,Chris Rainey,RB,dead_cap,pittsburgh-steelers,68119,2012
34435,65000,0,Trai Essex,T,dead_cap,pittsburgh-steelers,65000,2012
34436,65000,0,Justin Peelle,TE,dead_cap,pittsburgh-steelers,65000,2012
34437,0,46685,Chris Scott,G,dead_cap,pittsburgh-steelers,46685,2012
34438,0,39724,Crezdon Butler,CB,dead_cap,pittsburgh-steelers,39724,2012
34439,0,15298,Terrence Frederick,CB,dead_cap,pittsburgh-steelers,15298,2012
34440,12456,0,Toney Clemons,WR,dead_cap,pittsburgh-steelers,12456,2012
34441,11628,0,Baron Batch,RB,dead_cap,pittsburgh-steelers,11628,2012
34442,6667,0,John Clay,RB,dead_cap,pittsburgh-steelers,6667,2012
34443,6667,0,Anthony Gray,DT,dead_cap,pittsburgh-steelers,6667,2012
34444,4000,0,Terrence McCrae,WR,dead_cap,pittsburgh-steelers,4000,2012
34445,3334,0,Niles Brinkley,CB,dead_cap,pittsburgh-steelers,3334,2012
34446,2667,0,Miguel Chavis,TE,dead_cap,pittsburgh-steelers,2667,2012
34447,2500,0,Grant Ressel,K,dead_cap,pittsburgh-steelers,2500,2012
34448,2000,0,Vaughn Charlton,TE,dead_cap,pittsburgh-steelers,2000,2012
34449,1667,0,Terry Carter,CB,dead_cap,pittsburgh-steelers,1667,2012
34450,1667,0,Ikponmwosa Igbinosun,DE,dead_cap,pittsburgh-steelers,1667,2012
34451,1667,0,Ryan Lee,G,dead_cap,pittsburgh-steelers,1667,2012
34452,1667,0,Brandon Lindsey,LB,dead_cap,pittsburgh-steelers,1667,2012
34453,1667,0,Marquis Maze,WR,dead_cap,pittsburgh-steelers,1667,2012
34454,1667,0,Jake Stoller,DE,dead_cap,pittsburgh-steelers,1667,2012
34455,1334,0,Erik Clanton,LB,dead_cap,pittsburgh-steelers,1334,2012
34456,1334,0,Brett Greenwood,CB,dead_cap,pittsburgh-steelers,1334,2012
34457,1334,0,Eric Greenwood,WR,dead_cap,pittsburgh-steelers,1334,2012
34458,1334,0,Colin Miller,C,dead_cap,pittsburgh-steelers,1334,2012
34459,1334,0,Adam Mims,WR,dead_cap,pittsburgh-steelers,1334,2012
34460,1334,0,Armand Robinson,WR,dead_cap,pittsburgh-steelers,1334,2012
34461,1333,0,Weslye Saunders,WR,dead_cap,pittsburgh-steelers,1333,2012
34462,833,0,Connor Dixon,WR,dead_cap,pittsburgh-steelers,833,2012
34463,667,0,Aaron Bates,P,dead_cap,pittsburgh-steelers,667,2012
34464,667,0,Ty Boyle,DE,dead_cap,pittsburgh-steelers,667,2012
34465,667,0,Derek Chard,C,dead_cap,pittsburgh-steelers,667,2012
34466,667,0,Chris Dieker,QB,dead_cap,pittsburgh-steelers,667,2012
34467,667,0,Josh Harrison,T,dead_cap,pittsburgh-steelers,667,2012
34468,2600000,10995000,Ben Roethlisberger,QB,active,pittsburgh-steelers,13595000,2013
34469,7500000,2637500,Troy Polamalu,S,active,pittsburgh-steelers,10137500,2013
34470,2162000,5646500,Heath Miller,TE,active,pittsburgh-steelers,7808500,2013
34471,940000,4942403,Ike Taylor,CB,active,pittsburgh-steelers,5882403,2013
34472,750000,5066250,Lawrence Timmons,ILB,active,pittsburgh-steelers,5816250,2013
34473,650000,4970000,Antonio Brown,WR,active,pittsburgh-steelers,5620000,2013
34474,2825000,2750000,Brett Keisel,DE,active,pittsburgh-steelers,5575000,2013
34475,3500000,1250000,Ryan Clark,S,active,pittsburgh-steelers,4750000,2013
34476,715000,3255678,Evander Hood,DE,active,pittsburgh-steelers,3970678,2013
34477,977250,2951250,Maurkice Pouncey,C,active,pittsburgh-steelers,3928500,2013
34478,2500000,0,Emmanuel Sanders,WR,active,pittsburgh-steelers,2500000,2013
34479,984548,844096,Cameron Heyward,DE,active,pittsburgh-steelers,1828644,2013
34480,745177,1030709,David DeCastro,G,active,pittsburgh-steelers,1775886,2013
34481,1425000,337500,Shaun Suisham,K,active,pittsburgh-steelers,1762500,2013
34482,405000,1177818,Jarvis Jones,OLB,active,pittsburgh-steelers,1582818,2013
34483,1100000,400000,Ramon Foster,G,active,pittsburgh-steelers,1500000,2013
34484,1000000,500000,Jerricho Cotchery,WR,active,pittsburgh-steelers,1500000,2013
34485,900000,558333,Steve McLendon,DT,active,pittsburgh-steelers,1458333,2013
34486,1000000,283333,Bruce Gradkowski,QB,active,pittsburgh-steelers,1283333,2013
34487,1000000,166667,William Gay,CB,active,pittsburgh-steelers,1166667,2013
34488,630000,355000,Jason Worilds,OLB,active,pittsburgh-steelers,985000,2013
34489,825000,137500,Matt Spaeth,TE,active,pittsburgh-steelers,962500,2013
34490,668402,211802,Marcus Gilbert,RT,active,pittsburgh-steelers,880204,2013
34491,480000,325375,Mike Adams,LT,active,pittsburgh-steelers,805375,2013
34492,405000,344200,Le'Veon Bell,RB,active,pittsburgh-steelers,749200,2013
34493,555000,130300,Curtis Brown,CB,active,pittsburgh-steelers,685300,2013
34494,630000,35000,David Johnson,TE,active,pittsburgh-steelers,665000,2013
34495,555000,97875,Cortez Allen,CB,active,pittsburgh-steelers,652875,2013
34496,630000,0,Michael Palmer,TE,active,pittsburgh-steelers,630000,2013
34497,630000,0,Cody Wallace,C,active,pittsburgh-steelers,630000,2013
34498,630000,0,Al Woods,DT,active,pittsburgh-steelers,630000,2013
34499,840000,65000,Greg Warren,LS,active,pittsburgh-steelers,905000,2013
34500,555000,40700,Chris Carter,ILB,active,pittsburgh-steelers,595700,2013
34501,840000,0,Will Allen,SS,active,pittsburgh-steelers,840000,2013
34502,630000,0,Jonathan Dwyer,RB,active,pittsburgh-steelers,630000,2013
34503,715000,32500,Felix Jones,RB,active,pittsburgh-steelers,747500,2013
34504,715000,0,Guy Whimper,G,active,pittsburgh-steelers,715000,2013
34505,405000,147844,Markus Wheaton,WR,active,pittsburgh-steelers,552844,2013
34506,715000,0,Fernando Velasco,G,active,pittsburgh-steelers,715000,2013
34507,405000,113288,Shamarko Thomas,SS,active,pittsburgh-steelers,518288,2013
34508,405000,109805,Landry Jones,QB,active,pittsburgh-steelers,514805,2013
34509,480000,11474,Kelvin Beachum,LT,active,pittsburgh-steelers,491474,2013
34510,480000,11474,David Paulson,TE,active,pittsburgh-steelers,491474,2013
34511,480000,1667,Robert Golden,FS,active,pittsburgh-steelers,481667,2013
34512,480000,0,Antwon Blake,CB,active,pittsburgh-steelers,480000,2013
34513,480000,0,Will Johnson,FB,active,pittsburgh-steelers,480000,2013
34514,630000,0,Stevenson Sylvester,ILB,active,pittsburgh-steelers,630000,2013
34515,405000,19670,Vince Williams,ILB,active,pittsburgh-steelers,424670,2013
34516,405000,0,Hebron Fangupo,DT,active,pittsburgh-steelers,405000,2013
34517,405000,0,Terence Garvin,ILB,active,pittsburgh-steelers,405000,2013
34518,405000,0,Derek Moye,WR,active,pittsburgh-steelers,405000,2013
34519,288000,14462,Nick Williams,DE,active,pittsburgh-steelers,302462,2013
34520,840000,0,Mat McBriar,P,active,pittsburgh-steelers,840000,2013
34521,555000,0,Eric Olsen,C,active,pittsburgh-steelers,555000,2013
34522,405000,0,Isaiah Green,S,active,pittsburgh-steelers,405000,2013
34523,480000,0,David Snow,G,active,pittsburgh-steelers,480000,2013
34524,405000,0,Brian Arnfelt,DE,active,pittsburgh-steelers,405000,2013
34525,715000,0,Jamaal Westerman,LB,active,pittsburgh-steelers,715000,2013
34526,3600000,5590000,LaMarr Woodley,OLB,injured_reserve,pittsburgh-steelers,9190000,2013
34527,1500000,333333,Larry Foote,ILB,injured_reserve,pittsburgh-steelers,1833333,2013
34528,715000,1021397,Levi Brown,LT,injured_reserve,pittsburgh-steelers,1736397,2013
34529,940000,65000,Plaxico Burress,WR,injured_reserve,pittsburgh-steelers,1005000,2013
34530,715000,65000,LaRod Stephens-Howling,RB,injured_reserve,pittsburgh-steelers,780000,2013
34531,288000,2500,Nik Embernate,G,injured_reserve,pittsburgh-steelers,290500,2013
34532,715000,0,Rashad Butler,LT,injured_reserve,pittsburgh-steelers,715000,2013
34533,102000,0,Brian Arnfelt,DE,practice_squad,pittsburgh-steelers,102000,2013
34534,102000,0,Terence Garvin,ILB,practice_squad,pittsburgh-steelers,102000,2013
34535,30000,0,Devin Smith,CB,practice_squad,pittsburgh-steelers,30000,2013
34536,18000,0,Devon Wylie,WR,practice_squad,pittsburgh-steelers,18000,2013
34537,12000,0,Brandon Jones,CB,practice_squad,pittsburgh-steelers,12000,2013
34538,4930000,0,James Harrison,OLB,dead_cap,pittsburgh-steelers,4930000,2013
34539,2150000,0,Willie Colon,G,dead_cap,pittsburgh-steelers,2150000,2013
34540,1323000,0,Issac Redman,RB,dead_cap,pittsburgh-steelers,1323000,2013
34541,497882,0,Kion Wilson,ILB,dead_cap,pittsburgh-steelers,497882,2013
34542,324984,0,Alameda Ta'amu,DT,dead_cap,pittsburgh-steelers,324984,2013
34543,296471,0,Zoltan Mesko,P,dead_cap,pittsburgh-steelers,296471,2013
34544,261177,0,Richard Gordon,TE,dead_cap,pittsburgh-steelers,261177,2013
34545,184942,0,Isaiah Green,S,dead_cap,pittsburgh-steelers,184942,2013
34546,169412,0,Da'Mon Cromartie-Smith,CB,dead_cap,pittsburgh-steelers,169412,2013
34547,136239,0,Chris Rainey,RB,dead_cap,pittsburgh-steelers,136239,2013
34548,130588,0,DeMarcus Van Dyke,CB,dead_cap,pittsburgh-steelers,130588,2013
34549,90000,0,Joe Long,LT,dead_cap,pittsburgh-steelers,90000,2013
34550,84000,0,Brian Arnfelt,DE,dead_cap,pittsburgh-steelers,84000,2013
34551,50824,0,Justin Cheadle,G,dead_cap,pittsburgh-steelers,50824,2013
34552,47513,0,Terry Hawthorne,CB,dead_cap,pittsburgh-steelers,47513,2013
34553,37368,0,Toney Clemons,WR,dead_cap,pittsburgh-steelers,37368,2013
34554,36833,0,Alan Baxter,OLB,dead_cap,pittsburgh-steelers,36833,2013
34555,0,34422,Terrence Frederick,CB,dead_cap,pittsburgh-steelers,34422,2013
34556,32647,0,Shayne Graham,K,dead_cap,pittsburgh-steelers,32647,2013
34557,26018,0,Justin Brown,WR,dead_cap,pittsburgh-steelers,26018,2013
34558,24000,0,Ray Graham,RB,dead_cap,pittsburgh-steelers,24000,2013
34559,24000,0,George Winn,RB,dead_cap,pittsburgh-steelers,24000,2013
34560,23256,0,Baron Batch,RB,dead_cap,pittsburgh-steelers,23256,2013
34561,4000,0,Ivory Wade,C,dead_cap,pittsburgh-steelers,4000,2013
34562,3334,0,Terry Carter,CB,dead_cap,pittsburgh-steelers,3334,2013
34563,3334,0,Ikponmwosa Igbinosun,DE,dead_cap,pittsburgh-steelers,3334,2013
34564,3334,0,Ryan Lee,G,dead_cap,pittsburgh-steelers,3334,2013
34565,3334,0,Marquis Maze,WR,dead_cap,pittsburgh-steelers,3334,2013
34566,2667,0,Brandon Lindsey,LB,dead_cap,pittsburgh-steelers,2667,2013
34567,2667,0,Jake Stoller,DE,dead_cap,pittsburgh-steelers,2667,2013
34568,2500,0,Mike Golic Jr.,RT,dead_cap,pittsburgh-steelers,2500,2013
34569,2000,0,Anthony Rashad-White,DT,dead_cap,pittsburgh-steelers,2000,2013
34570,1667,0,Connor Dixon,WR,dead_cap,pittsburgh-steelers,1667,2013
34571,1667,0,Cordian Hagans,DE,dead_cap,pittsburgh-steelers,1667,2013
34572,1667,0,Adrian Robinson,OLB,dead_cap,pittsburgh-steelers,1667,2013
34573,1666,0,Drew Butler,P,dead_cap,pittsburgh-steelers,1666,2013
34574,1500,0,Chris Hubbard,RT,dead_cap,pittsburgh-steelers,1500,2013
34575,1333,0,Reggie Dunn,WR,dead_cap,pittsburgh-steelers,1333,2013
34576,1333,0,Omar Hunter,DT,dead_cap,pittsburgh-steelers,1333,2013
34577,1333,0,Weslye Saunders,WR,dead_cap,pittsburgh-steelers,1333,2013
34578,1000,0,Joe Madsen,C,dead_cap,pittsburgh-steelers,1000,2013
34579,1000,0,Curtis McNeal,RB,dead_cap,pittsburgh-steelers,1000,2013
34580,833,0,J.D. Woods,WR,dead_cap,pittsburgh-steelers,833,2013
34581,666,0,Mike Farrell,LT,dead_cap,pittsburgh-steelers,666,2013
34582,666,0,Terence Garvin,ILB,dead_cap,pittsburgh-steelers,666,2013
34583,500,0,Luke Ingram,LS,dead_cap,pittsburgh-steelers,500,2013
34584,12100000,6795000,Ben Roethlisberger,QB,active,pittsburgh-steelers,18895000,2014
34585,6750000,5066250,Lawrence Timmons,ILB,active,pittsburgh-steelers,11816250,2014
34586,9754000,0,Jason Worilds,OLB,active,pittsburgh-steelers,9754000,2014
34587,2750000,4942403,Ike Taylor,CB,active,pittsburgh-steelers,7692403,2014
34588,1500000,4887500,Troy Polamalu,S,active,pittsburgh-steelers,6387500,2014
34589,1020000,5709666,Heath Miller,TE,active,pittsburgh-steelers,6729666,2014
34590,1000000,5401250,Maurkice Pouncey,C,active,pittsburgh-steelers,6401250,2014
34591,730000,3787500,Antonio Brown,WR,active,pittsburgh-steelers,4517500,2014
34592,2425000,558333,Steve McLendon,DT,active,pittsburgh-steelers,2983333,2014
34593,650000,1741802,Marcus Gilbert,RT,active,pittsburgh-steelers,2391802,2014
34594,750000,1450000,Mike Mitchell,FS,active,pittsburgh-steelers,2200000,2014
34595,1289322,844096,Cameron Heyward,DE,active,pittsburgh-steelers,2133418,2014
34596,1100354,1030709,David DeCastro,G,active,pittsburgh-steelers,2131063,2014
34597,650000,1447875,Cortez Allen,CB,active,pittsburgh-steelers,2097875,2014
34598,800705,1177818,Jarvis Jones,OLB,active,pittsburgh-steelers,1978523,2014
34599,1650000,300000,Ramon Foster,G,active,pittsburgh-steelers,1950000,2014
34600,1550000,283333,Bruce Gradkowski,QB,active,pittsburgh-steelers,1833333,2014
34601,855000,907500,Shaun Suisham,K,active,pittsburgh-steelers,1762500,2014
34602,420000,1308584,Ryan Shazier,ILB,active,pittsburgh-steelers,1728584,2014
34603,1500000,166667,William Gay,CB,active,pittsburgh-steelers,1666667,2014
34604,1000000,500000,Cam Thomas,DT,active,pittsburgh-steelers,1500000,2014
34605,855000,322500,Lance Moore,WR,active,pittsburgh-steelers,1177500,2014
34606,900000,137500,Matt Spaeth,TE,active,pittsburgh-steelers,1037500,2014
34607,712150,254300,Mike Adams,LT,active,pittsburgh-steelers,966450,2014
34608,495000,441500,Le'Veon Bell,RB,active,pittsburgh-steelers,936500,2014
34609,730000,150000,Cody Wallace,C,active,pittsburgh-steelers,880000,2014
34610,420000,418081,Stephon Tuitt,DE,active,pittsburgh-steelers,838081,2014
34611,590000,136345,Sean Spence,ILB,active,pittsburgh-steelers,726345,2014
34612,515000,147844,Markus Wheaton,WR,active,pittsburgh-steelers,662844,2014
34613,955000,65000,Will Allen,SS,active,pittsburgh-steelers,1020000,2014
34614,855000,65000,Greg Warren,LS,active,pittsburgh-steelers,920000,2014
34615,730000,65000,Darrius Heyward-Bey,WR,active,pittsburgh-steelers,795000,2014
34616,730000,65000,Brice McCain,CB,active,pittsburgh-steelers,795000,2014
34617,730000,65000,Arthur Moats,OLB,active,pittsburgh-steelers,795000,2014
34618,495000,113288,Shamarko Thomas,SS,active,pittsburgh-steelers,608288,2014
34619,495000,109805,Landry Jones,QB,active,pittsburgh-steelers,604805,2014
34620,570000,11474,Kelvin Beachum,LT,active,pittsburgh-steelers,581474,2014
34621,570000,1667,Robert Golden,FS,active,pittsburgh-steelers,571667,2014
34622,730000,0,Michael Palmer,TE,active,pittsburgh-steelers,730000,2014
34623,570000,0,Antwon Blake,CB,active,pittsburgh-steelers,570000,2014
34624,570000,0,Will Johnson,FB,active,pittsburgh-steelers,570000,2014
34625,420000,126504,Dri Archer,RB,active,pittsburgh-steelers,546504,2014
34626,955000,65000,James Harrison,OLB,active,pittsburgh-steelers,1020000,2014
34627,420000,109805,Martavis Bryant,WR,active,pittsburgh-steelers,529805,2014
34628,495000,19670,Vince Williams,ILB,active,pittsburgh-steelers,514670,2014
34629,495000,0,Terence Garvin,ILB,active,pittsburgh-steelers,495000,2014
34630,495000,0,B.W. Webb,CB,active,pittsburgh-steelers,495000,2014
34631,420000,19670,Daniel McCullers,DT,active,pittsburgh-steelers,439670,2014
34632,420000,0,Chris Hubbard,RT,active,pittsburgh-steelers,420000,2014
34633,420000,0,Brad Wing,P,active,pittsburgh-steelers,420000,2014
34634,495000,0,Ross Ventrone,SS,active,pittsburgh-steelers,495000,2014
34635,730000,0,Clifton Geathers,DE,active,pittsburgh-steelers,730000,2014
34636,420000,0,Josh Harris,RB,active,pittsburgh-steelers,420000,2014
34637,0,0,Ben Tate,RB,active,pittsburgh-steelers,0,2014
34638,1000000,250000,Brett Keisel,DE,injured_reserve,pittsburgh-steelers,1250000,2014
34639,303000,26213,Jordan Zumwalt,ILB,injured_reserve,pittsburgh-steelers,329213,2014
34640,303000,0,Bryant Browning,LT,injured_reserve,pittsburgh-steelers,303000,2014
34641,107100,0,Rob Blanchflower,TE,practice_squad,pittsburgh-steelers,107100,2014
34642,107100,0,C.J. Goodwin,S,practice_squad,pittsburgh-steelers,107100,2014
34643,107100,0,Howard Jones,OLB,practice_squad,pittsburgh-steelers,107100,2014
34644,107100,0,Alejandro Villanueva,LT,practice_squad,pittsburgh-steelers,107100,2014
34645,44100,0,Ethan Hemer,DT,practice_squad,pittsburgh-steelers,44100,2014
34646,31500,0,Joe Kruger,DE,practice_squad,pittsburgh-steelers,31500,2014
34647,18900,0,Kevin Fogg,CB,practice_squad,pittsburgh-steelers,18900,2014
34648,12600,0,Ronald Patrick,C,practice_squad,pittsburgh-steelers,12600,2014
34649,0,5590000,LaMarr Woodley,OLB,dead_cap,pittsburgh-steelers,5590000,2014
34650,4300000,0,Willie Colon,G,dead_cap,pittsburgh-steelers,4300000,2014
34651,900000,475000,LeGarrette Blount,RB,dead_cap,pittsburgh-steelers,1375000,2014
34652,666667,0,Larry Foote,ILB,dead_cap,pittsburgh-steelers,666667,2014
34653,148235,36140,Wesley Johnson,C,dead_cap,pittsburgh-steelers,184375,2014
34654,142539,0,Terry Hawthorne,CB,dead_cap,pittsburgh-steelers,142539,2014
34655,137118,0,David Snow,G,dead_cap,pittsburgh-steelers,137118,2014
34656,130300,0,Curtis Brown,CB,dead_cap,pittsburgh-steelers,130300,2014
34657,44100,47513,Shaquille Richardson,CB,dead_cap,pittsburgh-steelers,91613,2014
34658,75600,14462,Nick Williams,DE,dead_cap,pittsburgh-steelers,90062,2014
34659,78054,0,Justin Brown,WR,dead_cap,pittsburgh-steelers,78054,2014
34660,74541,0,Justin Cheadle,G,dead_cap,pittsburgh-steelers,74541,2014
34661,69300,0,Josh Harris,RB,dead_cap,pittsburgh-steelers,69300,2014
34662,63000,2500,Josh Mauro,DT,dead_cap,pittsburgh-steelers,65500,2014
34663,0,65000,Guy Whimper,G,dead_cap,pittsburgh-steelers,65000,2014
34664,56700,0,Adam Gettis,G,dead_cap,pittsburgh-steelers,56700,2014
34665,53471,0,Danny Coale,WR,dead_cap,pittsburgh-steelers,53471,2014
34666,44100,0,Derek Moye,WR,dead_cap,pittsburgh-steelers,44100,2014
34667,0,40700,Chris Carter,ILB,dead_cap,pittsburgh-steelers,40700,2014
34668,31500,0,Jordan Dangerfield,FS,dead_cap,pittsburgh-steelers,31500,2014
34669,31500,0,Ross Ventrone,SS,dead_cap,pittsburgh-steelers,31500,2014
34670,25200,1666,Ethan Hemer,DT,dead_cap,pittsburgh-steelers,26866,2014
34671,0,14850,Rob Blanchflower,TE,dead_cap,pittsburgh-steelers,14850,2014
34672,0,11474,David Paulson,TE,dead_cap,pittsburgh-steelers,11474,2014
34673,11400,0,LaDarius Perkins,RB,dead_cap,pittsburgh-steelers,11400,2014
34674,5000,0,Nik Embernate,G,dead_cap,pittsburgh-steelers,5000,2014
34675,5000,0,Mike Golic Jr.,RT,dead_cap,pittsburgh-steelers,5000,2014
34676,3334,0,Cordian Hagans,DE,dead_cap,pittsburgh-steelers,3334,2014
34677,0,3333,Howard Jones,OLB,dead_cap,pittsburgh-steelers,3333,2014
34678,0,3000,Kaycee Ike,RT,dead_cap,pittsburgh-steelers,3000,2014
34679,3000,0,Chris Hubbard,RT,dead_cap,pittsburgh-steelers,3000,2014
34680,2667,0,Reggie Dunn,WR,dead_cap,pittsburgh-steelers,2667,2014
34681,2667,0,Omar Hunter,DT,dead_cap,pittsburgh-steelers,2667,2014
34682,0,2500,Eric Waters,TE,dead_cap,pittsburgh-steelers,2500,2014
34683,0,2000,Roy Philon,DE,dead_cap,pittsburgh-steelers,2000,2014
34684,2000,0,Joe Madsen,C,dead_cap,pittsburgh-steelers,2000,2014
34685,2000,0,Curtis McNeal,RB,dead_cap,pittsburgh-steelers,2000,2014
34686,1667,0,Alan Baxter,OLB,dead_cap,pittsburgh-steelers,1667,2014
34687,1667,0,Drew Butler,P,dead_cap,pittsburgh-steelers,1667,2014
34688,1667,0,Adrian Robinson,OLB,dead_cap,pittsburgh-steelers,1667,2014
34689,1667,0,J.D. Woods,WR,dead_cap,pittsburgh-steelers,1667,2014
34690,0,1666,Brendon Kay,QB,dead_cap,pittsburgh-steelers,1666,2014
34691,0,1666,Will Simmons,G,dead_cap,pittsburgh-steelers,1666,2014
34692,1334,0,Brian Arnfelt,DE,dead_cap,pittsburgh-steelers,1334,2014
34693,1334,0,Mike Farrell,LT,dead_cap,pittsburgh-steelers,1334,2014
34694,1334,0,Terence Garvin,ILB,dead_cap,pittsburgh-steelers,1334,2014
34695,0,1333,Chris Elkins,C,dead_cap,pittsburgh-steelers,1333,2014
34696,1000,0,Luke Ingram,LS,dead_cap,pittsburgh-steelers,1000,2014
34697,1000000,16245000,Ben Roethlisberger,QB,active,pittsburgh-steelers,17245000,2015
34698,870000,8381250,Lawrence Timmons,ILB,active,pittsburgh-steelers,9251250,2015
34699,1000000,6120833,Antonio Brown,WR,active,pittsburgh-steelers,7120833,2015
34700,2631000,4350000,Cortez Allen,CB,active,pittsburgh-steelers,6981000,2015
34701,1000000,5400000,Cameron Heyward,DE,active,pittsburgh-steelers,6400000,2015
34702,745000,3551000,Maurkice Pouncey,C,active,pittsburgh-steelers,4296000,2015
34703,970000,3181666,Heath Miller,TE,active,pittsburgh-steelers,4151666,2015
34704,745000,2511000,Marcus Gilbert,RT,active,pittsburgh-steelers,3256000,2015
34705,2250000,558334,Steve McLendon,DT,active,pittsburgh-steelers,2808334,2015
34706,745000,1763750,Mike Mitchell,FS,active,pittsburgh-steelers,2508750,2015
34707,2000000,500000,Cam Thomas,DT,active,pittsburgh-steelers,2500000,2015
34708,1030531,1455709,David DeCastro,G,active,pittsburgh-steelers,2486240,2015
34709,1196410,1177818,Jarvis Jones,OLB,active,pittsburgh-steelers,2374228,2015
34710,852146,1308584,Ryan Shazier,ILB,active,pittsburgh-steelers,2160730,2015
34711,1850000,300000,Ramon Foster,G,active,pittsburgh-steelers,2150000,2015
34712,1550000,283334,Bruce Gradkowski,QB,active,pittsburgh-steelers,1833334,2015
34713,435000,1241778,Bud Dupree,OLB,active,pittsburgh-steelers,1676778,2015
34714,1500000,166668,William Gay,CB,active,pittsburgh-steelers,1666668,2015
34715,1542000,0,Antwon Blake,CB,active,pittsburgh-steelers,1542000,2015
34716,1542000,0,Brandon Boykin,CB,active,pittsburgh-steelers,1542000,2015
34717,1542000,0,Robert Golden,FS,active,pittsburgh-steelers,1542000,2015
34718,1542000,0,Will Johnson,FB,active,pittsburgh-steelers,1542000,2015
34719,850000,633333,Arthur Moats,OLB,active,pittsburgh-steelers,1483333,2015
34720,870000,565000,DeAngelo Williams,RB,active,pittsburgh-steelers,1435000,2015
34721,1100000,150000,Cody Wallace,C,active,pittsburgh-steelers,1250000,2015
34722,1000000,250000,James Harrison,OLB,active,pittsburgh-steelers,1250000,2015
34723,873225,254300,Mike Adams,LT,active,pittsburgh-steelers,1127525,2015
34724,925000,137500,Matt Spaeth,TE,active,pittsburgh-steelers,1062500,2015
34725,629520,418081,Stephon Tuitt,DE,active,pittsburgh-steelers,1047601,2015
34726,680000,136345,Sean Spence,ILB,active,pittsburgh-steelers,816345,2015
34727,605000,147844,Markus Wheaton,WR,active,pittsburgh-steelers,752844,2015
34728,435000,292462,Senquez Golson,CB,active,pittsburgh-steelers,727462,2015
34729,585000,113288,Shamarko Thomas,SS,active,pittsburgh-steelers,698288,2015
34730,585000,109805,Landry Jones,QB,active,pittsburgh-steelers,694805,2015
34731,970000,80000,Will Allen,SS,active,pittsburgh-steelers,1050000,2015
34732,970000,80000,Greg Warren,LS,active,pittsburgh-steelers,1050000,2015
34733,745000,80000,Clifton Geathers,DE,active,pittsburgh-steelers,825000,2015
34734,745000,80000,Darrius Heyward-Bey,WR,active,pittsburgh-steelers,825000,2015
34735,585000,19670,Vince Williams,ILB,active,pittsburgh-steelers,604670,2015
34736,435000,157878,Sammie Coates,WR,active,pittsburgh-steelers,592878,2015
34737,970000,0,Michael Vick,QB,active,pittsburgh-steelers,970000,2015
34738,745000,0,Doug Legursky,C,active,pittsburgh-steelers,745000,2015
34739,745000,0,Jordan Todman,RB,active,pittsburgh-steelers,745000,2015
34740,585000,0,Terence Garvin,ILB,active,pittsburgh-steelers,585000,2015
34741,510000,19670,Daniel McCullers,DT,active,pittsburgh-steelers,529670,2015
34742,510000,0,Chris Hubbard,RT,active,pittsburgh-steelers,510000,2015
34743,390000,109805,Martavis Bryant,WR,active,pittsburgh-steelers,499805,2015
34744,435000,52228,Jesse James,TE,active,pittsburgh-steelers,487228,2015
34745,435000,29232,Leterrius Walton,DE,active,pittsburgh-steelers,464232,2015
34746,435000,0,Jordan Berry,P,active,pittsburgh-steelers,435000,2015
34747,435000,0,Ross Cockrell,CB,active,pittsburgh-steelers,435000,2015
34748,435000,0,Alejandro Villanueva,LT,active,pittsburgh-steelers,435000,2015
34749,427058,0,Byron Stingily,RT,active,pittsburgh-steelers,427058,2015
34750,358235,0,Anthony Chickillo,OLB,active,pittsburgh-steelers,358235,2015
34751,332647,0,Chris Boswell,K,active,pittsburgh-steelers,332647,2015
34752,318000,1666,Eli Rogers,WR,active,pittsburgh-steelers,319666,2015
34753,318000,0,Mitchell Van Dyk,LT,active,pittsburgh-steelers,318000,2015
34754,230294,0,Doran Grant,CB,active,pittsburgh-steelers,230294,2015
34755,180000,0,Fitz Toussaint,RB,active,pittsburgh-steelers,180000,2015
34756,34411,0,Ross Ventrone,SS,active,pittsburgh-steelers,34411,2015
34757,25588,0,L.J. Fort,ILB,active,pittsburgh-steelers,25588,2015
34758,463000,1603000,Shaun Suisham,K,injured_reserve,pittsburgh-steelers,2066000,2015
34759,1542000,11474,Kelvin Beachum,LT,injured_reserve,pittsburgh-steelers,1553474,2015
34760,687882,344200,Le'Veon Bell,RB,injured_reserve,pittsburgh-steelers,1032082,2015
34761,745000,0,David Nelson,WR,injured_reserve,pittsburgh-steelers,745000,2015
34762,428117,0,Roosevelt Nix,FB,injured_reserve,pittsburgh-steelers,428117,2015
34763,318000,26213,Jordan Zumwalt,ILB,injured_reserve,pittsburgh-steelers,344213,2015
34764,318000,333,Micah Hatchie,RT,injured_reserve,pittsburgh-steelers,318333,2015
34765,318000,0,Rob Blanchflower,TE,injured_reserve,pittsburgh-steelers,318000,2015
34766,318000,0,Kelvin Palmer,RT,injured_reserve,pittsburgh-steelers,318000,2015
34767,112200,0,Ethan Hemer,DT,practice_squad,pittsburgh-steelers,112200,2015
34768,92400,0,B.J. Finney,C,practice_squad,pittsburgh-steelers,92400,2015
34769,66000,0,Isaiah Frey,CB,practice_squad,pittsburgh-steelers,66000,2015
34770,0,8580000,LaMarr Woodley,OLB,dead_cap,pittsburgh-steelers,8580000,2015
34771,0,4500000,Troy Polamalu,S,dead_cap,pittsburgh-steelers,4500000,2015
34772,2500000,0,Josh Scobee,K,dead_cap,pittsburgh-steelers,2500000,2015
34773,870000,0,Garret Hartley,K,dead_cap,pittsburgh-steelers,870000,2015
34774,476470,0,Jacoby Jones,WR,dead_cap,pittsburgh-steelers,476470,2015
34775,0,475000,LeGarrette Blount,RB,dead_cap,pittsburgh-steelers,475000,2015
34776,240000,134504,Dri Archer,RB,dead_cap,pittsburgh-steelers,374504,2015
34777,0,322500,Lance Moore,WR,dead_cap,pittsburgh-steelers,322500,2015
34778,0,250000,Brett Keisel,DE,dead_cap,pittsburgh-steelers,250000,2015
34779,201352,1500,Tyler Murphy,WR,dead_cap,pittsburgh-steelers,202852,2015
34780,172058,0,Ross Ventrone,SS,dead_cap,pittsburgh-steelers,172058,2015
34781,169164,0,Caushaud Lyons,DE,dead_cap,pittsburgh-steelers,169164,2015
34782,46200,122253,Doran Grant,CB,dead_cap,pittsburgh-steelers,168453,2015
34783,0,142539,Shaquille Richardson,CB,dead_cap,pittsburgh-steelers,142539,2015
34784,116470,0,Isaiah Pead,RB,dead_cap,pittsburgh-steelers,116470,2015
34785,112200,0,Jordan Dangerfield,FS,dead_cap,pittsburgh-steelers,112200,2015
34786,112200,0,Matt Feiler,RT,dead_cap,pittsburgh-steelers,112200,2015
34787,112200,0,Xavier Grimble,TE,dead_cap,pittsburgh-steelers,112200,2015
34788,112200,0,Shakim Phillips,WR,dead_cap,pittsburgh-steelers,112200,2015
34789,0,108420,Wesley Johnson,C,dead_cap,pittsburgh-steelers,108420,2015
34790,105600,0,L.J. Fort,ILB,dead_cap,pittsburgh-steelers,105600,2015
34791,74823,0,Ray Hamilton,TE,dead_cap,pittsburgh-steelers,74823,2015
34792,72600,0,Fitz Toussaint,RB,dead_cap,pittsburgh-steelers,72600,2015
34793,0,44550,Rob Blanchflower,TE,dead_cap,pittsburgh-steelers,44550,2015
34794,37411,1666,Cameron Clear,T,dead_cap,pittsburgh-steelers,39077,2015
34795,13200,22621,Anthony Chickillo,OLB,dead_cap,pittsburgh-steelers,35821,2015
34796,33000,0,Rajion Neal,RB,dead_cap,pittsburgh-steelers,33000,2015
34797,0,28924,Nick Williams,DE,dead_cap,pittsburgh-steelers,28924,2015
34798,19800,0,Isaiah Burse,WR,dead_cap,pittsburgh-steelers,19800,2015
34799,0,14628,Gerod Holliman,FS,dead_cap,pittsburgh-steelers,14628,2015
34800,0,11474,David Paulson,TE,dead_cap,pittsburgh-steelers,11474,2015
34801,10000,0,Devin Gardner,QB,dead_cap,pittsburgh-steelers,10000,2015
34802,6600,1666,Reese Dismukes,G,dead_cap,pittsburgh-steelers,8266,2015
34803,0,6667,Howard Jones,OLB,dead_cap,pittsburgh-steelers,6667,2015
34804,6600,0,Shayon Green,OLB,dead_cap,pittsburgh-steelers,6600,2015
34805,0,5000,Josh Mauro,DT,dead_cap,pittsburgh-steelers,5000,2015
34806,0,5000,Eric Waters,TE,dead_cap,pittsburgh-steelers,5000,2015
34807,0,4000,Roy Philon,DE,dead_cap,pittsburgh-steelers,4000,2015
34808,0,3334,Ethan Hemer,DT,dead_cap,pittsburgh-steelers,3334,2015
34809,0,3334,Brendon Kay,QB,dead_cap,pittsburgh-steelers,3334,2015
34810,0,3334,Will Simmons,G,dead_cap,pittsburgh-steelers,3334,2015
34811,0,3333,B.J. Finney,C,dead_cap,pittsburgh-steelers,3333,2015
34812,0,2667,Chris Elkins,C,dead_cap,pittsburgh-steelers,2667,2015
34813,0,2666,Miles Dieffenbach,C,dead_cap,pittsburgh-steelers,2666,2015
34814,0,2500,Shawn Lemon,ILB,dead_cap,pittsburgh-steelers,2500,2015
34815,0,1666,Ross Scheuerman,RB,dead_cap,pittsburgh-steelers,1666,2015
34816,0,1000,Brandon Prate,DT,dead_cap,pittsburgh-steelers,1000,2015
34817,0,833,Niko Davis,DE,dead_cap,pittsburgh-steelers,833,2015
34818,0,333,Cameron Stingily,RB,dead_cap,pittsburgh-steelers,333,2015
34819,0,333,Mike Thornton,DT,dead_cap,pittsburgh-steelers,333,2015
34820,0,333,Kevin Whimpey,T,dead_cap,pittsburgh-steelers,333,2015
34821,17750000,6200000,Ben Roethlisberger,QB,active,pittsburgh-steelers,23950000,2016
34822,8750000,6381250,Lawrence Timmons,ILB,active,pittsburgh-steelers,15131250,2016
34823,1275000,10608333,Antonio Brown,WR,active,pittsburgh-steelers,11883333,2016
34824,3500000,7051000,Maurkice Pouncey,C,active,pittsburgh-steelers,10551000,2016
34825,2070000,3200000,David DeCastro,G,active,pittsburgh-steelers,5270000,2016
34826,760000,3308500,Marcus Gilbert,RT,active,pittsburgh-steelers,4068500,2016
34827,885000,3135416,Mike Mitchell,FS,active,pittsburgh-steelers,4020416,2016
34828,2500000,633333,Arthur Moats,OLB,active,pittsburgh-steelers,3133333,2016
34829,1592115,1177818,Jarvis Jones,OLB,active,pittsburgh-steelers,2769933,2016
34830,1284292,1308584,Ryan Shazier,ILB,active,pittsburgh-steelers,2592876,2016
34831,2000000,565000,DeAngelo Williams,RB,active,pittsburgh-steelers,2565000,2016
34832,1850000,633333,William Gay,CB,active,pittsburgh-steelers,2483333,2016
34833,1250000,1187500,Ladarius Green,TE,active,pittsburgh-steelers,2437500,2016
34834,1500000,916666,Ramon Foster,G,active,pittsburgh-steelers,2416666,2016
34835,854195,1241778,Bud Dupree,OLB,active,pittsburgh-steelers,2095973,2016
34836,450000,1293814,Artie Burns,CB,active,pittsburgh-steelers,1743814,2016
34837,1250000,250000,James Harrison,OLB,active,pittsburgh-steelers,1500000,2016
34838,839041,418081,Stephon Tuitt,DE,active,pittsburgh-steelers,1257122,2016
34839,853147,344200,Le'Veon Bell,RB,active,pittsburgh-steelers,1197347,2016
34840,675000,519670,Vince Williams,ILB,active,pittsburgh-steelers,1194670,2016
34841,760000,416666,Robert Golden,FS,active,pittsburgh-steelers,1176666,2016
34842,1000000,133333,Darrius Heyward-Bey,WR,active,pittsburgh-steelers,1133333,2016
34843,786682,0,Justin Gilbert,CB,active,pittsburgh-steelers,786682,2016
34844,675000,109805,Landry Jones,QB,active,pittsburgh-steelers,784805,2016
34845,450000,293085,Sean Davis,SS,active,pittsburgh-steelers,743085,2016
34846,525000,157878,Sammie Coates,WR,active,pittsburgh-steelers,682878,2016
34847,985000,80000,Greg Warren,LS,active,pittsburgh-steelers,1065000,2016
34848,450000,173314,Javon Hargrave,DT,active,pittsburgh-steelers,623314,2016
34849,600000,19670,Daniel McCullers,DT,active,pittsburgh-steelers,619670,2016
34850,760000,0,David Johnson,TE,active,pittsburgh-steelers,760000,2016
34851,760000,0,Ricardo Mathews,DT,active,pittsburgh-steelers,760000,2016
34852,600000,0,Ross Cockrell,CB,active,pittsburgh-steelers,600000,2016
34853,600000,0,Chris Hubbard,RT,active,pittsburgh-steelers,600000,2016
34854,600000,0,Zach Mettenberger,QB,active,pittsburgh-steelers,600000,2016
34855,600000,0,Fitz Toussaint,RB,active,pittsburgh-steelers,600000,2016
34856,525000,52228,Jesse James,TE,active,pittsburgh-steelers,577228,2016
34857,525000,29232,Leterrius Walton,DE,active,pittsburgh-steelers,554232,2016
34858,525000,0,Jordan Berry,P,active,pittsburgh-steelers,525000,2016
34859,525000,0,Chris Boswell,K,active,pittsburgh-steelers,525000,2016
34860,525000,0,Anthony Chickillo,OLB,active,pittsburgh-steelers,525000,2016
34861,525000,0,Roosevelt Nix,FB,active,pittsburgh-steelers,525000,2016
34862,525000,0,Alejandro Villanueva,LT,active,pittsburgh-steelers,525000,2016
34863,450000,15762,Tyler Matakevich,ILB,active,pittsburgh-steelers,465762,2016
34864,450000,1666,Eli Rogers,WR,active,pittsburgh-steelers,451666,2016
34865,450000,0,Jordan Dangerfield,FS,active,pittsburgh-steelers,450000,2016
34866,450000,0,B.J. Finney,C,active,pittsburgh-steelers,450000,2016
34867,450000,0,Xavier Grimble,TE,active,pittsburgh-steelers,450000,2016
34868,291170,0,Brian Mihalik,T,active,pittsburgh-steelers,291170,2016
34869,238230,0,Cobi Hamilton,WR,active,pittsburgh-steelers,238230,2016
34870,216174,0,L.J. Fort,ILB,active,pittsburgh-steelers,216174,2016
34871,79410,0,Demarcus Ayers,WR,active,pittsburgh-steelers,79410,2016
34872,52940,0,Johnny Maxey,DT,active,pittsburgh-steelers,52940,2016
34873,52940,0,Al-Hajj Shabazz,CB,active,pittsburgh-steelers,52940,2016
34874,3000000,7400000,Cameron Heyward,DE,injured_reserve,pittsburgh-steelers,10400000,2016
34875,1671000,147844,Markus Wheaton,WR,injured_reserve,pittsburgh-steelers,1818844,2016
34876,1325000,337500,Ryan Harris,LT,injured_reserve,pittsburgh-steelers,1662500,2016
34877,1200000,150000,Cody Wallace,C,injured_reserve,pittsburgh-steelers,1350000,2016
34878,616865,292462,Senquez Golson,CB,injured_reserve,pittsburgh-steelers,909327,2016
34879,675000,113288,Shamarko Thomas,SS,injured_reserve,pittsburgh-steelers,788288,2016
34880,760000,0,Steven Johnson,ILB,injured_reserve,pittsburgh-steelers,760000,2016
34881,333000,132622,Jerald Hawkins,T,injured_reserve,pittsburgh-steelers,465622,2016
34882,450000,2666,Canaan Severin,WR,injured_reserve,pittsburgh-steelers,452666,2016
34883,478000,80000,Bruce Gradkowski,QB,injured_reserve,pittsburgh-steelers,558000,2016
34884,333000,0,Kevin Anderson,OLB,injured_reserve,pittsburgh-steelers,333000,2016
34885,333000,0,Cole Manhart,G,injured_reserve,pittsburgh-steelers,333000,2016
34886,333000,0,Valerian Ume-Ezeoke,C,injured_reserve,pittsburgh-steelers,333000,2016
34887,69000,0,Keavon Milton,T,practice_squad,pittsburgh-steelers,69000,2016
34888,20700,0,Shaquille Riddick,OLB,practice_squad,pittsburgh-steelers,20700,2016
34889,0,4050000,Cortez Allen,CB,dead_cap,pittsburgh-steelers,4050000,2016
34890,0,3181668,Heath Miller,TE,dead_cap,pittsburgh-steelers,3181668,2016
34891,0,1103000,Shaun Suisham,K,dead_cap,pittsburgh-steelers,1103000,2016
34892,478000,80000,Bruce Gradkowski,QB,dead_cap,pittsburgh-steelers,558000,2016
34893,0,366759,Doran Grant,CB,dead_cap,pittsburgh-steelers,366759,2016
34894,323752,0,Daryl Richardson,RB,dead_cap,pittsburgh-steelers,323752,2016
34895,277938,0,L.J. Fort,ILB,dead_cap,pittsburgh-steelers,277938,2016
34896,0,253008,Dri Archer,RB,dead_cap,pittsburgh-steelers,253008,2016
34897,239360,0,Al-Hajj Shabazz,CB,dead_cap,pittsburgh-steelers,239360,2016
34898,156440,0,Matt Feiler,RT,dead_cap,pittsburgh-steelers,156440,2016
34899,0,137500,Matt Spaeth,TE,dead_cap,pittsburgh-steelers,137500,2016
34900,117300,0,Caushaud Lyons,DE,dead_cap,pittsburgh-steelers,117300,2016
34901,96600,19913,Demarcus Ayers,WR,dead_cap,pittsburgh-steelers,116513,2016
34902,89700,25089,Travis Feeney,OLB,dead_cap,pittsburgh-steelers,114789,2016
34903,103500,0,Johnny Maxey,DT,dead_cap,pittsburgh-steelers,103500,2016
34904,96600,0,Jacob Hagen,FS,dead_cap,pittsburgh-steelers,96600,2016
34905,89411,0,Randy Bullock,K,dead_cap,pittsburgh-steelers,89411,2016
34906,0,67865,Anthony Chickillo,OLB,dead_cap,pittsburgh-steelers,67865,2016
34907,55200,0,Cobi Hamilton,WR,dead_cap,pittsburgh-steelers,55200,2016
34908,55200,0,Marcus Tucker,WR,dead_cap,pittsburgh-steelers,55200,2016
34909,48300,0,Rashaun Allen,TE,dead_cap,pittsburgh-steelers,48300,2016
34910,0,43884,Gerod Holliman,FS,dead_cap,pittsburgh-steelers,43884,2016
34911,42300,0,Brandon Brown-Dukes,RB,dead_cap,pittsburgh-steelers,42300,2016
34912,41400,0,Karlos Williams,RB,dead_cap,pittsburgh-steelers,41400,2016
34913,34500,0,David Cobb,RB,dead_cap,pittsburgh-steelers,34500,2016
34914,34500,0,Dreamius Smith,RB,dead_cap,pittsburgh-steelers,34500,2016
34915,0,26213,Jordan Zumwalt,ILB,dead_cap,pittsburgh-steelers,26213,2016
34916,0,25000,Steven Johnson,ILB,dead_cap,pittsburgh-steelers,25000,2016
34917,20700,0,Mike Hilton,CB,dead_cap,pittsburgh-steelers,20700,2016
34918,13800,0,Brandon Dixon,CB,dead_cap,pittsburgh-steelers,13800,2016
34919,6900,667,Cameron Stingily,RB,dead_cap,pittsburgh-steelers,7567,2016
34920,0,6667,B.J. Finney,C,dead_cap,pittsburgh-steelers,6667,2016
34921,0,5334,Miles Dieffenbach,C,dead_cap,pittsburgh-steelers,5334,2016
34922,0,5000,Shawn Lemon,ILB,dead_cap,pittsburgh-steelers,5000,2016
34923,0,3334,Cameron Clear,T,dead_cap,pittsburgh-steelers,3334,2016
34924,0,3334,Reese Dismukes,G,dead_cap,pittsburgh-steelers,3334,2016
34925,0,3334,Ross Scheuerman,RB,dead_cap,pittsburgh-steelers,3334,2016
34926,0,3000,Tyler Murphy,WR,dead_cap,pittsburgh-steelers,3000,2016
34927,0,2333,Tyriq McCord,OLB,dead_cap,pittsburgh-steelers,2333,2016
34928,0,2000,David Reeves,TE,dead_cap,pittsburgh-steelers,2000,2016
34929,0,1667,Niko Davis,DE,dead_cap,pittsburgh-steelers,1667,2016
34930,0,1333,Quinton Schooley,C,dead_cap,pittsburgh-steelers,1333,2016
34931,0,667,Micah Hatchie,RT,dead_cap,pittsburgh-steelers,667,2016
34932,0,667,Mike Thornton,DT,dead_cap,pittsburgh-steelers,667,2016
34933,0,667,Kevin Whimpey,T,dead_cap,pittsburgh-steelers,667,2016
34934,0,666,Jay Rome,TE,dead_cap,pittsburgh-steelers,666,2016
34935,12000000,6200000,Ben Roethlisberger,QB,active,pittsburgh-steelers,18200000,2017
34936,910000,12708333,Antonio Brown,WR,active,pittsburgh-steelers,13618333,2017
34937,12120000,0,Le'Veon Bell,RB,active,pittsburgh-steelers,12120000,2017
34938,7500000,3551000,Maurkice Pouncey,C,active,pittsburgh-steelers,11051000,2017
34939,1100000,9950000,David DeCastro,G,active,pittsburgh-steelers,11050000,2017
34940,5000000,3135416,Mike Mitchell,FS,active,pittsburgh-steelers,8135416,2017
34941,775000,6456250,Cameron Heyward,DE,active,pittsburgh-steelers,7231250,2017
34942,3058824,3308500,Marcus Gilbert,RT,active,pittsburgh-steelers,6367324,2017
34943,1000000,3018081,Stephon Tuitt,DE,active,pittsburgh-steelers,4018081,2017
34944,2675000,916666,Ramon Foster,G,active,pittsburgh-steelers,3591666,2017
34945,1250000,1916666,Joe Haden,CB,active,pittsburgh-steelers,3166666,2017
34946,1500000,1625000,Alejandro Villanueva,LT,active,pittsburgh-steelers,3125000,2017
34947,2250000,633334,Arthur Moats,OLB,active,pittsburgh-steelers,2883334,2017
34948,2000000,633333,William Gay,CB,active,pittsburgh-steelers,2633333,2017
34949,1273390,1241778,Bud Dupree,OLB,active,pittsburgh-steelers,2515168,2017
34950,2000000,500000,Vince Williams,ILB,active,pittsburgh-steelers,2500000,2017
34951,1250000,1125000,Tyson Alualu,DE,active,pittsburgh-steelers,2375000,2017
34952,1900000,300000,Landry Jones,QB,active,pittsburgh-steelers,2200000,2017
34953,885954,1293814,Artie Burns,CB,active,pittsburgh-steelers,2179768,2017
34954,2100000,75000,Vance McDonald,TE,active,pittsburgh-steelers,2175000,2017
34955,1465000,416666,Robert Golden,FS,active,pittsburgh-steelers,1881666,2017
34956,1797000,0,Chris Hubbard,RT,active,pittsburgh-steelers,1797000,2017
34957,775000,925000,J.J. Wilcox,FS,active,pittsburgh-steelers,1700000,2017
34958,465000,1218376,T.J. Watt,OLB,active,pittsburgh-steelers,1683376,2017
34959,1200000,133333,Darrius Heyward-Bey,WR,active,pittsburgh-steelers,1333333,2017
34960,775000,212500,Coty Sensabaugh,CB,active,pittsburgh-steelers,987500,2017
34961,635771,293085,Sean Davis,SS,active,pittsburgh-steelers,928856,2017
34962,437648,297868,JuJu Smith-Schuster,WR,active,pittsburgh-steelers,735516,2017
34963,560000,173314,Javon Hargrave,DT,active,pittsburgh-steelers,733314,2017
34964,615000,109805,Martavis Bryant,WR,active,pittsburgh-steelers,724805,2017
34965,690000,19670,Daniel McCullers,DT,active,pittsburgh-steelers,709670,2017
34966,775000,80000,Justin Hunter,WR,active,pittsburgh-steelers,855000,2017
34967,615000,52228,Jesse James,TE,active,pittsburgh-steelers,667228,2017
34968,615000,29232,Leterrius Walton,DE,active,pittsburgh-steelers,644232,2017
34969,615000,0,Jordan Berry,P,active,pittsburgh-steelers,615000,2017
34970,615000,0,Chris Boswell,K,active,pittsburgh-steelers,615000,2017
34971,615000,0,Anthony Chickillo,OLB,active,pittsburgh-steelers,615000,2017
34972,615000,0,Roosevelt Nix,FB,active,pittsburgh-steelers,615000,2017
34973,465000,149781,Joshua Dobbs,QB,active,pittsburgh-steelers,614781,2017
34974,465000,132622,Jerald Hawkins,T,active,pittsburgh-steelers,597622,2017
34975,389288,184032,Cameron Sutton,CB,active,pittsburgh-steelers,573320,2017
34976,540000,15762,Tyler Matakevich,ILB,active,pittsburgh-steelers,555762,2017
34977,542647,0,L.J. Fort,ILB,active,pittsburgh-steelers,542647,2017
34978,540000,1668,Eli Rogers,WR,active,pittsburgh-steelers,541668,2017
34979,540000,0,Kameron Canaday,LS,active,pittsburgh-steelers,540000,2017
34980,540000,0,B.J. Finney,C,active,pittsburgh-steelers,540000,2017
34981,540000,0,Xavier Grimble,TE,active,pittsburgh-steelers,540000,2017
34982,465000,57544,Brian Allen,CB,active,pittsburgh-steelers,522544,2017
34983,465000,0,Matt Feiler,RT,active,pittsburgh-steelers,465000,2017
34984,465000,0,Mike Hilton,CB,active,pittsburgh-steelers,465000,2017
34985,243529,0,Fitz Toussaint,RB,active,pittsburgh-steelers,243529,2017
34986,182353,0,Sean Spence,ILB,active,pittsburgh-steelers,182353,2017
34987,91176,0,Stevan Ridley,RB,active,pittsburgh-steelers,91176,2017
34988,1716438,1308584,Ryan Shazier,ILB,injured_reserve,pittsburgh-steelers,3025022,2017
34989,451235,176572,James Conner,RB,injured_reserve,pittsburgh-steelers,627807,2017
34990,378000,0,Greg Ducre,CB,injured_reserve,pittsburgh-steelers,378000,2017
34991,348000,16504,Keion Adams,OLB,injured_reserve,pittsburgh-steelers,364504,2017
34992,348000,0,Antonio Crawford,CB,injured_reserve,pittsburgh-steelers,348000,2017
34993,348000,0,Mike Matthews,C,injured_reserve,pittsburgh-steelers,348000,2017
34994,1150000,3562500,Ladarius Green,TE,dead_cap,pittsburgh-steelers,4712500,2017
34995,0,2206000,Shaun Suisham,K,dead_cap,pittsburgh-steelers,2206000,2017
34996,1200000,750000,James Harrison,OLB,dead_cap,pittsburgh-steelers,1950000,2017
34997,0,337500,Ryan Harris,LT,dead_cap,pittsburgh-steelers,337500,2017
34998,336883,0,Terrell Watson,RB,dead_cap,pittsburgh-steelers,336883,2017
34999,0,292462,Senquez Golson,CB,dead_cap,pittsburgh-steelers,292462,2017
35000,0,182879,Sammie Coates,WR,dead_cap,pittsburgh-steelers,182879,2017
35001,45588,80000,Steven Johnson,ILB,dead_cap,pittsburgh-steelers,125588,2017
35002,122400,0,Kyle Friend,T,dead_cap,pittsburgh-steelers,122400,2017
35003,122400,0,Lavon Hooks,DE,dead_cap,pittsburgh-steelers,122400,2017
35004,122400,0,Farrington Huguenin,DE,dead_cap,pittsburgh-steelers,122400,2017
35005,122400,0,Jake McGee,TE,dead_cap,pittsburgh-steelers,122400,2017
35006,122400,0,Dashaun Phillips,CB,dead_cap,pittsburgh-steelers,122400,2017
35007,122400,0,Marcus Tucker,WR,dead_cap,pittsburgh-steelers,122400,2017
35008,0,117500,David Johnson,TE,dead_cap,pittsburgh-steelers,117500,2017
35009,108000,0,Matt Galambos,ILB,dead_cap,pittsburgh-steelers,108000,2017
35010,100800,0,Keith Kelsey,ILB,dead_cap,pittsburgh-steelers,100800,2017
35011,0,80000,Greg Warren,LS,dead_cap,pittsburgh-steelers,80000,2017
35012,79200,0,Jordan Dangerfield,FS,dead_cap,pittsburgh-steelers,79200,2017
35013,79200,0,Fitz Toussaint,RB,dead_cap,pittsburgh-steelers,79200,2017
35014,0,75267,Travis Feeney,OLB,dead_cap,pittsburgh-steelers,75267,2017
35015,64800,0,Justin Thomas,WR,dead_cap,pittsburgh-steelers,64800,2017
35016,0,59739,Demarcus Ayers,WR,dead_cap,pittsburgh-steelers,59739,2017
35017,57600,0,Jake Rodgers,T,dead_cap,pittsburgh-steelers,57600,2017
35018,43376,0,L.J. Fort,ILB,dead_cap,pittsburgh-steelers,43376,2017
35019,43200,0,Jacob Hagen,FS,dead_cap,pittsburgh-steelers,43200,2017
35020,0,32328,Colin Holba,LS,dead_cap,pittsburgh-steelers,32328,2017
35021,0,26213,Jordan Zumwalt,ILB,dead_cap,pittsburgh-steelers,26213,2017
35022,0,5334,Canaan Severin,WR,dead_cap,pittsburgh-steelers,5334,2017
35023,0,4667,Tyriq McCord,OLB,dead_cap,pittsburgh-steelers,4667,2017
35024,0,2667,Quinton Schooley,C,dead_cap,pittsburgh-steelers,2667,2017
35025,0,1334,Jay Rome,TE,dead_cap,pittsburgh-steelers,1334,2017
35026,12000000,11200000,Ben Roethlisberger,QB,active,pittsburgh-steelers,23200000,2018
35027,9000000,2916666,Joe Haden,CB,active,pittsburgh-steelers,11916666,2018
35028,7000000,3551000,Maurkice Pouncey,C,active,pittsburgh-steelers,10551000,2018
35029,915000,7040000,Antonio Brown,WR,active,pittsburgh-steelers,7955000,2018
35030,915000,6151250,Cameron Heyward,DT,active,pittsburgh-steelers,7066250,2018
35031,790000,4897500,David DeCastro,G,active,pittsburgh-steelers,5687500,2018
35032,790000,4642000,Stephon Tuitt,DE,active,pittsburgh-steelers,5432000,2018
35033,705000,3390000,Alejandro Villanueva,LT,active,pittsburgh-steelers,4095000,2018
35034,3000000,625000,Tyson Alualu,DE,active,pittsburgh-steelers,3625000,2018
35035,2675000,916668,Ramon Foster,G,active,pittsburgh-steelers,3591668,2018
35036,800000,2400000,Vince Williams,ILB,active,pittsburgh-steelers,3200000,2018
35037,1692583,1241780,Bud Dupree,OLB,active,pittsburgh-steelers,2934363,2018
35038,1321907,1293814,Artie Burns,CB,active,pittsburgh-steelers,2615721,2018
35039,1000000,1416666,Morgan Burnett,SS,active,pittsburgh-steelers,2416666,2018
35040,790000,1580625,Vance McDonald,TE,active,pittsburgh-steelers,2370625,2018
35041,885844,1218376,T.J. Watt,OLB,active,pittsburgh-steelers,2104220,2018
35042,1907000,52228,Jesse James,TE,active,pittsburgh-steelers,1959228,2018
35043,480000,1465052,Terrell Edmunds,SS,active,pittsburgh-steelers,1945052,2018
35044,1907000,0,Jordan Berry,P,active,pittsburgh-steelers,1907000,2018
35045,1907000,0,Anthony Chickillo,OLB,active,pittsburgh-steelers,1907000,2018
35046,1400000,212500,Coty Sensabaugh,CB,active,pittsburgh-steelers,1612500,2018
35047,800000,700000,Jon Bostic,ILB,active,pittsburgh-steelers,1500000,2018
35048,1000000,437500,Roosevelt Nix,FB,active,pittsburgh-steelers,1437500,2018
35049,1200000,133334,Darrius Heyward-Bey,WR,active,pittsburgh-steelers,1333334,2018
35050,821543,293085,Sean Davis,FS,active,pittsburgh-steelers,1114628,2018
35051,655717,297868,JuJu Smith-Schuster,WR,active,pittsburgh-steelers,953585,2018
35052,691000,173314,Javon Hargrave,DT,active,pittsburgh-steelers,864314,2018
35053,480000,338426,James Washington,WR,active,pittsburgh-steelers,818426,2018
35054,587400,184032,Cameron Sutton,CB,active,pittsburgh-steelers,771432,2018
35055,578000,176572,James Conner,RB,active,pittsburgh-steelers,754572,2018
35056,705000,29234,Leterrius Walton,DE,active,pittsburgh-steelers,734234,2018
35057,790000,90000,Daniel McCullers,DT,active,pittsburgh-steelers,880000,2018
35058,480000,233066,Mason Rudolph,QB,active,pittsburgh-steelers,713066,2018
35059,705000,0,L.J. Fort,ILB,active,pittsburgh-steelers,705000,2018
35060,555000,139781,Joshua Dobbs,QB,active,pittsburgh-steelers,694781,2018
35061,480000,203091,Chuks Okorafor,T,active,pittsburgh-steelers,683091,2018
35062,630000,15762,Tyler Matakevich,ILB,active,pittsburgh-steelers,645762,2018
35063,790000,0,Stevan Ridley,RB,active,pittsburgh-steelers,790000,2018
35064,630000,0,Kameron Canaday,LS,active,pittsburgh-steelers,630000,2018
35065,630000,0,B.J. Finney,G,active,pittsburgh-steelers,630000,2018
35066,630000,0,Xavier Grimble,TE,active,pittsburgh-steelers,630000,2018
35067,555000,0,Zach Banner,T,active,pittsburgh-steelers,555000,2018
35068,555000,0,Jordan Dangerfield,FS,active,pittsburgh-steelers,555000,2018
35069,555000,0,Matt Feiler,RT,active,pittsburgh-steelers,555000,2018
35070,555000,0,Mike Hilton,CB,active,pittsburgh-steelers,555000,2018
35071,555000,0,Ryan Switzer,WR,active,pittsburgh-steelers,555000,2018
35072,480000,73159,Marcus Allen,S,active,pittsburgh-steelers,553159,2018
35073,480000,64516,Jaylen Samuels,RB,active,pittsburgh-steelers,544516,2018
35074,424412,0,Brian Allen,CB,active,pittsburgh-steelers,424412,2018
35075,411706,0,Eli Rogers,WR,active,pittsburgh-steelers,411706,2018
35076,397399,5000,Olasunkanmi Adeniyi,LB,active,pittsburgh-steelers,402399,2018
35077,130588,0,Trey Edmunds,RB,active,pittsburgh-steelers,130588,2018
35078,28235,0,Matt McCrane,K,active,pittsburgh-steelers,28235,2018
35079,4050000,3308500,Marcus Gilbert,RT,injured_reserve,pittsburgh-steelers,7358500,2018
35080,705000,2495000,Chris Boswell,K,injured_reserve,pittsburgh-steelers,3200000,2018
35081,630000,132622,Jerald Hawkins,T,injured_reserve,pittsburgh-steelers,762622,2018
35082,790000,80000,Justin Hunter,WR,injured_reserve,pittsburgh-steelers,870000,2018
35083,790000,0,Nat Berhe,SS,injured_reserve,pittsburgh-steelers,790000,2018
35084,363000,2500,Trey Johnson,CB,injured_reserve,pittsburgh-steelers,365500,2018
35085,363000,0,Joseph Cheek,T,injured_reserve,pittsburgh-steelers,363000,2018
35086,363000,0,Malik Golden,S,injured_reserve,pittsburgh-steelers,363000,2018
35087,363000,0,Keith Kelsey,ILB,injured_reserve,pittsburgh-steelers,363000,2018
35088,363000,0,Jake McGee,TE,injured_reserve,pittsburgh-steelers,363000,2018
35089,0,3135418,Mike Mitchell,FS,dead_cap,pittsburgh-steelers,3135418,2018
35090,0,675000,J.J. Wilcox,FS,dead_cap,pittsburgh-steelers,675000,2018
35091,0,633334,William Gay,CB,dead_cap,pittsburgh-steelers,633334,2018
35092,0,416668,Robert Golden,FS,dead_cap,pittsburgh-steelers,416668,2018
35093,397459,3333,Matthew Thomas,LB,dead_cap,pittsburgh-steelers,400792,2018
35094,0,300000,Landry Jones,QB,dead_cap,pittsburgh-steelers,300000,2018
35095,0,292462,Senquez Golson,CB,dead_cap,pittsburgh-steelers,292462,2018
35096,0,250000,James Harrison,OLB,dead_cap,pittsburgh-steelers,250000,2018
35097,234872,0,Ryan Malleck,TE,dead_cap,pittsburgh-steelers,234872,2018
35098,0,157881,Sammie Coates,WR,dead_cap,pittsburgh-steelers,157881,2018
35099,129200,16504,Keion Adams,OLB,dead_cap,pittsburgh-steelers,145704,2018
35100,129200,0,Trey Griffey,WR,dead_cap,pittsburgh-steelers,129200,2018
35101,129200,0,Bucky Hodges,TE,dead_cap,pittsburgh-steelers,129200,2018
35102,129200,0,Lavon Hooks,DE,dead_cap,pittsburgh-steelers,129200,2018
35103,129200,0,Tevin Jones,WR,dead_cap,pittsburgh-steelers,129200,2018
35104,129200,0,Patrick Morris,C,dead_cap,pittsburgh-steelers,129200,2018
35105,129200,0,R.J. Prince,G,dead_cap,pittsburgh-steelers,129200,2018
35106,0,117500,David Johnson,TE,dead_cap,pittsburgh-steelers,117500,2018
35107,98800,0,Trey Edmunds,RB,dead_cap,pittsburgh-steelers,98800,2018
35108,98800,0,Farrington Huguenin,DE,dead_cap,pittsburgh-steelers,98800,2018
35109,98800,0,Herb Waters,WR,dead_cap,pittsburgh-steelers,98800,2018
35110,0,96987,Colin Holba,LS,dead_cap,pittsburgh-steelers,96987,2018
35111,0,90000,Nat Berhe,SS,dead_cap,pittsburgh-steelers,90000,2018
35112,30400,57544,Brian Allen,CB,dead_cap,pittsburgh-steelers,87944,2018
35113,30400,0,Ralph Webb,RB,dead_cap,pittsburgh-steelers,30400,2018
35114,0,18134,Joshua Frazier,DT,dead_cap,pittsburgh-steelers,18134,2018
35115,7600,0,Jarvion Franklin,RB,dead_cap,pittsburgh-steelers,7600,2018
35116,8750000,6151250,Cameron Heyward,DT,active,pittsburgh-steelers,14901250,2019
35117,7070000,4897500,David DeCastro,G,active,pittsburgh-steelers,11967500,2019
35118,1200000,10516668,Joe Haden,CB,active,pittsburgh-steelers,11716668,2019
35119,9232000,0,Bud Dupree,OLB,active,pittsburgh-steelers,9232000,2019
35120,5000000,3390000,Alejandro Villanueva,LT,active,pittsburgh-steelers,8390000,2019
35121,1000000,6951000,Maurkice Pouncey,C,active,pittsburgh-steelers,7951000,2019
35122,4200000,1533750,Vance McDonald,TE,active,pittsburgh-steelers,5733750,2019
35123,1000000,3200000,Chris Boswell,K,active,pittsburgh-steelers,4200000,2019
35124,1500000,2500000,Steven Nelson,CB,active,pittsburgh-steelers,4000000,2019
35125,1000000,2875000,Mark Barron,ILB,active,pittsburgh-steelers,3875000,2019
35126,805000,3031667,Vince Williams,ILB,active,pittsburgh-steelers,3836667,2019
35127,495000,2936230,Devin Bush,ILB,active,pittsburgh-steelers,3431230,2019
35128,3095000,0,B.J. Finney,G,active,pittsburgh-steelers,3095000,2019
35129,957862,2093817,Artie Burns,CB,active,pittsburgh-steelers,3051679,2019
35130,1100000,1575000,Ramon Foster,G,active,pittsburgh-steelers,2675000,2019
35131,1306688,1218376,T.J. Watt,OLB,active,pittsburgh-steelers,2525064,2019
35132,966263,1465052,Terrell Edmunds,S,active,pittsburgh-steelers,2431315,2019
35133,2025000,173314,Javon Hargrave,DT,active,pittsburgh-steelers,2198314,2019
35134,1250000,875000,Tyson Alualu,DE,active,pittsburgh-steelers,2125000,2019
35135,805000,1097500,Anthony Chickillo,OLB,active,pittsburgh-steelers,1902500,2019
35136,1150000,375000,Jordan Berry,P,active,pittsburgh-steelers,1525000,2019
35137,846434,297868,JuJu Smith-Schuster,WR,active,pittsburgh-steelers,1144302,2019
35138,1000000,125000,Daniel McCullers,DT,active,pittsburgh-steelers,1125000,2019
35139,1083199,0,Minkah Fitzpatrick,S,active,pittsburgh-steelers,1083199,2019
35140,684607,338426,James Washington,WR,active,pittsburgh-steelers,1023033,2019
35141,677400,184032,Cameron Sutton,CB,active,pittsburgh-steelers,861432,2019
35142,668000,176572,James Conner,RB,active,pittsburgh-steelers,844572,2019
35143,620000,203091,Chuks Okorafor,T,active,pittsburgh-steelers,823091,2019
35144,495000,283357,Diontae Johnson,WR,active,pittsburgh-steelers,778357,2019
35145,720000,15764,Tyler Matakevich,ILB,active,pittsburgh-steelers,735764,2019
35146,495000,230545,Justin Layne,CB,active,pittsburgh-steelers,725545,2019
35147,720000,0,Kameron Canaday,LS,active,pittsburgh-steelers,720000,2019
35148,495000,175517,Benny Snell Jr.,RB,active,pittsburgh-steelers,670517,2019
35149,645000,0,Zach Banner,T,active,pittsburgh-steelers,645000,2019
35150,645000,0,Jordan Dangerfield,FS,active,pittsburgh-steelers,645000,2019
35151,645000,0,Matt Feiler,RT,active,pittsburgh-steelers,645000,2019
35152,645000,0,Mike Hilton,CB,active,pittsburgh-steelers,645000,2019
35153,645000,0,Johnny Holton,WR,active,pittsburgh-steelers,645000,2019
35154,570000,64516,Jaylen Samuels,RB,active,pittsburgh-steelers,634516,2019
35155,606118,0,Nick Vannett,TE,active,pittsburgh-steelers,606118,2019
35156,495000,86115,Zach Gentry,TE,active,pittsburgh-steelers,581115,2019
35157,570000,5000,Olasunkanmi Adeniyi,LB,active,pittsburgh-steelers,575000,2019
35158,495000,42158,Isaiah Buggs,DE,active,pittsburgh-steelers,537158,2019
35159,455294,0,Trey Edmunds,RB,active,pittsburgh-steelers,455294,2019
35160,455294,0,Paxton Lynch,QB,active,pittsburgh-steelers,455294,2019
35161,436765,0,Devlin Hodges,QB,active,pittsburgh-steelers,436765,2019
35162,232944,0,Robert Spillane,LB,active,pittsburgh-steelers,232944,2019
35163,203824,0,Kerrith Whyte,RB,active,pittsburgh-steelers,203824,2019
35164,174706,0,Deon Cain,WR,active,pittsburgh-steelers,174706,2019
35165,174706,0,Tuzar Skipper,DE,active,pittsburgh-steelers,174706,2019
35166,67059,0,Marcus Allen,S,active,pittsburgh-steelers,67059,2019
35167,67058,0,Amara Darboh,WR,active,pittsburgh-steelers,67058,2019
35168,29118,0,J.C. Hassenauer,C,active,pittsburgh-steelers,29118,2019
35169,2500000,23700000,Ben Roethlisberger,QB,injured_reserve,pittsburgh-steelers,26200000,2019
35170,805000,8940750,Stephon Tuitt,DE,injured_reserve,pittsburgh-steelers,9745750,2019
35171,1250000,437500,Roosevelt Nix,FB,injured_reserve,pittsburgh-steelers,1687500,2019
35172,1007314,293087,Sean Davis,FS,injured_reserve,pittsburgh-steelers,1300401,2019
35173,658267,233066,Mason Rudolph,QB,injured_reserve,pittsburgh-steelers,891333,2019
35174,645000,0,Ryan Switzer,WR,injured_reserve,pittsburgh-steelers,645000,2019
35175,439944,31838,Ulysees Gilbert,LB,injured_reserve,pittsburgh-steelers,471782,2019
35176,417351,0,Leterrius Walton,DT,injured_reserve,pittsburgh-steelers,417351,2019
35177,378000,0,Lavon Hooks,DE,injured_reserve,pittsburgh-steelers,378000,2019
35178,0,21120000,Antonio Brown,WR,dead_cap,pittsburgh-steelers,21120000,2019
35179,0,2833334,Morgan Burnett,SS,dead_cap,pittsburgh-steelers,2833334,2019
35180,794120,1750000,Donte Moncrief,WR,dead_cap,pittsburgh-steelers,2544120,2019
35181,2025000,0,Xavier Grimble,TE,dead_cap,pittsburgh-steelers,2025000,2019
35182,0,1728500,Marcus Gilbert,RT,dead_cap,pittsburgh-steelers,1728500,2019
35183,0,700000,Jon Bostic,ILB,dead_cap,pittsburgh-steelers,700000,2019
35184,436770,0,Kam Kelly,FS,dead_cap,pittsburgh-steelers,436770,2019
35185,296471,0,Jayrone Elliott,OLB,dead_cap,pittsburgh-steelers,296471,2019
35186,0,250000,Eli Rogers,WR,dead_cap,pittsburgh-steelers,250000,2019
35187,225588,0,Tevin Jones,WR,dead_cap,pittsburgh-steelers,225588,2019
35188,120000,73159,Marcus Allen,S,dead_cap,pittsburgh-steelers,193159,2019
35189,37941,149781,Joshua Dobbs,QB,dead_cap,pittsburgh-steelers,187722,2019
35190,174706,5000,Fred Johnson,G,dead_cap,pittsburgh-steelers,179706,2019
35191,136000,26362,Derwin Gray,T,dead_cap,pittsburgh-steelers,162362,2019
35192,146235,0,Patrick Morris,C,dead_cap,pittsburgh-steelers,146235,2019
35193,136000,0,Henry Mondeaux,DT,dead_cap,pittsburgh-steelers,136000,2019
35194,0,132622,Jerald Hawkins,T,dead_cap,pittsburgh-steelers,132622,2019
35195,128000,0,Kevin Rader,TE,dead_cap,pittsburgh-steelers,128000,2019
35196,112000,13332,Alexander Myres,CB,dead_cap,pittsburgh-steelers,125332,2019
35197,0,115088,Brian Allen,CB,dead_cap,pittsburgh-steelers,115088,2019
35198,103353,0,Tony Brooks-James,RB,dead_cap,pittsburgh-steelers,103353,2019
35199,88000,0,Christian Dilauro,G,dead_cap,pittsburgh-steelers,88000,2019
35200,8000,50628,Sutton Smith,OLB,dead_cap,pittsburgh-steelers,58628,2019
35201,56000,0,Robert Spillane,LB,dead_cap,pittsburgh-steelers,56000,2019
35202,0,54404,Joshua Frazier,DT,dead_cap,pittsburgh-steelers,54404,2019
35203,48000,0,Quadree Henderson,WR,dead_cap,pittsburgh-steelers,48000,2019
35204,48000,0,Ralph Webb,RB,dead_cap,pittsburgh-steelers,48000,2019
35205,40000,0,Trey Edmunds,RB,dead_cap,pittsburgh-steelers,40000,2019
35206,40000,0,J.C. Hassenauer,C,dead_cap,pittsburgh-steelers,40000,2019
35207,0,33008,Keion Adams,OLB,dead_cap,pittsburgh-steelers,33008,2019
35208,32000,0,Amara Darboh,WR,dead_cap,pittsburgh-steelers,32000,2019
35209,24000,0,Paxton Lynch,QB,dead_cap,pittsburgh-steelers,24000,2019
35210,24000,0,Trevon Mathis,CB,dead_cap,pittsburgh-steelers,24000,2019
35211,16000,333,Devlin Hodges,QB,dead_cap,pittsburgh-steelers,16333,2019
35212,16000,0,Jamal Custis,WR,dead_cap,pittsburgh-steelers,16000,2019
35213,16000,0,Terry Wright,WR,dead_cap,pittsburgh-steelers,16000,2019
35214,16000,0,Darrin Hall,RB,dead_cap,pittsburgh-steelers,16000,2019
35215,8000,0,J.T. Barrett,QB,dead_cap,pittsburgh-steelers,8000,2019
35216,8000,0,Taryn Christion,QB,dead_cap,pittsburgh-steelers,8000,2019
35217,8000,0,Alize Mack,TE,dead_cap,pittsburgh-steelers,8000,2019
35218,8000,0,Tray Matthews,S,dead_cap,pittsburgh-steelers,8000,2019
35219,0,6667,Matthew Thomas,LB,dead_cap,pittsburgh-steelers,6667,2019
35220,0,6000,Diontae Spencer,WR,dead_cap,pittsburgh-steelers,6000,2019
35221,0,3333,Dravon Askew-Henry,S,dead_cap,pittsburgh-steelers,3333,2019
35222,0,2500,Garrett Brumfield,G,dead_cap,pittsburgh-steelers,2500,2019
35223,0,2500,Trey Johnson,CB,dead_cap,pittsburgh-steelers,2500,2019
35224,0,2333,Trevor Wood,TE,dead_cap,pittsburgh-steelers,2333,2019
35225,0,1666,Travon McMillan,RB,dead_cap,pittsburgh-steelers,1666,2019
35226,0,1666,Matthew Wright,K,dead_cap,pittsburgh-steelers,1666,2019
35227,0,666,Ian Berryman,P,dead_cap,pittsburgh-steelers,666,2019
35228,0,666,P.J. Locke,S,dead_cap,pittsburgh-steelers,666,2019
35229,0,333,Damian Prince,T,dead_cap,pittsburgh-steelers,333,2019
35230,0,333,Tuzar Skipper,DE,dead_cap,pittsburgh-steelers,333,2019
35231,8500000,25000000,Ben Roethlisberger,QB,active,pittsburgh-steelers,33500000,2020
35232,9000000,5940750,Stephon Tuitt,DE,active,pittsburgh-steelers,14940750,2020
35233,8750000,4897500,David DeCastro,G,active,pittsburgh-steelers,13647500,2020
35234,9500000,3751250,Cameron Heyward,DT,active,pittsburgh-steelers,13251250,2020
35235,3500000,9100000,Joe Haden,CB,active,pittsburgh-steelers,12600000,2020
35236,5000000,6000000,Maurkice Pouncey,C,active,pittsburgh-steelers,11000000,2020
35237,5250000,5500000,Steven Nelson,CB,active,pittsburgh-steelers,10750000,2020
35238,5000000,3390000,Alejandro Villanueva,LT,active,pittsburgh-steelers,8390000,2020
35239,4500000,3625000,Mark Barron,ILB,active,pittsburgh-steelers,8125000,2020
35240,5500000,1627500,Vance McDonald,TE,active,pittsburgh-steelers,7127500,2020
35241,4000000,3031667,Vince Williams,ILB,active,pittsburgh-steelers,7031667,2020
35242,4500000,1597500,Anthony Chickillo,OLB,active,pittsburgh-steelers,6097500,2020
35243,4000000,1575000,Ramon Foster,G,active,pittsburgh-steelers,5575000,2020
35244,1352808,2936230,Devin Bush,ILB,active,pittsburgh-steelers,4289038,2020
35245,2750000,875000,Tyson Alualu,DE,active,pittsburgh-steelers,3625000,2020
35246,1375000,2200000,Chris Boswell,K,active,pittsburgh-steelers,3575000,2020
35247,1727532,1218376,T.J. Watt,OLB,active,pittsburgh-steelers,2945908,2020
35248,1452526,1465052,Terrell Edmunds,S,active,pittsburgh-steelers,2917578,2020
35249,1800000,375000,Jordan Berry,P,active,pittsburgh-steelers,2175000,2020
35250,1975252,0,Minkah Fitzpatrick,S,active,pittsburgh-steelers,1975252,2020
35251,1450000,437500,Roosevelt Nix,FB,active,pittsburgh-steelers,1887500,2020
35252,1500000,125000,Daniel McCullers,DT,active,pittsburgh-steelers,1625000,2020
35253,1037152,297871,JuJu Smith-Schuster,WR,active,pittsburgh-steelers,1335023,2020
35254,889213,338426,James Washington,WR,active,pittsburgh-steelers,1227639,2020
35255,836554,233066,Mason Rudolph,QB,active,pittsburgh-steelers,1069620,2020
35256,689589,283357,Diontae Johnson,WR,active,pittsburgh-steelers,972946,2020
35257,751200,184032,Cameron Sutton,CB,active,pittsburgh-steelers,935232,2020
35258,758000,176572,James Conner,RB,active,pittsburgh-steelers,934572,2020
35259,711000,203091,Chuks Okorafor,T,active,pittsburgh-steelers,914091,2020
35260,660000,230545,Justin Layne,CB,active,pittsburgh-steelers,890545,2020
35261,585000,175517,Benny Snell Jr.,RB,active,pittsburgh-steelers,760517,2020
35262,735000,0,Trey Edmunds,RB,active,pittsburgh-steelers,735000,2020
35263,735000,0,Johnny Holton,WR,active,pittsburgh-steelers,735000,2020
35264,735000,0,Paxton Lynch,QB,active,pittsburgh-steelers,735000,2020
35265,735000,0,Ryan Switzer,WR,active,pittsburgh-steelers,735000,2020
35266,660000,64516,Jaylen Samuels,RB,active,pittsburgh-steelers,724516,2020
35267,585000,86115,Zach Gentry,TE,active,pittsburgh-steelers,671115,2020
35268,660000,5000,Olasunkanmi Adeniyi,LB,active,pittsburgh-steelers,665000,2020
35269,660000,0,Amara Darboh,WR,active,pittsburgh-steelers,660000,2020
35270,585000,42158,Isaiah Buggs,DE,active,pittsburgh-steelers,627158,2020
35271,585000,31838,Ulysees Gilbert,LB,active,pittsburgh-steelers,616838,2020
35272,585000,0,Deon Cain,WR,active,pittsburgh-steelers,585000,2020
35273,585000,0,Devlin Hodges,QB,active,pittsburgh-steelers,585000,2020
35274,585000,0,Tuzar Skipper,DE,active,pittsburgh-steelers,585000,2020
35275,585000,0,Robert Spillane,LB,active,pittsburgh-steelers,585000,2020
35276,585000,0,Kerrith Whyte,RB,active,pittsburgh-steelers,585000,2020
35277,0,0,J.T. Barrett,QB,active,pittsburgh-steelers,0,2020
35278,0,0,John Battle,S,active,pittsburgh-steelers,0,2020
35279,0,0,Jamal Custis,WR,active,pittsburgh-steelers,0,2020
35280,0,0,Christian Dilauro,G,active,pittsburgh-steelers,0,2020
35281,0,0,Derwin Gray,T,active,pittsburgh-steelers,0,2020
35282,0,0,Darrin Hall,RB,active,pittsburgh-steelers,0,2020
35283,0,0,Quadree Henderson,WR,active,pittsburgh-steelers,0,2020
35284,0,0,Anthony Johnson,WR,active,pittsburgh-steelers,0,2020
35285,0,0,Tray Matthews,S,active,pittsburgh-steelers,0,2020
35286,0,0,Henry Mondeaux,DT,active,pittsburgh-steelers,0,2020
35287,0,0,Alexander Myres,CB,active,pittsburgh-steelers,0,2020
35288,0,0,Kevin Rader,TE,active,pittsburgh-steelers,0,2020
35289,0,0,Christian Scotland-Williamson,TE,active,pittsburgh-steelers,0,2020
35290,0,0,Ralph Webb,RB,active,pittsburgh-steelers,0,2020
35291,0,1750000,Donte Moncrief,WR,dead_cap,pittsburgh-steelers,1750000,2020
35292,0,250000,Eli Rogers,WR,dead_cap,pittsburgh-steelers,250000,2020
35293,0,151887,Sutton Smith,OLB,dead_cap,pittsburgh-steelers,151887,2020
35294,0,149781,Joshua Dobbs,QB,dead_cap,pittsburgh-steelers,149781,2020
35295,0,146319,Marcus Allen,S,dead_cap,pittsburgh-steelers,146319,2020
35296,0,79088,Derwin Gray,T,dead_cap,pittsburgh-steelers,79088,2020
35297,0,13334,Alexander Myres,CB,dead_cap,pittsburgh-steelers,13334,2020
35298,0,13334,Alexander Myres,CB,dead_cap,pittsburgh-steelers,13334,2020
35299,0,10000,Fred Johnson,G,dead_cap,pittsburgh-steelers,10000,2020
35300,0,6667,Dravon Askew-Henry,S,dead_cap,pittsburgh-steelers,6667,2020
35301,0,5000,Garrett Brumfield,G,dead_cap,pittsburgh-steelers,5000,2020
35302,0,4667,Trevor Wood,TE,dead_cap,pittsburgh-steelers,4667,2020
35303,0,3334,Travon McMillan,RB,dead_cap,pittsburgh-steelers,3334,2020
35304,0,3334,Matthew Wright,K,dead_cap,pittsburgh-steelers,3334,2020
35305,0,2500,Trey Johnson,CB,dead_cap,pittsburgh-steelers,2500,2020
35306,0,1334,Ian Berryman,P,dead_cap,pittsburgh-steelers,1334,2020
35307,0,1334,P.J. Locke,S,dead_cap,pittsburgh-steelers,1334,2020
35308,0,667,Devlin Hodges,QB,dead_cap,pittsburgh-steelers,667,2020
35309,0,667,Damian Prince,T,dead_cap,pittsburgh-steelers,667,2020
35310,0,667,Tuzar Skipper,DE,dead_cap,pittsburgh-steelers,667,2020
35311,600000,0,Nate Clements,CB,active,san-francisco-49ers,600000,2007
35312,595000,0,Michael Lewis,S,active,san-francisco-49ers,595000,2007
35313,1675000,3520000,Alex Smith,QB,active,san-francisco-49ers,5195000,2007
35314,435000,3265833,Frank Gore,RB,active,san-francisco-49ers,3700833,2007
35315,360000,4780000,Vernon Davis,TE,active,san-francisco-49ers,5140000,2007
35316,2011684,604252,Kwame Harris,T,active,san-francisco-49ers,2615936,2007
35317,600000,1600000,Ashley Lelie,WR,active,san-francisco-49ers,2200000,2007
35318,605000,1428800,Shawntae Spencer,CB,active,san-francisco-49ers,2033800,2007
35319,835000,1191666,Walt Harris,CB,active,san-francisco-49ers,2026666,2007
35320,510000,1500000,Roderick Green,LB,active,san-francisco-49ers,2010000,2007
35321,650000,1083333,Aubrayo Franklin,DT,active,san-francisco-49ers,1733333,2007
35322,285000,1365000,Patrick Willis,ILB,active,san-francisco-49ers,1650000,2007
35323,450000,2080000,Manny Lawson,OLB,active,san-francisco-49ers,2530000,2007
35324,1200000,2500,Arnaz Battle,WR,active,san-francisco-49ers,1202500,2007
35325,449375,800000,David Baas,C,active,san-francisco-49ers,1249375,2007
35326,285000,735000,Joe Staley,LT,active,san-francisco-49ers,1020000,2007
35327,600000,338000,Andy Lee,P,active,san-francisco-49ers,938000,2007
35328,720000,183333,Brian Jennings,LS,active,san-francisco-49ers,903333,2007
35329,510000,216667,Keith Lewis,S,active,san-francisco-49ers,726667,2007
35330,510000,85500,Tony Wragge,G,active,san-francisco-49ers,595500,2007
35331,595000,0,Shaun Hill,QB,active,san-francisco-49ers,595000,2007
35332,435000,151833,Adam Snyder,G,active,san-francisco-49ers,586833,2007
35333,460000,109500,Isaac Sopoaga,DT,active,san-francisco-49ers,569500,2007
35334,435000,47250,Ronald Fields,DT,active,san-francisco-49ers,482250,2007
35335,285000,188454,Jason Hill,WR,active,san-francisco-49ers,473454,2007
35336,435000,9533,Billy Bajema,TE,active,san-francisco-49ers,444533,2007
35337,435000,0,Patrick Estes,TE,active,san-francisco-49ers,435000,2007
35338,285000,148125,Ray McDonald,DT,active,san-francisco-49ers,433125,2007
35339,360000,44000,Parys Haralson,DE,active,san-francisco-49ers,404000,2007
35340,285000,103219,Dashon Goldson,FS,active,san-francisco-49ers,388219,2007
35341,360000,25500,Delanie Walker,TE,active,san-francisco-49ers,385500,2007
35342,360000,21667,Marcus Hudson,CB,active,san-francisco-49ers,381667,2007
35343,360000,21320,Melvin Oliver,DE,active,san-francisco-49ers,381320,2007
35344,360000,11781,Michael Robinson,FB,active,san-francisco-49ers,371781,2007
35345,285000,44250,Tarell Brown,CB,active,san-francisco-49ers,329250,2007
35346,190000,120000,Jay Moore,LB,active,san-francisco-49ers,310000,2007
35347,190000,120000,Jay Moore,LB,active,san-francisco-49ers,310000,2007
35348,296470,0,LeRon McCoy,WR,active,san-francisco-49ers,296470,2007
35349,190000,93250,Joe Cohen,DT,active,san-francisco-49ers,283250,2007
35350,105000,0,Chris Weinke,QB,active,san-francisco-49ers,105000,2007
35351,79900,0,Thomas Clayton,RB,practice_squad,san-francisco-49ers,79900,2007
35352,79900,0,Mark Washington,LB,practice_squad,san-francisco-49ers,79900,2007
35353,23500,0,Harvey Dahl,G,practice_squad,san-francisco-49ers,23500,2007
35354,1618583,0,Jeremy Newberry,C,dead_cap,san-francisco-49ers,1618583,2007
35355,168750,0,Brandon Williams,WR,dead_cap,san-francisco-49ers,168750,2007
35356,68000,0,Rasheed Marshall,WR,dead_cap,san-francisco-49ers,68000,2007
35357,40000,0,Colby Bockwoldt,OLB,dead_cap,san-francisco-49ers,40000,2007
35358,24125,0,Thomas Clayton,RB,dead_cap,san-francisco-49ers,24125,2007
35359,20167,0,Derrick Johnson,CB,dead_cap,san-francisco-49ers,20167,2007
35360,9750,0,Patrick Estes,TE,dead_cap,san-francisco-49ers,9750,2007
35361,8383,0,Vickiel Vaughn,CB,dead_cap,san-francisco-49ers,8383,2007
35362,3383334,0,Nate Clements,CB,active,san-francisco-49ers,3383334,2008
35363,2562000,3066000,Frank Gore,RB,active,san-francisco-49ers,5628000,2008
35364,680000,1428800,Shawntae Spencer,CB,active,san-francisco-49ers,2108800,2008
35365,2300000,3520000,Alex Smith,QB,active,san-francisco-49ers,5820000,2008
35366,370000,4765000,Patrick Willis,ILB,active,san-francisco-49ers,5135000,2008
35367,605000,0,Michael Lewis,S,active,san-francisco-49ers,605000,2008
35368,750000,3250000,Justin Smith,DE,active,san-francisco-49ers,4000000,2008
35369,1975000,1525000,Issac Bruce,WR,active,san-francisco-49ers,3500000,2008
35370,900000,4780000,Vernon Davis,TE,active,san-francisco-49ers,5680000,2008
35371,1400000,666666,Walt Harris,CB,active,san-francisco-49ers,2066666,2008
35372,1000000,1000000,Bryant Johnson,WR,active,san-francisco-49ers,2000000,2008
35373,900000,1100000,Adam Snyder,G,active,san-francisco-49ers,2000000,2008
35374,700000,955000,Isaac Sopoaga,DT,active,san-francisco-49ers,1655000,2008
35375,1050000,683333,Aubrayo Franklin,DT,active,san-francisco-49ers,1733333,2008
35376,1040000,660000,Takeo Spikes,LB,active,san-francisco-49ers,1700000,2008
35377,637500,2080000,Manny Lawson,OLB,active,san-francisco-49ers,2717500,2008
35378,1000000,650000,Shaun Hill,QB,active,san-francisco-49ers,1650000,2008
35379,1340000,2500,Arnaz Battle,WR,active,san-francisco-49ers,1342500,2008
35380,370000,1480000,Joe Staley,LT,active,san-francisco-49ers,1850000,2008
35381,558125,800000,David Baas,C,active,san-francisco-49ers,1358125,2008
35382,295000,818000,Kentwan Balmer,DE,active,san-francisco-49ers,1113000,2008
35383,710000,338000,Andy Lee,P,active,san-francisco-49ers,1048000,2008
35384,775000,216667,Keith Lewis,S,active,san-francisco-49ers,991667,2008
35385,927000,0,Billy Bajema,TE,active,san-francisco-49ers,927000,2008
35386,730000,183333,Brian Jennings,LS,active,san-francisco-49ers,913333,2008
35387,445000,385500,Delanie Walker,TE,active,san-francisco-49ers,830500,2008
35388,605000,173000,Tony Wragge,G,active,san-francisco-49ers,778000,2008
35389,295000,445000,Chilo Rachal,G,active,san-francisco-49ers,740000,2008
35390,445000,251781,Michael Robinson,FB,active,san-francisco-49ers,696781,2008
35391,605000,10000,Roderick Green,LB,active,san-francisco-49ers,615000,2008
35392,520000,47250,Ronald Fields,DT,active,san-francisco-49ers,567250,2008
35393,370000,188454,Jason Hill,WR,active,san-francisco-49ers,558454,2008
35394,370000,148125,Ray McDonald,DT,active,san-francisco-49ers,518125,2008
35395,295000,196000,Reggie Smith,S,active,san-francisco-49ers,491000,2008
35396,445000,44000,Parys Haralson,DE,active,san-francisco-49ers,489000,2008
35397,370000,103219,Dashon Goldson,FS,active,san-francisco-49ers,473219,2008
35398,445000,21667,Marcus Hudson,CB,active,san-francisco-49ers,466667,2008
35399,445000,0,Ahmad Brooks,OLB,active,san-francisco-49ers,445000,2008
35400,295000,122125,Cody Wallace,C,active,san-francisco-49ers,417125,2008
35401,370000,44250,Tarell Brown,CB,active,san-francisco-49ers,414250,2008
35402,295000,26500,Josh Morgan,WR,active,san-francisco-49ers,321500,2008
35403,200000,120000,Jay Moore,LB,active,san-francisco-49ers,320000,2008
35404,88840,0,Larry Grant,LB,active,san-francisco-49ers,88840,2008
35405,52058,0,Thomas Clayton,RB,active,san-francisco-49ers,52058,2008
35406,17532,0,Chris Hannon,WR,active,san-francisco-49ers,17532,2008
35407,88400,0,Thomas Clayton,RB,practice_squad,san-francisco-49ers,88400,2008
35408,88400,0,Chris Hannon,WR,practice_squad,san-francisco-49ers,88400,2008
35409,0,1000000,Ashley Lelie,WR,dead_cap,san-francisco-49ers,1000000,2008
35410,0,544252,Kwame Harris,T,dead_cap,san-francisco-49ers,544252,2008
35411,337500,0,Brandon Williams,WR,dead_cap,san-francisco-49ers,337500,2008
35412,93250,0,Joe Cohen,DT,dead_cap,san-francisco-49ers,93250,2008
35413,72375,0,Thomas Clayton,RB,dead_cap,san-francisco-49ers,72375,2008
35414,21320,0,Melvin Oliver,DE,dead_cap,san-francisco-49ers,21320,2008
35415,16766,0,Vickiel Vaughn,CB,dead_cap,san-francisco-49ers,16766,2008
35416,9750,0,Patrick Estes,TE,dead_cap,san-francisco-49ers,9750,2008
35417,1500,0,Brian De La Puente,C,dead_cap,san-francisco-49ers,1500,2008
35418,460000,13690000,Joe Staley,LT,active,san-francisco-49ers,14150000,2009
35419,3500000,8400000,Justin Smith,DE,active,san-francisco-49ers,11900000,2009
35420,2000000,9853332,Alex Smith,QB,active,san-francisco-49ers,11853332,2009
35421,2500000,4497250,Frank Gore,RB,active,san-francisco-49ers,6997250,2009
35422,880000,4894000,Parys Haralson,DE,active,san-francisco-49ers,5774000,2009
35423,3516666,0,Nate Clements,CB,active,san-francisco-49ers,3516666,2009
35424,1862500,955000,Isaac Sopoaga,DT,active,san-francisco-49ers,2817500,2009
35425,1900000,0,Michael Lewis,S,active,san-francisco-49ers,1900000,2009
35426,2440000,4680000,Vernon Davis,TE,active,san-francisco-49ers,7120000,2009
35427,1670000,1200000,Shawntae Spencer,CB,active,san-francisco-49ers,2870000,2009
35428,2000000,633334,Aubrayo Franklin,DT,active,san-francisco-49ers,2633334,2009
35429,620000,1980000,Brandon Jones,WR,active,san-francisco-49ers,2600000,2009
35430,1725000,775000,Issac Bruce,WR,active,san-francisco-49ers,2500000,2009
35431,1400000,1100000,Adam Snyder,G,active,san-francisco-49ers,2500000,2009
35432,1250000,1234375,Takeo Spikes,LB,active,san-francisco-49ers,2484375,2009
35433,2393077,0,Michael Crabtree,WR,active,san-francisco-49ers,2393077,2009
35434,500000,2915000,Patrick Willis,ILB,active,san-francisco-49ers,3415000,2009
35435,1400000,650000,Shaun Hill,QB,active,san-francisco-49ers,2050000,2009
35436,915000,2080000,Manny Lawson,OLB,active,san-francisco-49ers,2995000,2009
35437,1490000,2500,Arnaz Battle,WR,active,san-francisco-49ers,1492500,2009
35438,1000000,451562,Tarell Brown,CB,active,san-francisco-49ers,1451562,2009
35439,1000000,338000,Andy Lee,P,active,san-francisco-49ers,1338000,2009
35440,385000,1532500,Kentwan Balmer,DE,active,san-francisco-49ers,1917500,2009
35441,666875,800000,David Baas,C,active,san-francisco-49ers,1466875,2009
35442,1200000,0,Tony Pashos,RT,active,san-francisco-49ers,1200000,2009
35443,745000,427333,Moran Norris,RB,active,san-francisco-49ers,1172333,2009
35444,745000,184166,Brian Jennings,LS,active,san-francisco-49ers,929166,2009
35445,535000,385500,Delanie Walker,TE,active,san-francisco-49ers,920500,2009
35446,460000,399500,Chilo Rachal,G,active,san-francisco-49ers,859500,2009
35447,535000,251781,Michael Robinson,FB,active,san-francisco-49ers,786781,2009
35448,620000,87500,Tony Wragge,G,active,san-francisco-49ers,707500,2009
35449,460000,188454,Jason Hill,WR,active,san-francisco-49ers,648454,2009
35450,460000,148125,Ray McDonald,DT,active,san-francisco-49ers,608125,2009
35451,385000,196000,Reggie Smith,S,active,san-francisco-49ers,581000,2009
35452,460000,103219,Dashon Goldson,FS,active,san-francisco-49ers,563219,2009
35453,535000,21667,Marcus Hudson,CB,active,san-francisco-49ers,556667,2009
35454,535000,0,Ahmad Brooks,OLB,active,san-francisco-49ers,535000,2009
35455,310000,207061,Glen Coffee,RB,active,san-francisco-49ers,517061,2009
35456,385000,122125,Cody Wallace,C,active,san-francisco-49ers,507125,2009
35457,385000,26500,Josh Morgan,WR,active,san-francisco-49ers,411500,2009
35458,385000,0,Brian De La Puente,C,active,san-francisco-49ers,385000,2009
35459,310000,48062,Scott McKillop,LB,active,san-francisco-49ers,358062,2009
35460,310000,37575,Nate Davis,QB,active,san-francisco-49ers,347575,2009
35461,310000,14970,Curtis Taylor,S,active,san-francisco-49ers,324970,2009
35462,310000,10750,Ricky Jean Francois,DT,active,san-francisco-49ers,320750,2009
35463,1700000,666668,Walt Harris,CB,injured_reserve,san-francisco-49ers,2366668,2009
35464,230000,0,Thomas Clayton,RB,injured_reserve,san-francisco-49ers,230000,2009
35465,88400,0,Alex Boone,G,practice_squad,san-francisco-49ers,88400,2009
35466,88400,0,Kory Sheets,RB,practice_squad,san-francisco-49ers,88400,2009
35467,0,544252,Kwame Harris,T,dead_cap,san-francisco-49ers,544252,2009
35468,240000,0,Jay Moore,LB,dead_cap,san-francisco-49ers,240000,2009
35469,216667,0,Keith Lewis,S,dead_cap,san-francisco-49ers,216667,2009
35470,186500,0,Joe Cohen,DT,dead_cap,san-francisco-49ers,186500,2009
35471,26625,0,Bear Pascoe,TE,dead_cap,san-francisco-49ers,26625,2009
35472,21320,0,Melvin Oliver,DE,dead_cap,san-francisco-49ers,21320,2009
35473,14875,0,Larry Grant,LB,dead_cap,san-francisco-49ers,14875,2009
35474,5500,0,Kory Sheets,RB,dead_cap,san-francisco-49ers,5500,2009
35475,2500,0,Maurice Price,WR,dead_cap,san-francisco-49ers,2500,2009
35476,1500,0,Brian De La Puente,C,dead_cap,san-francisco-49ers,1500,2009
35477,500,0,Alex Boone,G,dead_cap,san-francisco-49ers,500,2009
35478,395000,9318240,Michael Crabtree,WR,active,san-francisco-49ers,9713240,2010
35479,3000000,10153332,Alex Smith,QB,active,san-francisco-49ers,13153332,2010
35480,6000000,0,Nate Clements,CB,active,san-francisco-49ers,6000000,2010
35481,3874000,6346666,Vernon Davis,TE,active,san-francisco-49ers,10220666,2010
35482,7003000,0,Aubrayo Franklin,DT,active,san-francisco-49ers,7003000,2010
35483,550000,6855000,Joe Staley,LT,active,san-francisco-49ers,7405000,2010
35484,2850000,4337875,Frank Gore,RB,active,san-francisco-49ers,7187875,2010
35485,2625000,3650000,Justin Smith,DE,active,san-francisco-49ers,6275000,2010
35486,320000,4796962,Mike Iupati,G,active,san-francisco-49ers,5116962,2010
35487,3217500,955000,Isaac Sopoaga,DT,active,san-francisco-49ers,4172500,2010
35488,2850000,1200000,Shawntae Spencer,CB,active,san-francisco-49ers,4050000,2010
35489,320000,3588567,Anthony Davis,RT,active,san-francisco-49ers,3908567,2010
35490,1875000,2000000,David Carr,QB,active,san-francisco-49ers,3875000,2010
35491,1200000,1840000,Parys Haralson,DE,active,san-francisco-49ers,3040000,2010
35492,2250000,750000,Takeo Spikes,LB,active,san-francisco-49ers,3000000,2010
35493,1098000,2815000,Patrick Willis,ILB,active,san-francisco-49ers,3913000,2010
35494,1650000,1100000,Adam Snyder,G,active,san-francisco-49ers,2750000,2010
35495,1650000,650000,Shaun Hill,QB,active,san-francisco-49ers,2300000,2010
35496,1750000,427333,Moran Norris,RB,active,san-francisco-49ers,2177333,2010
35497,1015000,1110000,Delanie Walker,TE,active,san-francisco-49ers,2125000,2010
35498,900000,925000,Ahmad Brooks,OLB,active,san-francisco-49ers,1825000,2010
35499,1300000,300000,Michael Lewis,S,active,san-francisco-49ers,1600000,2010
35500,625000,2080000,Manny Lawson,OLB,active,san-francisco-49ers,2705000,2010
35501,552000,1080500,Chilo Rachal,G,active,san-francisco-49ers,1632500,2010
35502,555000,875000,Tarell Brown,CB,active,san-francisco-49ers,1430000,2010
35503,1000000,338000,Andy Lee,P,active,san-francisco-49ers,1338000,2010
35504,1076000,221000,Brian Jennings,LS,active,san-francisco-49ers,1297000,2010
35505,1101000,148125,Ray McDonald,DT,active,san-francisco-49ers,1249125,2010
35506,1226000,0,David Baas,C,active,san-francisco-49ers,1226000,2010
35507,1035833,50000,Ted Ginn Jr.,WR,active,san-francisco-49ers,1085833,2010
35508,750000,0,Travis LaBoy,DT,active,san-francisco-49ers,750000,2010
35509,650000,265000,Michael Robinson,FB,active,san-francisco-49ers,915000,2010
35510,807520,25000,Tony Wragge,G,active,san-francisco-49ers,832520,2010
35511,550000,188454,Jason Hill,WR,active,san-francisco-49ers,738454,2010
35512,470000,196000,Reggie Smith,S,active,san-francisco-49ers,666000,2010
35513,550000,103219,Dashon Goldson,FS,active,san-francisco-49ers,653219,2010
35514,395000,207061,Glen Coffee,RB,active,san-francisco-49ers,602061,2010
35515,545000,0,Troy Smith,QB,active,san-francisco-49ers,545000,2010
35516,470000,26500,Josh Morgan,WR,active,san-francisco-49ers,496500,2010
35517,320000,175562,Navorro Bowman,ILB,active,san-francisco-49ers,495562,2010
35518,395000,14970,Curtis Taylor,S,active,san-francisco-49ers,409970,2010
35519,32000,377000,Taylor Mays,SS,active,san-francisco-49ers,409000,2010
35520,395000,10750,Ricky Jean Francois,DT,active,san-francisco-49ers,405750,2010
35521,395000,0,C.J. Spillman,S,active,san-francisco-49ers,395000,2010
35522,320000,30150,Anthony Dixon,RB,active,san-francisco-49ers,350150,2010
35523,320000,26550,Nate Byham,TE,active,san-francisco-49ers,346550,2010
35524,320000,19850,Kyle Williams,WR,active,san-francisco-49ers,339850,2010
35525,320000,14462,Phillip Adams,CB,active,san-francisco-49ers,334462,2010
35526,320000,0,Alex Boone,G,active,san-francisco-49ers,320000,2010
35527,320000,0,Thaddeus Gibson,DE,active,san-francisco-49ers,320000,2010
35528,320000,0,Will Tukuafu,FB,active,san-francisco-49ers,320000,2010
35529,263529,0,Tramaine Brock,CB,active,san-francisco-49ers,263529,2010
35530,112941,0,Chris Maragos,FS,active,san-francisco-49ers,112941,2010
35531,40300,0,Nate Davis,QB,active,san-francisco-49ers,40300,2010
35532,240000,48062,Scott McKillop,LB,injured_reserve,san-francisco-49ers,288062,2010
35533,176800,0,Tramaine Brock,CB,practice_squad,san-francisco-49ers,176800,2010
35534,88400,0,Jehuu Caulcrick,RB,practice_squad,san-francisco-49ers,88400,2010
35535,88400,0,Colin Cloherty,TE,practice_squad,san-francisco-49ers,88400,2010
35536,88400,0,Chris Maragos,FS,practice_squad,san-francisco-49ers,88400,2010
35537,0,5666666,Brandon Lloyd,WR,dead_cap,san-francisco-49ers,5666666,2010
35538,0,1532500,Kentwan Balmer,DE,dead_cap,san-francisco-49ers,1532500,2010
35539,700000,0,Brandon Jones,WR,dead_cap,san-francisco-49ers,700000,2010
35540,240000,0,Michael Robinson,FB,dead_cap,san-francisco-49ers,240000,2010
35541,240000,0,Jay Moore,LB,dead_cap,san-francisco-49ers,240000,2010
35542,207061,0,Glen Coffee,RB,dead_cap,san-francisco-49ers,207061,2010
35543,122125,0,Cody Wallace,C,dead_cap,san-francisco-49ers,122125,2010
35544,79875,0,Bear Pascoe,TE,dead_cap,san-francisco-49ers,79875,2010
35545,44625,0,Larry Grant,LB,dead_cap,san-francisco-49ers,44625,2010
35546,5500,0,Kory Sheets,RB,dead_cap,san-francisco-49ers,5500,2010
35547,2500,0,Tramaine Brock,CB,dead_cap,san-francisco-49ers,2500,2010
35548,2500,0,Chris Maragos,FS,dead_cap,san-francisco-49ers,2500,2010
35549,2500,0,Maurice Price,WR,dead_cap,san-francisco-49ers,2500,2010
35550,500,0,Alex Boone,G,dead_cap,san-francisco-49ers,500,2010
35551,5000000,3650000,Justin Smith,DE,active,san-francisco-49ers,8650000,2011
35552,3900000,3966000,Frank Gore,RB,active,san-francisco-49ers,7866000,2011
35553,4708000,2266666,Vernon Davis,TE,active,san-francisco-49ers,6974666,2011
35554,1594455,6003958,Patrick Willis,ILB,active,san-francisco-49ers,7598413,2011
35555,3875000,1270443,Michael Crabtree,WR,active,san-francisco-49ers,5145443,2011
35556,3800000,955000,Isaac Sopoaga,DT,active,san-francisco-49ers,4755000,2011
35557,4000000,900000,Alex Smith,QB,active,san-francisco-49ers,4900000,2011
35558,2125000,2125000,Carlos Rogers,CB,active,san-francisco-49ers,4250000,2011
35559,3100000,0,Shawntae Spencer,CB,active,san-francisco-49ers,3100000,2011
35560,2000000,1100000,Adam Snyder,G,active,san-francisco-49ers,3100000,2011
35561,487500,3966667,Anthony Davis,RT,active,san-francisco-49ers,4454167,2011
35562,375000,2240273,Aldon Smith,OLB,active,san-francisco-49ers,2615273,2011
35563,1500000,1083333,Donte Whitner,SS,active,san-francisco-49ers,2583333,2011
35564,1200000,1225000,Ahmad Brooks,OLB,active,san-francisco-49ers,2425000,2011
35565,1850000,500000,Parys Haralson,DE,active,san-francisco-49ers,2350000,2011
35566,1000000,1166667,Jonathan Goodwin,C,active,san-francisco-49ers,2166667,2011
35567,1150000,1639750,Joe Staley,LT,active,san-francisco-49ers,2789750,2011
35568,1000000,1100000,Braylon Edwards,WR,active,san-francisco-49ers,2100000,2011
35569,1000000,1000000,Dashon Goldson,FS,active,san-francisco-49ers,2000000,2011
35570,1000000,1000000,Ray McDonald,DT,active,san-francisco-49ers,2000000,2011
35571,1500000,427333,Moran Norris,RB,active,san-francisco-49ers,1927333,2011
35572,1300000,616667,David Akers,K,active,san-francisco-49ers,1916667,2011
35573,450000,2415000,Mike Iupati,G,active,san-francisco-49ers,2865000,2011
35574,800000,907312,Tarell Brown,CB,active,san-francisco-49ers,1707312,2011
35575,750000,860000,Delanie Walker,TE,active,san-francisco-49ers,1610000,2011
35576,1393750,50000,Ted Ginn Jr.,WR,active,san-francisco-49ers,1443750,2011
35577,1000000,338000,Andy Lee,P,active,san-francisco-49ers,1338000,2011
35578,865000,221000,Brian Jennings,LS,active,san-francisco-49ers,1086000,2011
35579,644000,409500,Chilo Rachal,G,active,san-francisco-49ers,1053500,2011
35580,810000,0,Madieu Williams,S,active,san-francisco-49ers,810000,2011
35581,375000,556691,Colin Kaepernick,QB,active,san-francisco-49ers,931691,2011
35582,810000,0,Josh McCown,QB,active,san-francisco-49ers,810000,2011
35583,450000,340000,Alex Boone,G,active,san-francisco-49ers,790000,2011
35584,555000,196000,Reggie Smith,S,active,san-francisco-49ers,751000,2011
35585,700000,50000,Blake Costanzo,OLB,active,san-francisco-49ers,750000,2011
35586,700000,50000,Tavares Gooden,ILB,active,san-francisco-49ers,750000,2011
35587,450000,175562,Navorro Bowman,ILB,active,san-francisco-49ers,625562,2011
35588,600000,0,Antwan Applewhite,DE,active,san-francisco-49ers,600000,2011
35589,600000,0,Larry Grant,LB,active,san-francisco-49ers,600000,2011
35590,555000,26500,Josh Morgan,WR,active,san-francisco-49ers,581500,2011
35591,810000,30000,Tony Wragge,G,active,san-francisco-49ers,840000,2011
35592,525000,0,C.J. Spillman,S,active,san-francisco-49ers,525000,2011
35593,375000,149719,Chris Culliver,CB,active,san-francisco-49ers,524719,2011
35594,480000,10750,Ricky Jean Francois,DT,active,san-francisco-49ers,490750,2011
35595,375000,109805,Kendall Hunter,RB,active,san-francisco-49ers,484805,2011
35596,450000,0,Tramaine Brock,CB,active,san-francisco-49ers,450000,2011
35597,405000,30150,Anthony Dixon,RB,active,san-francisco-49ers,435150,2011
35598,405000,26550,Nate Byham,TE,active,san-francisco-49ers,431550,2011
35599,405000,19850,Kyle Williams,WR,active,san-francisco-49ers,424850,2011
35600,375000,40075,Daniel Kilgore,C,active,san-francisco-49ers,415075,2011
35601,405000,0,Will Tukuafu,FB,active,san-francisco-49ers,405000,2011
35602,375000,15613,Bruce Miller,FB,active,san-francisco-49ers,390613,2011
35603,375000,11475,Curtis Holcomb,CB,active,san-francisco-49ers,386475,2011
35604,375000,11475,Michael Person,G,active,san-francisco-49ers,386475,2011
35605,375000,4166,Demarcus Dobbs,DE,active,san-francisco-49ers,379166,2011
35606,375000,0,Colin Jones,FS,active,san-francisco-49ers,375000,2011
35607,375000,0,Scott Tolzien,QB,active,san-francisco-49ers,375000,2011
35608,375000,0,Ian Williams,DT,active,san-francisco-49ers,375000,2011
35609,370584,0,Brett Swain,WR,active,san-francisco-49ers,370584,2011
35610,96900,0,Chase Beeler,C,active,san-francisco-49ers,96900,2011
35611,96900,0,Derek Hall,T,active,san-francisco-49ers,96900,2011
35612,96900,0,Joe Hastings,WR,active,san-francisco-49ers,96900,2011
35613,96900,0,Ian Johnson,RB,active,san-francisco-49ers,96900,2011
35614,96900,0,John Matthews,WR,active,san-francisco-49ers,96900,2011
35615,96900,0,Cory Nelms,S,active,san-francisco-49ers,96900,2011
35616,96900,0,Monte Simmons,OLB,active,san-francisco-49ers,96900,2011
35617,96900,0,Konrad Reuland,TE,practice_squad,san-francisco-49ers,96900,2011
35618,96900,0,Michael Wilhoite,ILB,practice_squad,san-francisco-49ers,96900,2011
35619,2100000,0,Brandon Jones,WR,dead_cap,san-francisco-49ers,2100000,2011
35620,0,3065000,Kentwan Balmer,DE,dead_cap,san-francisco-49ers,3065000,2011
35621,1131000,0,Taylor Mays,SS,dead_cap,san-francisco-49ers,1131000,2011
35622,480000,0,Michael Robinson,FB,dead_cap,san-francisco-49ers,480000,2011
35623,207061,0,Glen Coffee,RB,dead_cap,san-francisco-49ers,207061,2011
35624,122125,0,Cody Wallace,C,dead_cap,san-francisco-49ers,122125,2011
35625,48062,0,Scott McKillop,LB,dead_cap,san-francisco-49ers,48062,2011
35626,29940,0,Curtis Taylor,S,dead_cap,san-francisco-49ers,29940,2011
35627,0,26055,Ronald Johnson,WR,dead_cap,san-francisco-49ers,26055,2011
35628,0,24724,Colin Jones,FS,dead_cap,san-francisco-49ers,24724,2011
35629,0,14462,Phillip Adams,CB,dead_cap,san-francisco-49ers,14462,2011
35630,0,5833,Chris Hogan,WR,dead_cap,san-francisco-49ers,5833,2011
35631,2500,0,Tramaine Brock,CB,dead_cap,san-francisco-49ers,2500,2011
35632,2500,0,Chris Maragos,FS,dead_cap,san-francisco-49ers,2500,2011
35633,0,2000,Sealver Siliga,DT,dead_cap,san-francisco-49ers,2000,2011
35634,1000,0,Kenny Wiggins,G,dead_cap,san-francisco-49ers,1000,2011
35635,333,0,Konrad Reuland,TE,dead_cap,san-francisco-49ers,333,2011
35636,333,0,Kenny Rowe,OLB,dead_cap,san-francisco-49ers,333,2011
35637,1904000,16933332,Patrick Willis,ILB,active,san-francisco-49ers,18837332,2012
35638,5000000,4250000,Alex Smith,QB,active,san-francisco-49ers,9250000,2012
35639,4271062,2605416,Vernon Davis,TE,active,san-francisco-49ers,6876478,2012
35640,5875000,900000,Justin Smith,DE,active,san-francisco-49ers,6775000,2012
35641,6212000,0,Dashon Goldson,FS,active,san-francisco-49ers,6212000,2012
35642,2000000,4000000,Frank Gore,RB,active,san-francisco-49ers,6000000,2012
35643,3800000,955000,Isaac Sopoaga,DT,active,san-francisco-49ers,4755000,2012
35644,3000000,1864062,Carlos Rogers,CB,active,san-francisco-49ers,4864062,2012
35645,3500000,1270443,Michael Crabtree,WR,active,san-francisco-49ers,4770443,2012
35646,3300000,1083333,Donte Whitner,SS,active,san-francisco-49ers,4383333,2012
35647,2400000,1316667,Jonathan Goodwin,C,active,san-francisco-49ers,3716667,2012
35648,3000000,616667,David Akers,K,active,san-francisco-49ers,3616667,2012
35649,2358823,1238235,Ray McDonald,DT,active,san-francisco-49ers,3597058,2012
35650,1028818,2240273,Aldon Smith,OLB,active,san-francisco-49ers,3269091,2012
35651,925000,3966667,Anthony Davis,RT,active,san-francisco-49ers,4891667,2012
35652,750000,2100000,Ahmad Brooks,OLB,active,san-francisco-49ers,2850000,2012
35653,1800000,700000,Joe Staley,LT,active,san-francisco-49ers,2500000,2012
35654,1750000,750000,Randy Moss,WR,active,san-francisco-49ers,2500000,2012
35655,703500,2715000,Mike Iupati,G,active,san-francisco-49ers,3418500,2012
35656,540000,1675562,Navorro Bowman,ILB,active,san-francisco-49ers,2215562,2012
35657,1100000,863000,Andy Lee,P,active,san-francisco-49ers,1963000,2012
35658,1045000,860000,Delanie Walker,TE,active,san-francisco-49ers,1905000,2012
35659,850000,957312,Tarell Brown,CB,active,san-francisco-49ers,1807312,2012
35660,782000,150000,Brandon Jacobs,RB,active,san-francisco-49ers,932000,2012
35661,1200000,175000,Ted Ginn Jr.,WR,active,san-francisco-49ers,1375000,2012
35662,390000,873188,A.J.  Jenkins,WR,active,san-francisco-49ers,1263188,2012
35663,1260000,0,Larry Grant,LB,active,san-francisco-49ers,1260000,2012
35664,607922,556691,Colin Kaepernick,QB,active,san-francisco-49ers,1164613,2012
35665,875000,221000,Brian Jennings,LS,active,san-francisco-49ers,1096000,2012
35666,750000,333333,C.J. Spillman,S,active,san-francisco-49ers,1083333,2012
35667,1000000,0,Clark Haggans,LB,active,san-francisco-49ers,1000000,2012
35668,925000,25000,Leonard Davis,G,active,san-francisco-49ers,950000,2012
35669,540000,390000,Alex Boone,G,active,san-francisco-49ers,930000,2012
35670,826000,0,Ryan Pontbriand,C,active,san-francisco-49ers,826000,2012
35671,615000,10750,Ricky Jean Francois,DT,active,san-francisco-49ers,625750,2012
35672,465000,149719,Chris Culliver,CB,active,san-francisco-49ers,614719,2012
35673,390000,213436,LaMichael James,RB,active,san-francisco-49ers,603436,2012
35674,465000,109805,Kendall Hunter,RB,active,san-francisco-49ers,574805,2012
35675,700000,0,Tavares Gooden,ILB,active,san-francisco-49ers,700000,2012
35676,540000,0,Tramaine Brock,CB,active,san-francisco-49ers,540000,2012
35677,540000,0,Chad Hall,WR,active,san-francisco-49ers,540000,2012
35678,540000,0,Darcel McBath,S,active,san-francisco-49ers,540000,2012
35679,490000,30150,Anthony Dixon,RB,active,san-francisco-49ers,520150,2012
35680,490000,19850,Kyle Williams,WR,active,san-francisco-49ers,509850,2012
35681,465000,40075,Daniel Kilgore,C,active,san-francisco-49ers,505075,2012
35682,390000,106301,Joe Looney,G,active,san-francisco-49ers,496301,2012
35683,465000,15613,Bruce Miller,FB,active,san-francisco-49ers,480613,2012
35684,465000,4166,Demarcus Dobbs,DE,active,san-francisco-49ers,469166,2012
35685,465000,0,Eric Bakhtiari,DE,active,san-francisco-49ers,465000,2012
35686,465000,0,Perrish Cox,CB,active,san-francisco-49ers,465000,2012
35687,465000,0,John Matthews,WR,active,san-francisco-49ers,465000,2012
35688,465000,0,Scott Tolzien,QB,active,san-francisco-49ers,465000,2012
35689,465000,0,Will Tukuafu,FB,active,san-francisco-49ers,465000,2012
35690,465000,0,Ian Williams,DT,active,san-francisco-49ers,465000,2012
35691,390000,27625,Trenton Robinson,FS,active,san-francisco-49ers,417625,2012
35692,390000,2000,Garrett Celek,TE,active,san-francisco-49ers,392000,2012
35693,390000,0,Michael Wilhoite,ILB,active,san-francisco-49ers,390000,2012
35694,389997,0,Tony Jerod-Eddie,DE,active,san-francisco-49ers,389997,2012
35695,273000,1666,Jewel Hampton,RB,active,san-francisco-49ers,274666,2012
35696,2450000,100000,Parys Haralson,DE,injured_reserve,san-francisco-49ers,2550000,2012
35697,1200000,1350000,Mario Manningham,WR,injured_reserve,san-francisco-49ers,2550000,2012
35698,390000,41200,Darius Fleming,OLB,injured_reserve,san-francisco-49ers,431200,2012
35699,193800,0,Ricardo Lockette,WR,practice_squad,san-francisco-49ers,193800,2012
35700,96900,0,Tony Jerod-Eddie,DE,practice_squad,san-francisco-49ers,96900,2012
35701,96900,0,Cam Johnson,OLB,practice_squad,san-francisco-49ers,96900,2012
35702,96900,0,Al Netter,RT,practice_squad,san-francisco-49ers,96900,2012
35703,96900,0,Michael Thomas,FS,practice_squad,san-francisco-49ers,96900,2012
35704,96900,0,Kenny Wiggins,G,practice_squad,san-francisco-49ers,96900,2012
35705,96900,0,Michael Wilhoite,ILB,practice_squad,san-francisco-49ers,96900,2012
35706,175000,0,Josh Johnson,QB,dead_cap,san-francisco-49ers,175000,2012
35707,0,78165,Ronald Johnson,WR,dead_cap,san-francisco-49ers,78165,2012
35708,0,74172,Colin Jones,FS,dead_cap,san-francisco-49ers,74172,2012
35709,48062,0,Scott McKillop,LB,dead_cap,san-francisco-49ers,48062,2012
35710,0,28924,Phillip Adams,CB,dead_cap,san-francisco-49ers,28924,2012
35711,26550,0,Nate Byham,TE,dead_cap,san-francisco-49ers,26550,2012
35712,25000,0,Rock Cartwright,RB,dead_cap,san-francisco-49ers,25000,2012
35713,0,23128,Jason Slowey,C,dead_cap,san-francisco-49ers,23128,2012
35714,11787,0,Cam Johnson,OLB,dead_cap,san-francisco-49ers,11787,2012
35715,0,11667,Chris Hogan,WR,dead_cap,san-francisco-49ers,11667,2012
35716,0,11475,Curtis Holcomb,CB,dead_cap,san-francisco-49ers,11475,2012
35717,11475,0,Michael Person,G,dead_cap,san-francisco-49ers,11475,2012
35718,0,4000,Sealver Siliga,DT,dead_cap,san-francisco-49ers,4000,2012
35719,3720,0,Eric Bakhtiari,DE,dead_cap,san-francisco-49ers,3720,2012
35720,3333,0,Nathan Palmer,WR,dead_cap,san-francisco-49ers,3333,2012
35721,2666,0,Brian Tyms,WR,dead_cap,san-francisco-49ers,2666,2012
35722,2500,0,Al Netter,RT,dead_cap,san-francisco-49ers,2500,2012
35723,2000,0,Kevin Murphy,LT,dead_cap,san-francisco-49ers,2000,2012
35724,2000,0,Kenny Wiggins,G,dead_cap,san-francisco-49ers,2000,2012
35725,1668,0,Matthew Masifilo,G,dead_cap,san-francisco-49ers,1668,2012
35726,1333,0,Michael Thomas,FS,dead_cap,san-francisco-49ers,1333,2012
35727,1166,0,Joe Holland,OLB,dead_cap,san-francisco-49ers,1166,2012
35728,1000,0,Kourtnei Brown,OLB,dead_cap,san-francisco-49ers,1000,2012
35729,1000,0,Tony Jerod-Eddie,DE,dead_cap,san-francisco-49ers,1000,2012
35730,1000,0,Anthony Mosley,CB,dead_cap,san-francisco-49ers,1000,2012
35731,1000,0,Chris Owusu,WR,dead_cap,san-francisco-49ers,1000,2012
35732,667,0,Konrad Reuland,TE,dead_cap,san-francisco-49ers,667,2012
35733,667,0,Kenny Rowe,OLB,dead_cap,san-francisco-49ers,667,2012
35734,333,0,Patrick Butrym,DT,dead_cap,san-francisco-49ers,333,2012
35735,222,0,Cameron Bell,RB,dead_cap,san-francisco-49ers,222,2012
35736,6072000,2667916,Vernon Davis,TE,active,san-francisco-49ers,8739916,2013
35737,5500000,1864062,Carlos Rogers,CB,active,san-francisco-49ers,7364062,2013
35738,3300000,3150000,Frank Gore,RB,active,san-francisco-49ers,6450000,2013
35739,6000000,0,Anquan Boldin,WR,active,san-francisco-49ers,6000000,2013
35740,4500000,1270443,Michael Crabtree,WR,active,san-francisco-49ers,5770443,2013
35741,2700000,2350000,Ahmad Brooks,OLB,active,san-francisco-49ers,5050000,2013
35742,3850000,1083333,Donte Whitner,SS,active,san-francisco-49ers,4933333,2013
35743,880000,5066666,Anthony Davis,RT,active,san-francisco-49ers,5946666,2013
35744,1800000,2275000,Andy Lee,P,active,san-francisco-49ers,4075000,2013
35745,940000,3186666,Justin Smith,DE,active,san-francisco-49ers,4126666,2013
35746,1682636,2240273,Aldon Smith,OLB,active,san-francisco-49ers,3922909,2013
35747,2500000,666668,Jonathan Goodwin,C,active,san-francisco-49ers,3166668,2013
35748,630000,3275562,Navorro Bowman,ILB,active,san-francisco-49ers,3905562,2013
35749,2100000,700000,Joe Staley,LT,active,san-francisco-49ers,2800000,2013
35750,1002000,2715000,Mike Iupati,G,active,san-francisco-49ers,3717000,2013
35751,715000,2455735,Ray McDonald,DT,active,san-francisco-49ers,3170735,2013
35752,715000,1671750,Patrick Willis,ILB,active,san-francisco-49ers,2386750,2013
35753,1000000,1350000,Phil Dawson,K,active,san-francisco-49ers,2350000,2013
35754,715000,1492500,Glenn Dorsey,DE,active,san-francisco-49ers,2207500,2013
35755,1323000,750000,Tramaine Brock,CB,active,san-francisco-49ers,2073000,2013
35756,950000,990000,Alex Boone,G,active,san-francisco-49ers,1940000,2013
35757,925000,907312,Tarell Brown,CB,active,san-francisco-49ers,1832312,2013
35758,900000,883333,Craig Dahl,SS,active,san-francisco-49ers,1783333,2013
35759,1225000,333333,C.J. Spillman,S,active,san-francisco-49ers,1558333,2013
35760,405000,1136955,Eric Reid,SS,active,san-francisco-49ers,1541955,2013
35761,740844,656691,Colin Kaepernick,QB,active,san-francisco-49ers,1397535,2013
35762,1000000,350000,Dan Skuta,OLB,active,san-francisco-49ers,1350000,2013
35763,893000,250000,Adam Snyder,G,active,san-francisco-49ers,1143000,2013
35764,1061510,0,Jonathan Baldwin,WR,active,san-francisco-49ers,1061510,2013
35765,405000,494578,Cornellius Carradine,DE,active,san-francisco-49ers,899578,2013
35766,715000,165000,Raymond Ventrone,S,active,san-francisco-49ers,880000,2013
35767,490859,263436,LaMichael James,RB,active,san-francisco-49ers,754295,2013
35768,555000,149719,Chris Culliver,CB,active,san-francisco-49ers,704719,2013
35769,555000,109805,Kendall Hunter,RB,active,san-francisco-49ers,664805,2013
35770,630000,30150,Anthony Dixon,RB,active,san-francisco-49ers,660150,2013
35771,405000,249396,Vance McDonald,TE,active,san-francisco-49ers,654396,2013
35772,630000,0,Colt McCoy,QB,active,san-francisco-49ers,630000,2013
35773,555000,40075,Daniel Kilgore,C,active,san-francisco-49ers,595075,2013
35774,480000,106301,Joe Looney,G,active,san-francisco-49ers,586301,2013
35775,555000,15613,Bruce Miller,FB,active,san-francisco-49ers,570613,2013
35776,405000,135880,Corey Lemonier,OLB,active,san-francisco-49ers,540880,2013
35777,522353,4166,Demarcus Dobbs,DE,active,san-francisco-49ers,526519,2013
35778,522648,0,Eric Wright,CB,active,san-francisco-49ers,522648,2013
35779,940000,0,Kassim Osgood,WR,active,san-francisco-49ers,940000,2013
35780,405000,97875,Quinton Patton,WR,active,san-francisco-49ers,502875,2013
35781,480000,2000,Garrett Celek,TE,active,san-francisco-49ers,482000,2013
35782,480000,0,Michael Wilhoite,ILB,active,san-francisco-49ers,480000,2013
35783,405000,45413,Quinton Dial,DT,active,san-francisco-49ers,450413,2013
35784,405000,26918,Nick Moody,ILB,active,san-francisco-49ers,431918,2013
35785,405000,1666,Kevin McDermott,LS,active,san-francisco-49ers,406666,2013
35786,405000,0,Tony Jerod-Eddie,DE,active,san-francisco-49ers,405000,2013
35787,405000,0,Darryl Morris,CB,active,san-francisco-49ers,405000,2013
35788,288000,1000,Lawrence Okoye,DT,active,san-francisco-49ers,289000,2013
35789,405000,0,Derek Carrier,TE,active,san-francisco-49ers,405000,2013
35790,405000,0,Ryan Seymour,G,active,san-francisco-49ers,405000,2013
35791,1800000,1000000,Mario Manningham,WR,injured_reserve,san-francisco-49ers,2800000,2013
35792,555000,333333,Ian Williams,DT,injured_reserve,san-francisco-49ers,888333,2013
35793,303000,41200,Darius Fleming,OLB,injured_reserve,san-francisco-49ers,344200,2013
35794,288000,1666,Alex Debniak,FB,injured_reserve,san-francisco-49ers,289666,2013
35795,288000,0,Brandon Carswell,WR,injured_reserve,san-francisco-49ers,288000,2013
35796,405000,75146,Marcus Lattimore,RB,non_fb_injury,san-francisco-49ers,480146,2013
35797,288000,1666,Luke Marquardt,RT,non_fb_injury,san-francisco-49ers,289666,2013
35798,214412,0,Nathan Stupar,OLB,practice_squad,san-francisco-49ers,214412,2013
35799,84000,0,Michael Thomas,FS,practice_squad,san-francisco-49ers,84000,2013
35800,60000,0,Derek Carrier,TE,practice_squad,san-francisco-49ers,60000,2013
35801,60000,0,D'Aundre Reed,DE,practice_squad,san-francisco-49ers,60000,2013
35802,30000,0,Patrick Omameh,G,practice_squad,san-francisco-49ers,30000,2013
35803,18000,0,Darryl Morris,CB,practice_squad,san-francisco-49ers,18000,2013
35804,1268750,0,Nnamdi Asomugha,CB,dead_cap,san-francisco-49ers,1268750,2013
35805,873188,0,A.J.  Jenkins,WR,dead_cap,san-francisco-49ers,873188,2013
35806,566668,0,David Akers,K,dead_cap,san-francisco-49ers,566668,2013
35807,390427,0,Kyle Williams,WR,dead_cap,san-francisco-49ers,390427,2013
35808,333529,0,Marlon Moore,WR,dead_cap,san-francisco-49ers,333529,2013
35809,326471,0,Perrish Cox,CB,dead_cap,san-francisco-49ers,326471,2013
35810,228529,0,Will Tukuafu,FB,dead_cap,san-francisco-49ers,228529,2013
35811,221000,0,Brian Jennings,LS,dead_cap,san-francisco-49ers,221000,2013
35812,197647,0,McLeod Bethel-Thompson,QB,dead_cap,san-francisco-49ers,197647,2013
35813,175000,0,Josh Johnson,QB,dead_cap,san-francisco-49ers,175000,2013
35814,148235,0,Jermaine Cunningham,DE,dead_cap,san-francisco-49ers,148235,2013
35815,106922,0,B.J. Daniels,WR,dead_cap,san-francisco-49ers,106922,2013
35816,74118,0,John Skelton,QB,dead_cap,san-francisco-49ers,74118,2013
35817,0,69384,Jason Slowey,C,dead_cap,san-francisco-49ers,69384,2013
35818,65294,0,Owen Marecic,FB,dead_cap,san-francisco-49ers,65294,2013
35819,35361,0,Cam Johnson,OLB,dead_cap,san-francisco-49ers,35361,2013
35820,0,27625,Trenton Robinson,FS,dead_cap,san-francisco-49ers,27625,2013
35821,26550,0,Nate Byham,TE,dead_cap,san-francisco-49ers,26550,2013
35822,0,22950,Curtis Holcomb,CB,dead_cap,san-francisco-49ers,22950,2013
35823,22950,0,Michael Person,G,dead_cap,san-francisco-49ers,22950,2013
35824,11474,0,Carter Bykowski,LT,dead_cap,san-francisco-49ers,11474,2013
35825,11474,0,Marcus Cooper,CB,dead_cap,san-francisco-49ers,11474,2013
35826,6667,0,Nathan Palmer,WR,dead_cap,san-francisco-49ers,6667,2013
35827,5334,0,Brian Tyms,WR,dead_cap,san-francisco-49ers,5334,2013
35828,5000,0,Ricardo Lockette,WR,dead_cap,san-francisco-49ers,5000,2013
35829,5000,0,Al Netter,RT,dead_cap,san-francisco-49ers,5000,2013
35830,3332,0,Matthew Masifilo,G,dead_cap,san-francisco-49ers,3332,2013
35831,2667,0,Lowell Rose,CB,dead_cap,san-francisco-49ers,2667,2013
35832,2667,0,Michael Thomas,FS,dead_cap,san-francisco-49ers,2667,2013
35833,2666,0,Darryl Morris,CB,dead_cap,san-francisco-49ers,2666,2013
35834,2332,0,Joe Holland,OLB,dead_cap,san-francisco-49ers,2332,2013
35835,2000,0,Kourtnei Brown,OLB,dead_cap,san-francisco-49ers,2000,2013
35836,2000,0,Tony Jerod-Eddie,DE,dead_cap,san-francisco-49ers,2000,2013
35837,2000,0,Anthony Mosley,CB,dead_cap,san-francisco-49ers,2000,2013
35838,2000,0,Chris Owusu,WR,dead_cap,san-francisco-49ers,2000,2013
35839,1666,0,Jewel Hampton,RB,dead_cap,san-francisco-49ers,1666,2013
35840,1333,0,Sherman Carter,C,dead_cap,san-francisco-49ers,1333,2013
35841,1333,0,MarQueis Gray,TE,dead_cap,san-francisco-49ers,1333,2013
35842,1000,0,D.J. Harper,RB,dead_cap,san-francisco-49ers,1000,2013
35843,1000,0,Patrick Omameh,G,dead_cap,san-francisco-49ers,1000,2013
35844,1000,0,Mike Purcell,DT,dead_cap,san-francisco-49ers,1000,2013
35845,667,0,Cameron Bell,RB,dead_cap,san-francisco-49ers,667,2013
35846,667,0,Patrick Butrym,DT,dead_cap,san-francisco-49ers,667,2013
35847,667,0,David Gonzales,G,dead_cap,san-francisco-49ers,667,2013
35848,333,0,Chuck Jacobs,WR,dead_cap,san-francisco-49ers,333,2013
35849,1845600,7386666,Anthony Davis,RT,active,san-francisco-49ers,9232266,2014
35850,4700000,2667916,Vernon Davis,TE,active,san-francisco-49ers,7367916,2014
35851,3150000,3786666,Justin Smith,DE,active,san-francisco-49ers,6936666,2014
35852,3300000,3150000,Frank Gore,RB,active,san-francisco-49ers,6450000,2014
35853,3500000,1270443,Michael Crabtree,WR,active,san-francisco-49ers,4770443,2014
35854,2970500,2742863,Mike Iupati,G,active,san-francisco-49ers,5713363,2014
35855,855000,3648750,Ahmad Brooks,OLB,active,san-francisco-49ers,4503750,2014
35856,2300000,2184166,Glenn Dorsey,DE,active,san-francisco-49ers,4484166,2014
35857,730000,4504000,Navorro Bowman,ILB,active,san-francisco-49ers,5234000,2014
35858,3650000,275000,Stevie Johnson,WR,active,san-francisco-49ers,3925000,2014
35859,645000,3122444,Colin Kaepernick,QB,active,san-francisco-49ers,3767444,2014
35860,2700000,700000,Joe Staley,LT,active,san-francisco-49ers,3400000,2014
35861,2336454,2240273,Aldon Smith,OLB,active,san-francisco-49ers,4576727,2014
35862,1250000,1750000,Antoine Bethea,SS,active,san-francisco-49ers,3000000,2014
35863,2600000,390000,Alex Boone,G,active,san-francisco-49ers,2990000,2014
35864,1900000,500000,Andy Lee,P,active,san-francisco-49ers,2400000,2014
35865,955000,1409000,Anquan Boldin,WR,active,san-francisco-49ers,2364000,2014
35866,2011587,0,Blaine Gabbert,QB,active,san-francisco-49ers,2011587,2014
35867,1000000,1000000,Phil Dawson,K,active,san-francisco-49ers,2000000,2014
35868,800000,1200000,Tramaine Brock,CB,active,san-francisco-49ers,2000000,2014
35869,790489,1136955,Eric Reid,SS,active,san-francisco-49ers,1927444,2014
35870,1300000,350000,Dan Skuta,OLB,active,san-francisco-49ers,1650000,2014
35871,1431000,149719,Chris Culliver,CB,active,san-francisco-49ers,1580719,2014
35872,420000,873188,Jimmie Ward,FS,active,san-francisco-49ers,1293188,2014
35873,825000,458333,Craig Dahl,SS,active,san-francisco-49ers,1283333,2014
35874,579895,544578,Cornellius Carradine,DE,active,san-francisco-49ers,1124473,2014
35875,645000,462114,Bruce Miller,FB,active,san-francisco-49ers,1107114,2014
35876,645000,377575,Daniel Kilgore,C,active,san-francisco-49ers,1022575,2014
35877,955000,50000,Brandon Lloyd,WR,active,san-francisco-49ers,1005000,2014
35878,824933,0,Jonathan Martin,RT,active,san-francisco-49ers,824933,2014
35879,518599,299396,Vance McDonald,TE,active,san-francisco-49ers,817995,2014
35880,645000,159805,Kendall Hunter,RB,active,san-francisco-49ers,804805,2014
35881,645000,50000,Perrish Cox,CB,active,san-francisco-49ers,695000,2014
35882,570000,106301,Joe Looney,G,active,san-francisco-49ers,676301,2014
35883,420000,249396,Carlos Hyde,RB,active,san-francisco-49ers,669396,2014
35884,505000,135880,Corey Lemonier,OLB,active,san-francisco-49ers,640880,2014
35885,495000,97875,Quinton Patton,WR,active,san-francisco-49ers,592875,2014
35886,420000,167812,Marcus Martin,G,active,san-francisco-49ers,587812,2014
35887,570000,2000,Garrett Celek,TE,active,san-francisco-49ers,572000,2014
35888,730000,0,Chris Cook,CB,active,san-francisco-49ers,730000,2014
35889,570000,0,Kyle Nelson,LS,active,san-francisco-49ers,570000,2014
35890,570000,0,Michael Wilhoite,ILB,active,san-francisco-49ers,570000,2014
35891,495000,45413,Quinton Dial,DT,active,san-francisco-49ers,540413,2014
35892,420000,118607,Bruce Ellington,WR,active,san-francisco-49ers,538607,2014
35893,495000,26918,Nick Moody,ILB,active,san-francisco-49ers,521918,2014
35894,420000,100136,Dontae Johnson,CB,active,san-francisco-49ers,520136,2014
35895,495000,0,Derek Carrier,TE,active,san-francisco-49ers,495000,2014
35896,495000,0,Tony Jerod-Eddie,DE,active,san-francisco-49ers,495000,2014
35897,420000,49500,Aaron Lynch,DE,active,san-francisco-49ers,469500,2014
35898,420000,2000,L.J. McCray,SS,active,san-francisco-49ers,422000,2014
35899,420000,1666,Dillon Farrell,C,active,san-francisco-49ers,421666,2014
35900,730000,0,Josh Johnson,QB,active,san-francisco-49ers,730000,2014
35901,303000,30150,Kenneth Acker,CB,active,san-francisco-49ers,333150,2014
35902,645000,0,Alfonso Smith,RB,active,san-francisco-49ers,645000,2014
35903,495000,0,Leon McFadden,CB,active,san-francisco-49ers,495000,2014
35904,420000,0,Asante Cleveland,TE,active,san-francisco-49ers,420000,2014
35905,645000,0,Phillip Tanner,RB,active,san-francisco-49ers,645000,2014
35906,420000,0,Marcus Cromartie,CB,active,san-francisco-49ers,420000,2014
35907,420000,0,Andrew Tiller,G,active,san-francisco-49ers,420000,2014
35908,730000,0,Desmond Bishop,OLB,active,san-francisco-49ers,730000,2014
35909,420000,0,Mike Purcell,DT,active,san-francisco-49ers,420000,2014
35910,420000,0,Chase Thomas,OLB,active,san-francisco-49ers,420000,2014
35911,570000,0,Trindon Holliday,KR,active,san-francisco-49ers,570000,2014
35912,420000,0,Cameron Fuller,CB,active,san-francisco-49ers,420000,2014
35913,5285000,1578000,Patrick Willis,ILB,injured_reserve,san-francisco-49ers,6863000,2014
35914,950000,333333,Ian Williams,DT,injured_reserve,san-francisco-49ers,1283333,2014
35915,420000,154359,Chris Borland,OLB,injured_reserve,san-francisco-49ers,574359,2014
35916,955000,0,Kassim Osgood,WR,injured_reserve,san-francisco-49ers,955000,2014
35917,855000,0,Raymond Ventrone,S,injured_reserve,san-francisco-49ers,855000,2014
35918,303000,1666,Fou Fonoti,RT,injured_reserve,san-francisco-49ers,304666,2014
35919,303000,0,Chuck Jacobs,WR,injured_reserve,san-francisco-49ers,303000,2014
35920,420000,126504,Brandon Thomas,G,non_fb_injury,san-francisco-49ers,546504,2014
35921,420000,41200,Keith Reaser,CB,non_fb_injury,san-francisco-49ers,461200,2014
35922,420000,11787,Trey Millard,FB,non_fb_injury,san-francisco-49ers,431787,2014
35923,107100,0,Kendall Gaskins,FB,practice_squad,san-francisco-49ers,107100,2014
35924,107100,0,Lance Lewis,WR,practice_squad,san-francisco-49ers,107100,2014
35925,107100,0,Lawrence Okoye,DT,practice_squad,san-francisco-49ers,107100,2014
35926,44100,0,Shayne Skov,ILB,practice_squad,san-francisco-49ers,44100,2014
35927,18900,0,Chris Martin,RT,practice_squad,san-francisco-49ers,18900,2014
35928,12600,0,Xavier Grimble,TE,practice_squad,san-francisco-49ers,12600,2014
35929,6300,0,Garrison Smith,DE,practice_squad,san-francisco-49ers,6300,2014
35930,855000,2984735,Ray McDonald,DT,dead_cap,san-francisco-49ers,3839735,2014
35931,1746376,0,A.J.  Jenkins,WR,dead_cap,san-francisco-49ers,1746376,2014
35932,1494531,0,Carlos Rogers,CB,dead_cap,san-francisco-49ers,1494531,2014
35933,757588,0,Demarcus Dobbs,DE,dead_cap,san-francisco-49ers,757588,2014
35934,0,333334,C.J. Spillman,S,dead_cap,san-francisco-49ers,333334,2014
35935,303000,1666,Luke Marquardt,RT,dead_cap,san-francisco-49ers,304666,2014
35936,37748,263436,LaMichael James,RB,dead_cap,san-francisco-49ers,301184,2014
35937,0,250000,Adam Snyder,G,dead_cap,san-francisco-49ers,250000,2014
35938,234705,0,Josh Johnson,QB,dead_cap,san-francisco-49ers,234705,2014
35939,114353,75146,Marcus Lattimore,RB,dead_cap,san-francisco-49ers,189499,2014
35940,167646,0,Kassim Osgood,WR,dead_cap,san-francisco-49ers,167646,2014
35941,143418,0,Chase Thomas,OLB,dead_cap,san-francisco-49ers,143418,2014
35942,122622,0,Carter Bykowski,LT,dead_cap,san-francisco-49ers,122622,2014
35943,113824,0,Will Tukuafu,FB,dead_cap,san-francisco-49ers,113824,2014
35944,100588,0,Raymond Ventrone,S,dead_cap,san-francisco-49ers,100588,2014
35945,94006,2666,Asante Cleveland,TE,dead_cap,san-francisco-49ers,96672,2014
35946,96500,0,Mike Purcell,DT,dead_cap,san-francisco-49ers,96500,2014
35947,82400,0,Darius Fleming,OLB,dead_cap,san-francisco-49ers,82400,2014
35948,56700,0,Xavier Grimble,TE,dead_cap,san-francisco-49ers,56700,2014
35949,56700,0,Andrew Tiller,G,dead_cap,san-francisco-49ers,56700,2014
35950,0,55250,Trenton Robinson,FS,dead_cap,san-francisco-49ers,55250,2014
35951,50400,0,Chance Casey,CB,dead_cap,san-francisco-49ers,50400,2014
35952,37800,0,Leon McFadden,CB,dead_cap,san-francisco-49ers,37800,2014
35953,34884,0,B.J. Daniels,WR,dead_cap,san-francisco-49ers,34884,2014
35954,34422,0,Marcus Cooper,CB,dead_cap,san-francisco-49ers,34422,2014
35955,31500,0,John Fullington,G,dead_cap,san-francisco-49ers,31500,2014
35956,18900,0,Marcus Cromartie,CB,dead_cap,san-francisco-49ers,18900,2014
35957,15100,2500,Shayne Skov,ILB,dead_cap,san-francisco-49ers,17600,2014
35958,0,7500,Morgan Breslin,DE,dead_cap,san-francisco-49ers,7500,2014
35959,6300,0,Cameron Fuller,CB,dead_cap,san-francisco-49ers,6300,2014
35960,5334,0,Darryl Morris,CB,dead_cap,san-francisco-49ers,5334,2014
35961,5334,0,Lowell Rose,CB,dead_cap,san-francisco-49ers,5334,2014
35962,5000,0,Ricardo Lockette,WR,dead_cap,san-francisco-49ers,5000,2014
35963,3334,0,Alex Debniak,FB,dead_cap,san-francisco-49ers,3334,2014
35964,2667,0,Sherman Carter,C,dead_cap,san-francisco-49ers,2667,2014
35965,2667,0,MarQueis Gray,TE,dead_cap,san-francisco-49ers,2667,2014
35966,2000,0,D.J. Harper,RB,dead_cap,san-francisco-49ers,2000,2014
35967,2000,0,Patrick Omameh,G,dead_cap,san-francisco-49ers,2000,2014
35968,1668,0,Jewel Hampton,RB,dead_cap,san-francisco-49ers,1668,2014
35969,0,1666,Fou Fonoti,RT,dead_cap,san-francisco-49ers,1666,2014
35970,0,1666,Kevin McDermott,LS,dead_cap,san-francisco-49ers,1666,2014
35971,0,1000,Kory Faulkner,QB,dead_cap,san-francisco-49ers,1000,2014
35972,0,1000,Lawrence Okoye,DT,dead_cap,san-francisco-49ers,1000,2014
35973,667,0,Chuck Jacobs,WR,dead_cap,san-francisco-49ers,667,2014
35974,4700000,3754000,Navorro Bowman,ILB,active,san-francisco-49ers,8454000,2015
35975,4500000,3100000,Joe Staley,LT,active,san-francisco-49ers,7600000,2015
35976,3500000,3555000,Ahmad Brooks,OLB,active,san-francisco-49ers,7055000,2015
35977,5500000,1409000,Anquan Boldin,WR,active,san-francisco-49ers,6909000,2015
35978,3134000,1000000,Phil Dawson,K,active,san-francisco-49ers,4134000,2015
35979,750000,2850000,Torrey Smith,WR,active,san-francisco-49ers,3600000,2015
35980,1450000,1900000,Erik Pears,RT,active,san-francisco-49ers,3350000,2015
35981,1850000,940000,Tramaine Brock,CB,active,san-francisco-49ers,2790000,2015
35982,1175976,1136955,Eric Reid,SS,active,san-francisco-49ers,2312931,2015
35983,800000,1075000,Daniel Kilgore,C,active,san-francisco-49ers,1875000,2015
35984,435000,1354569,Arik Armstead,DE,active,san-francisco-49ers,1789569,2015
35985,1450000,300000,Blaine Gabbert,QB,active,san-francisco-49ers,1750000,2015
35986,1100000,646500,Bruce Miller,FB,active,san-francisco-49ers,1746500,2015
35987,743297,873188,Jimmie Ward,FS,active,san-francisco-49ers,1616485,2015
35988,1000000,495834,Ian Williams,DT,active,san-francisco-49ers,1495834,2015
35989,804789,544578,Cornellius Carradine,DE,active,san-francisco-49ers,1349367,2015
35990,750000,420000,Nick Bellore,ILB,active,san-francisco-49ers,1170000,2015
35991,632198,349396,Vance McDonald,TE,active,san-francisco-49ers,981594,2015
35992,435000,480821,Jaquiski Tartt,FS,active,san-francisco-49ers,915821,2015
35993,660000,150000,Kyle Nelson,LS,active,san-francisco-49ers,810000,2015
35994,595000,135880,Corey Lemonier,OLB,active,san-francisco-49ers,730880,2015
35995,525000,187812,Marcus Martin,G,active,san-francisco-49ers,712812,2015
35996,585000,97875,Quinton Patton,WR,active,san-francisco-49ers,682875,2015
35997,510000,126504,Brandon Thomas,G,active,san-francisco-49ers,636504,2015
35998,585000,45413,Quinton Dial,DT,active,san-francisco-49ers,630413,2015
35999,510000,118607,Bruce Ellington,WR,active,san-francisco-49ers,628607,2015
36000,510000,100136,Dontae Johnson,CB,active,san-francisco-49ers,610136,2015
36001,435000,174343,Eli Harold,OLB,active,san-francisco-49ers,609343,2015
36002,585000,0,Tony Jerod-Eddie,DE,active,san-francisco-49ers,585000,2015
36003,435000,126283,Blake Bell,TE,active,san-francisco-49ers,561283,2015
36004,510000,49500,Aaron Lynch,DE,active,san-francisco-49ers,559500,2015
36005,482058,50000,Jerome Simpson,WR,active,san-francisco-49ers,532058,2015
36006,510000,0,Jordan Devey,G,active,san-francisco-49ers,510000,2015
36007,435000,48550,Bradley Pinion,P,active,san-francisco-49ers,483550,2015
36008,435000,41200,Keith Reaser,CB,active,san-francisco-49ers,476200,2015
36009,435000,30419,Ian Silberman,G,active,san-francisco-49ers,465419,2015
36010,435000,30150,Kenneth Acker,CB,active,san-francisco-49ers,465150,2015
36011,435000,13973,Trenton Brown,RT,active,san-francisco-49ers,448973,2015
36012,447353,0,Gerald Hodges,OLB,active,san-francisco-49ers,447353,2015
36013,435000,2333,DeAndre White,WR,active,san-francisco-49ers,437333,2015
36014,435000,0,Mike Purcell,DT,active,san-francisco-49ers,435000,2015
36015,390000,0,Andrew Tiller,G,active,san-francisco-49ers,390000,2015
36016,318000,13195,Rory Anderson,TE,active,san-francisco-49ers,331195,2015
36017,318000,2000,Dres Anderson,WR,active,san-francisco-49ers,320000,2015
36018,270000,0,Marcus Cromartie,CB,active,san-francisco-49ers,270000,2015
36019,270000,0,Chris Davis,CB,active,san-francisco-49ers,270000,2015
36020,255882,0,Kendall Gaskins,FB,active,san-francisco-49ers,255882,2015
36021,206470,0,Ray-Ray Armstrong,OLB,active,san-francisco-49ers,206470,2015
36022,179117,0,Dylan Thompson,QB,active,san-francisco-49ers,179117,2015
36023,120000,0,Brian Leonhardt,TE,active,san-francisco-49ers,120000,2015
36024,102352,0,Shayne Skov,ILB,active,san-francisco-49ers,102352,2015
36025,77647,0,DuJuan Harris,RB,active,san-francisco-49ers,77647,2015
36026,51176,0,Jarryd Hayne,RB,active,san-francisco-49ers,51176,2015
36027,25588,0,Je'Ron Hamm,WR,active,san-francisco-49ers,25588,2015
36028,10400000,4865753,Colin Kaepernick,QB,injured_reserve,san-francisco-49ers,15265753,2015
36029,3000000,1750000,Antoine Bethea,SS,injured_reserve,san-francisco-49ers,4750000,2015
36030,3400000,323000,Alex Boone,G,injured_reserve,san-francisco-49ers,3723000,2015
36031,1600000,806250,Reggie Bush,RB,injured_reserve,san-francisco-49ers,2406250,2015
36032,1500000,841666,Glenn Dorsey,DE,injured_reserve,san-francisco-49ers,2341666,2015
36033,537349,299396,Carlos Hyde,RB,injured_reserve,san-francisco-49ers,836745,2015
36034,660000,50000,Garrett Celek,TE,injured_reserve,san-francisco-49ers,710000,2015
36035,660000,0,Michael Wilhoite,ILB,injured_reserve,san-francisco-49ers,660000,2015
36036,435000,117195,Mike Davis,RB,injured_reserve,san-francisco-49ers,552195,2015
36037,416294,2000,L.J. McCray,SS,injured_reserve,san-francisco-49ers,418294,2015
36038,349411,0,Shaun Draughn,RB,injured_reserve,san-francisco-49ers,349411,2015
36039,0,5965707,Ray McDonald,DT,dead_cap,san-francisco-49ers,5965707,2015
36040,2047058,2442920,Vernon Davis,TE,dead_cap,san-francisco-49ers,4489978,2015
36041,0,5066668,Anthony Davis,RT,dead_cap,san-francisco-49ers,5066668,2015
36042,850000,1750000,Shareece Wright,CB,dead_cap,san-francisco-49ers,2600000,2015
36043,2000000,500000,Darnell Dockett,DE,dead_cap,san-francisco-49ers,2500000,2015
36044,0,2186668,Justin Smith,DE,dead_cap,san-francisco-49ers,2186668,2015
36045,0,1600000,Aldon Smith,OLB,dead_cap,san-francisco-49ers,1600000,2015
36046,1494531,0,Carlos Rogers,CB,dead_cap,san-francisco-49ers,1494531,2015
36047,450000,483334,Craig Dahl,SS,dead_cap,san-francisco-49ers,933334,2015
36048,0,843500,Patrick Willis,ILB,dead_cap,san-francisco-49ers,843500,2015
36049,500000,200000,Chris Cook,CB,dead_cap,san-francisco-49ers,700000,2015
36050,0,500000,Andy Lee,P,dead_cap,san-francisco-49ers,500000,2015
36051,0,463077,Chris Borland,OLB,dead_cap,san-francisco-49ers,463077,2015
36052,307058,5000,Shayne Skov,ILB,dead_cap,san-francisco-49ers,312058,2015
36053,232941,0,Travaris Cadet,RB,dead_cap,san-francisco-49ers,232941,2015
36054,225317,2666,Jarryd Hayne,RB,dead_cap,san-francisco-49ers,227983,2015
36055,0,213436,LaMichael James,RB,dead_cap,san-francisco-49ers,213436,2015
36056,0,150292,Marcus Lattimore,RB,dead_cap,san-francisco-49ers,150292,2015
36057,0,133333,Derek Carrier,TE,dead_cap,san-francisco-49ers,133333,2015
36058,112200,12050,Kaleb Ramsey,DT,dead_cap,san-francisco-49ers,124250,2015
36059,117200,3333,Marcus Rush,OLB,dead_cap,san-francisco-49ers,120533,2015
36060,38823,75000,Kendall Hunter,RB,dead_cap,san-francisco-49ers,113823,2015
36061,112200,833,DiAndre Campbell,WR,dead_cap,san-francisco-49ers,113033,2015
36062,112200,0,Garrison Smith,DE,dead_cap,san-francisco-49ers,112200,2015
36063,106500,2500,Jermaine Whitehead,FS,dead_cap,san-francisco-49ers,109000,2015
36064,0,106301,Joe Looney,G,dead_cap,san-francisco-49ers,106301,2015
36065,102352,0,Nick Easton,C,dead_cap,san-francisco-49ers,102352,2015
36066,76000,3333,Dylan Thompson,QB,dead_cap,san-francisco-49ers,79333,2015
36067,51000,10202,Lawrence Okoye,DT,dead_cap,san-francisco-49ers,61202,2015
36068,56118,0,Ben Gottschalk,RT,dead_cap,san-francisco-49ers,56118,2015
36069,52800,0,Marcus Cromartie,CB,dead_cap,san-francisco-49ers,52800,2015
36070,46200,0,Kendall Gaskins,FB,dead_cap,san-francisco-49ers,46200,2015
36071,39600,0,McLeod Bethel-Thompson,QB,dead_cap,san-francisco-49ers,39600,2015
36072,51176,0,Pierre Thomas,RB,dead_cap,san-francisco-49ers,51176,2015
36073,33000,0,Jamie Childers,TE,dead_cap,san-francisco-49ers,33000,2015
36074,33000,0,Brian Folkerts,C,dead_cap,san-francisco-49ers,33000,2015
36075,33000,0,Tanner Hawkinson,G,dead_cap,san-francisco-49ers,33000,2015
36076,33000,0,Andrew Tiller,G,dead_cap,san-francisco-49ers,33000,2015
36077,33000,0,Andrew Turzilli,WR,dead_cap,san-francisco-49ers,33000,2015
36078,0,26918,Nick Moody,ILB,dead_cap,san-francisco-49ers,26918,2015
36079,10000,3333,Issac Blakeney,WR,dead_cap,san-francisco-49ers,13333,2015
36080,0,11787,Trey Millard,FB,dead_cap,san-francisco-49ers,11787,2015
36081,10000,0,Xavier Grimble,TE,dead_cap,san-francisco-49ers,10000,2015
36082,6600,0,Chris Davis,CB,dead_cap,san-francisco-49ers,6600,2015
36083,6600,0,Kyle Sebetic,CB,dead_cap,san-francisco-49ers,6600,2015
36084,6600,0,Kevin Snyder,ILB,dead_cap,san-francisco-49ers,6600,2015
36085,0,5334,Asante Cleveland,TE,dead_cap,san-francisco-49ers,5334,2015
36086,0,3334,Fou Fonoti,RT,dead_cap,san-francisco-49ers,3334,2015
36087,0,2000,Kory Faulkner,QB,dead_cap,san-francisco-49ers,2000,2015
36088,0,1668,Luke Marquardt,RT,dead_cap,san-francisco-49ers,1668,2015
36089,0,1668,Kevin McDermott,LS,dead_cap,san-francisco-49ers,1668,2015
36090,0,1666,Dillon Farrell,C,dead_cap,san-francisco-49ers,1666,2015
36091,0,1666,Patrick Miller,T,dead_cap,san-francisco-49ers,1666,2015
36092,0,1000,Darius Davis,WR,dead_cap,san-francisco-49ers,1000,2015
36093,11900000,4865753,Colin Kaepernick,QB,active,san-francisco-49ers,16765753,2016
36094,5400000,2900000,Joe Staley,LT,active,san-francisco-49ers,8300000,2016
36095,4900000,3105000,Ahmad Brooks,OLB,active,san-francisco-49ers,8005000,2016
36096,4500000,1525000,Antoine Bethea,SS,active,san-francisco-49ers,6025000,2016
36097,2700000,1180000,Tramaine Brock,CB,active,san-francisco-49ers,3880000,2016
36098,450000,2857453,DeForest Buckner,DT,active,san-francisco-49ers,3307453,2016
36099,3134000,0,Phil Dawson,K,active,san-francisco-49ers,3134000,2016
36100,1800000,966668,Glenn Dorsey,DE,active,san-francisco-49ers,2766668,2016
36101,1050000,1583333,Zane Beadles,G,active,san-francisco-49ers,2633333,2016
36102,1750000,550000,Blaine Gabbert,QB,active,san-francisco-49ers,2300000,2016
36103,1029684,1169578,Cornellius Carradine,DE,active,san-francisco-49ers,2199262,2016
36104,1000000,915625,Garrett Celek,TE,active,san-francisco-49ers,1915625,2016
36105,450000,1241693,Joshua Garnett,G,active,san-francisco-49ers,1691693,2016
36106,1671000,0,Gerald Hodges,OLB,active,san-francisco-49ers,1671000,2016
36107,1671000,0,Michael Wilhoite,ILB,active,san-francisco-49ers,1671000,2016
36108,675000,852163,Quinton Dial,DT,active,san-francisco-49ers,1527163,2016
36109,663955,480821,Jaquiski Tartt,FS,active,san-francisco-49ers,1144776,2016
36110,800000,200000,Tony Jerod-Eddie,DE,active,san-francisco-49ers,1000000,2016
36111,795000,175000,Kyle Nelson,LS,active,san-francisco-49ers,970000,2016
36112,760000,100000,Shaun Draughn,RB,active,san-francisco-49ers,860000,2016
36113,760000,40000,Christian Ponder,QB,active,san-francisco-49ers,800000,2016
36114,760000,0,Jeremy Kerley,WR,active,san-francisco-49ers,760000,2016
36115,760000,0,Rod Streater,WR,active,san-francisco-49ers,760000,2016
36116,540000,189343,Eli Harold,OLB,active,san-francisco-49ers,729343,2016
36117,600000,100136,Dontae Johnson,CB,active,san-francisco-49ers,700136,2016
36118,525000,117195,Mike Davis,RB,active,san-francisco-49ers,642195,2016
36119,600000,41200,Keith Reaser,CB,active,san-francisco-49ers,641200,2016
36120,600000,0,Marcus Cromartie,CB,active,san-francisco-49ers,600000,2016
36121,600000,0,Andrew Tiller,G,active,san-francisco-49ers,600000,2016
36122,525000,48550,Bradley Pinion,P,active,san-francisco-49ers,573550,2016
36123,450000,95848,Rashard Robinson,CB,active,san-francisco-49ers,545848,2016
36124,525000,13973,Trenton Brown,RT,active,san-francisco-49ers,538973,2016
36125,525000,0,Mike Purcell,DT,active,san-francisco-49ers,525000,2016
36126,450000,67601,Ronald Blair,DE,active,san-francisco-49ers,517601,2016
36127,450000,64403,John Theus,T,active,san-francisco-49ers,514403,2016
36128,458823,49500,Aaron Lynch,DE,active,san-francisco-49ers,508323,2016
36129,491764,0,DuJuan Harris,RB,active,san-francisco-49ers,491764,2016
36130,450000,25089,Aaron Burbridge,WR,active,san-francisco-49ers,475089,2016
36131,432348,0,Je'Ron Hamm,WR,active,san-francisco-49ers,432348,2016
36132,317647,0,Chris Jones,DT,active,san-francisco-49ers,317647,2016
36133,317640,6,JaCorey Shepherd,CB,active,san-francisco-49ers,317646,2016
36134,247056,0,Chris Harper,WR,active,san-francisco-49ers,247056,2016
36135,211764,0,Vinnie Sunseri,SS,active,san-francisco-49ers,211764,2016
36136,154411,0,Marcus Ball,FS,active,san-francisco-49ers,154411,2016
36137,89411,0,Jim Dray,TE,active,san-francisco-49ers,89411,2016
36138,89411,0,Andrew Gardner,G,active,san-francisco-49ers,89411,2016
36139,79410,0,Alex Balducci,G,active,san-francisco-49ers,79410,2016
36140,70588,0,Carl Bradford,OLB,active,san-francisco-49ers,70588,2016
36141,52940,0,Prince Charles Iworah,CB,active,san-francisco-49ers,52940,2016
36142,52940,0,Wynton McManis,OLB,active,san-francisco-49ers,52940,2016
36143,52940,0,DeAndre Smelter,WR,active,san-francisco-49ers,52940,2016
36144,30882,0,Zach Moore,DE,active,san-francisco-49ers,30882,2016
36145,30882,0,Raheem Mostert,RB,active,san-francisco-49ers,30882,2016
36146,5850000,5184000,Navorro Bowman,ILB,injured_reserve,san-francisco-49ers,11034000,2016
36147,4500000,3100000,Torrey Smith,WR,injured_reserve,san-francisco-49ers,7600000,2016
36148,1561464,1136955,Eric Reid,SS,injured_reserve,san-francisco-49ers,2698419,2016
36149,795797,1749396,Vance McDonald,TE,injured_reserve,san-francisco-49ers,2545193,2016
36150,882392,1354569,Arik Armstead,DE,injured_reserve,san-francisco-49ers,2236961,2016
36151,1066594,873188,Jimmie Ward,FS,injured_reserve,san-francisco-49ers,1939782,2016
36152,900000,450000,Daniel Kilgore,C,injured_reserve,san-francisco-49ers,1350000,2016
36153,760000,370000,Nick Bellore,ILB,injured_reserve,san-francisco-49ers,1130000,2016
36154,654698,349396,Carlos Hyde,RB,injured_reserve,san-francisco-49ers,1004094,2016
36155,675000,191666,Ray-Ray Armstrong,OLB,injured_reserve,san-francisco-49ers,866666,2016
36156,635000,187812,Marcus Martin,G,injured_reserve,san-francisco-49ers,822812,2016
36157,675000,97875,Quinton Patton,WR,injured_reserve,san-francisco-49ers,772875,2016
36158,600000,118607,Bruce Ellington,WR,injured_reserve,san-francisco-49ers,718607,2016
36159,450000,218139,Will Redmond,CB,injured_reserve,san-francisco-49ers,668139,2016
36160,525000,126283,Blake Bell,TE,injured_reserve,san-francisco-49ers,651283,2016
36161,463235,0,Shayne Skov,ILB,injured_reserve,san-francisco-49ers,463235,2016
36162,432705,0,Chris Davis,CB,injured_reserve,san-francisco-49ers,432705,2016
36163,333000,87500,Eric Rogers,WR,injured_reserve,san-francisco-49ers,420500,2016
36164,428000,0,Thaddeus Lewis,QB,injured_reserve,san-francisco-49ers,428000,2016
36165,20700,0,Mitchell Van Dyk,LT,practice_squad,san-francisco-49ers,20700,2016
36166,13800,0,DiAndre Campbell,WR,practice_squad,san-francisco-49ers,13800,2016
36167,1225000,3000000,Anthony Davis,RT,dead_cap,san-francisco-49ers,4225000,2016
36168,0,2727000,Anquan Boldin,WR,dead_cap,san-francisco-49ers,2727000,2016
36169,1000000,0,Ian Williams,DT,dead_cap,san-francisco-49ers,1000000,2016
36170,0,500000,Andy Lee,P,dead_cap,san-francisco-49ers,500000,2016
36171,0,500000,Erik Pears,RT,dead_cap,san-francisco-49ers,500000,2016
36172,0,486500,Bruce Miller,FB,dead_cap,san-francisco-49ers,486500,2016
36173,300000,0,Keshawn Martin,WR,dead_cap,san-francisco-49ers,300000,2016
36174,0,266667,Derek Carrier,TE,dead_cap,san-francisco-49ers,266667,2016
36175,211764,0,Taylor Hart,T,dead_cap,san-francisco-49ers,211764,2016
36176,62100,86423,DeAndre Smelter,WR,dead_cap,san-francisco-49ers,148523,2016
36177,0,135880,Corey Lemonier,OLB,dead_cap,san-francisco-49ers,135880,2016
36178,0,126504,Brandon Thomas,G,dead_cap,san-francisco-49ers,126504,2016
36179,103500,15369,Prince Charles Iworah,CB,dead_cap,san-francisco-49ers,118869,2016
36180,117300,0,Norman Price,T,dead_cap,san-francisco-49ers,117300,2016
36181,69000,46096,Fahn Cooper,T,dead_cap,san-francisco-49ers,115096,2016
36182,103500,6667,Marcus Rush,OLB,dead_cap,san-francisco-49ers,110167,2016
36183,82800,25089,Kelvin Taylor,RB,dead_cap,san-francisco-49ers,107889,2016
36184,103500,0,Curtis Grant,ILB,dead_cap,san-francisco-49ers,103500,2016
36185,96600,0,Alex Balducci,G,dead_cap,san-francisco-49ers,96600,2016
36186,62100,0,Chris Harper,WR,dead_cap,san-francisco-49ers,62100,2016
36187,58550,0,DuJuan Harris,RB,dead_cap,san-francisco-49ers,58550,2016
36188,48300,7500,Colin Kelly,RT,dead_cap,san-francisco-49ers,55800,2016
36189,55200,0,Mose Frazier,WR,dead_cap,san-francisco-49ers,55200,2016
36190,0,50000,Jerome Simpson,WR,dead_cap,san-francisco-49ers,50000,2016
36191,41400,2000,Dres Anderson,WR,dead_cap,san-francisco-49ers,43400,2016
36192,30882,0,Josh Allen,C,dead_cap,san-francisco-49ers,30882,2016
36193,0,30420,Ian Silberman,G,dead_cap,san-francisco-49ers,30420,2016
36194,0,30150,Kenneth Acker,CB,dead_cap,san-francisco-49ers,30150,2016
36195,0,28134,Jeff Driskel,QB,dead_cap,san-francisco-49ers,28134,2016
36196,27600,0,Raheem Mostert,RB,dead_cap,san-francisco-49ers,27600,2016
36197,0,26918,Nick Moody,ILB,dead_cap,san-francisco-49ers,26918,2016
36198,0,24100,Kaleb Ramsey,DT,dead_cap,san-francisco-49ers,24100,2016
36199,0,23574,Trey Millard,FB,dead_cap,san-francisco-49ers,23574,2016
36200,20700,0,Je'Ron Hamm,WR,dead_cap,san-francisco-49ers,20700,2016
36201,20700,0,Wynton McManis,OLB,dead_cap,san-francisco-49ers,20700,2016
36202,20700,0,Vinnie Sunseri,SS,dead_cap,san-francisco-49ers,20700,2016
36203,0,19794,Rory Anderson,TE,dead_cap,san-francisco-49ers,19794,2016
36204,13800,0,Brandon Chubb,ILB,dead_cap,san-francisco-49ers,13800,2016
36205,13800,0,Shayne Skov,ILB,dead_cap,san-francisco-49ers,13800,2016
36206,13800,0,Duke Thomas,S,dead_cap,san-francisco-49ers,13800,2016
36207,0,9203,Lawrence Okoye,DT,dead_cap,san-francisco-49ers,9203,2016
36208,6900,0,Marcus Ball,FS,dead_cap,san-francisco-49ers,6900,2016
36209,0,6667,Issac Blakeney,WR,dead_cap,san-francisco-49ers,6667,2016
36210,0,6667,Dylan Thompson,QB,dead_cap,san-francisco-49ers,6667,2016
36211,0,5334,Jarryd Hayne,RB,dead_cap,san-francisco-49ers,5334,2016
36212,0,5000,Jermaine Whitehead,FS,dead_cap,san-francisco-49ers,5000,2016
36213,3000,1333,Darren Lake,DT,dead_cap,san-francisco-49ers,4333,2016
36214,0,3334,Patrick Miller,T,dead_cap,san-francisco-49ers,3334,2016
36215,0,2666,Lenny Jones,DE,dead_cap,san-francisco-49ers,2666,2016
36216,0,2333,DeAndre White,WR,dead_cap,san-francisco-49ers,2333,2016
36217,0,2000,Darius Davis,WR,dead_cap,san-francisco-49ers,2000,2016
36218,0,2000,L.J. McCray,SS,dead_cap,san-francisco-49ers,2000,2016
36219,0,1667,DiAndre Campbell,WR,dead_cap,san-francisco-49ers,1667,2016
36220,0,1667,Dillon Farrell,C,dead_cap,san-francisco-49ers,1667,2016
36221,0,833,Jered Bell,S,dead_cap,san-francisco-49ers,833,2016
36222,8250000,2806250,Joe Staley,LT,active,san-francisco-49ers,11056250,2017
36223,5676000,0,Eric Reid,SS,active,san-francisco-49ers,5676000,2017
36224,465000,4653975,Solomon Thomas,DE,active,san-francisco-49ers,5118975,2017
36225,540000,3594316,DeForest Buckner,DT,active,san-francisco-49ers,4134316,2017
36226,2450000,1583333,Zane Beadles,G,active,san-francisco-49ers,4033333,2017
36227,2000000,1750000,Kyle Juszczyk,FB,active,san-francisco-49ers,3750000,2017
36228,2250000,1125000,Elvis Dumervil,OLB,active,san-francisco-49ers,3375000,2017
36229,1950000,1300000,Marquise Goodwin,WR,active,san-francisco-49ers,3250000,2017
36230,1650000,1271875,Earl Mitchell,DT,active,san-francisco-49ers,2921875,2017
36231,1550000,1025000,Garrett Celek,TE,active,san-francisco-49ers,2575000,2017
36232,1100000,878125,Cornellius Carradine,DE,active,san-francisco-49ers,1978125,2017
36233,1797000,49500,Aaron Lynch,DE,active,san-francisco-49ers,1846500,2017
36234,1250000,550000,Aldrick Robinson,WR,active,san-francisco-49ers,1800000,2017
36235,1500000,250000,Robbie Gould,K,active,san-francisco-49ers,1750000,2017
36236,1000000,700000,Daniel Kilgore,C,active,san-francisco-49ers,1700000,2017
36237,465000,1177830,Reuben Foster,ILB,active,san-francisco-49ers,1642830,2017
36238,1000000,533333,Dekoda Watson,OLB,active,san-francisco-49ers,1533333,2017
36239,1000000,450000,Brock Coyle,ILB,active,san-francisco-49ers,1450000,2017
36240,615000,825000,K'Waun Williams,CB,active,san-francisco-49ers,1440000,2017
36241,1000000,387500,Brandon Fusco,G,active,san-francisco-49ers,1387500,2017
36242,1212296,0,Laken Tomlinson,G,active,san-francisco-49ers,1212296,2017
36243,822047,349396,Carlos Hyde,RB,active,san-francisco-49ers,1171443,2017
36244,975000,175000,Kyle Nelson,LS,active,san-francisco-49ers,1150000,2017
36245,634000,189343,Eli Harold,OLB,active,san-francisco-49ers,823343,2017
36246,690000,100136,Dontae Johnson,CB,active,san-francisco-49ers,790136,2017
36247,465000,243393,Ahkello Witherspoon,CB,active,san-francisco-49ers,708393,2017
36248,615000,48550,Bradley Pinion,P,active,san-francisco-49ers,663550,2017
36249,465000,176572,C.J. Beathard,QB,active,san-francisco-49ers,641572,2017
36250,465000,74571,George Kittle,TE,active,san-francisco-49ers,539571,2017
36251,456698,67601,Ronald Blair,DE,active,san-francisco-49ers,524299,2017
36252,465000,50484,Trent Taylor,WR,active,san-francisco-49ers,515484,2017
36253,506471,0,Mark Nzeocha,ILB,active,san-francisco-49ers,506471,2017
36254,465000,36963,D.J. Jones,DT,active,san-francisco-49ers,501963,2017
36255,465000,36361,Pita Taumoepenu,OLB,active,san-francisco-49ers,501361,2017
36256,465000,21196,Adrian Colbert,FS,active,san-francisco-49ers,486196,2017
36257,465000,1666,Kendrick Bourne,WR,active,san-francisco-49ers,466666,2017
36258,465000,1666,Matt Breida,RB,active,san-francisco-49ers,466666,2017
36259,437647,0,Elijah Lee,OLB,active,san-francisco-49ers,437647,2017
36260,434158,0,Jimmy Garoppolo,QB,active,san-francisco-49ers,434158,2017
36261,582353,0,Leger Douzable,DT,active,san-francisco-49ers,582353,2017
36262,381180,0,Dexter McCoil,S,active,san-francisco-49ers,381180,2017
36263,365294,0,Antone Exum,FS,active,san-francisco-49ers,365294,2017
36264,364706,0,Logan Paulsen,TE,active,san-francisco-49ers,364706,2017
36265,588235,0,Leon Hall,CB,active,san-francisco-49ers,588235,2017
36266,423528,0,Louis Murphy,WR,active,san-francisco-49ers,423528,2017
36267,246177,0,Darrell Williams,T,active,san-francisco-49ers,246177,2017
36268,246176,0,Greg Mabin,CB,active,san-francisco-49ers,246176,2017
36269,243528,0,Cassius Marsh,OLB,active,san-francisco-49ers,243528,2017
36270,227941,0,Tim Barnes,C,active,san-francisco-49ers,227941,2017
36271,190590,0,Sheldon Day,DT,active,san-francisco-49ers,190590,2017
36272,136765,0,Jeremy McNichols,RB,active,san-francisco-49ers,136765,2017
36273,95294,0,Tyvis Powell,S,active,san-francisco-49ers,95294,2017
36274,82059,0,Max McCaffrey,WR,active,san-francisco-49ers,82059,2017
36275,3675000,2750000,Pierre Garcon,WR,injured_reserve,san-francisco-49ers,6425000,2017
36276,2000000,1700000,Malcolm Smith,OLB,injured_reserve,san-francisco-49ers,3700000,2017
36277,1329785,1354569,Arik Armstead,DE,injured_reserve,san-francisco-49ers,2684354,2017
36278,690000,1573078,Jimmie Ward,FS,injured_reserve,san-francisco-49ers,2263078,2017
36279,1400000,762500,Garry Gilliam,RT,injured_reserve,san-francisco-49ers,2162500,2017
36280,872923,1241693,Joshua Garnett,G,injured_reserve,san-francisco-49ers,2114616,2017
36281,792910,580821,Jaquiski Tartt,FS,injured_reserve,san-francisco-49ers,1373731,2017
36282,775000,206250,Don Jones,FS,injured_reserve,san-francisco-49ers,981250,2017
36283,775000,50000,Chris Jones,DT,injured_reserve,san-francisco-49ers,825000,2017
36284,615000,13973,Trenton Brown,RT,injured_reserve,san-francisco-49ers,628973,2017
36285,615000,0,Raheem Mostert,RB,injured_reserve,san-francisco-49ers,615000,2017
36286,729412,0,Asa Jackson,CB,injured_reserve,san-francisco-49ers,729412,2017
36287,348000,157346,Joe Williams,RB,injured_reserve,san-francisco-49ers,505346,2017
36288,444352,2666,Victor Bolden,WR,injured_reserve,san-francisco-49ers,447018,2017
36289,430586,1333,Erik Magnunson,T,injured_reserve,san-francisco-49ers,431919,2017
36290,363000,25089,Aaron Burbridge,WR,injured_reserve,san-francisco-49ers,388089,2017
36291,348000,4000,Jimmie Gilbert,OLB,injured_reserve,san-francisco-49ers,352000,2017
36292,348000,1666,Donavin Newsom,ILB,injured_reserve,san-francisco-49ers,349666,2017
36293,348000,0,Chanceller James,S,injured_reserve,san-francisco-49ers,348000,2017
36294,328235,0,Cole Hikutini,TE,injured_reserve,san-francisco-49ers,328235,2017
36295,6180588,4161500,Navorro Bowman,ILB,dead_cap,san-francisco-49ers,10342088,2017
36296,2950000,2325000,Brian Hoyer,QB,dead_cap,san-francisco-49ers,5275000,2017
36297,0,4931507,Colin Kaepernick,QB,dead_cap,san-francisco-49ers,4931507,2017
36298,0,4800000,Torrey Smith,WR,dead_cap,san-francisco-49ers,4800000,2017
36299,725000,906750,Quinton Dial,DT,dead_cap,san-francisco-49ers,1631750,2017
36300,0,1500000,Vance McDonald,TE,dead_cap,san-francisco-49ers,1500000,2017
36301,0,1250000,Antoine Bethea,SS,dead_cap,san-francisco-49ers,1250000,2017
36302,705882,438541,Ray-Ray Armstrong,OLB,dead_cap,san-francisco-49ers,1144423,2017
36303,820588,162500,Logan Paulsen,TE,dead_cap,san-francisco-49ers,983088,2017
36304,0,1797500,Ahmad Brooks,OLB,dead_cap,san-francisco-49ers,1797500,2017
36305,325000,616666,Jeremy Kerley,WR,dead_cap,san-francisco-49ers,941666,2017
36306,0,750000,Tramaine Brock,CB,dead_cap,san-francisco-49ers,750000,2017
36307,278061,243139,Will Redmond,CB,dead_cap,san-francisco-49ers,521200,2017
36308,0,446500,Bruce Miller,FB,dead_cap,san-francisco-49ers,446500,2017
36309,307050,46110,Prince Charles Iworah,CB,dead_cap,san-francisco-49ers,353160,2017
36310,254118,95848,Rashard Robinson,CB,dead_cap,san-francisco-49ers,349966,2017
36311,150000,182000,Tim Hightower,RB,dead_cap,san-francisco-49ers,332000,2017
36312,0,300000,Matt Barkley,QB,dead_cap,san-francisco-49ers,300000,2017
36313,122400,172846,DeAndre Smelter,WR,dead_cap,san-francisco-49ers,295246,2017
36314,258176,0,Xavier Cooper,DE,dead_cap,san-francisco-49ers,258176,2017
36315,235294,0,Tony McDaniel,DT,dead_cap,san-francisco-49ers,235294,2017
36316,0,234391,Mike Davis,RB,dead_cap,san-francisco-49ers,234391,2017
36317,0,167812,Marcus Martin,G,dead_cap,san-francisco-49ers,167812,2017
36318,182353,0,Datone Jones,DE,dead_cap,san-francisco-49ers,182353,2017
36319,0,138289,Fahn Cooper,T,dead_cap,san-francisco-49ers,138289,2017
36320,136765,0,Lorenzo Jerome,S,dead_cap,san-francisco-49ers,136765,2017
36321,0,126504,Brandon Thomas,G,dead_cap,san-francisco-49ers,126504,2017
36322,0,126283,Blake Bell,TE,dead_cap,san-francisco-49ers,126283,2017
36323,122400,0,Deandre Carter,WR,dead_cap,san-francisco-49ers,122400,2017
36324,122400,0,J.P. Flynn,T,dead_cap,san-francisco-49ers,122400,2017
36325,122400,0,Nick Mullens,QB,dead_cap,san-francisco-49ers,122400,2017
36326,0,118607,Bruce Ellington,WR,dead_cap,san-francisco-49ers,118607,2017
36327,117647,0,Leon Hall,CB,dead_cap,san-francisco-49ers,117647,2017
36328,100800,0,Pace Murphy,T,dead_cap,san-francisco-49ers,100800,2017
36329,31765,64403,John Theus,T,dead_cap,san-francisco-49ers,96168,2017
36330,91176,0,Bryce Harris,RT,dead_cap,san-francisco-49ers,91176,2017
36331,86400,0,Jeremy McNichols,RB,dead_cap,san-francisco-49ers,86400,2017
36332,0,84405,Jeff Driskel,QB,dead_cap,san-francisco-49ers,84405,2017
36333,40588,41200,Keith Reaser,CB,dead_cap,san-francisco-49ers,81788,2017
36334,79200,0,Cole Wick,TE,dead_cap,san-francisco-49ers,79200,2017
36335,0,75267,Kelvin Taylor,RB,dead_cap,san-francisco-49ers,75267,2017
36336,72000,0,Noble Nwachukwu,DE,dead_cap,san-francisco-49ers,72000,2017
36337,0,62500,Eric Rogers,WR,dead_cap,san-francisco-49ers,62500,2017
36338,61410,0,B.J. Johnson,WR,dead_cap,san-francisco-49ers,61410,2017
36339,0,60840,Ian Silberman,G,dead_cap,san-francisco-49ers,60840,2017
36340,57600,0,Andrew Lauderdale,T,dead_cap,san-francisco-49ers,57600,2017
36341,57600,0,Darrell Williams,T,dead_cap,san-francisco-49ers,57600,2017
36342,50400,0,Cameron Hunt,T,dead_cap,san-francisco-49ers,50400,2017
36343,46000,3333,Cole Hikutini,TE,dead_cap,san-francisco-49ers,49333,2017
36344,43200,0,Tyvis Powell,S,dead_cap,san-francisco-49ers,43200,2017
36345,36000,0,Jarnor Jones,CB,dead_cap,san-francisco-49ers,36000,2017
36346,36000,0,Boseko Lokombo,OLB,dead_cap,san-francisco-49ers,36000,2017
36347,36000,0,Channing Stribling,CB,dead_cap,san-francisco-49ers,36000,2017
36348,0,30150,Kenneth Acker,CB,dead_cap,san-francisco-49ers,30150,2017
36349,0,20000,Tim Barnes,C,dead_cap,san-francisco-49ers,20000,2017
36350,0,19794,Rory Anderson,TE,dead_cap,san-francisco-49ers,19794,2017
36351,14400,0,Jeremy Liggins,DT,dead_cap,san-francisco-49ers,14400,2017
36352,14400,0,Greg Mabin,CB,dead_cap,san-francisco-49ers,14400,2017
36353,14400,0,Trovon Reed,CB,dead_cap,san-francisco-49ers,14400,2017
36354,12000,1000,Malik Golden,S,dead_cap,san-francisco-49ers,13000,2017
36355,0,7500,Colin Kelly,RT,dead_cap,san-francisco-49ers,7500,2017
36356,7200,0,Ben Boulware,ILB,dead_cap,san-francisco-49ers,7200,2017
36357,7200,0,Asa Jackson,CB,dead_cap,san-francisco-49ers,7200,2017
36358,0,5334,Lenny Jones,DE,dead_cap,san-francisco-49ers,5334,2017
36359,0,5000,K.D. Cannon,WR,dead_cap,san-francisco-49ers,5000,2017
36360,0,2667,Darren Lake,DT,dead_cap,san-francisco-49ers,2667,2017
36361,0,2334,DeAndre White,WR,dead_cap,san-francisco-49ers,2334,2017
36362,0,2000,Dres Anderson,WR,dead_cap,san-francisco-49ers,2000,2017
36363,0,1667,Jered Bell,S,dead_cap,san-francisco-49ers,1667,2017
36364,8050000,2900000,Joe Staley,LT,active,san-francisco-49ers,10950000,2018
36365,3000000,6535000,Weston Richburg,C,active,san-francisco-49ers,9535000,2018
36366,2000000,4800000,Richard Sherman,CB,active,san-francisco-49ers,6800000,2018
36367,555000,5843720,Solomon Thomas,DE,active,san-francisco-49ers,6398720,2018
36368,1450000,4825000,Marquise Goodwin,WR,active,san-francisco-49ers,6275000,2018
36369,630000,4331179,DeForest Buckner,DT,active,san-francisco-49ers,4961179,2018
36370,3000000,1668750,Malcolm Smith,ILB,active,san-francisco-49ers,4668750,2018
36371,2750000,1750000,Kyle Juszczyk,FB,active,san-francisco-49ers,4500000,2018
36372,2250000,1506250,Earl Mitchell,DT,active,san-francisco-49ers,3756250,2018
36373,1100000,2400000,Cassius Marsh,OLB,active,san-francisco-49ers,3500000,2018
36374,480000,2854858,Mike McGlinchey,RT,active,san-francisco-49ers,3334858,2018
36375,1777177,1354569,Arik Armstead,DE,active,san-francisco-49ers,3131746,2018
36376,1600941,1250000,Laken Tomlinson,G,active,san-francisco-49ers,2850941,2018
36377,1750000,950000,Garry Gilliam,RT,active,san-francisco-49ers,2700000,2018
36378,1650000,1003125,Garrett Celek,TE,active,san-francisco-49ers,2653125,2018
36379,1295846,1241693,Joshua Garnett,G,active,san-francisco-49ers,2537539,2018
36380,1250000,1018750,K'Waun Williams,CB,active,san-francisco-49ers,2268750,2018
36381,2000000,250000,Robbie Gould,K,active,san-francisco-49ers,2250000,2018
36382,625393,176572,C.J. Beathard,QB,active,san-francisco-49ers,801965,2018
36383,705000,95000,Mark Nzeocha,OLB,active,san-francisco-49ers,800000,2018
36384,705000,48550,Bradley Pinion,P,active,san-francisco-49ers,753550,2018
36385,480000,252547,Fred Warner,ILB,active,san-francisco-49ers,732547,2018
36386,705000,0,Antone Exum,SS,active,san-francisco-49ers,705000,2018
36387,630000,67601,Ronald Blair,DE,active,san-francisco-49ers,697601,2018
36388,480000,196093,Tarvarius Moore,S,active,san-francisco-49ers,676093,2018
36389,658000,0,Shon Coleman,T,active,san-francisco-49ers,658000,2018
36390,915000,0,Michael Person,G,active,san-francisco-49ers,915000,2018
36391,790000,0,Alfred Morris,RB,active,san-francisco-49ers,790000,2018
36392,630000,0,Sheldon Day,DT,active,san-francisco-49ers,630000,2018
36393,555000,74571,George Kittle,TE,active,san-francisco-49ers,629571,2018
36394,555000,50484,Trent Taylor,WR,active,san-francisco-49ers,605484,2018
36395,555000,36963,D.J. Jones,DT,active,san-francisco-49ers,591963,2018
36396,480000,77842,D.J. Reed,CB,active,san-francisco-49ers,557842,2018
36397,555000,1666,Kendrick Bourne,WR,active,san-francisco-49ers,556666,2018
36398,404000,152550,Kentavius Street,DE,active,san-francisco-49ers,556550,2018
36399,555000,1333,Erik Magnunson,T,active,san-francisco-49ers,556333,2018
36400,555000,0,Elijah Lee,OLB,active,san-francisco-49ers,555000,2018
36401,480000,24510,Jullian Taylor,DT,active,san-francisco-49ers,504510,2018
36402,480000,19142,Richie James,WR,active,san-francisco-49ers,499142,2018
36403,424931,41573,Marcell Harris,S,active,san-francisco-49ers,466504,2018
36404,395290,0,Nick Mullens,QB,active,san-francisco-49ers,395290,2018
36405,338824,0,Ross Dwelley,TE,active,san-francisco-49ers,338824,2018
36406,261176,0,Matt Dayes,RB,active,san-francisco-49ers,261176,2018
36407,261176,0,Greg Mabin,CB,active,san-francisco-49ers,261176,2018
36408,169410,0,Jeff Wilson,RB,active,san-francisco-49ers,169410,2018
36409,163235,0,James Onwualu,OLB,active,san-francisco-49ers,163235,2018
36410,141175,0,Godwin Igwebuike,S,active,san-francisco-49ers,141175,2018
36411,130588,0,Colin Holba,LS,active,san-francisco-49ers,130588,2018
36412,130588,0,Pita Taumoepenu,OLB,active,san-francisco-49ers,130588,2018
36413,84705,0,Tyree Robinson,S,active,san-francisco-49ers,84705,2018
36414,74118,0,Tyvis Powell,S,active,san-francisco-49ers,74118,2018
36415,37059,0,Ryan Delaire,DE,active,san-francisco-49ers,37059,2018
36416,32647,0,Max McCaffrey,WR,active,san-francisco-49ers,32647,2018
36417,28235,0,Steven Dunbar,WR,active,san-francisco-49ers,28235,2018
36418,6200000,30800000,Jimmy Garoppolo,QB,injured_reserve,san-francisco-49ers,37000000,2018
36419,6625000,2625000,Pierre Garcon,WR,injured_reserve,san-francisco-49ers,9250000,2018
36420,8526000,0,Jimmie Ward,FS,injured_reserve,san-francisco-49ers,8526000,2018
36421,4200000,2300000,Jerick McKinnon,RB,injured_reserve,san-francisco-49ers,6500000,2018
36422,1021865,2080821,Jaquiski Tartt,SS,injured_reserve,san-francisco-49ers,3102686,2018
36423,900000,775000,Brock Coyle,OLB,injured_reserve,san-francisco-49ers,1675000,2018
36424,1050000,433333,Dekoda Watson,OLB,injured_reserve,san-francisco-49ers,1483333,2018
36425,480000,683737,Dante Pettis,WR,injured_reserve,san-francisco-49ers,1163737,2018
36426,638325,243393,Ahkello Witherspoon,CB,injured_reserve,san-francisco-49ers,881718,2018
36427,705000,0,Raheem Mostert,RB,injured_reserve,san-francisco-49ers,705000,2018
36428,555000,1666,Matt Breida,RB,injured_reserve,san-francisco-49ers,556666,2018
36429,450882,21196,Adrian Colbert,FS,injured_reserve,san-francisco-49ers,472078,2018
36430,363000,0,J.P. Flynn,T,injured_reserve,san-francisco-49ers,363000,2018
36431,199051,0,Emmanuel Moseley,CB,injured_reserve,san-francisco-49ers,199051,2018
36432,0,6854000,Navorro Bowman,ILB,dead_cap,san-francisco-49ers,6854000,2018
36433,0,4200000,Vance McDonald,TE,dead_cap,san-francisco-49ers,4200000,2018
36434,1000000,1750000,Jeremiah Attaochu,OLB,dead_cap,san-francisco-49ers,2750000,2018
36435,0,2475000,Jonathan Cooper,G,dead_cap,san-francisco-49ers,2475000,2018
36436,0,2000000,Brian Hoyer,QB,dead_cap,san-francisco-49ers,2000000,2018
36437,0,1613500,Quinton Dial,DT,dead_cap,san-francisco-49ers,1613500,2018
36438,463610,1117830,Reuben Foster,ILB,dead_cap,san-francisco-49ers,1581440,2018
36439,0,1133334,Jeremy Kerley,WR,dead_cap,san-francisco-49ers,1133334,2018
36440,790000,0,Matt Tobin,G,dead_cap,san-francisco-49ers,790000,2018
36441,0,583334,Zane Beadles,G,dead_cap,san-francisco-49ers,583334,2018
36442,0,500000,Elvis Dumervil,OLB,dead_cap,san-francisco-49ers,500000,2018
36443,0,436278,Will Redmond,CB,dead_cap,san-francisco-49ers,436278,2018
36444,276176,0,Greg Mabin,CB,dead_cap,san-francisco-49ers,276176,2018
36445,264773,0,Tyvis Powell,S,dead_cap,san-francisco-49ers,264773,2018
36446,256682,0,Cole Wick,TE,dead_cap,san-francisco-49ers,256682,2018
36447,0,250000,Matt Barkley,QB,dead_cap,san-francisco-49ers,250000,2018
36448,0,250000,Aldrick Robinson,WR,dead_cap,san-francisco-49ers,250000,2018
36449,248824,0,Tom Savage,QB,dead_cap,san-francisco-49ers,248824,2018
36450,213074,0,Najee Toran,T,dead_cap,san-francisco-49ers,213074,2018
36451,208835,2666,Victor Bolden,WR,dead_cap,san-francisco-49ers,211501,2018
36452,0,191697,Rashard Robinson,CB,dead_cap,san-francisco-49ers,191697,2018
36453,0,189344,Eli Harold,OLB,dead_cap,san-francisco-49ers,189344,2018
36454,0,166668,Ray-Ray Armstrong,OLB,dead_cap,san-francisco-49ers,166668,2018
36455,157718,0,Ryan Delaire,DE,dead_cap,san-francisco-49ers,157718,2018
36456,0,157346,Joe Williams,RB,dead_cap,san-francisco-49ers,157346,2018
36457,148236,0,Terence Garvin,ILB,dead_cap,san-francisco-49ers,148236,2018
36458,138831,0,Terrell Williams,S,dead_cap,san-francisco-49ers,138831,2018
36459,130800,6666,Tarvarus McFadden,CB,dead_cap,san-francisco-49ers,137466,2018
36460,98800,36361,Pita Taumoepenu,OLB,dead_cap,san-francisco-49ers,135161,2018
36461,0,128807,John Theus,T,dead_cap,san-francisco-49ers,128807,2018
36462,127705,0,Emmanuel Moseley,CB,dead_cap,san-francisco-49ers,127705,2018
36463,0,126283,Blake Bell,TE,dead_cap,san-francisco-49ers,126283,2018
36464,0,125000,Don Jones,FS,dead_cap,san-francisco-49ers,125000,2018
36465,121600,0,Steven Dunbar,WR,dead_cap,san-francisco-49ers,121600,2018
36466,106400,0,Christian Dilauro,G,dead_cap,san-francisco-49ers,106400,2018
36467,0,90000,Korey Toomer,ILB,dead_cap,san-francisco-49ers,90000,2018
36468,83600,3333,Jeff Wilson,RB,dead_cap,san-francisco-49ers,86933,2018
36469,30718,25089,Aaron Burbridge,WR,dead_cap,san-francisco-49ers,55807,2018
36470,45600,0,Ross Dwelley,TE,dead_cap,san-francisco-49ers,45600,2018
36471,45600,0,Zack Golditch,G,dead_cap,san-francisco-49ers,45600,2018
36472,30400,0,Tyrell Adams,OLB,dead_cap,san-francisco-49ers,30400,2018
36473,30400,0,Matt Dayes,RB,dead_cap,san-francisco-49ers,30400,2018
36474,30400,0,Max McCaffrey,WR,dead_cap,san-francisco-49ers,30400,2018
36475,30400,0,Frank Stephens,WR,dead_cap,san-francisco-49ers,30400,2018
36476,22800,0,Daeshon Hall,DE,dead_cap,san-francisco-49ers,22800,2018
36477,22800,0,Marcus Lucas,TE,dead_cap,san-francisco-49ers,22800,2018
36478,22800,0,Nick Mullens,QB,dead_cap,san-francisco-49ers,22800,2018
36479,15200,0,Dexter McCoil,S,dead_cap,san-francisco-49ers,15200,2018
36480,15200,0,Jordan Smallwood,WR,dead_cap,san-francisco-49ers,15200,2018
36481,0,13974,Trenton Brown,RT,dead_cap,san-francisco-49ers,13974,2018
36482,0,8000,Jimmie Gilbert,OLB,dead_cap,san-francisco-49ers,8000,2018
36483,7600,0,James Onwualu,OLB,dead_cap,san-francisco-49ers,7600,2018
36484,7600,0,Niles Scott,DT,dead_cap,san-francisco-49ers,7600,2018
36485,0,6667,Cole Hikutini,TE,dead_cap,san-francisco-49ers,6667,2018
36486,0,3334,Donavin Newsom,ILB,dead_cap,san-francisco-49ers,3334,2018
36487,0,2000,Malik Golden,S,dead_cap,san-francisco-49ers,2000,2018
36488,17200000,2800000,Jimmy Garoppolo,QB,active,san-francisco-49ers,20000000,2019
36489,7550000,6868750,Joe Staley,LT,active,san-francisco-49ers,14418750,2019
36490,4750000,9615625,Dee Ford,DE,active,san-francisco-49ers,14365625,2019
36491,7000000,6925000,Richard Sherman,CB,active,san-francisco-49ers,13925000,2019
36492,9046000,0,Arik Armstead,DE,active,san-francisco-49ers,9046000,2019
36493,645000,7033465,Solomon Thomas,DE,active,san-francisco-49ers,7678465,2019
36494,495000,5605339,Nick Bosa,DE,active,san-francisco-49ers,6100339,2019
36495,5970588,0,Emmanuel Sanders,WR,active,san-francisco-49ers,5970588,2019
36496,4200000,1650000,Kyle Juszczyk,FB,active,san-francisco-49ers,5850000,2019
36497,720000,5068044,DeForest Buckner,DT,active,san-francisco-49ers,5788044,2019
36498,3000000,1975000,Jaquiski Tartt,SS,active,san-francisco-49ers,4975000,2019
36499,2000000,2218750,Jimmie Ward,FS,active,san-francisco-49ers,4218750,2019
36500,570000,3598580,Mike McGlinchey,RT,active,san-francisco-49ers,4168580,2019
36501,3150000,750000,Robbie Gould,K,active,san-francisco-49ers,3900000,2019
36502,2000000,1750000,Laken Tomlinson,G,active,san-francisco-49ers,3750000,2019
36503,1550000,2018750,Tevin Coleman,RB,active,san-francisco-49ers,3568750,2019
36504,1450000,1300000,Michael Person,G,active,san-francisco-49ers,2750000,2019
36505,1550000,1034375,K'Waun Williams,CB,active,san-francisco-49ers,2584375,2019
36506,1400000,583333,Raheem Mostert,RB,active,san-francisco-49ers,1983333,2019
36507,1100000,550000,Mark Nzeocha,OLB,active,san-francisco-49ers,1650000,2019
36508,770934,683737,Dante Pettis,WR,active,san-francisco-49ers,1454671,2019
36509,495000,904519,Deebo Samuel,WR,active,san-francisco-49ers,1399519,2019
36510,815375,243393,Ahkello Witherspoon,CB,active,san-francisco-49ers,1058768,2019
36511,601765,450000,Kyle Nelson,LS,active,san-francisco-49ers,1051765,2019
36512,785786,176572,C.J. Beathard,QB,active,san-francisco-49ers,962358,2019
36513,663137,252547,Fred Warner,OLB,active,san-francisco-49ers,915684,2019
36514,603000,196093,Tarvarius Moore,FS,active,san-francisco-49ers,799093,2019
36515,720000,0,Sheldon Day,DT,active,san-francisco-49ers,720000,2019
36516,645000,74571,George Kittle,TE,active,san-francisco-49ers,719571,2019
36517,495000,191018,Mitch Wishnowsky,P,active,san-francisco-49ers,686018,2019
36518,570000,77842,D.J. Reed,CB,active,san-francisco-49ers,647842,2019
36519,645000,1668,Kendrick Bourne,WR,active,san-francisco-49ers,646668,2019
36520,645000,1668,Matt Breida,RB,active,san-francisco-49ers,646668,2019
36521,805000,0,Ben Garland,C,active,san-francisco-49ers,805000,2019
36522,805000,0,Levine Toilolo,TE,active,san-francisco-49ers,805000,2019
36523,570000,19142,Richie James,WR,active,san-francisco-49ers,589142,2019
36524,495000,80429,Dre Greenlaw,LB,active,san-francisco-49ers,575429,2019
36525,570000,0,Ross Dwelley,TE,active,san-francisco-49ers,570000,2019
36526,570000,0,Nick Mullens,QB,active,san-francisco-49ers,570000,2019
36527,495000,44714,Justin Skule,T,active,san-francisco-49ers,539714,2019
36528,536464,0,Jeff Wilson,RB,active,san-francisco-49ers,536464,2019
36529,378000,152550,Kentavius Street,DE,active,san-francisco-49ers,530550,2019
36530,495000,5000,Azeez Al-Shaair,LB,active,san-francisco-49ers,500000,2019
36531,495000,0,Daniel Brunskill,G,active,san-francisco-49ers,495000,2019
36532,495000,0,Emmanuel Moseley,CB,active,san-francisco-49ers,495000,2019
36533,435882,0,Marcell Harris,S,active,san-francisco-49ers,435882,2019
36534,303528,0,Elijah Lee,OLB,active,san-francisco-49ers,303528,2019
36535,142059,0,Jordan Matthews,WR,active,san-francisco-49ers,142059,2019
36536,113824,0,Dontae Johnson,CB,active,san-francisco-49ers,113824,2019
36537,87353,0,Daniel Helm,TE,active,san-francisco-49ers,87353,2019
36538,42353,0,Anthony Zettel,DE,active,san-francisco-49ers,42353,2019
36539,29118,0,Kevin Givens,DT,active,san-francisco-49ers,29118,2019
36540,0,0,Earl Mitchell,DT,active,san-francisco-49ers,0,2019
36541,1750000,9875000,Kwon Alexander,ILB,injured_reserve,san-francisco-49ers,11625000,2019
36542,5500000,2285000,Weston Richburg,C,injured_reserve,san-francisco-49ers,7785000,2019
36543,3700000,2050000,Jerick McKinnon,RB,injured_reserve,san-francisco-49ers,5750000,2019
36544,2950000,956250,Marquise Goodwin,WR,injured_reserve,san-francisco-49ers,3906250,2019
36545,1700000,784375,Garrett Celek,TE,injured_reserve,san-francisco-49ers,2484375,2019
36546,2005000,20000,Shon Coleman,T,injured_reserve,san-francisco-49ers,2025000,2019
36547,1100000,493750,Jason Verrett,CB,injured_reserve,san-francisco-49ers,1593750,2019
36548,720000,67602,Ronald Blair,DE,injured_reserve,san-francisco-49ers,787602,2019
36549,645000,50484,Trent Taylor,WR,injured_reserve,san-francisco-49ers,695484,2019
36550,405531,283123,Jalen Hurd,WR,injured_reserve,san-francisco-49ers,688654,2019
36551,645000,36963,D.J. Jones,DT,injured_reserve,san-francisco-49ers,681963,2019
36552,570000,24510,Jullian Taylor,DT,injured_reserve,san-francisco-49ers,594510,2019
36553,378000,39577,Tim Harris,CB,injured_reserve,san-francisco-49ers,417577,2019
36554,378000,1666,Shawn Poindexter,WR,injured_reserve,san-francisco-49ers,379666,2019
36555,378000,0,Andrew Lauderdale,T,injured_reserve,san-francisco-49ers,378000,2019
36556,331471,0,Damontre Moore,DE,injured_reserve,san-francisco-49ers,331471,2019
36557,136000,0,Demetrius Flannigan-Fowles,S,practice_squad,san-francisco-49ers,136000,2019
36558,136000,0,Ross Reynolds,G,practice_squad,san-francisco-49ers,136000,2019
36559,104000,0,Jaryd Jones-Smith,T,practice_squad,san-francisco-49ers,104000,2019
36560,40000,0,Alex Barrett,DE,practice_squad,san-francisco-49ers,40000,2019
36561,32000,0,Chris Thompson,WR,practice_squad,san-francisco-49ers,32000,2019
36562,24000,0,Joey Alfieri,LB,practice_squad,san-francisco-49ers,24000,2019
36563,24000,0,Kofi Amichia,C,practice_squad,san-francisco-49ers,24000,2019
36564,24000,0,Jermaine Kelly,CB,practice_squad,san-francisco-49ers,24000,2019
36565,24000,0,Jacob Thieneman,S,practice_squad,san-francisco-49ers,24000,2019
36566,104000,0,Jalen Tabor,CB,practice_squad,san-francisco-49ers,104000,2019
36567,0,7200000,Pierre Garcon,WR,dead_cap,san-francisco-49ers,7200000,2019
36568,0,4200000,Malcolm Smith,OLB,dead_cap,san-francisco-49ers,4200000,2019
36569,1100000,1400000,Brock Coyle,OLB,dead_cap,san-francisco-49ers,2500000,2019
36570,0,2355660,Reuben Foster,ILB,dead_cap,san-francisco-49ers,2355660,2019
36571,750000,1241693,Joshua Garnett,G,dead_cap,san-francisco-49ers,1991693,2019
36572,0,1500000,Earl Mitchell,DT,dead_cap,san-francisco-49ers,1500000,2019
36573,850000,300000,David Mayo,ILB,dead_cap,san-francisco-49ers,1150000,2019
36574,189412,300000,Jordan Matthews,WR,dead_cap,san-francisco-49ers,489412,2019
36575,341469,0,Elijah Lee,OLB,dead_cap,san-francisco-49ers,341469,2019
36576,0,333334,Dekoda Watson,OLB,dead_cap,san-francisco-49ers,333334,2019
36577,0,314692,Joe Williams,RB,dead_cap,san-francisco-49ers,314692,2019
36578,265000,4000,Kevin Givens,DT,dead_cap,san-francisco-49ers,269000,2019
36579,424118,0,Sam Young,LT,dead_cap,san-francisco-49ers,424118,2019
36580,230116,0,Jeremiah Valoaga,DE,dead_cap,san-francisco-49ers,230116,2019
36581,284118,0,Dontae Johnson,CB,dead_cap,san-francisco-49ers,284118,2019
36582,805000,50000,Antone Exum,S,dead_cap,san-francisco-49ers,855000,2019
36583,120000,41574,Marcell Harris,S,dead_cap,san-francisco-49ers,161574,2019
36584,242353,0,Garrison Sanborn,LS,dead_cap,san-francisco-49ers,242353,2019
36585,131000,5000,Malik Henry,WR,dead_cap,san-francisco-49ers,136000,2019
36586,116471,0,Chase McLaughlin,K,dead_cap,san-francisco-49ers,116471,2019
36587,112000,0,Daniel Helm,TE,dead_cap,san-francisco-49ers,112000,2019
36588,58235,50002,Kaden Smith,TE,dead_cap,san-francisco-49ers,108237,2019
36589,88000,0,Will Holden,T,dead_cap,san-francisco-49ers,88000,2019
36590,75882,0,Colin Holba,LS,dead_cap,san-francisco-49ers,75882,2019
36591,0,72722,Pita Taumoepenu,OLB,dead_cap,san-francisco-49ers,72722,2019
36592,64000,0,Deontay Burnett,WR,dead_cap,san-francisco-49ers,64000,2019
36593,60000,0,Ryan Pope,T,dead_cap,san-francisco-49ers,60000,2019
36594,50000,4166,Demetrius Flannigan-Fowles,S,dead_cap,san-francisco-49ers,54166,2019
36595,40000,0,Christian Sam,ILB,dead_cap,san-francisco-49ers,40000,2019
36596,60588,0,Jon Condo,LS,dead_cap,san-francisco-49ers,60588,2019
36597,33000,666,Ross Reynolds,G,dead_cap,san-francisco-49ers,33666,2019
36598,25000,3333,Tyree Mayfield,TE,dead_cap,san-francisco-49ers,28333,2019
36599,0,25089,Aaron Burbridge,WR,dead_cap,san-francisco-49ers,25089,2019
36600,20000,5000,Cam Glenn,S,dead_cap,san-francisco-49ers,25000,2019
36601,0,21197,Adrian Colbert,FS,dead_cap,san-francisco-49ers,21197,2019
36602,12000,6667,Jeff Wilson,RB,dead_cap,san-francisco-49ers,18667,2019
36603,15000,1666,Wilton Speight,QB,dead_cap,san-francisco-49ers,16666,2019
36604,0,13334,Tarvarus McFadden,CB,dead_cap,san-francisco-49ers,13334,2019
36605,8000,3333,Jamell Garcia-Williams,DT,dead_cap,san-francisco-49ers,11333,2019
36606,0,2668,Victor Bolden,WR,dead_cap,san-francisco-49ers,2668,2019
36607,0,1334,Erik Magnunson,T,dead_cap,san-francisco-49ers,1334,2019
36608,23800000,2800000,Jimmy Garoppolo,QB,active,san-francisco-49ers,26600000,2020
36609,13650000,2215625,Dee Ford,DE,active,san-francisco-49ers,15865625,2020
36610,14360000,0,DeForest Buckner,DT,active,san-francisco-49ers,14360000,2020
36611,11250000,1475000,Kwon Alexander,ILB,active,san-francisco-49ers,12725000,2020
36612,10550000,918750,Joe Staley,LT,active,san-francisco-49ers,11468750,2020
36613,8000000,1987500,Richard Sherman,CB,active,san-francisco-49ers,9987500,2020
36614,735000,8223213,Solomon Thomas,DE,active,san-francisco-49ers,8958213,2020
36615,6500000,2285000,Weston Richburg,C,active,san-francisco-49ers,8785000,2020
36616,6500000,2050000,Jerick McKinnon,RB,active,san-francisco-49ers,8550000,2020
36617,2020085,5605339,Nick Bosa,DE,active,san-francisco-49ers,7625424,2020
36618,5050000,1650000,Kyle Juszczyk,FB,active,san-francisco-49ers,6700000,2020
36619,4300000,1975000,Jaquiski Tartt,SS,active,san-francisco-49ers,6275000,2020
36620,3500000,1750000,Laken Tomlinson,G,active,san-francisco-49ers,5250000,2020
36621,4350000,750000,Robbie Gould,K,active,san-francisco-49ers,5100000,2020
36622,660000,4342302,Mike McGlinchey,RT,active,san-francisco-49ers,5002302,2020
36623,3950000,956250,Marquise Goodwin,WR,active,san-francisco-49ers,4906250,2020
36624,4550000,350000,Tevin Coleman,RB,active,san-francisco-49ers,4900000,2020
36625,2575000,633333,Raheem Mostert,RB,active,san-francisco-49ers,3208333,2020
36626,2150000,1034375,K'Waun Williams,CB,active,san-francisco-49ers,3184375,2020
36627,2200000,300000,Michael Person,G,active,san-francisco-49ers,2500000,2020
36628,844880,904519,Deebo Samuel,WR,active,san-francisco-49ers,1749399,2020
36629,1061869,683737,Dante Pettis,WR,active,san-francisco-49ers,1745606,2020
36630,1350000,150000,Mark Nzeocha,OLB,active,san-francisco-49ers,1500000,2020
36631,992393,243393,Ahkello Witherspoon,CB,active,san-francisco-49ers,1235786,2020
36632,946179,176572,C.J. Beathard,QB,active,san-francisco-49ers,1122751,2020
36633,844000,252547,Fred Warner,OLB,active,san-francisco-49ers,1096547,2020
36634,975000,0,Kyle Nelson,LS,active,san-francisco-49ers,975000,2020
36635,689531,283123,Jalen Hurd,WR,active,san-francisco-49ers,972654,2020
36636,700000,196093,Tarvarius Moore,FS,active,san-francisco-49ers,896093,2020
36637,660000,152550,Kentavius Street,DE,active,san-francisco-49ers,812550,2020
36638,735000,74574,George Kittle,TE,active,san-francisco-49ers,809574,2020
36639,735000,50485,Trent Taylor,WR,active,san-francisco-49ers,785485,2020
36640,585000,191018,Mitch Wishnowsky,P,active,san-francisco-49ers,776018,2020
36641,735000,36966,D.J. Jones,DT,active,san-francisco-49ers,771966,2020
36642,660000,77842,D.J. Reed,CB,active,san-francisco-49ers,737842,2020
36643,660000,24510,Jullian Taylor,DT,active,san-francisco-49ers,684510,2020
36644,660000,19142,Richie James,WR,active,san-francisco-49ers,679142,2020
36645,585000,80429,Dre Greenlaw,LB,active,san-francisco-49ers,665429,2020
36646,660000,0,Marcell Harris,S,active,san-francisco-49ers,660000,2020
36647,585000,44714,Justin Skule,T,active,san-francisco-49ers,629714,2020
36648,585000,5000,Azeez Al-Shaair,LB,active,san-francisco-49ers,590000,2020
36649,585000,0,Daniel Helm,TE,active,san-francisco-49ers,585000,2020
36650,510000,39577,Tim Harris,CB,active,san-francisco-49ers,549577,2020
36651,510000,1666,Shawn Poindexter,WR,active,san-francisco-49ers,511666,2020
36652,510000,0,Kevin Givens,DT,active,san-francisco-49ers,510000,2020
36653,0,0,Chris Edwards,S,active,san-francisco-49ers,0,2020
36654,0,0,Derrick Kindred,S,active,san-francisco-49ers,0,2020
36655,0,0,Jonathan Kongbo,DE,active,san-francisco-49ers,0,2020
36656,0,0,Leonard Wester,T,active,san-francisco-49ers,0,2020
36657,0,150006,Kaden Smith,TE,dead_cap,san-francisco-49ers,150006,2020
36658,0,83148,Marcell Harris,S,dead_cap,san-francisco-49ers,83148,2020
36659,0,21197,Adrian Colbert,FS,dead_cap,san-francisco-49ers,21197,2020
36660,0,10000,Malik Henry,WR,dead_cap,san-francisco-49ers,10000,2020
36661,0,8334,Demetrius Flannigan-Fowles,S,dead_cap,san-francisco-49ers,8334,2020
36662,0,8000,Kevin Givens,DT,dead_cap,san-francisco-49ers,8000,2020
36663,0,6667,Jamell Garcia-Williams,DT,dead_cap,san-francisco-49ers,6667,2020
36664,0,6667,Tyree Mayfield,TE,dead_cap,san-francisco-49ers,6667,2020
36665,0,3334,Wilton Speight,QB,dead_cap,san-francisco-49ers,3334,2020
36666,0,1334,Ross Reynolds,G,dead_cap,san-francisco-49ers,1334,2020
36667,6000000,3200000,Matt Hasselbeck,QB,active,seattle-seahawks,9200000,2007
36668,2000000,7000000,Walter Jones,T,active,seattle-seahawks,9000000,2007
36669,2750000,800000,Nate Burleson,WR,active,seattle-seahawks,3550000,2007
36670,2000000,4300000,Julian Peterson,LB,active,seattle-seahawks,6300000,2007
36671,3380000,1400000,Deion Branch,WR,active,seattle-seahawks,4780000,2007
36672,1400000,4300000,Shaun Alexander,RB,active,seattle-seahawks,5700000,2007
36673,3000000,1500000,Rocky Bernard,DT,active,seattle-seahawks,4500000,2007
36674,2250000,1783333,Marcus Trufant,CB,active,seattle-seahawks,4033333,2007
36675,750000,1666666,Patrick Kerney,DE,active,seattle-seahawks,2416666,2007
36676,2078000,0,Josh Brown,K,active,seattle-seahawks,2078000,2007
36677,1850000,0,Sean Locklear,T,active,seattle-seahawks,1850000,2007
36678,1300000,375000,Jordan Babineaux,S,active,seattle-seahawks,1675000,2007
36679,595000,916667,Deon Grant,S,active,seattle-seahawks,1511667,2007
36680,0,1500000,Anthony Simmons,ILB,active,seattle-seahawks,1500000,2007
36681,525000,1590000,Chris Spencer,G,active,seattle-seahawks,2115000,2007
36682,360000,1842500,Kelly Jennings,CB,active,seattle-seahawks,2202500,2007
36683,950000,300000,Maurice Morris,RB,active,seattle-seahawks,1250000,2007
36684,700000,500000,Floyd Womack,G,active,seattle-seahawks,1200000,2007
36685,595000,400000,Seneca Wallace,QB,active,seattle-seahawks,995000,2007
36686,435000,820000,Lofa Tatupa,LB,active,seattle-seahawks,1255000,2007
36687,820000,40000,Marcus Pollard,TE,active,seattle-seahawks,860000,2007
36688,700000,150000,Will Heller,TE,active,seattle-seahawks,850000,2007
36689,735503,70000,Jason Babin,DE,active,seattle-seahawks,805503,2007
36690,360000,495000,Darryl Tapp,DE,active,seattle-seahawks,855000,2007
36691,435000,141250,Leroy Hill,LB,active,seattle-seahawks,576250,2007
36692,435000,114500,Ray Willis,T,active,seattle-seahawks,549500,2007
36693,285000,220000,Josh Wilson,CB,active,seattle-seahawks,505000,2007
36694,360000,130000,Rob Sims,G,active,seattle-seahawks,490000,2007
36695,435000,0,Alvin Pearman,RB,active,seattle-seahawks,435000,2007
36696,285000,108125,Baraka Atkins,OLB,active,seattle-seahawks,393125,2007
36697,285000,104250,Mansfield Wrotto,G,active,seattle-seahawks,389250,2007
36698,360000,0,David Kirtman,RB,active,seattle-seahawks,360000,2007
36699,285000,40775,Will Herring,LB,active,seattle-seahawks,325775,2007
36700,285000,27000,Ben Obomanu,WR,active,seattle-seahawks,312000,2007
36701,285000,0,Courtney Taylor,WR,active,seattle-seahawks,285000,2007
36702,285000,0,Steve Vallos,C,active,seattle-seahawks,285000,2007
36703,435000,0,Charlie Frye,QB,active,seattle-seahawks,435000,2007
36704,16764,0,Logan Payne,WR,injured_reserve,seattle-seahawks,16764,2007
36705,79900,0,Logan Payne,WR,practice_squad,seattle-seahawks,79900,2007
36706,0,3499999,Grant Wistrom,DE,dead_cap,seattle-seahawks,3499999,2007
36707,401667,0,Jeb Huckeba,DE,dead_cap,seattle-seahawks,401667,2007
36708,158750,0,David Greene,QB,dead_cap,seattle-seahawks,158750,2007
36709,110625,0,David Kirtman,RB,dead_cap,seattle-seahawks,110625,2007
36710,22562,0,Courtney Taylor,WR,dead_cap,seattle-seahawks,22562,2007
36711,18187,0,Jordan Kent,WR,dead_cap,seattle-seahawks,18187,2007
36712,11562,0,Steve Vallos,C,dead_cap,seattle-seahawks,11562,2007
36713,11500,0,Cornelius Wortham,LB,dead_cap,seattle-seahawks,11500,2007
36714,5500,0,Logan Payne,WR,dead_cap,seattle-seahawks,5500,2007
36715,5750000,4200000,Matt Hasselbeck,QB,active,seattle-seahawks,9950000,2008
36716,3500000,3800000,Julian Peterson,LB,active,seattle-seahawks,7300000,2008
36717,3250000,800000,Nate Burleson,WR,active,seattle-seahawks,4050000,2008
36718,3500000,1400000,Deion Branch,WR,active,seattle-seahawks,4900000,2008
36719,2937500,1500000,Rocky Bernard,DT,active,seattle-seahawks,4437500,2008
36720,1000000,4099999,Marcus Trufant,CB,active,seattle-seahawks,5099999,2008
36721,1730000,916667,Deon Grant,S,active,seattle-seahawks,2646667,2008
36722,1000000,2450000,Sean Locklear,T,active,seattle-seahawks,3450000,2008
36723,520000,2513332,Lofa Tatupa,LB,active,seattle-seahawks,3033332,2008
36724,700000,750000,Julius Jones,RB,active,seattle-seahawks,1450000,2008
36725,700000,1590000,Chris Spencer,G,active,seattle-seahawks,2290000,2008
36726,1500000,125000,Olindo Mare,K,active,seattle-seahawks,1625000,2008
36727,445000,1842500,Kelly Jennings,CB,active,seattle-seahawks,2287500,2008
36728,1000000,300000,Maurice Morris,RB,active,seattle-seahawks,1300000,2008
36729,295000,905000,Lawrence Jackson,DE,active,seattle-seahawks,1200000,2008
36730,370000,759000,Josh Wilson,CB,active,seattle-seahawks,1129000,2008
36731,610000,375000,Jordan Babineaux,S,active,seattle-seahawks,985000,2008
36732,927000,141250,Leroy Hill,LB,active,seattle-seahawks,1068250,2008
36733,605000,450000,T.J. Duckett,RB,active,seattle-seahawks,1055000,2008
36734,605000,400000,Seneca Wallace,QB,active,seattle-seahawks,1005000,2008
36735,887003,70000,Jason Babin,DE,active,seattle-seahawks,957003,2008
36736,800000,150000,Will Heller,TE,active,seattle-seahawks,950000,2008
36737,295000,475000,John Carlson,TE,active,seattle-seahawks,770000,2008
36738,445000,495000,Darryl Tapp,DE,active,seattle-seahawks,940000,2008
36739,520000,114500,Ray Willis,T,active,seattle-seahawks,634500,2008
36740,605000,0,Keary Colbert,WR,active,seattle-seahawks,605000,2008
36741,445000,130000,Rob Sims,G,active,seattle-seahawks,575000,2008
36742,370000,170250,Brandon Mebane,DT,active,seattle-seahawks,540250,2008
36743,370000,108125,Baraka Atkins,OLB,active,seattle-seahawks,478125,2008
36744,370000,104250,Mansfield Wrotto,G,active,seattle-seahawks,474250,2008
36745,730000,40000,Floyd Womack,G,active,seattle-seahawks,770000,2008
36746,445000,0,Jon Ryan,P,active,seattle-seahawks,445000,2008
36747,370000,40775,Will Herring,LB,active,seattle-seahawks,410775,2008
36748,295000,110375,Red Bryant,DE,active,seattle-seahawks,405375,2008
36749,370000,0,Ben Obomanu,WR,active,seattle-seahawks,370000,2008
36750,370000,0,Jeff Rowe,QB,active,seattle-seahawks,370000,2008
36751,370000,0,Courtney Taylor,WR,active,seattle-seahawks,370000,2008
36752,295000,39500,Owen Schmitt,FB,active,seattle-seahawks,334500,2008
36753,295000,11500,Justin Forsett,RB,active,seattle-seahawks,306500,2008
36754,295000,11412,Brandon Coutu,K,active,seattle-seahawks,306412,2008
36755,295000,1500,David Hawthorne,ILB,active,seattle-seahawks,296500,2008
36756,295000,0,Jordan Kent,WR,active,seattle-seahawks,295000,2008
36757,295000,0,Steve Vallos,C,active,seattle-seahawks,295000,2008
36758,200000,23500,Tyler Schmitt,LB,active,seattle-seahawks,223500,2008
36759,211176,0,Logan Payne,WR,active,seattle-seahawks,211176,2008
36760,950000,0,Charlie Frye,QB,active,seattle-seahawks,950000,2008
36761,5000000,4000000,Walter Jones,T,injured_reserve,seattle-seahawks,9000000,2008
36762,750000,1666666,Patrick Kerney,DE,injured_reserve,seattle-seahawks,2416666,2008
36763,88400,0,Matt Lawrence,RB,practice_squad,seattle-seahawks,88400,2008
36764,0,6900000,Shaun Alexander,RB,dead_cap,seattle-seahawks,6900000,2008
36765,0,3499999,Grant Wistrom,DE,dead_cap,seattle-seahawks,3499999,2008
36766,158750,0,David Greene,QB,dead_cap,seattle-seahawks,158750,2008
36767,67687,0,Courtney Taylor,WR,dead_cap,seattle-seahawks,67687,2008
36768,54561,0,Jordan Kent,WR,dead_cap,seattle-seahawks,54561,2008
36769,34686,0,Steve Vallos,C,dead_cap,seattle-seahawks,34686,2008
36770,10500,0,Ryan Plackemeier,P,dead_cap,seattle-seahawks,10500,2008
36771,5500,0,Logan Payne,WR,dead_cap,seattle-seahawks,5500,2008
36772,5250000,4200000,Matt Hasselbeck,QB,active,seattle-seahawks,9450000,2009
36773,4940000,1400000,Deion Branch,WR,active,seattle-seahawks,6340000,2009
36774,3250000,800000,Nate Burleson,WR,active,seattle-seahawks,4050000,2009
36775,4000000,1666666,Patrick Kerney,DE,active,seattle-seahawks,5666666,2009
36776,5000000,0,Leroy Hill,LB,active,seattle-seahawks,5000000,2009
36777,1000000,4099999,Marcus Trufant,CB,active,seattle-seahawks,5099999,2009
36778,2000000,916667,Deon Grant,S,active,seattle-seahawks,2916667,2009
36779,1000000,2450000,Sean Locklear,T,active,seattle-seahawks,3450000,2009
36780,2200000,1590000,Chris Spencer,G,active,seattle-seahawks,3790000,2009
36781,1950000,750000,Julius Jones,RB,active,seattle-seahawks,2700000,2009
36782,2500000,500000,Colin Cole,DT,active,seattle-seahawks,3000000,2009
36783,2000000,725000,Aaron Curry,OLB,active,seattle-seahawks,2725000,2009
36784,1750000,400000,Seneca Wallace,QB,active,seattle-seahawks,2150000,2009
36785,2000000,0,Cory Redding,DE,active,seattle-seahawks,2000000,2009
36786,1350000,375000,Jordan Babineaux,S,active,seattle-seahawks,1725000,2009
36787,1500000,375000,Olindo Mare,K,active,seattle-seahawks,1875000,2009
36788,1000000,718750,Edgerrin James,RB,active,seattle-seahawks,1718750,2009
36789,695000,1842500,Kelly Jennings,CB,active,seattle-seahawks,2537500,2009
36790,385000,1630000,Lawrence Jackson,DE,active,seattle-seahawks,2015000,2009
36791,1010000,0,Rob Sims,G,active,seattle-seahawks,1010000,2009
36792,423000,435000,John Carlson,TE,active,seattle-seahawks,858000,2009
36793,535000,495000,Darryl Tapp,DE,active,seattle-seahawks,1030000,2009
36794,460000,220000,Josh Wilson,CB,active,seattle-seahawks,680000,2009
36795,310000,362500,Max Unger,C,active,seattle-seahawks,672500,2009
36796,535000,105000,Jon Ryan,P,active,seattle-seahawks,640000,2009
36797,460000,170250,Brandon Mebane,DT,active,seattle-seahawks,630250,2009
36798,460000,104250,Mansfield Wrotto,G,active,seattle-seahawks,564250,2009
36799,460000,40775,Will Herring,LB,active,seattle-seahawks,500775,2009
36800,385000,110375,Red Bryant,DE,active,seattle-seahawks,495375,2009
36801,310000,170187,Deon Butler,WR,active,seattle-seahawks,480187,2009
36802,385000,39500,Owen Schmitt,FB,active,seattle-seahawks,424500,2009
36803,385000,11500,Justin Forsett,RB,active,seattle-seahawks,396500,2009
36804,385000,1500,David Hawthorne,ILB,active,seattle-seahawks,386500,2009
36805,385000,0,Ben Obomanu,WR,active,seattle-seahawks,385000,2009
36806,385000,0,Steve Vallos,C,active,seattle-seahawks,385000,2009
36807,310000,28562,Mike Teel,QB,active,seattle-seahawks,338562,2009
36808,310000,10137,Cameron Morrah,TE,active,seattle-seahawks,320137,2009
36809,310000,1500,Michael Bennett,DE,active,seattle-seahawks,311500,2009
36810,310000,0,Roy Lewis,CB,active,seattle-seahawks,310000,2009
36811,243529,0,Travis Fisher,CB,active,seattle-seahawks,243529,2009
36812,200588,0,Mike Gibson,C,active,seattle-seahawks,200588,2009
36813,18235,0,Trevor Canfield,G,active,seattle-seahawks,18235,2009
36814,6200000,4000000,Walter Jones,T,injured_reserve,seattle-seahawks,10200000,2009
36815,1350000,2513332,Lofa Tatupa,LB,injured_reserve,seattle-seahawks,3863332,2009
36816,335000,0,Kevin Houser,LS,injured_reserve,seattle-seahawks,335000,2009
36817,176800,0,Brian De La Puente,C,practice_squad,seattle-seahawks,176800,2009
36818,88400,0,Logan Payne,WR,practice_squad,seattle-seahawks,88400,2009
36819,88400,0,Blake Schlueter,C,practice_squad,seattle-seahawks,88400,2009
36820,4600000,0,Julian Peterson,LB,dead_cap,seattle-seahawks,4600000,2009
36821,0,400000,T.J. Duckett,RB,dead_cap,seattle-seahawks,400000,2009
36822,307500,0,Chris Henry,RB,dead_cap,seattle-seahawks,307500,2009
36823,108125,0,Baraka Atkins,OLB,dead_cap,seattle-seahawks,108125,2009
36824,70500,0,Tyler Schmitt,LB,dead_cap,seattle-seahawks,70500,2009
36825,11412,0,Brandon Coutu,K,dead_cap,seattle-seahawks,11412,2009
36826,10500,0,Ryan Plackemeier,P,dead_cap,seattle-seahawks,10500,2009
36827,3750,0,William Robinson,T,dead_cap,seattle-seahawks,3750,2009
36828,395000,11022500,Aaron Curry,OLB,active,seattle-seahawks,11417500,2010
36829,5450000,2450000,Sean Locklear,T,active,seattle-seahawks,7900000,2010
36830,1450000,6433332,Lofa Tatupa,LB,active,seattle-seahawks,7883332,2010
36831,1100000,7099999,Marcus Trufant,CB,active,seattle-seahawks,8199999,2010
36832,5750000,1000000,Matt Hasselbeck,QB,active,seattle-seahawks,6750000,2010
36833,2000000,2000000,Charlie Whitehurst,QB,active,seattle-seahawks,4000000,2010
36834,3250000,500000,Colin Cole,DT,active,seattle-seahawks,3750000,2010
36835,2814000,0,Olindo Mare,K,active,seattle-seahawks,2814000,2010
36836,320000,2280000,Russell Okung,LT,active,seattle-seahawks,2600000,2010
36837,2420000,0,Chris Spencer,G,active,seattle-seahawks,2420000,2010
36838,1150000,1842500,Kelly Jennings,CB,active,seattle-seahawks,2992500,2010
36839,2000000,0,Leroy Hill,LB,active,seattle-seahawks,2000000,2010
36840,1759000,0,Kevin Vickerson,DT,active,seattle-seahawks,1759000,2010
36841,1759000,0,Leon Washington,RB,active,seattle-seahawks,1759000,2010
36842,320000,1280000,Earl Thomas,FS,active,seattle-seahawks,1600000,2010
36843,1000000,580000,Jon Ryan,P,active,seattle-seahawks,1580000,2010
36844,1101000,170250,Brandon Mebane,DT,active,seattle-seahawks,1271250,2010
36845,1250000,0,Jordan Babineaux,S,active,seattle-seahawks,1250000,2010
36846,395000,847500,Max Unger,C,active,seattle-seahawks,1242500,2010
36847,521750,435000,John Carlson,TE,active,seattle-seahawks,956750,2010
36848,885000,0,Marshawn Lynch,RB,active,seattle-seahawks,885000,2010
36849,630000,84375,Michael Robinson,FB,active,seattle-seahawks,714375,2010
36850,704117,0,Brandon Stokley,WR,active,seattle-seahawks,704117,2010
36851,630000,50000,Matt McCoy,LB,active,seattle-seahawks,680000,2010
36852,545000,125000,Mike Williams,WR,active,seattle-seahawks,670000,2010
36853,630000,0,J.P. Losman,QB,active,seattle-seahawks,630000,2010
36854,630000,0,Ruvell Martin,WR,active,seattle-seahawks,630000,2010
36855,550000,40775,Will Herring,LB,active,seattle-seahawks,590775,2010
36856,583000,0,Kentwan Balmer,DE,active,seattle-seahawks,583000,2010
36857,470000,110375,Red Bryant,DE,active,seattle-seahawks,580375,2010
36858,320000,250000,Golden Tate,WR,active,seattle-seahawks,570000,2010
36859,395000,170187,Deon Butler,WR,active,seattle-seahawks,565187,2010
36860,545000,0,Mansfield Wrotto,G,active,seattle-seahawks,545000,2010
36861,500000,0,Brandon Jones,WR,active,seattle-seahawks,500000,2010
36862,470000,11500,Justin Forsett,RB,active,seattle-seahawks,481500,2010
36863,470000,0,Breno Giacomini,RT,active,seattle-seahawks,470000,2010
36864,466760,0,Jay Richardson,DE,active,seattle-seahawks,466760,2010
36865,320000,125875,Walter Thurmond,FS,active,seattle-seahawks,445875,2010
36866,395000,10137,Cameron Morrah,TE,active,seattle-seahawks,405137,2010
36867,320000,53402,Kam Chancellor,SS,active,seattle-seahawks,373402,2010
36868,320000,26212,Anthony McCoy,TE,active,seattle-seahawks,346212,2010
36869,341000,0,Paul Fanaika,G,active,seattle-seahawks,341000,2010
36870,320000,11898,Dexter Davis,DE,active,seattle-seahawks,331898,2010
36871,320000,10737,Jameson Konz,OLB,active,seattle-seahawks,330737,2010
36872,325294,0,Mike Gibson,C,active,seattle-seahawks,325294,2010
36873,320000,0,Marcus Brown,CB,active,seattle-seahawks,320000,2010
36874,320000,0,Clifton Geathers,DE,active,seattle-seahawks,320000,2010
36875,320000,0,Joe Pawelek,LB,active,seattle-seahawks,320000,2010
36876,320000,0,Josh Pinkard,CB,active,seattle-seahawks,320000,2010
36877,240000,0,Roy Lewis,CB,active,seattle-seahawks,240000,2010
36878,2956000,0,Stacy Andrews,G,active,seattle-seahawks,2956000,2010
36879,320000,0,Lemuel Jeanpierre,C,active,seattle-seahawks,320000,2010
36880,1500000,0,Chris Baker,TE,injured_reserve,seattle-seahawks,1500000,2010
36881,88400,0,Brian De La Puente,C,practice_squad,seattle-seahawks,88400,2010
36882,88400,0,Lemuel Jeanpierre,C,practice_squad,seattle-seahawks,88400,2010
36883,9300003,0,Patrick Kerney,DE,dead_cap,seattle-seahawks,9300003,2010
36884,6245000,400000,T.J. Houshmandzadeh,WR,dead_cap,seattle-seahawks,6645000,2010
36885,1916667,0,Deon Grant,S,dead_cap,seattle-seahawks,1916667,2010
36886,0,1200000,T.J. Duckett,RB,dead_cap,seattle-seahawks,1200000,2010
36887,0,1630000,Lawrence Jackson,DE,dead_cap,seattle-seahawks,1630000,2010
36888,700000,0,Julius Jones,RB,dead_cap,seattle-seahawks,700000,2010
36889,0,400000,Walter Jones,T,dead_cap,seattle-seahawks,400000,2010
36890,307500,0,Chris Henry,RB,dead_cap,seattle-seahawks,307500,2010
36891,220000,0,Josh Wilson,CB,dead_cap,seattle-seahawks,220000,2010
36892,0,111262,E.J. Wilson,DE,dead_cap,seattle-seahawks,111262,2010
36893,108125,0,Baraka Atkins,OLB,dead_cap,seattle-seahawks,108125,2010
36894,104250,0,Mansfield Wrotto,G,dead_cap,seattle-seahawks,104250,2010
36895,92941,0,Evan Smith,C,dead_cap,seattle-seahawks,92941,2010
36896,85686,0,Mike Teel,QB,dead_cap,seattle-seahawks,85686,2010
36897,31986,0,Courtney Greene,S,dead_cap,seattle-seahawks,31986,2010
36898,22824,0,Brandon Coutu,K,dead_cap,seattle-seahawks,22824,2010
36899,20800,0,Nick Reed,DE,dead_cap,seattle-seahawks,20800,2010
36900,5000,0,Jeff Byers,C,dead_cap,seattle-seahawks,5000,2010
36901,1500,0,Michael Bennett,DE,dead_cap,seattle-seahawks,1500,2010
36902,1400000,9480000,Russell Okung,LT,active,seattle-seahawks,10880000,2011
36903,4000000,333333,Robert Gallery,T,active,seattle-seahawks,4333333,2011
36904,4000000,200000,Brandon Mebane,DT,active,seattle-seahawks,4200000,2011
36905,625000,3441075,Earl Thomas,FS,active,seattle-seahawks,4066075,2011
36906,4000000,0,Charlie Whitehurst,QB,active,seattle-seahawks,4000000,2011
36907,2300000,1285000,Chris Clemons,DE,active,seattle-seahawks,3585000,2011
36908,2000000,1250000,Tarvaris Jackson,QB,active,seattle-seahawks,3250000,2011
36909,2000000,1200000,Sidney Rice,WR,active,seattle-seahawks,3200000,2011
36910,1750000,1375000,Mike Williams,WR,active,seattle-seahawks,3125000,2011
36911,2500000,550000,Alan Branch,DT,active,seattle-seahawks,3050000,2011
36912,2000000,1000000,Zach Miller,TE,active,seattle-seahawks,3000000,2011
36913,2000000,375000,Leon Washington,RB,active,seattle-seahawks,2375000,2011
36914,1100000,166667,Ben Obomanu,WR,active,seattle-seahawks,1266667,2011
36915,2140000,0,Marshawn Lynch,RB,active,seattle-seahawks,2140000,2011
36916,375000,1014364,James Carpenter,G,active,seattle-seahawks,1389364,2011
36917,1000000,350000,Michael Robinson,FB,active,seattle-seahawks,1350000,2011
36918,1100000,105000,Jon Ryan,P,active,seattle-seahawks,1205000,2011
36919,1200000,0,Tyler Polumbus,LT,active,seattle-seahawks,1200000,2011
36920,900000,225000,David Hawthorne,ILB,active,seattle-seahawks,1125000,2011
36921,620500,435000,John Carlson,TE,active,seattle-seahawks,1055500,2011
36922,480000,369500,Max Unger,C,active,seattle-seahawks,849500,2011
36923,685000,100000,Leroy Hill,LB,active,seattle-seahawks,785000,2011
36924,600000,110375,Red Bryant,DE,active,seattle-seahawks,710375,2011
36925,450000,250000,Golden Tate,WR,active,seattle-seahawks,700000,2011
36926,525000,170187,Deon Butler,WR,active,seattle-seahawks,695187,2011
36927,685000,0,Paul McQuistan,LT,active,seattle-seahawks,685000,2011
36928,640000,0,Allen Barbre,G,active,seattle-seahawks,640000,2011
36929,640000,0,Chris White,C,active,seattle-seahawks,640000,2011
36930,600000,11500,Justin Forsett,RB,active,seattle-seahawks,611500,2011
36931,600000,0,Kennard Cox,CB,active,seattle-seahawks,600000,2011
36932,450000,125875,Walter Thurmond,FS,active,seattle-seahawks,575875,2011
36933,555000,0,Breno Giacomini,RT,active,seattle-seahawks,555000,2011
36934,685000,25000,Matt McCoy,LB,active,seattle-seahawks,710000,2011
36935,525000,10137,Cameron Morrah,TE,active,seattle-seahawks,535137,2011
36936,375000,159375,John Moffitt,G,active,seattle-seahawks,534375,2011
36937,810000,50000,Jordan Babineaux,S,active,seattle-seahawks,860000,2011
36938,685000,0,Atari Bigby,S,active,seattle-seahawks,685000,2011
36939,685000,0,Heath Farwell,ILB,active,seattle-seahawks,685000,2011
36940,525000,0,Paul Fanaika,G,active,seattle-seahawks,525000,2011
36941,525000,0,Roy Lewis,CB,active,seattle-seahawks,525000,2011
36942,450000,53402,Kam Chancellor,SS,active,seattle-seahawks,503402,2011
36943,375000,121500,K.J. Wright,OLB,active,seattle-seahawks,496500,2011
36944,375000,116065,Kris Durham,WR,active,seattle-seahawks,491065,2011
36945,450000,26212,Anthony McCoy,TE,active,seattle-seahawks,476212,2011
36946,450000,11898,Dexter Davis,DE,active,seattle-seahawks,461898,2011
36947,450000,0,Clinton McDonald,DT,active,seattle-seahawks,450000,2011
36948,450000,0,Al Woods,DT,active,seattle-seahawks,450000,2011
36949,375000,45606,Richard Sherman,CB,active,seattle-seahawks,420606,2011
36950,405000,0,Clint Gresham,LS,active,seattle-seahawks,405000,2011
36951,375000,28363,Byron Maxwell,CB,active,seattle-seahawks,403363,2011
36952,375000,11475,Malcolm Smith,OLB,active,seattle-seahawks,386475,2011
36953,375000,5833,Doug Baldwin,WR,active,seattle-seahawks,380833,2011
36954,375000,5000,Jeron Johnson,SS,active,seattle-seahawks,380000,2011
36955,375000,0,Brandon Browner,CB,active,seattle-seahawks,375000,2011
36956,375000,0,Lemuel Jeanpierre,C,active,seattle-seahawks,375000,2011
36957,375000,0,Jameson Konz,OLB,active,seattle-seahawks,375000,2011
36958,375000,0,Ricardo Lockette,WR,active,seattle-seahawks,375000,2011
36959,375000,0,Michael Morgan,OLB,active,seattle-seahawks,375000,2011
36960,330000,0,Joe Pawelek,LB,active,seattle-seahawks,330000,2011
36961,291176,0,Chris Maragos,FS,active,seattle-seahawks,291176,2011
36962,123529,0,Mike Gibson,C,active,seattle-seahawks,123529,2011
36963,3000000,4349999,Marcus Trufant,CB,injured_reserve,seattle-seahawks,7349999,2011
36964,96900,0,Chris Maragos,FS,practice_squad,seattle-seahawks,96900,2011
36965,51300,0,Paul Fanaika,G,practice_squad,seattle-seahawks,51300,2011
36966,4800000,0,Sean Locklear,T,dead_cap,seattle-seahawks,4800000,2011
36967,0,7628823,Aaron Curry,OLB,dead_cap,seattle-seahawks,7628823,2011
36968,2033334,0,Deon Grant,S,dead_cap,seattle-seahawks,2033334,2011
36969,0,3260000,Lawrence Jackson,DE,dead_cap,seattle-seahawks,3260000,2011
36970,1666666,0,Lofa Tatupa,LB,dead_cap,seattle-seahawks,1666666,2011
36971,1400000,0,Julius Jones,RB,dead_cap,seattle-seahawks,1400000,2011
36972,0,1200000,T.J. Houshmandzadeh,WR,dead_cap,seattle-seahawks,1200000,2011
36973,1125000,0,Jordan Babineaux,S,dead_cap,seattle-seahawks,1125000,2011
36974,500000,0,Colin Cole,DT,dead_cap,seattle-seahawks,500000,2011
36975,400000,0,Seneca Wallace,QB,dead_cap,seattle-seahawks,400000,2011
36976,0,333786,E.J. Wilson,DE,dead_cap,seattle-seahawks,333786,2011
36977,0,200000,Kelly Jennings,CB,dead_cap,seattle-seahawks,200000,2011
36978,62400,0,Nick Reed,DE,dead_cap,seattle-seahawks,62400,2011
36979,0,44633,Mark LeGree,S,dead_cap,seattle-seahawks,44633,2011
36980,0,40166,Michael Huey,G,dead_cap,seattle-seahawks,40166,2011
36981,35294,0,Dominique Byrd,T,dead_cap,seattle-seahawks,35294,2011
36982,32211,0,Jameson Konz,OLB,dead_cap,seattle-seahawks,32211,2011
36983,0,25000,Ryan Sims,DT,dead_cap,seattle-seahawks,25000,2011
36984,0,22966,Lazarius Levingston,DT,dead_cap,seattle-seahawks,22966,2011
36985,333,0,Ron Parker,FS,dead_cap,seattle-seahawks,333,2011
36986,6480000,4480000,Russell Okung,LT,active,seattle-seahawks,10960000,2012
36987,7000000,1200000,Sidney Rice,WR,active,seattle-seahawks,8200000,2012
36988,6000000,1000000,Zach Miller,TE,active,seattle-seahawks,7000000,2012
36989,4000000,1500000,Marshawn Lynch,RB,active,seattle-seahawks,5500000,2012
36990,3000000,1550000,Alan Branch,DT,active,seattle-seahawks,4550000,2012
36991,3000000,1500000,Jason Jones,DE,active,seattle-seahawks,4500000,2012
36992,4000000,200000,Brandon Mebane,DT,active,seattle-seahawks,4200000,2012
36993,2000000,2166667,Chris Clemons,DE,active,seattle-seahawks,4166667,2012
36994,3000000,1000000,Red Bryant,DE,active,seattle-seahawks,4000000,2012
36995,2000000,2000000,Matt Flynn,QB,active,seattle-seahawks,4000000,2012
36996,2500000,1462500,Max Unger,C,active,seattle-seahawks,3962500,2012
36997,2000000,1375000,Leon Washington,RB,active,seattle-seahawks,3375000,2012
36998,1500000,1000000,Michael Robinson,FB,active,seattle-seahawks,2500000,2012
36999,1500000,750000,Breno Giacomini,RT,active,seattle-seahawks,2250000,2012
37000,1000000,848215,Earl Thomas,FS,active,seattle-seahawks,1848215,2012
37001,722341,1014364,James Carpenter,G,active,seattle-seahawks,1736705,2012
37002,390000,1308582,Bruce Irvin,OLB,active,seattle-seahawks,1698582,2012
37003,1250000,375000,Paul McQuistan,LT,active,seattle-seahawks,1625000,2012
37004,1300000,200000,Leroy Hill,LB,active,seattle-seahawks,1500000,2012
37005,1200000,105000,Jon Ryan,P,active,seattle-seahawks,1305000,2012
37006,1000000,300000,Marcus Trufant,CB,active,seattle-seahawks,1300000,2012
37007,1260000,0,Steven Hauschka,K,active,seattle-seahawks,1260000,2012
37008,825000,400000,Frank Omiyale,T,active,seattle-seahawks,1225000,2012
37009,1000000,166667,Heath Farwell,ILB,active,seattle-seahawks,1166667,2012
37010,540000,250000,Golden Tate,WR,active,seattle-seahawks,790000,2012
37011,390000,393236,Bobby Wagner,ILB,active,seattle-seahawks,783236,2012
37012,700000,0,Allen Barbre,G,active,seattle-seahawks,700000,2012
37013,700000,0,Ryan Longwell,K,active,seattle-seahawks,700000,2012
37014,540000,125875,Walter Thurmond,FS,active,seattle-seahawks,665875,2012
37015,505000,159375,John Moffitt,G,active,seattle-seahawks,664375,2012
37016,540000,53402,Kam Chancellor,SS,active,seattle-seahawks,593402,2012
37017,465000,121500,K.J. Wright,OLB,active,seattle-seahawks,586500,2012
37018,540000,26212,Anthony McCoy,TE,active,seattle-seahawks,566212,2012
37019,390000,154868,Russell Wilson,QB,active,seattle-seahawks,544868,2012
37020,825000,65000,Braylon Edwards,WR,active,seattle-seahawks,890000,2012
37021,540000,0,Chris Maragos,FS,active,seattle-seahawks,540000,2012
37022,540000,0,Clinton McDonald,DT,active,seattle-seahawks,540000,2012
37023,465000,45606,Richard Sherman,CB,active,seattle-seahawks,510606,2012
37024,505900,0,Michael Person,G,active,seattle-seahawks,505900,2012
37025,390000,114114,Robert Turbin,RB,active,seattle-seahawks,504114,2012
37026,490000,11898,Dexter Davis,DE,active,seattle-seahawks,501898,2012
37027,390000,108716,Jaye Howard,DE,active,seattle-seahawks,498716,2012
37028,465000,28363,Byron Maxwell,CB,active,seattle-seahawks,493363,2012
37029,490000,0,Clint Gresham,LS,active,seattle-seahawks,490000,2012
37030,465000,11475,Malcolm Smith,OLB,active,seattle-seahawks,476475,2012
37031,465000,5833,Doug Baldwin,WR,active,seattle-seahawks,470833,2012
37032,465000,5000,Jeron Johnson,SS,active,seattle-seahawks,470000,2012
37033,465000,0,Allen Bradford,ILB,active,seattle-seahawks,465000,2012
37034,465000,0,Brandon Browner,CB,active,seattle-seahawks,465000,2012
37035,465000,0,Lemuel Jeanpierre,C,active,seattle-seahawks,465000,2012
37036,465000,0,Michael Morgan,OLB,active,seattle-seahawks,465000,2012
37037,390000,31279,Jeremy Lane,CB,active,seattle-seahawks,421279,2012
37038,390000,27515,Winston Guy,FS,active,seattle-seahawks,417515,2012
37039,390000,14212,J.R. Sweezy,G,active,seattle-seahawks,404212,2012
37040,390000,12358,Greg Scruggs,DE,active,seattle-seahawks,402358,2012
37041,390000,0,Rishaw  Johnson,G,active,seattle-seahawks,390000,2012
37042,390000,0,Jermaine Kearse,WR,active,seattle-seahawks,390000,2012
37043,390000,0,Sean McGrath,TE,active,seattle-seahawks,390000,2012
37044,390000,0,Deshawn Shead,FS,active,seattle-seahawks,390000,2012
37045,615000,0,Deon Butler,WR,active,seattle-seahawks,615000,2012
37046,2000000,166667,Ben Obomanu,WR,injured_reserve,seattle-seahawks,2166667,2012
37047,615000,10137,Cameron Morrah,TE,injured_reserve,seattle-seahawks,625137,2012
37048,465000,0,Charly Martin,WR,injured_reserve,seattle-seahawks,465000,2012
37049,0,19673823,Aaron Curry,OLB,dead_cap,seattle-seahawks,19673823,2012
37050,0,8000002,Marcus Trufant,CB,dead_cap,seattle-seahawks,8000002,2012
37051,3333334,0,Lofa Tatupa,LB,dead_cap,seattle-seahawks,3333334,2012
37052,1000000,0,Colin Cole,DT,dead_cap,seattle-seahawks,1000000,2012
37053,750000,0,Tarvaris Jackson,QB,dead_cap,seattle-seahawks,750000,2012
37054,0,666668,Robert Gallery,T,dead_cap,seattle-seahawks,666668,2012
37055,170187,0,Deon Butler,WR,dead_cap,seattle-seahawks,170187,2012
37056,0,154753,Kris Durham,WR,dead_cap,seattle-seahawks,154753,2012
37057,0,133899,Mark LeGree,S,dead_cap,seattle-seahawks,133899,2012
37058,0,125000,Mike Williams,WR,dead_cap,seattle-seahawks,125000,2012
37059,100000,0,Taitusi Lutui,G,dead_cap,seattle-seahawks,100000,2012
37060,0,80334,Michael Huey,G,dead_cap,seattle-seahawks,80334,2012
37061,0,65000,Terrell Owens,WR,dead_cap,seattle-seahawks,65000,2012
37062,47000,0,Korey Toomer,ILB,dead_cap,seattle-seahawks,47000,2012
37063,0,45933,Lazarius Levingston,DT,dead_cap,seattle-seahawks,45933,2012
37064,10137,0,Cameron Morrah,TE,dead_cap,seattle-seahawks,10137,2012
37065,667,0,Ron Parker,FS,dead_cap,seattle-seahawks,667,2012
37066,6800000,4200000,Zach Miller,TE,active,seattle-seahawks,11000000,2013
37067,7060000,4480000,Russell Okung,LT,active,seattle-seahawks,11540000,2013
37068,7000000,1500000,Marshawn Lynch,RB,active,seattle-seahawks,8500000,2013
37069,6000000,2166667,Chris Clemons,DE,active,seattle-seahawks,8166667,2013
37070,6600000,1000000,Red Bryant,DE,active,seattle-seahawks,7600000,2013
37071,4900000,1100000,Max Unger,C,active,seattle-seahawks,6000000,2013
37072,5000000,200000,Brandon Mebane,DT,active,seattle-seahawks,5200000,2013
37073,2500000,2400000,Percy Harvin,WR,active,seattle-seahawks,4900000,2013
37074,3000000,1800000,Michael Bennett,DE,active,seattle-seahawks,4800000,2013
37075,3500000,1250000,Breno Giacomini,RT,active,seattle-seahawks,4750000,2013
37076,2825000,1053402,Kam Chancellor,SS,active,seattle-seahawks,3878402,2013
37077,1500000,2250000,Cliff Avril,DE,active,seattle-seahawks,3750000,2013
37078,3000000,375000,Paul McQuistan,LT,active,seattle-seahawks,3375000,2013
37079,2050000,848215,Earl Thomas,FS,active,seattle-seahawks,2898215,2013
37080,1069682,1014364,James Carpenter,G,active,seattle-seahawks,2084046,2013
37081,622946,1308582,Bruce Irvin,OLB,active,seattle-seahawks,1931528,2013
37082,1500000,166667,Heath Farwell,ILB,active,seattle-seahawks,1666667,2013
37083,1300000,105000,Jon Ryan,P,active,seattle-seahawks,1405000,2013
37084,585809,393236,Bobby Wagner,ILB,active,seattle-seahawks,979045,2013
37085,700000,255000,Chris Maragos,FS,active,seattle-seahawks,955000,2013
37086,630000,270000,O'Brien Schofield,OLB,active,seattle-seahawks,900000,2013
37087,630000,250000,Golden Tate,WR,active,seattle-seahawks,880000,2013
37088,840000,0,Tarvaris Jackson,QB,active,seattle-seahawks,840000,2013
37089,555000,218756,Brandon Browner,CB,active,seattle-seahawks,773756,2013
37090,630000,137500,Clint Gresham,LS,active,seattle-seahawks,767500,2013
37091,526217,154868,Russell Wilson,QB,active,seattle-seahawks,681085,2013
37092,555000,121500,K.J. Wright,OLB,active,seattle-seahawks,676500,2013
37093,715000,0,Kellen Davis,TE,active,seattle-seahawks,715000,2013
37094,630000,26212,Anthony McCoy,TE,active,seattle-seahawks,656212,2013
37095,715000,65000,Steven Hauschka,K,active,seattle-seahawks,780000,2013
37096,405000,208533,Christine Michael,RB,active,seattle-seahawks,613533,2013
37097,481764,125875,Walter Thurmond,FS,active,seattle-seahawks,607639,2013
37098,840000,50000,Tony McDaniel,DT,active,seattle-seahawks,890000,2013
37099,555000,45606,Richard Sherman,CB,active,seattle-seahawks,600606,2013
37100,480000,114114,Robert Turbin,RB,active,seattle-seahawks,594114,2013
37101,630000,0,Clinton McDonald,DT,active,seattle-seahawks,630000,2013
37102,555000,28363,Byron Maxwell,CB,active,seattle-seahawks,583363,2013
37103,555000,11475,Malcolm Smith,OLB,active,seattle-seahawks,566475,2013
37104,555000,5833,Doug Baldwin,WR,active,seattle-seahawks,560833,2013
37105,555000,5000,Jeron Johnson,SS,active,seattle-seahawks,560000,2013
37106,555000,0,Lemuel Jeanpierre,C,active,seattle-seahawks,555000,2013
37107,555000,0,Michael Morgan,OLB,active,seattle-seahawks,555000,2013
37108,405000,136035,Jordan Hill,DT,active,seattle-seahawks,541035,2013
37109,480000,31279,Jeremy Lane,CB,active,seattle-seahawks,511279,2013
37110,480000,14212,J.R. Sweezy,G,active,seattle-seahawks,494212,2013
37111,480000,0,Jermaine Kearse,WR,active,seattle-seahawks,480000,2013
37112,405000,44633,Luke Willson,TE,active,seattle-seahawks,449633,2013
37113,405000,24358,Spencer Ware,RB,active,seattle-seahawks,429358,2013
37114,405000,11474,Michael Bowie,RT,active,seattle-seahawks,416474,2013
37115,405000,2000,Alvin Bailey,G,active,seattle-seahawks,407000,2013
37116,405000,0,Derrick Coleman,FB,active,seattle-seahawks,405000,2013
37117,405000,0,Benson Mayowa,DE,active,seattle-seahawks,405000,2013
37118,405000,0,Caylin Hauptmann,G,active,seattle-seahawks,405000,2013
37119,494117,0,Michael Robinson,FB,active,seattle-seahawks,494117,2013
37120,480000,0,Ricardo Lockette,WR,active,seattle-seahawks,480000,2013
37121,480000,0,Deshawn Shead,FS,active,seattle-seahawks,480000,2013
37122,480000,0,Bryan Walters,WR,active,seattle-seahawks,480000,2013
37123,8500000,1200000,Sidney Rice,WR,injured_reserve,seattle-seahawks,9700000,2013
37124,288000,52763,Jesse Williams,DT,injured_reserve,seattle-seahawks,340763,2013
37125,288000,4166,Kenneth Boatright,DE,injured_reserve,seattle-seahawks,292166,2013
37126,288000,0,Chandler Fenner,CB,injured_reserve,seattle-seahawks,288000,2013
37127,405000,0,Korey Toomer,ILB,non_fb_injury,seattle-seahawks,405000,2013
37128,95294,0,John Lotulelei,OLB,practice_squad,seattle-seahawks,95294,2013
37129,78000,0,Ryan Seymour,G,practice_squad,seattle-seahawks,78000,2013
37130,72000,0,Cooper Helfet,TE,practice_squad,seattle-seahawks,72000,2013
37131,42000,0,Arceto Clark,WR,practice_squad,seattle-seahawks,42000,2013
37132,24000,0,Sealver Siliga,DT,practice_squad,seattle-seahawks,24000,2013
37133,18000,0,Adewale Ojomo,DE,practice_squad,seattle-seahawks,18000,2013
37134,12000,0,Jared Smith,G,practice_squad,seattle-seahawks,12000,2013
37135,6000,0,Ricardo Lockette,WR,practice_squad,seattle-seahawks,6000,2013
37136,6000,0,Mike Taylor,OLB,practice_squad,seattle-seahawks,6000,2013
37137,6000,0,Devon Wylie,WR,practice_squad,seattle-seahawks,6000,2013
37138,4000000,0,Matt Flynn,QB,dead_cap,seattle-seahawks,4000000,2013
37139,1000000,0,Antoine Winfield,CB,dead_cap,seattle-seahawks,1000000,2013
37140,750000,0,Leon Washington,RB,dead_cap,seattle-seahawks,750000,2013
37141,0,309506,Kris Durham,WR,dead_cap,seattle-seahawks,309506,2013
37142,215412,0,Deshawn Shead,FS,dead_cap,seattle-seahawks,215412,2013
37143,201176,0,Bryan Walters,WR,dead_cap,seattle-seahawks,201176,2013
37144,175736,0,Stephen Williams,WR,dead_cap,seattle-seahawks,175736,2013
37145,166765,0,B.J. Daniels,WR,dead_cap,seattle-seahawks,166765,2013
37146,166668,0,Ben Obomanu,WR,dead_cap,seattle-seahawks,166668,2013
37147,150000,0,John Moffitt,G,dead_cap,seattle-seahawks,150000,2013
37148,140439,0,Korey Toomer,ILB,dead_cap,seattle-seahawks,140439,2013
37149,130588,0,Perrish Cox,CB,dead_cap,seattle-seahawks,130588,2013
37150,130588,0,Jason Spitz,G,dead_cap,seattle-seahawks,130588,2013
37151,0,125000,Mike Williams,WR,dead_cap,seattle-seahawks,125000,2013
37152,113824,0,Michael Brooks,DT,dead_cap,seattle-seahawks,113824,2013
37153,108716,0,Jaye Howard,DE,dead_cap,seattle-seahawks,108716,2013
37154,84706,0,D'Anthony Smith,DT,dead_cap,seattle-seahawks,84706,2013
37155,67765,0,Greg Herd,WR,dead_cap,seattle-seahawks,67765,2013
37156,65294,0,Michael Person,G,dead_cap,seattle-seahawks,65294,2013
37157,65000,0,Brady Quinn,QB,dead_cap,seattle-seahawks,65000,2013
37158,27515,0,Winston Guy,FS,dead_cap,seattle-seahawks,27515,2013
37159,24000,0,Zach Allen,G,dead_cap,seattle-seahawks,24000,2013
37160,24000,0,Jameson Konz,OLB,dead_cap,seattle-seahawks,24000,2013
37161,18358,0,Ty Powell,ILB,dead_cap,seattle-seahawks,18358,2013
37162,18000,0,Josh Lenz,WR,dead_cap,seattle-seahawks,18000,2013
37163,0,14856,Ryan Seymour,G,dead_cap,seattle-seahawks,14856,2013
37164,12000,0,Tyrone Walker,WR,dead_cap,seattle-seahawks,12000,2013
37165,11901,0,Dexter Davis,DE,dead_cap,seattle-seahawks,11901,2013
37166,11474,0,Jared Smith,G,dead_cap,seattle-seahawks,11474,2013
37167,0,10314,Chris Harper,WR,dead_cap,seattle-seahawks,10314,2013
37168,8333,0,John Lotulelei,OLB,dead_cap,seattle-seahawks,8333,2013
37169,6000,0,Nicholas Edwards,WR,dead_cap,seattle-seahawks,6000,2013
37170,5000,0,Ramon Buchanan,LB,dead_cap,seattle-seahawks,5000,2013
37171,4914,0,Allen Bradford,ILB,dead_cap,seattle-seahawks,4914,2013
37172,4166,0,Craig Wilkins,ILB,dead_cap,seattle-seahawks,4166,2013
37173,8760000,4480000,Russell Okung,LT,active,seattle-seahawks,13240000,2014
37174,7000000,2750000,Cliff Avril,DE,active,seattle-seahawks,9750000,2014
37175,6000000,2000000,Marshawn Lynch,RB,active,seattle-seahawks,8000000,2014
37176,4725000,2648215,Earl Thomas,FS,active,seattle-seahawks,7373215,2014
37177,5000000,1100000,Max Unger,C,active,seattle-seahawks,6100000,2014
37178,4725000,1100000,Kam Chancellor,SS,active,seattle-seahawks,5825000,2014
37179,5500000,200000,Brandon Mebane,DT,active,seattle-seahawks,5700000,2014
37180,2000000,2000000,Michael Bennett,DE,active,seattle-seahawks,4000000,2014
37181,1431000,2245606,Richard Sherman,CB,active,seattle-seahawks,3676606,2014
37182,1400000,1600000,Doug Baldwin,WR,active,seattle-seahawks,3000000,2014
37183,1431000,1121500,K.J. Wright,OLB,active,seattle-seahawks,2552500,2014
37184,1239290,1231607,Bruce Irvin,OLB,active,seattle-seahawks,2470897,2014
37185,1417000,1014364,James Carpenter,G,active,seattle-seahawks,2431364,2014
37186,1000000,1125000,Tony McDaniel,DT,active,seattle-seahawks,2125000,2014
37187,1500000,578125,Kevin Williams,DT,active,seattle-seahawks,2078125,2014
37188,875000,825000,Steven Hauschka,K,active,seattle-seahawks,1700000,2014
37189,1000000,453125,Jeron Johnson,SS,active,seattle-seahawks,1453125,2014
37190,1400000,0,Jon Ryan,P,active,seattle-seahawks,1400000,2014
37191,950000,400000,Anthony McCoy,TE,active,seattle-seahawks,1350000,2014
37192,1100000,150000,Tarvaris Jackson,QB,active,seattle-seahawks,1250000,2014
37193,781618,393236,Bobby Wagner,ILB,active,seattle-seahawks,1174854,2014
37194,750000,137500,Clint Gresham,LS,active,seattle-seahawks,887500,2014
37195,420000,436879,Paul Richardson,WR,active,seattle-seahawks,856879,2014
37196,662434,154868,Russell Wilson,QB,active,seattle-seahawks,817302,2014
37197,558383,208533,Christine Michael,RB,active,seattle-seahawks,766916,2014
37198,570000,114114,Robert Turbin,RB,active,seattle-seahawks,684114,2014
37199,1431000,0,Demarcus Dobbs,DE,active,seattle-seahawks,1431000,2014
37200,645000,28363,Byron Maxwell,CB,active,seattle-seahawks,673363,2014
37201,645000,11475,Malcolm Smith,OLB,active,seattle-seahawks,656475,2014
37202,495000,156035,Jordan Hill,DT,active,seattle-seahawks,651035,2014
37203,645000,0,Michael Morgan,OLB,active,seattle-seahawks,645000,2014
37204,420000,208533,Justin Britt,C,active,seattle-seahawks,628533,2014
37205,570000,31279,Jeremy Lane,CB,active,seattle-seahawks,601279,2014
37206,570000,14212,J.R. Sweezy,G,active,seattle-seahawks,584212,2014
37207,730000,0,O'Brien Schofield,OLB,active,seattle-seahawks,730000,2014
37208,570000,0,Jermaine Kearse,WR,active,seattle-seahawks,570000,2014
37209,570000,0,Ricardo Lockette,WR,active,seattle-seahawks,570000,2014
37210,570000,0,Deshawn Shead,FS,active,seattle-seahawks,570000,2014
37211,495000,51725,Tharold Simon,CB,active,seattle-seahawks,546725,2014
37212,495000,44633,Luke Willson,TE,active,seattle-seahawks,539633,2014
37213,420000,105027,Kevin Norwood,WR,active,seattle-seahawks,525027,2014
37214,645000,0,Steve Schilling,G,active,seattle-seahawks,645000,2014
37215,495000,2000,Alvin Bailey,G,active,seattle-seahawks,497000,2014
37216,495000,0,Derrick Coleman,FB,active,seattle-seahawks,495000,2014
37217,495000,0,B.J. Daniels,WR,active,seattle-seahawks,495000,2014
37218,303000,117563,Cassius Marsh,OLB,active,seattle-seahawks,420563,2014
37219,420000,4000,Garry Gilliam,RT,active,seattle-seahawks,424000,2014
37220,420000,1000,Brock Coyle,ILB,active,seattle-seahawks,421000,2014
37221,420000,0,Marcus Burley,CB,active,seattle-seahawks,420000,2014
37222,420000,0,Cooper Helfet,TE,active,seattle-seahawks,420000,2014
37223,303000,96413,Kevin Pierre-Louis,OLB,active,seattle-seahawks,399413,2014
37224,570000,0,Greg Scruggs,DE,active,seattle-seahawks,570000,2014
37225,495000,0,Patrick Lewis,C,active,seattle-seahawks,495000,2014
37226,341470,0,Will Tukuafu,FB,active,seattle-seahawks,341470,2014
37227,645000,0,Tony Moeaki,TE,active,seattle-seahawks,645000,2014
37228,570000,0,Bryan Walters,WR,active,seattle-seahawks,570000,2014
37229,420000,0,Chris Matthews,WR,active,seattle-seahawks,420000,2014
37230,420000,0,David King,DE,active,seattle-seahawks,420000,2014
37231,495000,0,Keavon Milton,T,active,seattle-seahawks,495000,2014
37232,730000,0,Landon Cohen,DT,active,seattle-seahawks,730000,2014
37233,900000,2987500,Zach Miller,TE,injured_reserve,seattle-seahawks,3887500,2014
37234,1250000,416667,Heath Farwell,ILB,injured_reserve,seattle-seahawks,1666667,2014
37235,570000,0,D'Anthony Smith,DT,injured_reserve,seattle-seahawks,570000,2014
37236,303000,52763,Jesse Williams,DT,injured_reserve,seattle-seahawks,355763,2014
37237,318000,0,David Gilreath,WR,injured_reserve,seattle-seahawks,318000,2014
37238,303000,1666,Mike Taylor,OLB,injured_reserve,seattle-seahawks,304666,2014
37239,420000,22058,Eric Pinkins,SS,non_fb_injury,seattle-seahawks,442058,2014
37240,0,25418,Garrett Scott,LT,non_fb_injury,seattle-seahawks,25418,2014
37241,107100,0,Demitrius Bronson,RB,practice_squad,seattle-seahawks,107100,2014
37242,107100,0,Nate Isles,G,practice_squad,seattle-seahawks,107100,2014
37243,107100,0,Julius Warmsley,DE,practice_squad,seattle-seahawks,107100,2014
37244,94500,0,Drew Nowak,C,practice_squad,seattle-seahawks,94500,2014
37245,44100,0,Ryan Robinson,DE,practice_squad,seattle-seahawks,44100,2014
37246,37800,0,Steven Terrell,CB,practice_squad,seattle-seahawks,37800,2014
37247,18900,0,Allen Bradford,ILB,practice_squad,seattle-seahawks,18900,2014
37248,6300,0,Rashaun Allen,TE,practice_squad,seattle-seahawks,6300,2014
37249,6300,0,Dion Bailey,SS,practice_squad,seattle-seahawks,6300,2014
37250,6300,0,Douglas McNeil,WR,practice_squad,seattle-seahawks,6300,2014
37251,6300,0,Jimmy Staten,DT,practice_squad,seattle-seahawks,6300,2014
37252,4529412,2400000,Percy Harvin,WR,dead_cap,seattle-seahawks,6929412,2014
37253,3000000,0,Red Bryant,DE,dead_cap,seattle-seahawks,3000000,2014
37254,2400000,150000,Sidney Rice,WR,dead_cap,seattle-seahawks,2550000,2014
37255,2166668,0,Chris Clemons,DE,dead_cap,seattle-seahawks,2166668,2014
37256,301765,0,Bryan Walters,WR,dead_cap,seattle-seahawks,301765,2014
37257,253359,0,Andrew McDonald,RT,dead_cap,seattle-seahawks,253359,2014
37258,223341,0,Rashaun Allen,TE,dead_cap,seattle-seahawks,223341,2014
37259,217432,0,Jaye Howard,DE,dead_cap,seattle-seahawks,217432,2014
37260,201176,12358,Greg Scruggs,DE,dead_cap,seattle-seahawks,213534,2014
37261,0,200000,Lemuel Jeanpierre,C,dead_cap,seattle-seahawks,200000,2014
37262,189706,0,Joshua Thomas,CB,dead_cap,seattle-seahawks,189706,2014
37263,183776,0,Allen Bradford,ILB,dead_cap,seattle-seahawks,183776,2014
37264,179735,0,Steven Terrell,CB,dead_cap,seattle-seahawks,179735,2014
37265,150000,0,John Moffitt,G,dead_cap,seattle-seahawks,150000,2014
37266,100800,40075,Jimmy Staten,DT,dead_cap,seattle-seahawks,140875,2014
37267,122277,0,Terrance Parks,SS,dead_cap,seattle-seahawks,122277,2014
37268,107100,0,B.J. Daniels,WR,dead_cap,seattle-seahawks,107100,2014
37269,87212,0,Phil Bates,WR,dead_cap,seattle-seahawks,87212,2014
37270,0,60000,Eric Winston,RT,dead_cap,seattle-seahawks,60000,2014
37271,53471,1666,Dion Bailey,SS,dead_cap,seattle-seahawks,55137,2014
37272,51794,0,Winston Guy,FS,dead_cap,seattle-seahawks,51794,2014
37273,0,44568,Ryan Seymour,G,dead_cap,seattle-seahawks,44568,2014
37274,44100,0,Keavon Milton,T,dead_cap,seattle-seahawks,44100,2014
37275,41718,0,L.J. Fort,ILB,dead_cap,seattle-seahawks,41718,2014
37276,37800,0,Cierre Wood,RB,dead_cap,seattle-seahawks,37800,2014
37277,37074,0,Ty Powell,ILB,dead_cap,seattle-seahawks,37074,2014
37278,34422,0,Jared Smith,G,dead_cap,seattle-seahawks,34422,2014
37279,31006,0,Brett Brackett,TE,dead_cap,seattle-seahawks,31006,2014
37280,0,30942,Chris Harper,WR,dead_cap,seattle-seahawks,30942,2014
37281,25200,0,Stanley Havili,FB,dead_cap,seattle-seahawks,25200,2014
37282,0,25000,Phillip Adams,CB,dead_cap,seattle-seahawks,25000,2014
37283,24706,0,Louchiez Purifoy,CB,dead_cap,seattle-seahawks,24706,2014
37284,0,24358,Spencer Ware,RB,dead_cap,seattle-seahawks,24358,2014
37285,18900,5000,Chris Matthews,WR,dead_cap,seattle-seahawks,23900,2014
37286,16667,0,John Lotulelei,OLB,dead_cap,seattle-seahawks,16667,2014
37287,15300,0,Ron Parker,FS,dead_cap,seattle-seahawks,15300,2014
37288,0,15064,Kiero Small,FB,dead_cap,seattle-seahawks,15064,2014
37289,12600,0,Jalen Saunders,WR,dead_cap,seattle-seahawks,12600,2014
37290,12600,0,Michael Zimmer,ILB,dead_cap,seattle-seahawks,12600,2014
37291,12500,0,Stephen Williams,WR,dead_cap,seattle-seahawks,12500,2014
37292,0,11474,Michael Bowie,RT,dead_cap,seattle-seahawks,11474,2014
37293,8334,0,Craig Wilkins,ILB,dead_cap,seattle-seahawks,8334,2014
37294,6300,0,David Arkin,G,dead_cap,seattle-seahawks,6300,2014
37295,6300,0,Josh Aubrey,SS,dead_cap,seattle-seahawks,6300,2014
37296,6300,0,Kennard Cox,CB,dead_cap,seattle-seahawks,6300,2014
37297,6300,0,Gator Hoskins,TE,dead_cap,seattle-seahawks,6300,2014
37298,6300,0,Ryan Robinson,DE,dead_cap,seattle-seahawks,6300,2014
37299,0,5000,Jackson Jeffcoat,OLB,dead_cap,seattle-seahawks,5000,2014
37300,0,5000,Andu Pulu,RT,dead_cap,seattle-seahawks,5000,2014
37301,0,4166,Kenneth Boatright,DE,dead_cap,seattle-seahawks,4166,2014
37302,0,4166,Chase Dixon,TE,dead_cap,seattle-seahawks,4166,2014
37303,0,2333,Keith Price,QB,dead_cap,seattle-seahawks,2333,2014
37304,0,1666,Mike Taylor,OLB,dead_cap,seattle-seahawks,1666,2014
37305,0,1166,Bronson Irwin,G,dead_cap,seattle-seahawks,1166,2014
37306,0,1000,Jimmy LeGree,CB,dead_cap,seattle-seahawks,1000,2014
37307,10000000,2200000,Richard Sherman,CB,active,seattle-seahawks,12200000,2015
37308,4500000,4000000,Marshawn Lynch,RB,active,seattle-seahawks,8500000,2015
37309,7500000,500000,Cliff Avril,DE,active,seattle-seahawks,8000000,2015
37310,6000000,2000000,Michael Bennett,DE,active,seattle-seahawks,8000000,2015
37311,5500000,1900000,Earl Thomas,FS,active,seattle-seahawks,7400000,2015
37312,4800000,4480000,Russell Okung,LT,active,seattle-seahawks,9280000,2015
37313,700000,6354868,Russell Wilson,QB,active,seattle-seahawks,7054868,2015
37314,5500000,200000,Brandon Mebane,DT,active,seattle-seahawks,5700000,2015
37315,4019117,1100000,Kam Chancellor,SS,active,seattle-seahawks,5119117,2015
37316,3750000,1000000,K.J. Wright,OLB,active,seattle-seahawks,4750000,2015
37317,2800000,1850000,Doug Baldwin,WR,active,seattle-seahawks,4650000,2015
37318,2000000,1325000,Steven Hauschka,K,active,seattle-seahawks,3325000,2015
37319,977427,1993236,Bobby Wagner,ILB,active,seattle-seahawks,2970663,2015
37320,1663935,1231607,Bruce Irvin,OLB,active,seattle-seahawks,2895542,2015
37321,1350000,1250000,Ahtyba Rubin,DT,active,seattle-seahawks,2600000,2015
37322,2356000,0,Jermaine Kearse,WR,active,seattle-seahawks,2356000,2015
37323,1542000,14212,J.R. Sweezy,G,active,seattle-seahawks,1556212,2015
37324,1500000,0,Jon Ryan,P,active,seattle-seahawks,1500000,2015
37325,1250000,250000,Tarvaris Jackson,QB,active,seattle-seahawks,1500000,2015
37326,750000,250000,Michael Morgan,OLB,active,seattle-seahawks,1000000,2015
37327,745000,100000,Clint Gresham,LS,active,seattle-seahawks,845000,2015
37328,577133,208533,Justin Britt,C,active,seattle-seahawks,785666,2015
37329,585000,156035,Jordan Hill,DT,active,seattle-seahawks,741035,2015
37330,660000,31279,Jeremy Lane,CB,active,seattle-seahawks,691279,2015
37331,435000,243586,Frank Clark,DE,active,seattle-seahawks,678586,2015
37332,745000,80000,Demarcus Dobbs,DE,active,seattle-seahawks,825000,2015
37333,745000,80000,Will Tukuafu,FB,active,seattle-seahawks,825000,2015
37334,660000,0,Deshawn Shead,FS,active,seattle-seahawks,660000,2015
37335,435000,196687,Tyler Lockett,WR,active,seattle-seahawks,631687,2015
37336,585000,44633,Luke Willson,TE,active,seattle-seahawks,629633,2015
37337,510000,117563,Cassius Marsh,OLB,active,seattle-seahawks,627563,2015
37338,870000,30000,Fred Jackson,RB,active,seattle-seahawks,900000,2015
37339,510000,96413,Kevin Pierre-Louis,OLB,active,seattle-seahawks,606413,2015
37340,585000,2000,Alvin Bailey,G,active,seattle-seahawks,587000,2015
37341,585000,0,Derrick Coleman,FB,active,seattle-seahawks,585000,2015
37342,585000,0,Patrick Lewis,C,active,seattle-seahawks,585000,2015
37343,585000,0,Kelcie McCray,SS,active,seattle-seahawks,585000,2015
37344,435000,86423,Mark Glowinski,G,active,seattle-seahawks,521423,2015
37345,510000,4000,Garry Gilliam,RT,active,seattle-seahawks,514000,2015
37346,510000,1000,Brock Coyle,ILB,active,seattle-seahawks,511000,2015
37347,510000,0,Marcus Burley,CB,active,seattle-seahawks,510000,2015
37348,510000,0,Cooper Helfet,TE,active,seattle-seahawks,510000,2015
37349,510000,0,Steven Terrell,CB,active,seattle-seahawks,510000,2015
37350,435000,41563,Tye Smith,CB,active,seattle-seahawks,476563,2015
37351,435000,22621,Kristjan Sokoli,G,active,seattle-seahawks,457621,2015
37352,403764,51725,Tharold Simon,CB,active,seattle-seahawks,455489,2015
37353,482058,0,Lemuel Jeanpierre,C,active,seattle-seahawks,482058,2015
37354,333000,0,Mohammed Seisay,CB,active,seattle-seahawks,333000,2015
37355,179117,0,Eric Pinkins,SS,active,seattle-seahawks,179117,2015
37356,179117,0,Kevin Smith,WR,active,seattle-seahawks,179117,2015
37357,150000,0,A.J. Francis,DE,active,seattle-seahawks,150000,2015
37358,131470,0,Chase Coffman,TE,active,seattle-seahawks,131470,2015
37359,116470,0,Bryce Brown,RB,active,seattle-seahawks,116470,2015
37360,103235,0,Christine Michael,RB,active,seattle-seahawks,103235,2015
37361,51176,0,Kasen Williams,WR,active,seattle-seahawks,51176,2015
37362,2900000,5100000,Jimmy Graham,TE,injured_reserve,seattle-seahawks,8000000,2015
37363,634220,436879,Paul Richardson,WR,injured_reserve,seattle-seahawks,1071099,2015
37364,660000,0,Ricardo Lockette,WR,injured_reserve,seattle-seahawks,660000,2015
37365,414352,5000,Thomas Rawls,RB,injured_reserve,seattle-seahawks,419352,2015
37366,412941,0,Nick Moody,ILB,injured_reserve,seattle-seahawks,412941,2015
37367,333000,0,Ryan Robinson,DE,injured_reserve,seattle-seahawks,333000,2015
37368,318000,0,Kona Schwenke,DT,injured_reserve,seattle-seahawks,318000,2015
37369,155294,0,Anthony McCoy,TE,injured_reserve,seattle-seahawks,155294,2015
37370,112200,0,Will Pericak,DT,practice_squad,seattle-seahawks,112200,2015
37371,99000,0,George Farmer,WR,practice_squad,seattle-seahawks,99000,2015
37372,46200,0,Trovon Reed,CB,practice_squad,seattle-seahawks,46200,2015
37373,33000,0,Drew Nowak,C,practice_squad,seattle-seahawks,33000,2015
37374,26400,0,Douglas McNeil,WR,practice_squad,seattle-seahawks,26400,2015
37375,13200,0,Antwan Goodley,WR,practice_squad,seattle-seahawks,13200,2015
37376,6600,0,Justin Hamilton,DT,practice_squad,seattle-seahawks,6600,2015
37377,0,7200000,Percy Harvin,WR,dead_cap,seattle-seahawks,7200000,2015
37378,3500000,1166666,Cary Williams,CB,dead_cap,seattle-seahawks,4666666,2015
37379,0,2200000,Max Unger,C,dead_cap,seattle-seahawks,2200000,2015
37380,0,1000000,Zach Miller,TE,dead_cap,seattle-seahawks,1000000,2015
37381,0,625000,Tony McDaniel,DT,dead_cap,seattle-seahawks,625000,2015
37382,333000,0,B.J. Daniels,WR,dead_cap,seattle-seahawks,333000,2015
37383,307058,0,Drew Nowak,C,dead_cap,seattle-seahawks,307058,2015
37384,300000,5000,Chris Matthews,WR,dead_cap,seattle-seahawks,305000,2015
37385,300000,0,David King,DE,dead_cap,seattle-seahawks,300000,2015
37386,0,208533,Christine Michael,RB,dead_cap,seattle-seahawks,208533,2015
37387,72600,112562,Terry Poole,G,dead_cap,seattle-seahawks,185162,2015
37388,127940,3334,Dion Bailey,SS,dead_cap,seattle-seahawks,131274,2015
37389,0,120225,Jimmy Staten,DT,dead_cap,seattle-seahawks,120225,2015
37390,116470,0,Bryce Brown,RB,dead_cap,seattle-seahawks,116470,2015
37391,0,114114,Robert Turbin,RB,dead_cap,seattle-seahawks,114114,2015
37392,0,112358,Greg Scruggs,DE,dead_cap,seattle-seahawks,112358,2015
37393,0,105526,Jesse Williams,DT,dead_cap,seattle-seahawks,105526,2015
37394,0,105027,Kevin Norwood,WR,dead_cap,seattle-seahawks,105027,2015
37395,99000,0,Kasen Williams,WR,dead_cap,seattle-seahawks,99000,2015
37396,84247,0,DuJuan Harris,RB,dead_cap,seattle-seahawks,84247,2015
37397,0,80000,Will Blackmon,CB,dead_cap,seattle-seahawks,80000,2015
37398,0,80000,Lemuel Jeanpierre,C,dead_cap,seattle-seahawks,80000,2015
37399,0,76254,Garrett Scott,LT,dead_cap,seattle-seahawks,76254,2015
37400,0,75000,Anthony McCoy,TE,dead_cap,seattle-seahawks,75000,2015
37401,46200,22058,Eric Pinkins,SS,dead_cap,seattle-seahawks,68258,2015
37402,66000,0,Kevin Short,CB,dead_cap,seattle-seahawks,66000,2015
37403,66000,0,Kevin Smith,WR,dead_cap,seattle-seahawks,66000,2015
37404,58588,1666,Rod Smith,RB,dead_cap,seattle-seahawks,60254,2015
37405,59400,0,Robert Thomas,DT,dead_cap,seattle-seahawks,59400,2015
37406,52800,0,Rashaun Allen,TE,dead_cap,seattle-seahawks,52800,2015
37407,52800,0,Harold Spears,TE,dead_cap,seattle-seahawks,52800,2015
37408,0,50000,D'Anthony Smith,DT,dead_cap,seattle-seahawks,50000,2015
37409,0,48716,Spencer Ware,RB,dead_cap,seattle-seahawks,48716,2015
37410,0,45192,Kiero Small,FB,dead_cap,seattle-seahawks,45192,2015
37411,36600,0,A.J. Francis,DE,dead_cap,seattle-seahawks,36600,2015
37412,48823,0,Chase Coffman,TE,dead_cap,seattle-seahawks,48823,2015
37413,43823,0,Crezdon Butler,CB,dead_cap,seattle-seahawks,43823,2015
37414,33000,0,Nick Moody,ILB,dead_cap,seattle-seahawks,33000,2015
37415,30000,0,Akeem Davis,SS,dead_cap,seattle-seahawks,30000,2015
37416,26400,0,Justin Hamilton,DT,dead_cap,seattle-seahawks,26400,2015
37417,0,22948,Michael Bowie,RT,dead_cap,seattle-seahawks,22948,2015
37418,0,22621,Obum Gwacham,DE,dead_cap,seattle-seahawks,22621,2015
37419,19800,1166,Alex Singleton,LB,dead_cap,seattle-seahawks,20966,2015
37420,19800,0,Stanley Jean-Baptiste,CB,dead_cap,seattle-seahawks,19800,2015
37421,19800,0,Deshon Foxx,WR,dead_cap,seattle-seahawks,19800,2015
37422,0,13373,Ryan Murphy,FS,dead_cap,seattle-seahawks,13373,2015
37423,13200,0,Tyrell Adams,OLB,dead_cap,seattle-seahawks,13200,2015
37424,13200,0,Douglas McNeil,WR,dead_cap,seattle-seahawks,13200,2015
37425,13200,0,Julius Warmsley,DE,dead_cap,seattle-seahawks,13200,2015
37426,0,10000,Jackson Jeffcoat,OLB,dead_cap,seattle-seahawks,10000,2015
37427,0,10000,Andu Pulu,RT,dead_cap,seattle-seahawks,10000,2015
37428,0,8334,Chase Dixon,TE,dead_cap,seattle-seahawks,8334,2015
37429,6600,0,Antwan Goodley,WR,dead_cap,seattle-seahawks,6600,2015
37430,6600,0,Tyler Slavin,WR,dead_cap,seattle-seahawks,6600,2015
37431,0,5000,Tory Slater,DT,dead_cap,seattle-seahawks,5000,2015
37432,0,5000,Triston Wade,FS,dead_cap,seattle-seahawks,5000,2015
37433,0,4667,Keith Price,QB,dead_cap,seattle-seahawks,4667,2015
37434,0,4168,Kenneth Boatright,DE,dead_cap,seattle-seahawks,4168,2015
37435,0,3500,Trovon Reed,CB,dead_cap,seattle-seahawks,3500,2015
37436,0,3334,Mike Taylor,OLB,dead_cap,seattle-seahawks,3334,2015
37437,0,3333,Kennan Lambert,SS,dead_cap,seattle-seahawks,3333,2015
37438,0,2500,Quayshawn Nealy,ILB,dead_cap,seattle-seahawks,2500,2015
37439,0,2334,Bronson Irwin,G,dead_cap,seattle-seahawks,2334,2015
37440,0,2000,Jesse Davis,T,dead_cap,seattle-seahawks,2000,2015
37441,0,2000,Jimmy LeGree,CB,dead_cap,seattle-seahawks,2000,2015
37442,0,1666,Ronald Martin,SS,dead_cap,seattle-seahawks,1666,2015
37443,0,833,Nate Boyer,LS,dead_cap,seattle-seahawks,833,2015
37444,12342000,6200000,Russell Wilson,QB,active,seattle-seahawks,18542000,2016
37445,12569000,2200000,Richard Sherman,CB,active,seattle-seahawks,14769000,2016
37446,8900000,100000,Jimmy Graham,TE,active,seattle-seahawks,9000000,2016
37447,4000000,4050000,Michael Bennett,DE,active,seattle-seahawks,8050000,2016
37448,1000000,7000000,Doug Baldwin,WR,active,seattle-seahawks,8000000,2016
37449,6000000,500000,Cliff Avril,DE,active,seattle-seahawks,6500000,2016
37450,5250000,1000000,K.J. Wright,OLB,active,seattle-seahawks,6250000,2016
37451,5100000,1000000,Kam Chancellor,SS,active,seattle-seahawks,6100000,2016
37452,3000000,4068750,Bobby Wagner,ILB,active,seattle-seahawks,7068750,2016
37453,2700000,825000,Steven Hauschka,K,active,seattle-seahawks,3525000,2016
37454,2000000,1250000,Jeremy Lane,CB,active,seattle-seahawks,3250000,2016
37455,1000000,2000000,Ahtyba Rubin,DT,active,seattle-seahawks,3000000,2016
37456,800000,1833333,Jermaine Kearse,WR,active,seattle-seahawks,2633333,2016
37457,1671000,44633,Luke Willson,TE,active,seattle-seahawks,1715633,2016
37458,1000000,600000,Jon Ryan,P,active,seattle-seahawks,1600000,2016
37459,450000,1052746,Germain Ifedi,RT,active,seattle-seahawks,1502746,2016
37460,848440,436879,Paul Richardson,WR,active,seattle-seahawks,1285319,2016
37461,800000,200000,Michael Morgan,OLB,active,seattle-seahawks,1000000,2016
37462,800000,200000,Bradley Sowell,LT,active,seattle-seahawks,1000000,2016
37463,734267,208533,Justin Britt,C,active,seattle-seahawks,942800,2016
37464,450000,439024,Jarran Reed,DT,active,seattle-seahawks,889024,2016
37465,604647,243586,Frank Clark,DE,active,seattle-seahawks,848233,2016
37466,675000,50000,Kelcie McCray,SS,active,seattle-seahawks,725000,2016
37467,600000,117563,Cassius Marsh,OLB,active,seattle-seahawks,717563,2016
37468,600000,96413,Kevin Pierre-Louis,OLB,active,seattle-seahawks,696413,2016
37469,675000,0,Brandon Williams,TE,active,seattle-seahawks,675000,2016
37470,675000,0,Neiko Thorpe,CB,active,seattle-seahawks,675000,2016
37471,450000,173116,C.J. Prosise,RB,active,seattle-seahawks,623116,2016
37472,450000,164220,Nick Vannett,TE,active,seattle-seahawks,614220,2016
37473,525000,86423,Mark Glowinski,G,active,seattle-seahawks,611423,2016
37474,450000,161355,Rees Odhiambo,T,active,seattle-seahawks,611355,2016
37475,600000,4000,Garry Gilliam,RT,active,seattle-seahawks,604000,2016
37476,600000,1000,Brock Coyle,ILB,active,seattle-seahawks,601000,2016
37477,985000,0,Tony McDaniel,DT,active,seattle-seahawks,985000,2016
37478,760000,0,Deshawn Shead,FS,active,seattle-seahawks,760000,2016
37479,600000,0,Dewey McDonald,OLB,active,seattle-seahawks,600000,2016
37480,600000,0,Steven Terrell,CB,active,seattle-seahawks,600000,2016
37481,525000,5000,Thomas Rawls,RB,active,seattle-seahawks,530000,2016
37482,450000,46096,Alex Collins,RB,active,seattle-seahawks,496096,2016
37483,450000,25089,Joey Hunt,C,active,seattle-seahawks,475089,2016
37484,450000,6666,George Fant,T,active,seattle-seahawks,456666,2016
37485,450000,5000,Trevone Boykin,QB,active,seattle-seahawks,455000,2016
37486,450000,3333,DeAndre Elliot,CB,active,seattle-seahawks,453333,2016
37487,450000,0,Tanner McEvoy,S,active,seattle-seahawks,450000,2016
37488,317647,0,John Jenkins,DE,active,seattle-seahawks,317647,2016
37489,208235,0,Marcel Reece,FB,active,seattle-seahawks,208235,2016
37490,178823,0,Jeron Johnson,SS,active,seattle-seahawks,178823,2016
37491,92647,0,Ronald Powell,OLB,active,seattle-seahawks,92647,2016
37492,61764,0,Terrence Magee,RT,active,seattle-seahawks,61764,2016
37493,52940,0,J.D. McKissic,RB,active,seattle-seahawks,52940,2016
37494,26470,0,Kasen Williams,WR,active,seattle-seahawks,26470,2016
37495,8000000,1900000,Earl Thomas,FS,injured_reserve,seattle-seahawks,9900000,2016
37496,580000,196687,Tyler Lockett,WR,injured_reserve,seattle-seahawks,776687,2016
37497,525000,0,Mohammed Seisay,CB,injured_reserve,seattle-seahawks,525000,2016
37498,450000,0,Nolan Frese,LS,injured_reserve,seattle-seahawks,450000,2016
37499,447058,0,Will Tukuafu,FB,injured_reserve,seattle-seahawks,447058,2016
37500,381170,63455,Quinton Jefferson,DE,injured_reserve,seattle-seahawks,444625,2016
37501,374288,0,Garrison Smith,DE,injured_reserve,seattle-seahawks,374288,2016
37502,357354,0,Damontre Moore,DE,injured_reserve,seattle-seahawks,357354,2016
37503,348000,0,Tavaris Barnes,DE,injured_reserve,seattle-seahawks,348000,2016
37504,348000,0,Stanley Jean-Baptiste,CB,injured_reserve,seattle-seahawks,348000,2016
37505,333000,0,Brandon Cottom,RB,injured_reserve,seattle-seahawks,333000,2016
37506,333000,0,Tre Madden,RB,injured_reserve,seattle-seahawks,333000,2016
37507,333000,0,Ronnie Shields,TE,injured_reserve,seattle-seahawks,333000,2016
37508,333000,0,Tyler Slavin,WR,injured_reserve,seattle-seahawks,333000,2016
37509,333000,0,Joe Sommers,TE,injured_reserve,seattle-seahawks,333000,2016
37510,185290,0,Troymaine Pope,RB,injured_reserve,seattle-seahawks,185290,2016
37511,75900,0,Justin Hamilton,DT,practice_squad,seattle-seahawks,75900,2016
37512,0,5000000,Marshawn Lynch,RB,dead_cap,seattle-seahawks,5000000,2016
37513,0,2333334,Cary Williams,CB,dead_cap,seattle-seahawks,2333334,2016
37514,1250000,993750,J'Marcus Webb,RT,dead_cap,seattle-seahawks,2243750,2016
37515,397058,258533,Christine Michael,RB,dead_cap,seattle-seahawks,655591,2016
37516,178823,200000,Sealver Siliga,DT,dead_cap,seattle-seahawks,378823,2016
37517,345247,0,Jordan Tripp,ILB,dead_cap,seattle-seahawks,345247,2016
37518,0,337686,Terry Poole,G,dead_cap,seattle-seahawks,337686,2016
37519,0,300000,Chris Clemons,DE,dead_cap,seattle-seahawks,300000,2016
37520,0,210054,Kevin Norwood,WR,dead_cap,seattle-seahawks,210054,2016
37521,208235,0,C.J. Spiller,RB,dead_cap,seattle-seahawks,208235,2016
37522,0,200000,Clint Gresham,LS,dead_cap,seattle-seahawks,200000,2016
37523,0,156035,Jordan Hill,DT,dead_cap,seattle-seahawks,156035,2016
37524,110400,16224,Kenny Lawler,WR,dead_cap,seattle-seahawks,126624,2016
37525,117300,0,Marcus Lucas,TE,dead_cap,seattle-seahawks,117300,2016
37526,117300,0,Will Pericak,DT,dead_cap,seattle-seahawks,117300,2016
37527,117300,0,Tylor Harris,DT,dead_cap,seattle-seahawks,117300,2016
37528,110400,0,Kache Palacio,OLB,dead_cap,seattle-seahawks,110400,2016
37529,103500,0,Kasen Williams,WR,dead_cap,seattle-seahawks,103500,2016
37530,94340,0,George Farmer,WR,dead_cap,seattle-seahawks,94340,2016
37531,39705,51725,Tharold Simon,CB,dead_cap,seattle-seahawks,91430,2016
37532,82800,0,Robert Myers,G,dead_cap,seattle-seahawks,82800,2016
37533,0,80000,Jahri Evans,G,dead_cap,seattle-seahawks,80000,2016
37534,0,67863,Obum Gwacham,DE,dead_cap,seattle-seahawks,67863,2016
37535,62100,0,Pierre Desir,CB,dead_cap,seattle-seahawks,62100,2016
37536,13800,41563,Tye Smith,CB,dead_cap,seattle-seahawks,55363,2016
37537,34500,15624,Zac Brooks,RB,dead_cap,seattle-seahawks,50124,2016
37538,44705,0,Will Tukuafu,FB,dead_cap,seattle-seahawks,44705,2016
37539,0,44116,Eric Pinkins,SS,dead_cap,seattle-seahawks,44116,2016
37540,40270,0,Kelvin Taylor,RB,dead_cap,seattle-seahawks,40270,2016
37541,0,40119,Ryan Murphy,FS,dead_cap,seattle-seahawks,40119,2016
37542,37782,0,Terrence Magee,RT,dead_cap,seattle-seahawks,37782,2016
37543,35294,0,Malliciah Goodman,DE,dead_cap,seattle-seahawks,35294,2016
37544,27600,0,Shaneil Jenkins,DE,dead_cap,seattle-seahawks,27600,2016
37545,26470,0,Taniela Tupou,DT,dead_cap,seattle-seahawks,26470,2016
37546,0,22621,Kristjan Sokoli,G,dead_cap,seattle-seahawks,22621,2016
37547,20700,0,Antwan Goodley,WR,dead_cap,seattle-seahawks,20700,2016
37548,20700,0,Jake Heaps,QB,dead_cap,seattle-seahawks,20700,2016
37549,20700,0,Julian Howsare,LB,dead_cap,seattle-seahawks,20700,2016
37550,20700,0,Malcolm Johnson,FB,dead_cap,seattle-seahawks,20700,2016
37551,13800,0,Sterling Bailey,DE,dead_cap,seattle-seahawks,13800,2016
37552,13800,0,Troymaine Pope,RB,dead_cap,seattle-seahawks,13800,2016
37553,0,10000,Triston Wade,FS,dead_cap,seattle-seahawks,10000,2016
37554,6900,0,Ross Burbank,C,dead_cap,seattle-seahawks,6900,2016
37555,6900,0,Takoby Cofield,T,dead_cap,seattle-seahawks,6900,2016
37556,6900,0,Justin Hamilton,DT,dead_cap,seattle-seahawks,6900,2016
37557,6900,0,Michael Ola,T,dead_cap,seattle-seahawks,6900,2016
37558,6900,0,Rodney Smith,WR,dead_cap,seattle-seahawks,6900,2016
37559,6900,0,Kevin Smith,WR,dead_cap,seattle-seahawks,6900,2016
37560,6900,0,Joel Stave,QB,dead_cap,seattle-seahawks,6900,2016
37561,0,6667,Kennan Lambert,SS,dead_cap,seattle-seahawks,6667,2016
37562,0,5000,Quayshawn Nealy,ILB,dead_cap,seattle-seahawks,5000,2016
37563,0,4000,Jesse Davis,T,dead_cap,seattle-seahawks,4000,2016
37564,0,3334,Ronald Martin,SS,dead_cap,seattle-seahawks,3334,2016
37565,0,3334,Rod Smith,RB,dead_cap,seattle-seahawks,3334,2016
37566,0,2334,Alex Singleton,LB,dead_cap,seattle-seahawks,2334,2016
37567,0,2000,Lars Koht,DT,dead_cap,seattle-seahawks,2000,2016
37568,0,1667,Nate Boyer,LS,dead_cap,seattle-seahawks,1667,2016
37569,0,1666,Christian French,OLB,dead_cap,seattle-seahawks,1666,2016
37570,0,333,Lene Maiava,T,dead_cap,seattle-seahawks,333,2016
37571,6340000,8286666,Russell Wilson,QB,active,seattle-seahawks,14626666,2017
37572,6000000,4768750,Michael Bennett,DE,active,seattle-seahawks,10768750,2017
37573,8500000,1900000,Earl Thomas,FS,active,seattle-seahawks,10400000,2017
37574,7900000,2100000,Jimmy Graham,TE,active,seattle-seahawks,10000000,2017
37575,8069000,0,Sheldon Richardson,DT,active,seattle-seahawks,8069000,2017
37576,4000000,4600000,Bobby Wagner,ILB,active,seattle-seahawks,8600000,2017
37577,2750000,4500000,Luke Joeckel,G,active,seattle-seahawks,7250000,2017
37578,5800000,1000000,K.J. Wright,OLB,active,seattle-seahawks,6800000,2017
37579,4000000,1250000,Jeremy Lane,CB,active,seattle-seahawks,5250000,2017
37580,4976471,0,Duane Brown,LT,active,seattle-seahawks,4976471,2017
37581,775000,3643750,Doug Baldwin,WR,active,seattle-seahawks,4418750,2017
37582,1365000,2197500,Eddie Lacy,RB,active,seattle-seahawks,3562500,2017
37583,891400,1458533,Justin Britt,C,active,seattle-seahawks,2349933,2017
37584,800000,1200000,Bradley McDougald,SS,active,seattle-seahawks,2000000,2017
37585,825687,1052746,Germain Ifedi,RT,active,seattle-seahawks,1878433,2017
37586,1000000,800000,Luke Willson,TE,active,seattle-seahawks,1800000,2017
37587,1000000,600000,Jon Ryan,P,active,seattle-seahawks,1600000,2017
37588,800000,750000,Michael Wilhoite,ILB,active,seattle-seahawks,1550000,2017
37589,1062659,436879,Paul Richardson,WR,active,seattle-seahawks,1499538,2017
37590,800000,487500,Neiko Thorpe,CB,active,seattle-seahawks,1287500,2017
37591,1050000,150000,Deshawn Shead,FS,active,seattle-seahawks,1200000,2017
37592,672256,439024,Jarran Reed,DT,active,seattle-seahawks,1111280,2017
37593,800000,234375,Blair Walsh,K,active,seattle-seahawks,1034375,2017
37594,774294,243586,Frank Clark,DE,active,seattle-seahawks,1017880,2017
37595,690000,300000,Marcus Smith,DE,active,seattle-seahawks,990000,2017
37596,695000,196687,Tyler Lockett,WR,active,seattle-seahawks,891687,2017
37597,850000,0,Matt Tobin,G,active,seattle-seahawks,850000,2017
37598,465000,336642,Ethan Pocic,T,active,seattle-seahawks,801642,2017
37599,562000,164220,Nick Vannett,TE,active,seattle-seahawks,726220,2017
37600,775000,80000,Austin Davis,QB,active,seattle-seahawks,855000,2017
37601,775000,80000,Terence Garvin,ILB,active,seattle-seahawks,855000,2017
37602,465000,189655,Shaquill Griffin,CB,active,seattle-seahawks,654655,2017
37603,465000,181869,Delano Hill,S,active,seattle-seahawks,646869,2017
37604,465000,176572,Amara Darboh,WR,active,seattle-seahawks,641572,2017
37605,465000,168001,Tedric Thompson,S,active,seattle-seahawks,633001,2017
37606,615000,5000,Thomas Rawls,RB,active,seattle-seahawks,620000,2017
37607,615000,0,D.J. Alexander,ILB,active,seattle-seahawks,615000,2017
37608,615000,0,Justin Coleman,CB,active,seattle-seahawks,615000,2017
37609,540000,0,Tanner McEvoy,S,active,seattle-seahawks,540000,2017
37610,540000,0,J.D. McKissic,RB,active,seattle-seahawks,540000,2017
37611,540000,0,Tyler Ott,LS,active,seattle-seahawks,540000,2017
37612,465000,6666,Jordan Roos,G,active,seattle-seahawks,471666,2017
37613,412941,0,Branden Jackson,DE,active,seattle-seahawks,412941,2017
37614,412941,0,Quinton Jefferson,DE,active,seattle-seahawks,412941,2017
37615,370588,0,Byron Maxwell,CB,active,seattle-seahawks,370588,2017
37616,365976,0,Dion Jordan,DE,active,seattle-seahawks,365976,2017
37617,253235,0,Mike Davis,RB,active,seattle-seahawks,253235,2017
37618,164118,0,David Moore,WR,active,seattle-seahawks,164118,2017
37619,127059,0,Joey Hunt,C,active,seattle-seahawks,127059,2017
37620,95294,0,Paul Dawson,OLB,active,seattle-seahawks,95294,2017
37621,95294,0,Garrison Smith,DE,active,seattle-seahawks,95294,2017
37622,82059,0,Michael Tyson,CB,active,seattle-seahawks,82059,2017
37623,27353,0,Tyrone Swoopes,TE,active,seattle-seahawks,27353,2017
37624,11431000,2200000,Richard Sherman,CB,injured_reserve,seattle-seahawks,13631000,2017
37625,3000000,3743744,Kam Chancellor,SS,injured_reserve,seattle-seahawks,6743744,2017
37626,4500000,1000000,Cliff Avril,DE,injured_reserve,seattle-seahawks,5500000,2017
37627,775000,200000,Oday Aboushi,G,injured_reserve,seattle-seahawks,975000,2017
37628,565000,173116,C.J. Prosise,RB,injured_reserve,seattle-seahawks,738116,2017
37629,553000,161355,Rees Odhiambo,T,injured_reserve,seattle-seahawks,714355,2017
37630,690000,0,Dewey McDonald,OLB,injured_reserve,seattle-seahawks,690000,2017
37631,465000,176572,Nazair Jones,DT,injured_reserve,seattle-seahawks,641572,2017
37632,409937,0,Tre Madden,RB,injured_reserve,seattle-seahawks,409937,2017
37633,375530,16282,Christopher Carson,RB,injured_reserve,seattle-seahawks,391812,2017
37634,363000,6666,George Fant,T,injured_reserve,seattle-seahawks,369666,2017
37635,363000,3333,DeAndre Elliot,CB,injured_reserve,seattle-seahawks,366333,2017
37636,363000,1666,Christian French,OLB,injured_reserve,seattle-seahawks,364666,2017
37637,348000,0,Jordan Simone,S,injured_reserve,seattle-seahawks,348000,2017
37638,348000,0,Tyrus Thompson,T,injured_reserve,seattle-seahawks,348000,2017
37639,218824,0,Josh Forrest,ILB,injured_reserve,seattle-seahawks,218824,2017
37640,85000,799625,Malik McDowell,DT,non_fb_injury,seattle-seahawks,884625,2017
37641,36000,0,Stevie Donatell,TE,practice_squad,seattle-seahawks,36000,2017
37642,14400,0,Kache Palacio,OLB,practice_squad,seattle-seahawks,14400,2017
37643,0,1833333,Jermaine Kearse,WR,dead_cap,seattle-seahawks,1833333,2017
37644,0,1500000,Ahtyba Rubin,DT,dead_cap,seattle-seahawks,1500000,2017
37645,0,600000,J'Marcus Webb,RT,dead_cap,seattle-seahawks,600000,2017
37646,339250,0,Garrison Smith,DE,dead_cap,seattle-seahawks,339250,2017
37647,286580,34045,Justin Senior,T,dead_cap,seattle-seahawks,320625,2017
37648,304520,0,Isaiah Battle,LT,dead_cap,seattle-seahawks,304520,2017
37649,235294,32000,Dwight Freeney,OLB,dead_cap,seattle-seahawks,267294,2017
37650,108529,86423,Mark Glowinski,G,dead_cap,seattle-seahawks,194952,2017
37651,100800,42998,Michael Tyson,CB,dead_cap,seattle-seahawks,143798,2017
37652,122400,5000,Trevone Boykin,QB,dead_cap,seattle-seahawks,127400,2017
37653,93600,25089,Joey Hunt,C,dead_cap,seattle-seahawks,118689,2017
37654,0,117563,Cassius Marsh,OLB,dead_cap,seattle-seahawks,117563,2017
37655,115200,0,Akeem King,SS,dead_cap,seattle-seahawks,115200,2017
37656,115200,0,Tyrone Swoopes,TE,dead_cap,seattle-seahawks,115200,2017
37657,79200,21841,David Moore,WR,dead_cap,seattle-seahawks,101041,2017
37658,0,96413,Kevin Pierre-Louis,OLB,dead_cap,seattle-seahawks,96413,2017
37659,90706,0,Rodney Coe,DT,dead_cap,seattle-seahawks,90706,2017
37660,0,83126,Tye Smith,CB,dead_cap,seattle-seahawks,83126,2017
37661,91176,0,David Bass,DE,dead_cap,seattle-seahawks,91176,2017
37662,72000,0,Mike Davis,RB,dead_cap,seattle-seahawks,72000,2017
37663,0,63456,Quinton Jefferson,DE,dead_cap,seattle-seahawks,63456,2017
37664,7200,48673,Kenny Lawler,WR,dead_cap,seattle-seahawks,55873,2017
37665,48953,0,Kache Palacio,OLB,dead_cap,seattle-seahawks,48953,2017
37666,0,46875,Zac Brooks,RB,dead_cap,seattle-seahawks,46875,2017
37667,0,46096,Alex Collins,RB,dead_cap,seattle-seahawks,46096,2017
37668,0,45242,Kristjan Sokoli,G,dead_cap,seattle-seahawks,45242,2017
37669,43200,0,Joe Jones,OLB,dead_cap,seattle-seahawks,43200,2017
37670,40588,0,Marcus Cromartie,CB,dead_cap,seattle-seahawks,40588,2017
37671,36000,0,Willie Beavers,T,dead_cap,seattle-seahawks,36000,2017
37672,36000,0,Cyril Grayson,WR,dead_cap,seattle-seahawks,36000,2017
37673,31765,0,Justin March,ILB,dead_cap,seattle-seahawks,31765,2017
37674,28800,0,Paul Dawson,OLB,dead_cap,seattle-seahawks,28800,2017
37675,28800,0,Trovon Reed,CB,dead_cap,seattle-seahawks,28800,2017
37676,28800,0,Tyvis Powell,S,dead_cap,seattle-seahawks,28800,2017
37677,21600,0,Josh Forrest,ILB,dead_cap,seattle-seahawks,21600,2017
37678,21600,0,Jalston Fowler,FB,dead_cap,seattle-seahawks,21600,2017
37679,21600,0,Jason Thompson,OLB,dead_cap,seattle-seahawks,21600,2017
37680,21600,0,Alex Carter,S,dead_cap,seattle-seahawks,21600,2017
37681,14400,0,Austin Calitro,ILB,dead_cap,seattle-seahawks,14400,2017
37682,14400,0,Gabe Holmes,TE,dead_cap,seattle-seahawks,14400,2017
37683,14400,0,Noble Nwachukwu,DE,dead_cap,seattle-seahawks,14400,2017
37684,7200,0,K.J. Brent,WR,dead_cap,seattle-seahawks,7200,2017
37685,7200,0,Kyle Coleman,FB,dead_cap,seattle-seahawks,7200,2017
37686,7200,0,Branden Jackson,DE,dead_cap,seattle-seahawks,7200,2017
37687,7200,0,Jarron Jones,DT,dead_cap,seattle-seahawks,7200,2017
37688,0,3334,Christian French,OLB,dead_cap,seattle-seahawks,3334,2017
37689,0,667,Lene Maiava,T,dead_cap,seattle-seahawks,667,2017
37690,15500000,8286666,Russell Wilson,QB,active,seattle-seahawks,23786666,2018
37691,10000000,4600000,Bobby Wagner,ILB,active,seattle-seahawks,14600000,2018
37692,8250000,3550000,Doug Baldwin,WR,active,seattle-seahawks,11800000,2018
37693,6250000,2000000,Duane Brown,LT,active,seattle-seahawks,8250000,2018
37694,7200000,1000000,K.J. Wright,OLB,active,seattle-seahawks,8200000,2018
37695,2750000,5083332,Justin Britt,C,active,seattle-seahawks,7833332,2018
37696,2000000,2446688,Tyler Lockett,WR,active,seattle-seahawks,4446688,2018
37697,1500000,1833333,Bradley McDougald,SS,active,seattle-seahawks,3333333,2018
37698,2914000,0,Justin Coleman,CB,active,seattle-seahawks,2914000,2018
37699,800000,1781250,Shamar Stephen,DT,active,seattle-seahawks,2581250,2018
37700,1000000,1550000,Barkevious Mingo,OLB,active,seattle-seahawks,2550000,2018
37701,1201373,1052746,Germain Ifedi,RT,active,seattle-seahawks,2254119,2018
37702,1600000,487500,Neiko Thorpe,CB,active,seattle-seahawks,2087500,2018
37703,1015000,1000000,Sebastian Janikowski,K,active,seattle-seahawks,2015000,2018
37704,800000,1175000,J.R. Sweezy,G,active,seattle-seahawks,1975000,2018
37705,480000,1477352,Rashaad Penny,RB,active,seattle-seahawks,1957352,2018
37706,1907000,0,Dion Jordan,DE,active,seattle-seahawks,1907000,2018
37707,1000000,866666,Ed Dickson,TE,active,seattle-seahawks,1866666,2018
37708,800000,975000,Jaron Brown,WR,active,seattle-seahawks,1775000,2018
37709,800000,606250,D.J. Fluker,G,active,seattle-seahawks,1406250,2018
37710,800000,537500,Mike Davis,RB,active,seattle-seahawks,1337500,2018
37711,894512,439024,Jarran Reed,DT,active,seattle-seahawks,1333536,2018
37712,943938,243588,Frank Clark,DE,active,seattle-seahawks,1187526,2018
37713,665410,336642,Ethan Pocic,G,active,seattle-seahawks,1002052,2018
37714,652000,164220,Nick Vannett,TE,active,seattle-seahawks,816220,2018
37715,588000,189655,Shaquill Griffin,CB,active,seattle-seahawks,777655,2018
37716,578000,176572,Nazair Jones,DT,active,seattle-seahawks,754572,2018
37717,555000,168001,Tedric Thompson,FS,active,seattle-seahawks,723001,2018
37718,480000,228139,Rasheem Green,DE,active,seattle-seahawks,708139,2018
37719,705000,0,Brett Hundley,QB,active,seattle-seahawks,705000,2018
37720,630000,6668,George Fant,RT,active,seattle-seahawks,636668,2018
37721,630000,0,Joey Hunt,C,active,seattle-seahawks,630000,2018
37722,630000,0,Quinton Jefferson,DE,active,seattle-seahawks,630000,2018
37723,630000,0,Tre Madden,FB,active,seattle-seahawks,630000,2018
37724,630000,0,J.D. McKissic,RB,active,seattle-seahawks,630000,2018
37725,630000,0,Tyler Ott,LS,active,seattle-seahawks,630000,2018
37726,555000,16282,Christopher Carson,RB,active,seattle-seahawks,571282,2018
37727,480000,79404,Shaquem Griffin,OLB,active,seattle-seahawks,559404,2018
37728,555000,0,Akeem King,SS,active,seattle-seahawks,555000,2018
37729,555000,0,David Moore,WR,active,seattle-seahawks,555000,2018
37730,480000,74682,Tre Flowers,CB,active,seattle-seahawks,554682,2018
37731,480000,72537,Michael Dickson,P,active,seattle-seahawks,552537,2018
37732,522353,0,Shalom Luani,S,active,seattle-seahawks,522353,2018
37733,480000,40509,Jake Martin,DE,active,seattle-seahawks,520509,2018
37734,518826,0,Branden Jackson,DE,active,seattle-seahawks,518826,2018
37735,480000,2666,Poona Ford,DT,active,seattle-seahawks,482666,2018
37736,604118,0,Maurice Alexander,SS,active,seattle-seahawks,604118,2018
37737,480000,0,Austin Calitro,ILB,active,seattle-seahawks,480000,2018
37738,296472,0,Kalan Reed,CB,active,seattle-seahawks,296472,2018
37739,84705,0,Emmanuel Ellerbe,LB,active,seattle-seahawks,84705,2018
37740,56470,0,Elijah Nkansah,T,active,seattle-seahawks,56470,2018
37741,56470,0,Bo Scarbrough,RB,active,seattle-seahawks,56470,2018
37742,0,0,Malik Turner,WR,active,seattle-seahawks,0,2018
37743,8500000,1900000,Earl Thomas,FS,injured_reserve,seattle-seahawks,10400000,2018
37744,660000,173116,C.J. Prosise,RB,injured_reserve,seattle-seahawks,833116,2018
37745,588000,181869,Delano Hill,S,injured_reserve,seattle-seahawks,769869,2018
37746,578000,176572,Amara Darboh,WR,injured_reserve,seattle-seahawks,754572,2018
37747,390516,162567,Will Dissly,TE,injured_reserve,seattle-seahawks,553083,2018
37748,466229,0,Jordan Simmons,T,injured_reserve,seattle-seahawks,466229,2018
37749,363000,61250,Jamarco Jones,T,injured_reserve,seattle-seahawks,424250,2018
37750,363000,666,Emmanuel Beal,LB,injured_reserve,seattle-seahawks,363666,2018
37751,363000,0,Ricky Ali'ifua,DE,injured_reserve,seattle-seahawks,363000,2018
37752,363000,0,Tevon Mutcherson,CB,injured_reserve,seattle-seahawks,363000,2018
37753,325293,0,Mychal Kendricks,OLB,injured_reserve,seattle-seahawks,325293,2018
37754,781156,799625,Malik McDowell,DT,non_fb_injury,seattle-seahawks,1580781,2018
37755,106400,0,Azeem Victor,ILB,practice_squad,seattle-seahawks,106400,2018
37756,0,5212500,Michael Bennett,DE,dead_cap,seattle-seahawks,5212500,2018
37757,0,2500000,Jeremy Lane,CB,dead_cap,seattle-seahawks,2500000,2018
37758,0,2200000,Richard Sherman,CB,dead_cap,seattle-seahawks,2200000,2018
37759,950000,915625,Tom Johnson,DT,dead_cap,seattle-seahawks,1865625,2018
37760,0,1833334,Jermaine Kearse,WR,dead_cap,seattle-seahawks,1833334,2018
37761,0,1500000,Ahtyba Rubin,DT,dead_cap,seattle-seahawks,1500000,2018
37762,1015000,90000,Brandon Marshall,WR,dead_cap,seattle-seahawks,1105000,2018
37763,0,600000,Jon Ryan,P,dead_cap,seattle-seahawks,600000,2018
37764,161765,400000,Dontae Johnson,CB,dead_cap,seattle-seahawks,561765,2018
37765,476000,25922,Alex McGough,QB,dead_cap,seattle-seahawks,501922,2018
37766,0,500000,Cliff Avril,DE,dead_cap,seattle-seahawks,500000,2018
37767,0,500000,Byron Maxwell,CB,dead_cap,seattle-seahawks,500000,2018
37768,0,400000,Marcus Smith,DE,dead_cap,seattle-seahawks,400000,2018
37769,366718,0,Darrell Daniels,TE,dead_cap,seattle-seahawks,366718,2018
37770,258445,0,Malik Turner,WR,dead_cap,seattle-seahawks,258445,2018
37771,253013,0,Keenan Reynolds,WR,dead_cap,seattle-seahawks,253013,2018
37772,111177,90000,Austin Davis,QB,dead_cap,seattle-seahawks,201177,2018
37773,0,161355,Rees Odhiambo,T,dead_cap,seattle-seahawks,161355,2018
37774,143823,0,Jermaine Grace,OLB,dead_cap,seattle-seahawks,143823,2018
37775,143340,0,Emmanuel Ellerbe,LB,dead_cap,seattle-seahawks,143340,2018
37776,129200,6666,Jordan Roos,G,dead_cap,seattle-seahawks,135866,2018
37777,130305,0,Tyrone Swoopes,TE,dead_cap,seattle-seahawks,130305,2018
37778,129200,0,Caleb Scott,WR,dead_cap,seattle-seahawks,129200,2018
37779,0,128996,Michael Tyson,CB,dead_cap,seattle-seahawks,128996,2018
37780,0,126912,Quinton Jefferson,DE,dead_cap,seattle-seahawks,126912,2018
37781,114000,0,Elijah Nkansah,T,dead_cap,seattle-seahawks,114000,2018
37782,114000,0,Simeon Thomas,CB,dead_cap,seattle-seahawks,114000,2018
37783,0,102137,Justin Senior,T,dead_cap,seattle-seahawks,102137,2018
37784,0,92192,Alex Collins,RB,dead_cap,seattle-seahawks,92192,2018
37785,0,90000,Maurice Alexander,SS,dead_cap,seattle-seahawks,90000,2018
37786,85412,4000,Khalid Hill,FB,dead_cap,seattle-seahawks,89412,2018
37787,0,86423,Mark Glowinski,G,dead_cap,seattle-seahawks,86423,2018
37788,76000,0,Justin Currie,SS,dead_cap,seattle-seahawks,76000,2018
37789,68400,0,Jeremy Boykins,CB,dead_cap,seattle-seahawks,68400,2018
37790,0,65524,David Moore,WR,dead_cap,seattle-seahawks,65524,2018
37791,0,50178,Joey Hunt,C,dead_cap,seattle-seahawks,50178,2018
37792,45600,0,Lavon Coleman,RB,dead_cap,seattle-seahawks,45600,2018
37793,0,40000,Isaiah Battle,LT,dead_cap,seattle-seahawks,40000,2018
37794,38000,0,Marcus Lucas,TE,dead_cap,seattle-seahawks,38000,2018
37795,38000,0,Kalan Reed,CB,dead_cap,seattle-seahawks,38000,2018
37796,32647,0,Shalom Luani,S,dead_cap,seattle-seahawks,32647,2018
37797,30400,0,Marcus Henry,C,dead_cap,seattle-seahawks,30400,2018
37798,22800,0,Branden Jackson,DE,dead_cap,seattle-seahawks,22800,2018
37799,15200,0,Troymaine Pope,RB,dead_cap,seattle-seahawks,15200,2018
37800,0,9000,D.J. Alexander,ILB,dead_cap,seattle-seahawks,9000,2018
37801,7600,0,J.J. Dielman,C,dead_cap,seattle-seahawks,7600,2018
37802,7600,0,Malachi Dupre,WR,dead_cap,seattle-seahawks,7600,2018
37803,7600,0,Frank Herron,DT,dead_cap,seattle-seahawks,7600,2018
37804,7600,0,Tre'Von Johnson,OLB,dead_cap,seattle-seahawks,7600,2018
37805,7600,0,Damore'ea Stringfellow,WR,dead_cap,seattle-seahawks,7600,2018
37806,7600,0,Vincent Valentine,DT,dead_cap,seattle-seahawks,7600,2018
37807,7600,0,Antwione Williams,OLB,dead_cap,seattle-seahawks,7600,2018
37808,0,5000,Trevone Boykin,QB,dead_cap,seattle-seahawks,5000,2018
37809,0,3334,DeAndre Elliot,CB,dead_cap,seattle-seahawks,3334,2018
37810,5000000,21286668,Russell Wilson,QB,active,seattle-seahawks,26286668,2019
37811,9500000,6350000,Bobby Wagner,ILB,active,seattle-seahawks,15850000,2019
37812,8000000,2725000,Duane Brown,LT,active,seattle-seahawks,10725000,2019
37813,2500000,5562500,Ezekiel Ansah,DE,active,seattle-seahawks,8062500,2019
37814,8000000,0,Jadeveon Clowney,DE,active,seattle-seahawks,8000000,2019
37815,3907000,3850000,Tyler Lockett,WR,active,seattle-seahawks,7757000,2019
37816,1500000,4000000,K.J. Wright,OLB,active,seattle-seahawks,5500000,2019
37817,2900000,1802083,Bradley McDougald,SS,active,seattle-seahawks,4702083,2019
37818,2000000,2000000,Mychal Kendricks,OLB,active,seattle-seahawks,4000000,2019
37819,3095000,0,George Fant,T,active,seattle-seahawks,3095000,2019
37820,1000000,1750000,Mike Iupati,G,active,seattle-seahawks,2750000,2019
37821,1577060,1052748,Germain Ifedi,RT,active,seattle-seahawks,2629808,2019
37822,1500000,1000000,Jason Myers,K,active,seattle-seahawks,2500000,2019
37823,850000,1437500,D.J. Fluker,G,active,seattle-seahawks,2287500,2019
37824,2025000,0,Quinton Jefferson,DE,active,seattle-seahawks,2025000,2019
37825,495000,1475196,L.J. Collier,DE,active,seattle-seahawks,1970196,2019
37826,1562941,62500,Quandre Diggs,SS,active,seattle-seahawks,1625441,2019
37827,1000000,500000,Jaron Brown,WR,active,seattle-seahawks,1500000,2019
37828,750000,603125,Akeem King,CB,active,seattle-seahawks,1353125,2019
37829,722615,439027,Jarran Reed,DT,active,seattle-seahawks,1161642,2019
37830,495000,638936,Marquise Blair,S,active,seattle-seahawks,1133936,2019
37831,930000,0,Nick Bellore,FB,active,seattle-seahawks,930000,2019
37832,750000,125000,Tyler Ott,LS,active,seattle-seahawks,875000,2019
37833,680000,189655,Shaquill Griffin,CB,active,seattle-seahawks,869655,2019
37834,639000,228139,Rasheem Green,DE,active,seattle-seahawks,867139,2019
37835,678000,181869,Delano Hill,S,active,seattle-seahawks,859869,2019
37836,495000,338827,D.K. Metcalf,WR,active,seattle-seahawks,833827,2019
37837,720000,0,Joey Hunt,C,active,seattle-seahawks,720000,2019
37838,720000,0,Branden Jackson,DE,active,seattle-seahawks,720000,2019
37839,495000,221031,Cody Barton,LB,active,seattle-seahawks,716031,2019
37840,495000,161299,Ugo Amadi,CB,active,seattle-seahawks,656299,2019
37841,570000,79404,Shaquem Griffin,OLB,active,seattle-seahawks,649404,2019
37842,805000,0,Geno Smith,QB,active,seattle-seahawks,805000,2019
37843,645000,0,David Moore,WR,active,seattle-seahawks,645000,2019
37844,570000,74682,Tre Flowers,CB,active,seattle-seahawks,644682,2019
37845,570000,72537,Michael Dickson,P,active,seattle-seahawks,642537,2019
37846,433059,172718,Phil Haynes,G,active,seattle-seahawks,605777,2019
37847,495000,85403,Ben Burr-Kirven,LB,active,seattle-seahawks,580403,2019
37848,570000,2666,Poona Ford,DT,active,seattle-seahawks,572666,2019
37849,570000,0,Malik Turner,WR,active,seattle-seahawks,570000,2019
37850,495000,61250,Jamarco Jones,T,active,seattle-seahawks,556250,2019
37851,662941,0,Luke Willson,TE,active,seattle-seahawks,662941,2019
37852,495000,35704,Travis Homer,RB,active,seattle-seahawks,530704,2019
37853,495000,20590,John Ursua,WR,active,seattle-seahawks,515590,2019
37854,455294,0,Jacob Hollister,TE,active,seattle-seahawks,455294,2019
37855,301765,0,Jordan Roos,G,active,seattle-seahawks,301765,2019
37856,174706,0,Tyrone Swoopes,TE,active,seattle-seahawks,174706,2019
37857,109412,0,Dekoda Watson,OLB,active,seattle-seahawks,109412,2019
37858,100588,0,Ryan Neal,FS,active,seattle-seahawks,100588,2019
37859,58235,0,Bryan Mone,DT,active,seattle-seahawks,58235,2019
37860,54706,0,Robert Turbin,RB,active,seattle-seahawks,54706,2019
37861,60588,0,Marshawn Lynch,RB,active,seattle-seahawks,60588,2019
37862,4500000,4833332,Justin Britt,C,injured_reserve,seattle-seahawks,9333332,2019
37863,3300000,866666,Ed Dickson,TE,injured_reserve,seattle-seahawks,4166666,2019
37864,969338,1477352,Rashaad Penny,RB,injured_reserve,seattle-seahawks,2446690,2019
37865,865821,336642,Ethan Pocic,G,injured_reserve,seattle-seahawks,1202463,2019
37866,850000,150000,Neiko Thorpe,CB,injured_reserve,seattle-seahawks,1000000,2019
37867,745000,173116,C.J. Prosise,RB,injured_reserve,seattle-seahawks,918116,2019
37868,668000,176572,Nazair Jones,DT,injured_reserve,seattle-seahawks,844572,2019
37869,645000,168001,Tedric Thompson,S,injured_reserve,seattle-seahawks,813001,2019
37870,570000,162567,Will Dissly,TE,injured_reserve,seattle-seahawks,732567,2019
37871,720000,0,Kalan Reed,CB,injured_reserve,seattle-seahawks,720000,2019
37872,645000,16282,Christopher Carson,RB,injured_reserve,seattle-seahawks,661282,2019
37873,570000,0,Emmanuel Ellerbe,LB,injured_reserve,seattle-seahawks,570000,2019
37874,570000,0,Jordan Simmons,T,injured_reserve,seattle-seahawks,570000,2019
37875,378000,2666,Demetrius Knox,G,injured_reserve,seattle-seahawks,380666,2019
37876,378000,1666,Justin Johnson,TE,injured_reserve,seattle-seahawks,379666,2019
37877,378000,600,Adam Choice,RB,injured_reserve,seattle-seahawks,378600,2019
37878,378000,0,Jeremy Boykins,CB,injured_reserve,seattle-seahawks,378000,2019
37879,136000,0,Kahlil McKenzie,G,practice_squad,seattle-seahawks,136000,2019
37880,40000,0,Wes Saxton,TE,practice_squad,seattle-seahawks,40000,2019
37881,24000,0,Xavier Turner,RB,practice_squad,seattle-seahawks,24000,2019
37882,5200000,5000000,Kam Chancellor,SS,dead_cap,seattle-seahawks,10200000,2019
37883,0,6287500,Doug Baldwin,WR,dead_cap,seattle-seahawks,6287500,2019
37884,0,1599253,Malik McDowell,DT,dead_cap,seattle-seahawks,1599253,2019
37885,0,1100000,Barkevious Mingo,OLB,dead_cap,seattle-seahawks,1100000,2019
37886,0,1560000,Marcus Tubbs,DT,dead_cap,seattle-seahawks,1560000,2019
37887,0,975000,Jaron Brown,WR,dead_cap,seattle-seahawks,975000,2019
37888,0,600000,Cassius Marsh,OLB,dead_cap,seattle-seahawks,600000,2019
37889,0,600000,Jon Ryan,P,dead_cap,seattle-seahawks,600000,2019
37890,473529,25000,Jamar Taylor,CB,dead_cap,seattle-seahawks,498529,2019
37891,300000,150000,Nick Bellore,FB,dead_cap,seattle-seahawks,450000,2019
37892,262059,177733,Gary Jennings,WR,dead_cap,seattle-seahawks,439792,2019
37893,129882,164220,Nick Vannett,TE,dead_cap,seattle-seahawks,294102,2019
37894,196472,333,Bryan Mone,DT,dead_cap,seattle-seahawks,196805,2019
37895,0,176572,Amara Darboh,WR,dead_cap,seattle-seahawks,176572,2019
37896,161823,0,Adrian Colbert,FS,dead_cap,seattle-seahawks,161823,2019
37897,0,161355,Rees Odhiambo,T,dead_cap,seattle-seahawks,161355,2019
37898,140589,6668,Jordan Roos,G,dead_cap,seattle-seahawks,147257,2019
37899,136000,0,Kyle Fuller,C,dead_cap,seattle-seahawks,136000,2019
37900,112000,0,Ryan Neal,FS,dead_cap,seattle-seahawks,112000,2019
37901,92472,0,Justin Currie,SS,dead_cap,seattle-seahawks,92472,2019
37902,0,90000,Earl Mitchell,DT,dead_cap,seattle-seahawks,90000,2019
37903,88000,0,Chad Wheeler,T,dead_cap,seattle-seahawks,88000,2019
37904,88000,0,Brian Allen,CB,dead_cap,seattle-seahawks,88000,2019
37905,80000,0,Penny Hart,WR,dead_cap,seattle-seahawks,80000,2019
37906,80000,0,Linden Stephens,S,dead_cap,seattle-seahawks,80000,2019
37907,0,77768,Alex McGough,QB,dead_cap,seattle-seahawks,77768,2019
37908,73529,0,Parry Nickerson,CB,dead_cap,seattle-seahawks,73529,2019
37909,48000,3333,Terry Wright,WR,dead_cap,seattle-seahawks,51333,2019
37910,48000,0,Pita Taumoepenu,OLB,dead_cap,seattle-seahawks,48000,2019
37911,0,40509,Jake Martin,DE,dead_cap,seattle-seahawks,40509,2019
37912,40000,0,Jacob Hollister,TE,dead_cap,seattle-seahawks,40000,2019
37913,40000,0,Tyrone Swoopes,TE,dead_cap,seattle-seahawks,40000,2019
37914,0,25000,Geno Smith,QB,dead_cap,seattle-seahawks,25000,2019
37915,24000,0,Malik Carney,DE,dead_cap,seattle-seahawks,24000,2019
37916,24000,0,Jachai Polite,OLB,dead_cap,seattle-seahawks,24000,2019
37917,16000,2666,Jazz Ferguson,WR,dead_cap,seattle-seahawks,18666,2019
37918,16000,0,Jermaine Grace,OLB,dead_cap,seattle-seahawks,16000,2019
37919,16000,0,Cardale Jones,QB,dead_cap,seattle-seahawks,16000,2019
37920,16000,0,Sutton Smith,OLB,dead_cap,seattle-seahawks,16000,2019
37921,0,14000,Ka'Raun White,WR,dead_cap,seattle-seahawks,14000,2019
37922,0,10000,Taryn Christion,QB,dead_cap,seattle-seahawks,10000,2019
37923,0,8000,Khalid Hill,FB,dead_cap,seattle-seahawks,8000,2019
37924,8000,0,Elijah Nkansah,T,dead_cap,seattle-seahawks,8000,2019
37925,8000,0,Simeon Thomas,CB,dead_cap,seattle-seahawks,8000,2019
37926,8000,0,Cody Thompson,WR,dead_cap,seattle-seahawks,8000,2019
37927,0,5000,Mik'Quan Deane,TE,dead_cap,seattle-seahawks,5000,2019
37928,0,3333,Davante Davis,CB,dead_cap,seattle-seahawks,3333,2019
37929,0,3333,Derrek Thomas,CB,dead_cap,seattle-seahawks,3333,2019
37930,0,1334,Emmanuel Beal,LB,dead_cap,seattle-seahawks,1334,2019
37931,0,1000,Jay-Tee Tiuli,DT,dead_cap,seattle-seahawks,1000,2019
37932,0,666,Jalen Harvey,S,dead_cap,seattle-seahawks,666,2019
37933,18000000,13000000,Russell Wilson,QB,active,seattle-seahawks,31000000,2020
37934,10750000,4000000,Bobby Wagner,ILB,active,seattle-seahawks,14750000,2020
37935,8750000,3562500,Duane Brown,LT,active,seattle-seahawks,12312500,2020
37936,8250000,4833336,Justin Britt,C,active,seattle-seahawks,13083336,2020
37937,8600000,2750000,Tyler Lockett,WR,active,seattle-seahawks,11350000,2020
37938,5000000,5000000,K.J. Wright,OLB,active,seattle-seahawks,10000000,2020
37939,3600000,1802084,Bradley McDougald,SS,active,seattle-seahawks,5402084,2020
37940,5000000,162500,Quandre Diggs,SS,active,seattle-seahawks,5162500,2020
37941,3000000,866668,Ed Dickson,TE,active,seattle-seahawks,3866668,2020
37942,2600000,1000000,Jason Myers,K,active,seattle-seahawks,3600000,2020
37943,2000000,1437500,D.J. Fluker,G,active,seattle-seahawks,3437500,2020
37944,1458676,1477352,Rashaad Penny,RB,active,seattle-seahawks,2936028,2020
37945,987549,1475196,L.J. Collier,DE,active,seattle-seahawks,2462745,2020
37946,778484,638936,Marquise Blair,S,active,seattle-seahawks,1417420,2020
37947,1066231,336642,Ethan Pocic,G,active,seattle-seahawks,1402873,2020
37948,703457,338827,D.K. Metcalf,WR,active,seattle-seahawks,1042284,2020
37949,1000000,0,Nick Bellore,FB,active,seattle-seahawks,1000000,2020
37950,850000,125000,Tyler Ott,LS,active,seattle-seahawks,975000,2020
37951,767000,189655,Shaquill Griffin,CB,active,seattle-seahawks,956655,2020
37952,728000,228139,Rasheem Green,DE,active,seattle-seahawks,956139,2020
37953,758375,176572,Nazair Jones,DT,active,seattle-seahawks,934947,2020
37954,748250,181869,Delano Hill,S,active,seattle-seahawks,930119,2020
37955,735000,168001,Tedric Thompson,S,active,seattle-seahawks,903001,2020
37956,658000,221031,Cody Barton,LB,active,seattle-seahawks,879031,2020
37957,660000,162567,Will Dissly,TE,active,seattle-seahawks,822567,2020
37958,585000,172718,Phil Haynes,G,active,seattle-seahawks,757718,2020
37959,735000,16283,Christopher Carson,RB,active,seattle-seahawks,751283,2020
37960,585000,161299,Ugo Amadi,CB,active,seattle-seahawks,746299,2020
37961,660000,79404,Shaquem Griffin,OLB,active,seattle-seahawks,739404,2020
37962,660000,74682,Tre Flowers,CB,active,seattle-seahawks,734682,2020
37963,660000,72537,Michael Dickson,P,active,seattle-seahawks,732537,2020
37964,660000,61250,Jamarco Jones,T,active,seattle-seahawks,721250,2020
37965,585000,85403,Ben Burr-Kirven,LB,active,seattle-seahawks,670403,2020
37966,660000,2668,Poona Ford,DT,active,seattle-seahawks,662668,2020
37967,585000,35704,Travis Homer,RB,active,seattle-seahawks,620704,2020
37968,585000,20590,John Ursua,WR,active,seattle-seahawks,605590,2020
37969,585000,600,Adam Choice,RB,active,seattle-seahawks,585600,2020
37970,585000,0,Bryan Mone,DT,active,seattle-seahawks,585000,2020
37971,510000,31960,Demarcus Christmas,DT,active,seattle-seahawks,541960,2020
37972,510000,2666,Demetrius Knox,G,active,seattle-seahawks,512666,2020
37973,510000,1666,Justin Johnson,TE,active,seattle-seahawks,511666,2020
37974,0,0,Brian Allen,CB,active,seattle-seahawks,0,2020
37975,0,0,Penny Hart,WR,active,seattle-seahawks,0,2020
37976,0,0,Sutton Smith,OLB,active,seattle-seahawks,0,2020
37977,0,0,Shakir Soto,DE,active,seattle-seahawks,0,2020
37978,0,0,Pita Taumoepenu,OLB,active,seattle-seahawks,0,2020
37979,0,0,Cody Thompson,WR,active,seattle-seahawks,0,2020
37980,0,533199,Gary Jennings,WR,dead_cap,seattle-seahawks,533199,2020
37981,0,176572,Amara Darboh,WR,dead_cap,seattle-seahawks,176572,2020
37982,0,150000,Nick Bellore,FB,dead_cap,seattle-seahawks,150000,2020
37983,0,81021,Jake Martin,DE,dead_cap,seattle-seahawks,81021,2020
37984,0,6667,Davante Davis,CB,dead_cap,seattle-seahawks,6667,2020
37985,0,6667,Derrek Thomas,CB,dead_cap,seattle-seahawks,6667,2020
37986,0,6667,Terry Wright,WR,dead_cap,seattle-seahawks,6667,2020
37987,0,5334,Jazz Ferguson,WR,dead_cap,seattle-seahawks,5334,2020
37988,0,2000,Jay-Tee Tiuli,DT,dead_cap,seattle-seahawks,2000,2020
37989,0,1334,Jalen Harvey,S,dead_cap,seattle-seahawks,1334,2020
37990,0,667,Bryan Mone,DT,dead_cap,seattle-seahawks,667,2020
37991,2800000,383333,Brian Kelly,CB,active,tampa-bay-buccaneers,3183333,2007
37992,3000000,200000,Ronde Barber,S,active,tampa-bay-buccaneers,3200000,2007
37993,3000000,750000,Derrick Brooks,LB,active,tampa-bay-buccaneers,3750000,2007
37994,2000000,1500000,Jeff Garcia,QB,active,tampa-bay-buccaneers,3500000,2007
37995,285000,2100000,Gaines Adams,DE,active,tampa-bay-buccaneers,2385000,2007
37996,1000000,1900000,Chris Hovan,DT,active,tampa-bay-buccaneers,2900000,2007
37997,845000,1000000,Phillip Buchanon,CB,active,tampa-bay-buccaneers,1845000,2007
37998,1000000,666667,Cato June,LB,active,tampa-bay-buccaneers,1666667,2007
37999,1530000,100000,Anthony Becht,TE,active,tampa-bay-buccaneers,1630000,2007
38000,1000000,400000,Matt Bryant,K,active,tampa-bay-buccaneers,1400000,2007
38001,285000,500000,Arron Sears,G,active,tampa-bay-buccaneers,785000,2007
38002,1200000,100000,Will Allen,SS,active,tampa-bay-buccaneers,1300000,2007
38003,1075000,200000,Davin Joseph,G,active,tampa-bay-buccaneers,1275000,2007
38004,755000,514000,Michael Clayton,WR,active,tampa-bay-buccaneers,1269000,2007
38005,780000,400000,Josh Bidwell,P,active,tampa-bay-buccaneers,1180000,2007
38006,285000,0,Kenneth Darby,RB,active,tampa-bay-buccaneers,285000,2007
38007,435000,412000,Barrett Ruud,LB,active,tampa-bay-buccaneers,847000,2007
38008,595000,150000,B.J. Askew,FB,active,tampa-bay-buccaneers,745000,2007
38009,360000,307500,Jeremy Trueblood,RT,active,tampa-bay-buccaneers,667500,2007
38010,435000,193000,Alex Smith,TE,active,tampa-bay-buccaneers,628000,2007
38011,595000,40000,Matt Lehr,C,active,tampa-bay-buccaneers,635000,2007
38012,595000,0,Ryan Sims,DT,active,tampa-bay-buccaneers,595000,2007
38013,435000,110000,Dan Buenning,G,active,tampa-bay-buccaneers,545000,2007
38014,360000,160000,Maurice Stovall,WR,active,tampa-bay-buccaneers,520000,2007
38015,510000,0,Leon Joe,ILB,active,tampa-bay-buccaneers,510000,2007
38016,510000,0,Luke McCown,QB,active,tampa-bay-buccaneers,510000,2007
38017,285000,206250,Quincy Black,LB,active,tampa-bay-buccaneers,491250,2007
38018,285000,200000,Sabby Piscitelli,S,active,tampa-bay-buccaneers,485000,2007
38019,595000,0,Sammy Davis,CB,active,tampa-bay-buccaneers,595000,2007
38020,435000,0,Jovan Haye,DT,active,tampa-bay-buccaneers,435000,2007
38021,285000,119250,Tanard Jackson,S,active,tampa-bay-buccaneers,404250,2007
38022,385000,0,Donte Nicholson,S,active,tampa-bay-buccaneers,385000,2007
38023,360000,0,Andrew Economos,LS,active,tampa-bay-buccaneers,360000,2007
38024,360000,0,Donald Penn,LT,active,tampa-bay-buccaneers,360000,2007
38025,285000,48000,Greg Peterson,DT,active,tampa-bay-buccaneers,333000,2007
38026,285000,25500,Adam Hayward,OLB,active,tampa-bay-buccaneers,310500,2007
38027,285000,15125,Chris Denman,T,active,tampa-bay-buccaneers,300125,2007
38028,285000,0,Marcus Hamilton,CB,active,tampa-bay-buccaneers,285000,2007
38029,205000,0,Charles Bennett,LB,active,tampa-bay-buccaneers,205000,2007
38030,155000,0,Chris Colmer,T,active,tampa-bay-buccaneers,155000,2007
38031,2000000,2050000,Luke Petitgout,RT,injured_reserve,tampa-bay-buccaneers,4050000,2007
38032,1370500,3380000,Carnell Williams,RB,injured_reserve,tampa-bay-buccaneers,4750500,2007
38033,220000,0,Paris Warren,WR,injured_reserve,tampa-bay-buccaneers,220000,2007
38034,79900,0,Lionel Gates,RB,practice_squad,tampa-bay-buccaneers,79900,2007
38035,79900,0,Brian Johnson,G,practice_squad,tampa-bay-buccaneers,79900,2007
38036,138600,0,Donte Nicholson,S,dead_cap,tampa-bay-buccaneers,138600,2007
38037,102500,0,Alan Zemaitis,CB,dead_cap,tampa-bay-buccaneers,102500,2007
38038,72000,0,Anthony Bryant,DT,dead_cap,tampa-bay-buccaneers,72000,2007
38039,40750,0,Julian Jenkins,DE,dead_cap,tampa-bay-buccaneers,40750,2007
38040,35000,0,David Boston,WR,dead_cap,tampa-bay-buccaneers,35000,2007
38041,33345,0,Justin Phinisee,CB,dead_cap,tampa-bay-buccaneers,33345,2007
38042,29511,0,Charles Bennett,LB,dead_cap,tampa-bay-buccaneers,29511,2007
38043,29400,0,Tim Massaquoi,TE,dead_cap,tampa-bay-buccaneers,29400,2007
38044,19500,0,T.J. Williams,TE,dead_cap,tampa-bay-buccaneers,19500,2007
38045,10000,0,Kenneth Darby,RB,dead_cap,tampa-bay-buccaneers,10000,2007
38046,10000,0,Marcus Hamilton,CB,dead_cap,tampa-bay-buccaneers,10000,2007
38047,1000000,6000000,Jeff Faine,C,active,tampa-bay-buccaneers,7000000,2008
38048,2157250,3380000,Carnell Williams,RB,active,tampa-bay-buccaneers,5537250,2008
38049,3000000,200000,Ronde Barber,S,active,tampa-bay-buccaneers,3200000,2008
38050,3000000,750000,Derrick Brooks,LB,active,tampa-bay-buccaneers,3750000,2008
38051,295000,3400000,Aqib Talib,CB,active,tampa-bay-buccaneers,3695000,2008
38052,1000000,666667,Cato June,LB,active,tampa-bay-buccaneers,1666667,2008
38053,2000000,1500000,Jeff Garcia,QB,active,tampa-bay-buccaneers,3500000,2008
38054,1905000,1250000,Phillip Buchanon,CB,active,tampa-bay-buccaneers,3155000,2008
38055,3000000,0,Warrick Dunn,RB,active,tampa-bay-buccaneers,3000000,2008
38056,370000,2609840,Gaines Adams,DE,active,tampa-bay-buccaneers,2979840,2008
38057,1600000,1900000,Chris Hovan,DT,active,tampa-bay-buccaneers,3500000,2008
38058,2000000,514000,Michael Clayton,WR,active,tampa-bay-buccaneers,2514000,2008
38059,2017000,0,Jovan Haye,DT,active,tampa-bay-buccaneers,2017000,2008
38060,625000,200000,B.J. Askew,FB,active,tampa-bay-buccaneers,825000,2008
38061,1300000,193000,Alex Smith,TE,active,tampa-bay-buccaneers,1493000,2008
38062,1290000,200000,Davin Joseph,G,active,tampa-bay-buccaneers,1490000,2008
38063,1300000,100000,Will Allen,SS,active,tampa-bay-buccaneers,1400000,2008
38064,1000000,400000,Josh Bidwell,P,active,tampa-bay-buccaneers,1400000,2008
38065,1000000,400000,Matt Bryant,K,active,tampa-bay-buccaneers,1400000,2008
38066,295000,1001375,Josh Johnson,QB,active,tampa-bay-buccaneers,1296375,2008
38067,520000,412000,Barrett Ruud,LB,active,tampa-bay-buccaneers,932000,2008
38068,900000,100000,Ryan Sims,DT,active,tampa-bay-buccaneers,1000000,2008
38069,295000,232000,Dexter Jackson,WR,active,tampa-bay-buccaneers,527000,2008
38070,370000,500000,Arron Sears,G,active,tampa-bay-buccaneers,870000,2008
38071,445000,307500,Jeremy Trueblood,RT,active,tampa-bay-buccaneers,752500,2008
38072,605000,40500,Sammy Davis,CB,active,tampa-bay-buccaneers,645500,2008
38073,520000,100000,Matt McCoy,LB,active,tampa-bay-buccaneers,620000,2008
38074,605000,0,Luke McCown,QB,active,tampa-bay-buccaneers,605000,2008
38075,445000,160000,Maurice Stovall,WR,active,tampa-bay-buccaneers,605000,2008
38076,370000,206250,Quincy Black,LB,active,tampa-bay-buccaneers,576250,2008
38077,370000,200000,Sabby Piscitelli,S,active,tampa-bay-buccaneers,570000,2008
38078,445000,105000,Andrew Economos,LS,active,tampa-bay-buccaneers,550000,2008
38079,370000,119250,Tanard Jackson,S,active,tampa-bay-buccaneers,489250,2008
38080,295000,178500,Jeremy Zuttah,C,active,tampa-bay-buccaneers,473500,2008
38081,460000,0,Donte Nicholson,S,active,tampa-bay-buccaneers,460000,2008
38082,445000,0,Donald Penn,LT,active,tampa-bay-buccaneers,445000,2008
38083,370000,48000,Greg Peterson,DT,active,tampa-bay-buccaneers,418000,2008
38084,370000,25500,Adam Hayward,OLB,active,tampa-bay-buccaneers,395500,2008
38085,370000,0,Marcus Hamilton,CB,active,tampa-bay-buccaneers,370000,2008
38086,310000,0,Chris Colmer,T,active,tampa-bay-buccaneers,310000,2008
38087,295000,2500,Elbert Mack,CB,active,tampa-bay-buccaneers,297500,2008
38088,88400,0,Dre Moore,DT,active,tampa-bay-buccaneers,88400,2008
38089,295000,0,James Lee,T,active,tampa-bay-buccaneers,295000,2008
38090,0,1000000,Luke Petitgout,RT,dead_cap,tampa-bay-buccaneers,1000000,2008
38091,0,400000,Anthony Becht,TE,dead_cap,tampa-bay-buccaneers,400000,2008
38092,205000,0,Alan Zemaitis,CB,dead_cap,tampa-bay-buccaneers,205000,2008
38093,115125,0,Dre Moore,DT,dead_cap,tampa-bay-buccaneers,115125,2008
38094,110000,0,Dan Buenning,G,dead_cap,tampa-bay-buccaneers,110000,2008
38095,88400,0,Paris Warren,WR,dead_cap,tampa-bay-buccaneers,88400,2008
38096,81500,0,Julian Jenkins,DE,dead_cap,tampa-bay-buccaneers,81500,2008
38097,39000,0,T.J. Williams,TE,dead_cap,tampa-bay-buccaneers,39000,2008
38098,30000,0,Kenneth Darby,RB,dead_cap,tampa-bay-buccaneers,30000,2008
38099,30000,0,Marcus Hamilton,CB,dead_cap,tampa-bay-buccaneers,30000,2008
38100,21875,0,Bruce Gradkowski,QB,dead_cap,tampa-bay-buccaneers,21875,2008
38101,15125,0,Chris Denman,T,dead_cap,tampa-bay-buccaneers,15125,2008
38102,1000000,7000000,Jeff Faine,C,active,tampa-bay-buccaneers,8000000,2009
38103,5170000,150000,Kellen Winslow,TE,active,tampa-bay-buccaneers,5320000,2009
38104,2094000,3380000,Carnell Williams,RB,active,tampa-bay-buccaneers,5474000,2009
38105,3000000,1114000,Michael Clayton,WR,active,tampa-bay-buccaneers,4114000,2009
38106,3000000,200000,Ronde Barber,S,active,tampa-bay-buccaneers,3200000,2009
38107,3000000,500000,Derrick Ward,RB,active,tampa-bay-buccaneers,3500000,2009
38108,2792000,0,Donald Penn,LT,active,tampa-bay-buccaneers,2792000,2009
38109,2000000,400000,Mike Nugent,K,active,tampa-bay-buccaneers,2400000,2009
38110,1600000,412000,Barrett Ruud,LB,active,tampa-bay-buccaneers,2012000,2009
38111,1100000,750000,Will Allen,SS,active,tampa-bay-buccaneers,1850000,2009
38112,1000000,812500,Ryan Sims,DT,active,tampa-bay-buccaneers,1812500,2009
38113,1505000,200000,Davin Joseph,G,active,tampa-bay-buccaneers,1705000,2009
38114,1181250,300000,Aqib Talib,CB,active,tampa-bay-buccaneers,1481250,2009
38115,310000,1070000,Josh Freeman,QB,active,tampa-bay-buccaneers,1380000,2009
38116,620000,200000,B.J. Askew,FB,active,tampa-bay-buccaneers,820000,2009
38117,460000,200000,Sabby Piscitelli,S,active,tampa-bay-buccaneers,660000,2009
38118,620000,0,Niko Koutouvides,ILB,active,tampa-bay-buccaneers,620000,2009
38119,460000,500000,Arron Sears,G,active,tampa-bay-buccaneers,960000,2009
38120,535000,307500,Jeremy Trueblood,RT,active,tampa-bay-buccaneers,842500,2009
38121,535000,160000,Maurice Stovall,WR,active,tampa-bay-buccaneers,695000,2009
38122,460000,206250,Quincy Black,LB,active,tampa-bay-buccaneers,666250,2009
38123,650000,0,Matt McCoy,LB,active,tampa-bay-buccaneers,650000,2009
38124,535000,105000,Andrew Economos,LS,active,tampa-bay-buccaneers,640000,2009
38125,460000,119250,Tanard Jackson,S,active,tampa-bay-buccaneers,579250,2009
38126,385000,178500,Jeremy Zuttah,C,active,tampa-bay-buccaneers,563500,2009
38127,545000,0,Donte Nicholson,S,active,tampa-bay-buccaneers,545000,2009
38128,535000,0,Anthony Alabi,T,active,tampa-bay-buccaneers,535000,2009
38129,390000,118996,Kyle Moore,DE,active,tampa-bay-buccaneers,508996,2009
38130,310000,192500,Roy Miller,DT,active,tampa-bay-buccaneers,502500,2009
38131,460000,25500,Adam Hayward,OLB,active,tampa-bay-buccaneers,485500,2009
38132,460000,0,Tim Crowder,DE,active,tampa-bay-buccaneers,460000,2009
38133,385000,31375,Josh Johnson,QB,active,tampa-bay-buccaneers,416375,2009
38134,390000,12067,Sammie Stroughter,WR,active,tampa-bay-buccaneers,402067,2009
38135,385000,2500,Elbert Mack,CB,active,tampa-bay-buccaneers,387500,2009
38136,385000,0,Connor Barth,K,active,tampa-bay-buccaneers,385000,2009
38137,385000,0,James Lee,T,active,tampa-bay-buccaneers,385000,2009
38138,385000,0,Corey Lynch,S,active,tampa-bay-buccaneers,385000,2009
38139,385000,0,Dre Moore,DT,active,tampa-bay-buccaneers,385000,2009
38140,385000,0,Shawn Murphy,G,active,tampa-bay-buccaneers,385000,2009
38141,385000,0,Carlton Powell,DT,active,tampa-bay-buccaneers,385000,2009
38142,620000,0,Marcus Johnson,T,active,tampa-bay-buccaneers,620000,2009
38143,310000,45250,Xavier Fulton,T,active,tampa-bay-buccaneers,355250,2009
38144,310000,15100,E.J. Biggers,CB,active,tampa-bay-buccaneers,325100,2009
38145,310000,0,Demar Dotson,RT,active,tampa-bay-buccaneers,310000,2009
38146,310000,0,Mike Mickens,CB,active,tampa-bay-buccaneers,310000,2009
38147,2000000,0,Byron Leftwich,QB,injured_reserve,tampa-bay-buccaneers,2000000,2009
38148,1000000,400000,Josh Bidwell,P,injured_reserve,tampa-bay-buccaneers,1400000,2009
38149,0,2609840,Gaines Adams,DE,dead_cap,tampa-bay-buccaneers,2609840,2009
38150,0,1250000,Luke McCown,QB,dead_cap,tampa-bay-buccaneers,1250000,2009
38151,0,1000000,Luke Petitgout,RT,dead_cap,tampa-bay-buccaneers,1000000,2009
38152,750000,0,Derrick Brooks,LB,dead_cap,tampa-bay-buccaneers,750000,2009
38153,682000,0,Dexter Jackson,WR,dead_cap,tampa-bay-buccaneers,682000,2009
38154,666667,0,Cato June,LB,dead_cap,tampa-bay-buccaneers,666667,2009
38155,600000,0,Matt Bryant,K,dead_cap,tampa-bay-buccaneers,600000,2009
38156,345375,0,Dre Moore,DT,dead_cap,tampa-bay-buccaneers,345375,2009
38157,193000,0,Alex Smith,TE,dead_cap,tampa-bay-buccaneers,193000,2009
38158,110000,0,Dan Buenning,G,dead_cap,tampa-bay-buccaneers,110000,2009
38159,48000,0,Greg Peterson,DT,dead_cap,tampa-bay-buccaneers,48000,2009
38160,30250,0,Chris Denman,T,dead_cap,tampa-bay-buccaneers,30250,2009
38161,21875,0,Bruce Gradkowski,QB,dead_cap,tampa-bay-buccaneers,21875,2009
38162,2295000,12792500,Gerald McCoy,DT,active,tampa-bay-buccaneers,15087500,2010
38163,6725000,150000,Kellen Winslow,TE,active,tampa-bay-buccaneers,6875000,2010
38164,395000,5810000,Josh Freeman,QB,active,tampa-bay-buccaneers,6205000,2010
38165,4500000,333333,Donald Penn,LT,active,tampa-bay-buccaneers,4833333,2010
38166,3000000,200000,Ronde Barber,S,active,tampa-bay-buccaneers,3200000,2010
38167,3268000,0,Barrett Ruud,LB,active,tampa-bay-buccaneers,3268000,2010
38168,2303400,0,Carnell Williams,RB,active,tampa-bay-buccaneers,2303400,2010
38169,1334117,300000,Aqib Talib,CB,active,tampa-bay-buccaneers,1634117,2010
38170,1176000,0,Maurice Stovall,WR,active,tampa-bay-buccaneers,1176000,2010
38171,1176000,0,Jeremy Trueblood,RT,active,tampa-bay-buccaneers,1176000,2010
38172,800000,0,Niko Koutouvides,ILB,active,tampa-bay-buccaneers,800000,2010
38173,1000000,0,Sean Jones,S,active,tampa-bay-buccaneers,1000000,2010
38174,320000,680000,Brian Price,DT,active,tampa-bay-buccaneers,1000000,2010
38175,950000,0,Jon Alston,LB,active,tampa-bay-buccaneers,950000,2010
38176,320000,525000,Arrelious Benn,WR,active,tampa-bay-buccaneers,845000,2010
38177,670000,105000,Andrew Economos,LS,active,tampa-bay-buccaneers,775000,2010
38178,470000,178500,Jeremy Zuttah,C,active,tampa-bay-buccaneers,648500,2010
38179,395000,192500,Roy Miller,DT,active,tampa-bay-buccaneers,587500,2010
38180,550000,25500,Adam Hayward,OLB,active,tampa-bay-buccaneers,575500,2010
38181,320000,232525,Myron Lewis,CB,active,tampa-bay-buccaneers,552525,2010
38182,550000,0,Tim Crowder,DE,active,tampa-bay-buccaneers,550000,2010
38183,470000,31375,Josh Johnson,QB,active,tampa-bay-buccaneers,501375,2010
38184,470000,0,Connor Barth,K,active,tampa-bay-buccaneers,470000,2010
38185,470000,0,Corey Lynch,S,active,tampa-bay-buccaneers,470000,2010
38186,470000,0,Elbert Mack,CB,active,tampa-bay-buccaneers,470000,2010
38187,320000,134562,Mike Williams,WR,active,tampa-bay-buccaneers,454562,2010
38188,405000,12067,Sammie Stroughter,WR,active,tampa-bay-buccaneers,417067,2010
38189,390000,16875,Cody Grimm,S,active,tampa-bay-buccaneers,406875,2010
38190,390000,8900,Erik Lorig,FB,active,tampa-bay-buccaneers,398900,2010
38191,395000,0,Michael Bennett,DE,active,tampa-bay-buccaneers,395000,2010
38192,390000,0,Derek Hardman,RT,active,tampa-bay-buccaneers,390000,2010
38193,320000,45250,Xavier Fulton,T,active,tampa-bay-buccaneers,365250,2010
38194,320000,15455,Dekoda Watson,OLB,active,tampa-bay-buccaneers,335455,2010
38195,320000,15100,E.J. Biggers,CB,active,tampa-bay-buccaneers,335100,2010
38196,320000,0,LeGarrette Blount,RB,active,tampa-bay-buccaneers,320000,2010
38197,320000,0,George Johnson,DE,active,tampa-bay-buccaneers,320000,2010
38198,320000,0,Ted Larsen,G,active,tampa-bay-buccaneers,320000,2010
38199,320000,0,Robert Malone,P,active,tampa-bay-buccaneers,320000,2010
38200,320000,0,Preston Parker,WR,active,tampa-bay-buccaneers,320000,2010
38201,320000,0,Ryan Purvis,TE,active,tampa-bay-buccaneers,320000,2010
38202,320000,0,Al Woods,DT,active,tampa-bay-buccaneers,320000,2010
38203,240000,0,Demar Dotson,RT,active,tampa-bay-buccaneers,240000,2010
38204,94117,0,Dezmon Briscoe,WR,active,tampa-bay-buccaneers,94117,2010
38205,18823,0,Doug Worthington,DE,active,tampa-bay-buccaneers,18823,2010
38206,470000,0,James Lee,T,active,tampa-bay-buccaneers,470000,2010
38207,5000000,0,Jeff Faine,C,injured_reserve,tampa-bay-buccaneers,5000000,2010
38208,3920000,200000,Davin Joseph,G,injured_reserve,tampa-bay-buccaneers,4120000,2010
38209,999068,206250,Quincy Black,LB,injured_reserve,tampa-bay-buccaneers,1205318,2010
38210,405000,118996,Kyle Moore,DE,injured_reserve,tampa-bay-buccaneers,523996,2010
38211,88400,0,Dezmon Briscoe,WR,practice_squad,tampa-bay-buccaneers,88400,2010
38212,88400,0,Nathan Overbay,TE,practice_squad,tampa-bay-buccaneers,88400,2010
38213,0,7829520,Gaines Adams,DE,dead_cap,tampa-bay-buccaneers,7829520,2010
38214,0,2800000,Carnell Williams,RB,dead_cap,tampa-bay-buccaneers,2800000,2010
38215,0,1300000,Chris Hovan,DT,dead_cap,tampa-bay-buccaneers,1300000,2010
38216,0,1250000,Luke McCown,QB,dead_cap,tampa-bay-buccaneers,1250000,2010
38217,1250000,0,Derrick Ward,RB,dead_cap,tampa-bay-buccaneers,1250000,2010
38218,485294,312500,Ryan Sims,DT,dead_cap,tampa-bay-buccaneers,797794,2010
38219,600000,0,B.J. Askew,FB,dead_cap,tampa-bay-buccaneers,600000,2010
38220,500000,0,Arron Sears,G,dead_cap,tampa-bay-buccaneers,500000,2010
38221,400000,0,Josh Bidwell,P,dead_cap,tampa-bay-buccaneers,400000,2010
38222,200000,0,Sabby Piscitelli,S,dead_cap,tampa-bay-buccaneers,200000,2010
38223,88400,0,Doug Worthington,DE,dead_cap,tampa-bay-buccaneers,88400,2010
38224,48000,0,Greg Peterson,DT,dead_cap,tampa-bay-buccaneers,48000,2010
38225,45250,0,Xavier Fulton,T,dead_cap,tampa-bay-buccaneers,45250,2010
38226,0,30750,Brent Bowden,P,dead_cap,tampa-bay-buccaneers,30750,2010
38227,9500000,0,Davin Joseph,G,active,tampa-bay-buccaneers,9500000,2011
38228,7200000,1333333,Donald Penn,LT,active,tampa-bay-buccaneers,8533333,2011
38229,8290000,0,Kellen Winslow,TE,active,tampa-bay-buccaneers,8290000,2011
38230,6000000,0,Quincy Black,LB,active,tampa-bay-buccaneers,6000000,2011
38231,4575000,0,Jeff Faine,C,active,tampa-bay-buccaneers,4575000,2011
38232,4000000,0,Ronde Barber,S,active,tampa-bay-buccaneers,4000000,2011
38233,873750,4890000,Gerald McCoy,DT,active,tampa-bay-buccaneers,5763750,2011
38234,3500000,0,Michael Koenen,P,active,tampa-bay-buccaneers,3500000,2011
38235,940000,2660000,Josh Freeman,QB,active,tampa-bay-buccaneers,3600000,2011
38236,1653750,300000,Aqib Talib,CB,active,tampa-bay-buccaneers,1953750,2011
38237,1835000,0,Connor Barth,K,active,tampa-bay-buccaneers,1835000,2011
38238,405000,1275000,Arrelious Benn,WR,active,tampa-bay-buccaneers,1680000,2011
38239,375000,1117758,Adrian Clayborn,DE,active,tampa-bay-buccaneers,1492758,2011
38240,1035000,300000,James Lee,T,active,tampa-bay-buccaneers,1335000,2011
38241,1250000,0,Sean Jones,S,active,tampa-bay-buccaneers,1250000,2011
38242,450000,680000,Brian Price,DT,active,tampa-bay-buccaneers,1130000,2011
38243,1100570,0,Adam Hayward,OLB,active,tampa-bay-buccaneers,1100570,2011
38244,1000000,0,Tanard Jackson,S,active,tampa-bay-buccaneers,1000000,2011
38245,675000,105000,Andrew Economos,LS,active,tampa-bay-buccaneers,780000,2011
38246,555000,178500,Jeremy Zuttah,C,active,tampa-bay-buccaneers,733500,2011
38247,375000,326025,Da'Quan Bowers,DT,active,tampa-bay-buccaneers,701025,2011
38248,480000,192500,Roy Miller,DT,active,tampa-bay-buccaneers,672500,2011
38249,405000,232525,Myron Lewis,CB,active,tampa-bay-buccaneers,637525,2011
38250,600000,31375,Josh Johnson,QB,active,tampa-bay-buccaneers,631375,2011
38251,450000,134562,Mike Williams,WR,active,tampa-bay-buccaneers,584562,2011
38252,555000,0,Corey Lynch,S,active,tampa-bay-buccaneers,555000,2011
38253,685000,0,John McCargo,DT,active,tampa-bay-buccaneers,685000,2011
38254,525000,0,Frank Okam,DT,active,tampa-bay-buccaneers,525000,2011
38255,375000,131250,Mason Foster,ILB,active,tampa-bay-buccaneers,506250,2011
38256,480000,15100,E.J. Biggers,CB,active,tampa-bay-buccaneers,495100,2011
38257,375000,118172,Luke Stocker,TE,active,tampa-bay-buccaneers,493172,2011
38258,480000,12067,Sammie Stroughter,WR,active,tampa-bay-buccaneers,492067,2011
38259,480000,0,Michael Bennett,DE,active,tampa-bay-buccaneers,480000,2011
38260,450000,0,LeGarrette Blount,RB,active,tampa-bay-buccaneers,450000,2011
38261,450000,0,Demar Dotson,RT,active,tampa-bay-buccaneers,450000,2011
38262,450000,0,E.J. Wilson,DE,active,tampa-bay-buccaneers,450000,2011
38263,405000,16875,Cody Grimm,S,active,tampa-bay-buccaneers,421875,2011
38264,405000,15455,Dekoda Watson,OLB,active,tampa-bay-buccaneers,420455,2011
38265,405000,0,Larry Asante,SS,active,tampa-bay-buccaneers,405000,2011
38266,405000,0,Dezmon Briscoe,WR,active,tampa-bay-buccaneers,405000,2011
38267,405000,0,Derek Hardman,RT,active,tampa-bay-buccaneers,405000,2011
38268,405000,0,Ted Larsen,G,active,tampa-bay-buccaneers,405000,2011
38269,405000,0,Erik Lorig,FB,active,tampa-bay-buccaneers,405000,2011
38270,405000,0,Robert Malone,P,active,tampa-bay-buccaneers,405000,2011
38271,405000,0,Preston Parker,WR,active,tampa-bay-buccaneers,405000,2011
38272,375000,13404,Anthony Gaitor,CB,active,tampa-bay-buccaneers,388404,2011
38273,375000,833,Devin Holland,S,active,tampa-bay-buccaneers,375833,2011
38274,375000,0,Allen Bradford,ILB,active,tampa-bay-buccaneers,375000,2011
38275,375000,0,George Johnson,DE,active,tampa-bay-buccaneers,375000,2011
38276,375000,0,Mossis Madu,RB,active,tampa-bay-buccaneers,375000,2011
38277,375000,0,Zack Pianalto,TE,active,tampa-bay-buccaneers,375000,2011
38278,375000,0,Jeremy Trueblood,RT,active,tampa-bay-buccaneers,375000,2011
38279,375000,0,Raymond Webber,WR,active,tampa-bay-buccaneers,375000,2011
38280,317647,0,Jacob Cutrera,ILB,active,tampa-bay-buccaneers,317647,2011
38281,96900,0,Danny Gorrer,CB,practice_squad,tampa-bay-buccaneers,96900,2011
38282,3000000,600000,Michael Clayton,WR,dead_cap,tampa-bay-buccaneers,3600000,2011
38283,1000000,0,Derrick Ward,RB,dead_cap,tampa-bay-buccaneers,1000000,2011
38284,0,625000,Ryan Sims,DT,dead_cap,tampa-bay-buccaneers,625000,2011
38285,118996,0,Kyle Moore,DE,dead_cap,tampa-bay-buccaneers,118996,2011
38286,0,92250,Brent Bowden,P,dead_cap,tampa-bay-buccaneers,92250,2011
38287,0,46685,Ahmad Black,S,dead_cap,tampa-bay-buccaneers,46685,2011
38288,45250,0,Xavier Fulton,T,dead_cap,tampa-bay-buccaneers,45250,2011
38289,26700,0,Erik Lorig,FB,dead_cap,tampa-bay-buccaneers,26700,2011
38290,0,24525,Allen Bradford,ILB,dead_cap,tampa-bay-buccaneers,24525,2011
38291,0,11475,Daniel Hardy,TE,dead_cap,tampa-bay-buccaneers,11475,2011
38292,2667,0,Michael VanDerMeulen,G,dead_cap,tampa-bay-buccaneers,2667,2011
38293,11000000,4432000,Vincent Jackson,WR,active,tampa-bay-buccaneers,15432000,2012
38294,6500000,8357000,Carl Nicks,G,active,tampa-bay-buccaneers,14857000,2012
38295,6547500,4890000,Gerald McCoy,DT,active,tampa-bay-buccaneers,11437500,2012
38296,6585000,2660000,Josh Freeman,QB,active,tampa-bay-buccaneers,9245000,2012
38297,5100000,1333333,Donald Penn,LT,active,tampa-bay-buccaneers,6433333,2012
38298,5544117,500000,Eric Wright,CB,active,tampa-bay-buccaneers,6044117,2012
38299,5500000,250000,Quincy Black,LB,active,tampa-bay-buccaneers,5750000,2012
38300,1450000,3000000,Connor Barth,K,active,tampa-bay-buccaneers,4450000,2012
38301,3375000,500000,Jeremy Zuttah,C,active,tampa-bay-buccaneers,3875000,2012
38302,3000000,0,Ronde Barber,S,active,tampa-bay-buccaneers,3000000,2012
38303,3000000,0,Michael Koenen,P,active,tampa-bay-buccaneers,3000000,2012
38304,2742000,0,Michael Bennett,DE,active,tampa-bay-buccaneers,2742000,2012
38305,2700000,0,Dallas Clark,TE,active,tampa-bay-buccaneers,2700000,2012
38306,390000,2240273,Mark Barron,ILB,active,tampa-bay-buccaneers,2630273,2012
38307,748189,1117758,Adrian Clayborn,DE,active,tampa-bay-buccaneers,1865947,2012
38308,1370000,192500,Roy Miller,DT,active,tampa-bay-buccaneers,1562500,2012
38309,1440000,15100,E.J. Biggers,CB,active,tampa-bay-buccaneers,1455100,2012
38310,390000,844096,Doug Martin,RB,active,tampa-bay-buccaneers,1234096,2012
38311,1105700,0,Adam Hayward,OLB,active,tampa-bay-buccaneers,1105700,2012
38312,490000,525000,Arrelious Benn,WR,active,tampa-bay-buccaneers,1015000,2012
38313,650000,0,D.J. Ware,RB,active,tampa-bay-buccaneers,650000,2012
38314,900000,0,Dan Orlovsky,QB,active,tampa-bay-buccaneers,900000,2012
38315,800000,200000,Demar Dotson,RT,active,tampa-bay-buccaneers,1000000,2012
38316,700000,300000,Gary Gibson,DT,active,tampa-bay-buccaneers,1000000,2012
38317,550256,326025,Da'Quan Bowers,DT,active,tampa-bay-buccaneers,876281,2012
38318,700000,105000,Andrew Economos,LS,active,tampa-bay-buccaneers,805000,2012
38319,540000,232525,Myron Lewis,CB,active,tampa-bay-buccaneers,772525,2012
38320,700000,0,Jamon Meredith,RT,active,tampa-bay-buccaneers,700000,2012
38321,540000,134562,Mike Williams,WR,active,tampa-bay-buccaneers,674562,2012
38322,501562,131250,Mason Foster,ILB,active,tampa-bay-buccaneers,632812,2012
38323,390000,241224,Lavonte David,OLB,active,tampa-bay-buccaneers,631224,2012
38324,615000,0,Tiquan Underwood,WR,active,tampa-bay-buccaneers,615000,2012
38325,615000,0,Cody Wallace,C,active,tampa-bay-buccaneers,615000,2012
38326,465000,118172,Luke Stocker,TE,active,tampa-bay-buccaneers,583172,2012
38327,700000,0,Brandon McDonald,CB,active,tampa-bay-buccaneers,700000,2012
38328,700000,0,Roscoe Parrish,WR,active,tampa-bay-buccaneers,700000,2012
38329,700000,0,Wallace Wright,WR,active,tampa-bay-buccaneers,700000,2012
38330,540000,0,LeGarrette Blount,RB,active,tampa-bay-buccaneers,540000,2012
38331,540000,0,Jacob Cutrera,ILB,active,tampa-bay-buccaneers,540000,2012
38332,540000,0,Danny Gorrer,CB,active,tampa-bay-buccaneers,540000,2012
38333,540000,0,Derek Hardman,RT,active,tampa-bay-buccaneers,540000,2012
38334,540000,0,Corvey Irvin,DT,active,tampa-bay-buccaneers,540000,2012
38335,540000,0,Ted Larsen,G,active,tampa-bay-buccaneers,540000,2012
38336,540000,0,Erik Lorig,FB,active,tampa-bay-buccaneers,540000,2012
38337,540000,0,Preston Parker,WR,active,tampa-bay-buccaneers,540000,2012
38338,540000,0,Nathan Triplett,LB,active,tampa-bay-buccaneers,540000,2012
38339,490000,16875,Cody Grimm,S,active,tampa-bay-buccaneers,506875,2012
38340,490000,15455,Dekoda Watson,OLB,active,tampa-bay-buccaneers,505455,2012
38341,465000,13404,Anthony Gaitor,CB,active,tampa-bay-buccaneers,478404,2012
38342,465000,0,Ahmad Black,S,active,tampa-bay-buccaneers,465000,2012
38343,465000,0,Nate Byham,TE,active,tampa-bay-buccaneers,465000,2012
38344,465000,0,Lazarius Levingston,DT,active,tampa-bay-buccaneers,465000,2012
38345,465000,0,Julian Vandervelde,C,active,tampa-bay-buccaneers,465000,2012
38346,465000,0,Markus White,DE,active,tampa-bay-buccaneers,465000,2012
38347,390000,51725,Najee Goode,OLB,active,tampa-bay-buccaneers,441725,2012
38348,390000,30150,Keith Tandy,FS,active,tampa-bay-buccaneers,420150,2012
38349,415000,0,Daniel Te'o-Nesheim,DE,active,tampa-bay-buccaneers,415000,2012
38350,390000,16287,Michael Smith,RB,active,tampa-bay-buccaneers,406287,2012
38351,390000,2500,Leonard Johnson,CB,active,tampa-bay-buccaneers,392500,2012
38352,390000,0,Matthew Masifilo,G,active,tampa-bay-buccaneers,390000,2012
38353,390000,0,Chris Owusu,WR,active,tampa-bay-buccaneers,390000,2012
38354,390000,0,Jake Rogers,K,active,tampa-bay-buccaneers,390000,2012
38355,540000,0,Roger Allen,G,active,tampa-bay-buccaneers,540000,2012
38356,390000,0,LeQuan Lewis,CB,active,tampa-bay-buccaneers,390000,2012
38357,390000,0,David Gilreath,WR,active,tampa-bay-buccaneers,390000,2012
38358,390000,0,David Douglas,WR,active,tampa-bay-buccaneers,390000,2012
38359,9500000,0,Davin Joseph,G,injured_reserve,tampa-bay-buccaneers,9500000,2012
38360,1000000,12067,Sammie Stroughter,WR,injured_reserve,tampa-bay-buccaneers,1012067,2012
38361,425000,143750,Jeremy Trueblood,RT,injured_reserve,tampa-bay-buccaneers,568750,2012
38362,465000,0,Aaron Morgan,DE,injured_reserve,tampa-bay-buccaneers,465000,2012
38363,390000,5000,Desmond Wynn,G,injured_reserve,tampa-bay-buccaneers,395000,2012
38364,390000,0,Jeff Demps,RB,injured_reserve,tampa-bay-buccaneers,390000,2012
38365,390000,0,Danny Noble,TE,injured_reserve,tampa-bay-buccaneers,390000,2012
38366,0,1800000,Michael Clayton,WR,dead_cap,tampa-bay-buccaneers,1800000,2012
38367,900000,0,Amobi Okoye,DT,dead_cap,tampa-bay-buccaneers,900000,2012
38368,680000,0,Brian Price,DT,dead_cap,tampa-bay-buccaneers,680000,2012
38369,0,140055,Ahmad Black,S,dead_cap,tampa-bay-buccaneers,140055,2012
38370,118996,0,Kyle Moore,DE,dead_cap,tampa-bay-buccaneers,118996,2012
38371,0,73575,Allen Bradford,ILB,dead_cap,tampa-bay-buccaneers,73575,2012
38372,65000,0,Nate Kaeding,K,dead_cap,tampa-bay-buccaneers,65000,2012
38373,51250,0,Dezmon Briscoe,WR,dead_cap,tampa-bay-buccaneers,51250,2012
38374,50000,0,Preston Parker,WR,dead_cap,tampa-bay-buccaneers,50000,2012
38375,0,34425,Daniel Hardy,TE,dead_cap,tampa-bay-buccaneers,34425,2012
38376,0,12250,Drake Dunsmore,TE,dead_cap,tampa-bay-buccaneers,12250,2012
38377,7000,0,Tramain Thomas,S,dead_cap,tampa-bay-buccaneers,7000,2012
38378,5334,0,Michael VanDerMeulen,G,dead_cap,tampa-bay-buccaneers,5334,2012
38379,5000,0,Cody Johnson,FB,dead_cap,tampa-bay-buccaneers,5000,2012
38380,3333,0,Bradley Sowell,LT,dead_cap,tampa-bay-buccaneers,3333,2012
38381,1666,0,Devin Holland,S,dead_cap,tampa-bay-buccaneers,1666,2012
38382,13000000,3000000,Darrelle Revis,CB,active,tampa-bay-buccaneers,16000000,2013
38383,8021250,4890000,Gerald McCoy,DT,active,tampa-bay-buccaneers,12911250,2013
38384,4235295,4500000,Dashon Goldson,FS,active,tampa-bay-buccaneers,8735295,2013
38385,7200000,1134562,Mike Williams,WR,active,tampa-bay-buccaneers,8334562,2013
38386,5000000,1333333,Donald Penn,LT,active,tampa-bay-buccaneers,6333333,2013
38387,6000000,0,Davin Joseph,G,active,tampa-bay-buccaneers,6000000,2013
38388,3875000,500000,Jeremy Zuttah,C,active,tampa-bay-buccaneers,4375000,2013
38389,1047000,2240273,Mark Barron,ILB,active,tampa-bay-buccaneers,3287273,2013
38390,840000,2432000,Vincent Jackson,WR,active,tampa-bay-buccaneers,3272000,2013
38391,3250000,0,Michael Koenen,P,active,tampa-bay-buccaneers,3250000,2013
38392,715000,2357000,Carl Nicks,G,active,tampa-bay-buccaneers,3072000,2013
38393,1121378,1117758,Adrian Clayborn,DE,active,tampa-bay-buccaneers,2239136,2013
38394,1000000,1000000,Demar Dotson,RT,active,tampa-bay-buccaneers,2000000,2013
38395,698524,844096,Doug Martin,RB,active,tampa-bay-buccaneers,1542620,2013
38396,1100000,300000,Jonathan Casillas,OLB,active,tampa-bay-buccaneers,1400000,2013
38397,1323000,0,Ted Larsen,G,active,tampa-bay-buccaneers,1323000,2013
38398,1323000,0,Daniel Te'o-Nesheim,DE,active,tampa-bay-buccaneers,1323000,2013
38399,1257000,0,Adam Hayward,OLB,active,tampa-bay-buccaneers,1257000,2013
38400,1250000,0,Derek Landri,DT,active,tampa-bay-buccaneers,1250000,2013
38401,725512,326025,Da'Quan Bowers,DT,active,tampa-bay-buccaneers,1051537,2013
38402,1016458,0,Gabe Carimi,G,active,tampa-bay-buccaneers,1016458,2013
38403,940000,65000,Rian Lindell,K,active,tampa-bay-buccaneers,1005000,2013
38404,1000000,0,Gary Gibson,DT,active,tampa-bay-buccaneers,1000000,2013
38405,1000000,0,Erik Lorig,FB,active,tampa-bay-buccaneers,1000000,2013
38406,800000,100000,Jamon Meredith,RT,active,tampa-bay-buccaneers,900000,2013
38407,405000,454331,Johnthan Banks,CB,active,tampa-bay-buccaneers,859331,2013
38408,547806,241224,Lavonte David,OLB,active,tampa-bay-buccaneers,789030,2013
38409,628124,131250,Mason Foster,ILB,active,tampa-bay-buccaneers,759374,2013
38410,555000,118172,Luke Stocker,TE,active,tampa-bay-buccaneers,673172,2013
38411,630000,15455,Dekoda Watson,OLB,active,tampa-bay-buccaneers,645455,2013
38412,630000,0,Danny Gorrer,CB,active,tampa-bay-buccaneers,630000,2013
38413,840000,0,Dan Orlovsky,QB,active,tampa-bay-buccaneers,840000,2013
38414,555000,13404,Anthony Gaitor,CB,active,tampa-bay-buccaneers,568404,2013
38415,405000,159375,Mike Glennon,QB,active,tampa-bay-buccaneers,564375,2013
38416,840000,65000,Andrew Economos,LS,active,tampa-bay-buccaneers,905000,2013
38417,405000,121071,Akeem Spence,DT,active,tampa-bay-buccaneers,526071,2013
38418,405000,100136,William Gholston,DE,active,tampa-bay-buccaneers,505136,2013
38419,480000,2500,Leonard Johnson,CB,active,tampa-bay-buccaneers,482500,2013
38420,480000,0,Matthew Masifilo,G,active,tampa-bay-buccaneers,480000,2013
38421,715000,0,Spencer Larsen,RB,active,tampa-bay-buccaneers,715000,2013
38422,405000,47938,Steven Means,DE,active,tampa-bay-buccaneers,452938,2013
38423,405000,25788,Mike James,RB,active,tampa-bay-buccaneers,430788,2013
38424,715000,0,Tiquan Underwood,WR,active,tampa-bay-buccaneers,715000,2013
38425,405000,3333,Rashaan Melvin,CB,active,tampa-bay-buccaneers,408333,2013
38426,405000,3333,Tim Wright,TE,active,tampa-bay-buccaneers,408333,2013
38427,405000,0,Eric Page,WR,active,tampa-bay-buccaneers,405000,2013
38428,405000,0,Russell Shepard,WR,active,tampa-bay-buccaneers,405000,2013
38429,405000,0,Deveron Carr,CB,active,tampa-bay-buccaneers,405000,2013
38430,555000,0,Nate Byham,TE,active,tampa-bay-buccaneers,555000,2013
38431,480000,0,Chris Owusu,WR,active,tampa-bay-buccaneers,480000,2013
38432,303000,16287,Michael Smith,RB,active,tampa-bay-buccaneers,319287,2013
38433,405000,0,Kelcie McCray,SS,active,tampa-bay-buccaneers,405000,2013
38434,405000,0,Patrick Omameh,G,active,tampa-bay-buccaneers,405000,2013
38435,480000,0,Bobby Rainey,RB,active,tampa-bay-buccaneers,480000,2013
38436,405000,0,Skye Dawson,WR,active,tampa-bay-buccaneers,405000,2013
38437,405000,0,Ka'lial Glaud,OLB,active,tampa-bay-buccaneers,405000,2013
38438,405000,0,Bradley McDougald,SS,active,tampa-bay-buccaneers,405000,2013
38439,405000,0,Michael Hill,RB,active,tampa-bay-buccaneers,405000,2013
38440,555000,0,Kyle Adams,TE,active,tampa-bay-buccaneers,555000,2013
38441,405000,0,Lonnie Pryor,RB,active,tampa-bay-buccaneers,405000,2013
38442,480000,0,Danny Lansanah,ILB,active,tampa-bay-buccaneers,480000,2013
38443,80000,30150,Keith Tandy,FS,active,tampa-bay-buccaneers,110150,2013
38444,700000,75000,Tom Crabtree,TE,injured_reserve,tampa-bay-buccaneers,775000,2013
38445,630000,20000,Jacob Cutrera,ILB,injured_reserve,tampa-bay-buccaneers,650000,2013
38446,715000,0,Michael Adams,S,injured_reserve,tampa-bay-buccaneers,715000,2013
38447,405000,0,Jeff Demps,RB,injured_reserve,tampa-bay-buccaneers,405000,2013
38448,288000,0,Marvin Booker,LT,injured_reserve,tampa-bay-buccaneers,288000,2013
38449,149647,0,Aaron Morgan,DE,injured_reserve,tampa-bay-buccaneers,149647,2013
38450,2300000,0,Connor Barth,K,non_fb_injury,tampa-bay-buccaneers,2300000,2013
38451,840000,65000,Lawrence Tynes,K,non_fb_injury,tampa-bay-buccaneers,905000,2013
38452,90000,0,Matthew Masifilo,G,practice_squad,tampa-bay-buccaneers,90000,2013
38453,54000,0,Ka'lial Glaud,OLB,practice_squad,tampa-bay-buccaneers,54000,2013
38454,40230,0,Danny Noble,TE,practice_squad,tampa-bay-buccaneers,40230,2013
38455,30000,0,Mike Remmers,RT,practice_squad,tampa-bay-buccaneers,30000,2013
38456,9760000,0,Josh Freeman,QB,dead_cap,tampa-bay-buccaneers,9760000,2013
38457,1250000,0,Kevin Ogletree,WR,dead_cap,tampa-bay-buccaneers,1250000,2013
38458,680000,0,Brian Price,DT,dead_cap,tampa-bay-buccaneers,680000,2013
38459,555000,0,Peyton Hillis,RB,dead_cap,tampa-bay-buccaneers,555000,2013
38460,555000,0,Trevor Scott,DE,dead_cap,tampa-bay-buccaneers,555000,2013
38461,525000,0,Arrelious Benn,WR,dead_cap,tampa-bay-buccaneers,525000,2013
38462,232525,0,Myron Lewis,CB,dead_cap,tampa-bay-buccaneers,232525,2013
38463,0,134562,Mike Williams,WR,dead_cap,tampa-bay-buccaneers,134562,2013
38464,130588,0,Ahmad Black,S,dead_cap,tampa-bay-buccaneers,130588,2013
38465,130588,0,Spencer Larsen,RB,dead_cap,tampa-bay-buccaneers,130588,2013
38466,60000,0,Matt Veldman,TE,dead_cap,tampa-bay-buccaneers,60000,2013
38467,59824,0,Skye Dawson,WR,dead_cap,tampa-bay-buccaneers,59824,2013
38468,0,51725,Najee Goode,OLB,dead_cap,tampa-bay-buccaneers,51725,2013
38469,40000,0,Chris Owusu,WR,dead_cap,tampa-bay-buccaneers,40000,2013
38470,0,36750,Drake Dunsmore,TE,dead_cap,tampa-bay-buccaneers,36750,2013
38471,30000,0,Randy Richards,RT,dead_cap,tampa-bay-buccaneers,30000,2013
38472,23000,5000,Deveron Carr,CB,dead_cap,tampa-bay-buccaneers,28000,2013
38473,23824,0,Bobby Felder,CB,dead_cap,tampa-bay-buccaneers,23824,2013
38474,23824,0,Chris Jones,DT,dead_cap,tampa-bay-buccaneers,23824,2013
38475,18000,0,Jordan Rodgers,QB,dead_cap,tampa-bay-buccaneers,18000,2013
38476,18000,0,Nick Saenz,S,dead_cap,tampa-bay-buccaneers,18000,2013
38477,18000,0,Jonathan Stewart,OLB,dead_cap,tampa-bay-buccaneers,18000,2013
38478,0,16875,Cody Grimm,S,dead_cap,tampa-bay-buccaneers,16875,2013
38479,6667,0,Bradley Sowell,LT,dead_cap,tampa-bay-buccaneers,6667,2013
38480,6000,0,Dan Buckner,WR,dead_cap,tampa-bay-buccaneers,6000,2013
38481,6000,0,Richard Clebert,DT,dead_cap,tampa-bay-buccaneers,6000,2013
38482,0,3333,Brice Schwab,RT,dead_cap,tampa-bay-buccaneers,3333,2013
38483,0,1667,Branden Smith,CB,dead_cap,tampa-bay-buccaneers,1667,2013
38484,0,1333,Jerry Johnson,WR,dead_cap,tampa-bay-buccaneers,1333,2013
38485,0,1333,Evan Landi,TE,dead_cap,tampa-bay-buccaneers,1333,2013
38486,0,1333,Nick Speller,T,dead_cap,tampa-bay-buccaneers,1333,2013
38487,0,1333,Jason Weaver,LT,dead_cap,tampa-bay-buccaneers,1333,2013
38488,17500000,5790000,Gerald McCoy,DT,active,tampa-bay-buccaneers,23290000,2014
38489,10000000,2432000,Vincent Jackson,WR,active,tampa-bay-buccaneers,12432000,2014
38490,6000000,3000000,Dashon Goldson,FS,active,tampa-bay-buccaneers,9000000,2014
38491,5000000,4000000,Michael Johnson,DE,active,tampa-bay-buccaneers,9000000,2014
38492,5000000,3250000,Alterraun Verner,CB,active,tampa-bay-buccaneers,8250000,2014
38493,6250000,0,Logan Mankins,G,active,tampa-bay-buccaneers,6250000,2014
38494,4000000,2000000,Anthony Collins,LT,active,tampa-bay-buccaneers,6000000,2014
38495,3750000,1000000,Josh McCown,QB,active,tampa-bay-buccaneers,4750000,2014
38496,3000000,500000,Clinton McDonald,DT,active,tampa-bay-buccaneers,3500000,2014
38497,2500000,1000000,Evan Smith,C,active,tampa-bay-buccaneers,3500000,2014
38498,3250000,0,Michael Koenen,P,active,tampa-bay-buccaneers,3250000,2014
38499,420000,2240273,Mike Evans,WR,active,tampa-bay-buccaneers,2660273,2014
38500,1494567,1117758,Adrian Clayborn,DE,active,tampa-bay-buccaneers,2612325,2014
38501,2000000,291666,Brandon Myers,TE,active,tampa-bay-buccaneers,2291666,2014
38502,2000000,0,Demar Dotson,RT,active,tampa-bay-buccaneers,2000000,2014
38503,1250000,625000,Mike Jenkins,CB,active,tampa-bay-buccaneers,1875000,2014
38504,1007048,844096,Doug Martin,RB,active,tampa-bay-buccaneers,1851144,2014
38505,1431000,131250,Mason Foster,ILB,active,tampa-bay-buccaneers,1562250,2014
38506,800000,400000,Dane Fletcher,ILB,active,tampa-bay-buccaneers,1200000,2014
38507,900768,326025,Da'Quan Bowers,DT,active,tampa-bay-buccaneers,1226793,2014
38508,619833,454331,Johnthan Banks,CB,active,tampa-bay-buccaneers,1074164,2014
38509,420000,535440,Austin Seferian-Jenkins,TE,active,tampa-bay-buccaneers,955440,2014
38510,705612,241224,Lavonte David,OLB,active,tampa-bay-buccaneers,946836,2014
38511,645000,118172,Luke Stocker,TE,active,tampa-bay-buccaneers,763172,2014
38512,546094,159375,Mike Glennon,QB,active,tampa-bay-buccaneers,705469,2014
38513,730000,65000,Oniel Cousins,G,active,tampa-bay-buccaneers,795000,2014
38514,730000,65000,Major Wright,S,active,tampa-bay-buccaneers,795000,2014
38515,495000,121071,Akeem Spence,DT,active,tampa-bay-buccaneers,616071,2014
38516,570000,30150,Keith Tandy,FS,active,tampa-bay-buccaneers,600150,2014
38517,495000,100136,William Gholston,DE,active,tampa-bay-buccaneers,595136,2014
38518,570000,2500,Leonard Johnson,CB,active,tampa-bay-buccaneers,572500,2014
38519,570000,0,Danny Lansanah,ILB,active,tampa-bay-buccaneers,570000,2014
38520,570000,0,Bobby Rainey,RB,active,tampa-bay-buccaneers,570000,2014
38521,730000,0,Larry English,OLB,active,tampa-bay-buccaneers,730000,2014
38522,364941,171023,Charles Sims,RB,active,tampa-bay-buccaneers,535964,2014
38523,495000,25788,Mike James,RB,active,tampa-bay-buccaneers,520788,2014
38524,495000,0,Garrett Gilkey,G,active,tampa-bay-buccaneers,495000,2014
38525,495000,0,Bradley McDougald,SS,active,tampa-bay-buccaneers,495000,2014
38526,495000,0,Patrick Omameh,G,active,tampa-bay-buccaneers,495000,2014
38527,495000,0,Russell Shepard,WR,active,tampa-bay-buccaneers,495000,2014
38528,420000,49625,Kevin Pamphile,G,active,tampa-bay-buccaneers,469625,2014
38529,601176,0,Louis Murphy,WR,active,tampa-bay-buccaneers,601176,2014
38530,420000,28000,Robert Herron,WR,active,tampa-bay-buccaneers,448000,2014
38531,420000,0,Andrew DePaola,LS,active,tampa-bay-buccaneers,420000,2014
38532,420000,0,Brandon Dixon,CB,active,tampa-bay-buccaneers,420000,2014
38533,420000,0,Patrick Murray,K,active,tampa-bay-buccaneers,420000,2014
38534,420000,0,Jacquies Smith,OLB,active,tampa-bay-buccaneers,420000,2014
38535,303000,53000,Kadeem Edwards,G,active,tampa-bay-buccaneers,356000,2014
38536,291176,0,Orie Lemon,ILB,active,tampa-bay-buccaneers,291176,2014
38537,320294,0,Isaiah Frey,CB,active,tampa-bay-buccaneers,320294,2014
38538,420000,0,T.J. Fatinikun,DE,active,tampa-bay-buccaneers,420000,2014
38539,420000,0,Josh Allen,C,active,tampa-bay-buccaneers,420000,2014
38540,420000,0,Cameron Brate,TE,active,tampa-bay-buccaneers,420000,2014
38541,730000,0,Jason Williams,OLB,active,tampa-bay-buccaneers,730000,2014
38542,420000,0,Solomon Patton,WR,active,tampa-bay-buccaneers,420000,2014
38543,730000,0,Lawrence Sidbury,OLB,active,tampa-bay-buccaneers,730000,2014
38544,570000,0,Evan Rodriguez,FB,active,tampa-bay-buccaneers,570000,2014
38545,495000,0,Tavarres King,WR,active,tampa-bay-buccaneers,495000,2014
38546,495000,0,C.J. Wilson,CB,active,tampa-bay-buccaneers,495000,2014
38547,420000,0,George Uko,DT,active,tampa-bay-buccaneers,420000,2014
38548,495000,0,Brandon Magee,ILB,injured_reserve,tampa-bay-buccaneers,495000,2014
38549,495000,0,Jorvorskie Lane,FB,injured_reserve,tampa-bay-buccaneers,495000,2014
38550,56700,0,Mike Kafka,QB,practice_squad,tampa-bay-buccaneers,56700,2014
38551,50400,0,Matthew Masifilo,G,practice_squad,tampa-bay-buccaneers,50400,2014
38552,50400,0,Matt Patchan,RT,practice_squad,tampa-bay-buccaneers,50400,2014
38553,44100,0,Jeremiah Warren,C,practice_squad,tampa-bay-buccaneers,44100,2014
38554,18900,0,Ka'lial Glaud,OLB,practice_squad,tampa-bay-buccaneers,18900,2014
38555,12600,0,Chandler Jones,WR,practice_squad,tampa-bay-buccaneers,12600,2014
38556,12600,0,Varmah Sonie,CB,practice_squad,tampa-bay-buccaneers,12600,2014
38557,6300,0,Shelton Johnson,S,practice_squad,tampa-bay-buccaneers,6300,2014
38558,3000000,2357000,Carl Nicks,G,dead_cap,tampa-bay-buccaneers,5357000,2014
38559,802352,2240273,Mark Barron,ILB,dead_cap,tampa-bay-buccaneers,3042625,2014
38560,517647,300000,Jonathan Casillas,OLB,dead_cap,tampa-bay-buccaneers,817647,2014
38561,0,666668,Donald Penn,LT,dead_cap,tampa-bay-buccaneers,666668,2014
38562,531177,0,Crezdon Butler,CB,dead_cap,tampa-bay-buccaneers,531177,2014
38563,0,350000,Jamon Meredith,RT,dead_cap,tampa-bay-buccaneers,350000,2014
38564,234706,0,Scott Solomon,OLB,dead_cap,tampa-bay-buccaneers,234706,2014
38565,210741,3000,Solomon Patton,WR,dead_cap,tampa-bay-buccaneers,213741,2014
38566,186547,0,Mike Kafka,QB,dead_cap,tampa-bay-buccaneers,186547,2014
38567,178235,0,Jibreel Black,DT,dead_cap,tampa-bay-buccaneers,178235,2014
38568,156653,0,C.J. Wilson,CB,dead_cap,tampa-bay-buccaneers,156653,2014
38569,142588,1000,Mycal Swaim,S,dead_cap,tampa-bay-buccaneers,143588,2014
38570,140418,0,Marcus Thigpen,WR,dead_cap,tampa-bay-buccaneers,140418,2014
38571,134118,0,Rishaw  Johnson,G,dead_cap,tampa-bay-buccaneers,134118,2014
38572,125824,0,Trindon Holliday,KR,dead_cap,tampa-bay-buccaneers,125824,2014
38573,115394,0,Jeremy Grable,OLB,dead_cap,tampa-bay-buccaneers,115394,2014
38574,107100,0,Derrius Brooks,CB,dead_cap,tampa-bay-buccaneers,107100,2014
38575,0,103450,Najee Goode,OLB,dead_cap,tampa-bay-buccaneers,103450,2014
38576,100588,0,Chris Owusu,WR,dead_cap,tampa-bay-buccaneers,100588,2014
38577,76941,3333,Rashaan Melvin,CB,dead_cap,tampa-bay-buccaneers,80274,2014
38578,79518,0,Matthew Masifilo,G,dead_cap,tampa-bay-buccaneers,79518,2014
38579,29118,47938,Steven Means,DE,dead_cap,tampa-bay-buccaneers,77056,2014
38580,75600,0,Cameron Brate,TE,dead_cap,tampa-bay-buccaneers,75600,2014
38581,56700,1666,Josh Allen,C,dead_cap,tampa-bay-buccaneers,58366,2014
38582,52429,0,Quinton Pointer,CB,dead_cap,tampa-bay-buccaneers,52429,2014
38583,0,50000,Tom Crabtree,TE,dead_cap,tampa-bay-buccaneers,50000,2014
38584,44100,0,Tavarres King,WR,dead_cap,tampa-bay-buccaneers,44100,2014
38585,44100,0,George Uko,DT,dead_cap,tampa-bay-buccaneers,44100,2014
38586,37941,0,D.J. Williams,TE,dead_cap,tampa-bay-buccaneers,37941,2014
38587,37800,0,Jeff Demps,RB,dead_cap,tampa-bay-buccaneers,37800,2014
38588,37800,0,Denicos Allen,OLB,dead_cap,tampa-bay-buccaneers,37800,2014
38589,33529,0,Louis Murphy,WR,dead_cap,tampa-bay-buccaneers,33529,2014
38590,0,32574,Michael Smith,RB,dead_cap,tampa-bay-buccaneers,32574,2014
38591,25200,0,T.J. Fatinikun,DE,dead_cap,tampa-bay-buccaneers,25200,2014
38592,25200,0,Carlos Fields,OLB,dead_cap,tampa-bay-buccaneers,25200,2014
38593,25200,0,Shayne Skov,ILB,dead_cap,tampa-bay-buccaneers,25200,2014
38594,18900,0,Ted Bolser,TE,dead_cap,tampa-bay-buccaneers,18900,2014
38595,18900,0,Kimario McFadden,SS,dead_cap,tampa-bay-buccaneers,18900,2014
38596,18900,0,Eric Page,WR,dead_cap,tampa-bay-buccaneers,18900,2014
38597,18900,0,Lonnie Pryor,RB,dead_cap,tampa-bay-buccaneers,18900,2014
38598,18900,0,Evan Rodriguez,FB,dead_cap,tampa-bay-buccaneers,18900,2014
38599,18900,0,Taylor Sloat,TE,dead_cap,tampa-bay-buccaneers,18900,2014
38600,16588,0,David Gettis,WR,dead_cap,tampa-bay-buccaneers,16588,2014
38601,0,13404,Anthony Gaitor,CB,dead_cap,tampa-bay-buccaneers,13404,2014
38602,12600,0,Mister Alexander,LB,dead_cap,tampa-bay-buccaneers,12600,2014
38603,12600,0,Kevin Cone,WR,dead_cap,tampa-bay-buccaneers,12600,2014
38604,12600,0,Brandon Magee,ILB,dead_cap,tampa-bay-buccaneers,12600,2014
38605,12600,0,Jarrod Pughsley,LT,dead_cap,tampa-bay-buccaneers,12600,2014
38606,12600,0,Adrian Robinson,OLB,dead_cap,tampa-bay-buccaneers,12600,2014
38607,0,10000,Deveron Carr,CB,dead_cap,tampa-bay-buccaneers,10000,2014
38608,0,10000,Desmond Wynn,G,dead_cap,tampa-bay-buccaneers,10000,2014
38609,0,6667,Brice Schwab,RT,dead_cap,tampa-bay-buccaneers,6667,2014
38610,6300,0,Ka'lial Glaud,OLB,dead_cap,tampa-bay-buccaneers,6300,2014
38611,6300,0,Jake Schum,P,dead_cap,tampa-bay-buccaneers,6300,2014
38612,6300,0,Ian Thompson,TE,dead_cap,tampa-bay-buccaneers,6300,2014
38613,0,5000,Chaz Sutton,DE,dead_cap,tampa-bay-buccaneers,5000,2014
38614,0,4950,Matt Patchan,RT,dead_cap,tampa-bay-buccaneers,4950,2014
38615,0,3334,Branden Smith,CB,dead_cap,tampa-bay-buccaneers,3334,2014
38616,0,3333,Euclid Cummings,DT,dead_cap,tampa-bay-buccaneers,3333,2014
38617,0,3333,Tim Wright,TE,dead_cap,tampa-bay-buccaneers,3333,2014
38618,0,3000,Brett Smith,QB,dead_cap,tampa-bay-buccaneers,3000,2014
38619,0,2667,Jerry Johnson,WR,dead_cap,tampa-bay-buccaneers,2667,2014
38620,0,2667,Evan Landi,TE,dead_cap,tampa-bay-buccaneers,2667,2014
38621,0,2667,Nick Speller,T,dead_cap,tampa-bay-buccaneers,2667,2014
38622,0,2667,Jason Weaver,LT,dead_cap,tampa-bay-buccaneers,2667,2014
38623,0,2500,Nate Askew,OLB,dead_cap,tampa-bay-buccaneers,2500,2014
38624,0,1666,Aaron Burks,WR,dead_cap,tampa-bay-buccaneers,1666,2014
38625,0,1666,Andrew Miller,G,dead_cap,tampa-bay-buccaneers,1666,2014
38626,0,1000,Keith Lewis,CB,dead_cap,tampa-bay-buccaneers,1000,2014
38627,5000000,11590000,Gerald McCoy,DT,active,tampa-bay-buccaneers,16590000,2015
38628,6750000,250000,Logan Mankins,G,active,tampa-bay-buccaneers,7000000,2015
38629,738418,5366224,Lavonte David,OLB,active,tampa-bay-buccaneers,6104642,2015
38630,435000,4174323,Jameis Winston,QB,active,tampa-bay-buccaneers,4609323,2015
38631,4250000,0,Alterraun Verner,CB,active,tampa-bay-buccaneers,4250000,2015
38632,3000000,1250000,Bruce Carter,ILB,active,tampa-bay-buccaneers,4250000,2015
38633,3750000,0,Evan Smith,C,active,tampa-bay-buccaneers,3750000,2015
38634,2250000,1500000,Henry Melton,DT,active,tampa-bay-buccaneers,3750000,2015
38635,510000,2815341,Mike Evans,WR,active,tampa-bay-buccaneers,3325341,2015
38636,750000,2000000,George Johnson,DE,active,tampa-bay-buccaneers,2750000,2015
38637,2500000,0,Demar Dotson,RT,active,tampa-bay-buccaneers,2500000,2015
38638,1500000,1000000,Gosder Cherilus,RT,active,tampa-bay-buccaneers,2500000,2015
38639,1315572,844096,Doug Martin,RB,active,tampa-bay-buccaneers,2159668,2015
38640,1542000,0,Bobby Rainey,RB,active,tampa-bay-buccaneers,1542000,2015
38641,875000,650000,Sterling Moore,CB,active,tampa-bay-buccaneers,1525000,2015
38642,1000000,500000,Tony McDaniel,DT,active,tampa-bay-buccaneers,1500000,2015
38643,1000000,500000,Luke Stocker,TE,active,tampa-bay-buccaneers,1500000,2015
38644,834666,454331,Johnthan Banks,CB,active,tampa-bay-buccaneers,1288997,2015
38645,1328125,0,Joe Hawley,C,active,tampa-bay-buccaneers,1328125,2015
38646,1000000,250000,Major Wright,S,active,tampa-bay-buccaneers,1250000,2015
38647,658861,535440,Austin Seferian-Jenkins,TE,active,tampa-bay-buccaneers,1194301,2015
38648,1000000,166666,Brandon Myers,TE,active,tampa-bay-buccaneers,1166666,2015
38649,435000,668429,Donovan Smith,LT,active,tampa-bay-buccaneers,1103429,2015
38650,687188,159375,Mike Glennon,QB,active,tampa-bay-buccaneers,846563,2015
38651,745000,80000,Mike Jenkins,CB,active,tampa-bay-buccaneers,825000,2015
38652,540000,186023,Charles Sims,RB,active,tampa-bay-buccaneers,726023,2015
38653,660000,30150,Keith Tandy,FS,active,tampa-bay-buccaneers,690150,2015
38654,435000,251106,Ali Marpet,C,active,tampa-bay-buccaneers,686106,2015
38655,585000,100136,William Gholston,DE,active,tampa-bay-buccaneers,685136,2015
38656,660000,0,Danny Lansanah,ILB,active,tampa-bay-buccaneers,660000,2015
38657,585000,0,Jorvorskie Lane,FB,active,tampa-bay-buccaneers,585000,2015
38658,585000,0,Bradley McDougald,SS,active,tampa-bay-buccaneers,585000,2015
38659,585000,0,Russell Shepard,WR,active,tampa-bay-buccaneers,585000,2015
38660,745000,0,Connor Barth,K,active,tampa-bay-buccaneers,745000,2015
38661,510000,49625,Kevin Pamphile,G,active,tampa-bay-buccaneers,559625,2015
38662,510000,0,Andrew DePaola,LS,active,tampa-bay-buccaneers,510000,2015
38663,510000,0,Jeremiah George,ILB,active,tampa-bay-buccaneers,510000,2015
38664,510000,0,Ryan Griffin,QB,active,tampa-bay-buccaneers,510000,2015
38665,510000,0,Jacquies Smith,OLB,active,tampa-bay-buccaneers,510000,2015
38666,450000,0,Cameron Brate,TE,active,tampa-bay-buccaneers,450000,2015
38667,435000,0,Jake Schum,P,active,tampa-bay-buccaneers,435000,2015
38668,318000,51209,Kenny Bell,WR,active,tampa-bay-buccaneers,369209,2015
38669,358235,0,Jude Adjei-Barimah,CB,active,tampa-bay-buccaneers,358235,2015
38670,332647,0,Donteea Dye,WR,active,tampa-bay-buccaneers,332647,2015
38671,332647,0,Howard Jones,OLB,active,tampa-bay-buccaneers,332647,2015
38672,255882,0,Adam Humphries,WR,active,tampa-bay-buccaneers,255882,2015
38673,179117,0,Josh Keyes,ILB,active,tampa-bay-buccaneers,179117,2015
38674,153529,0,Kourtnei Brown,OLB,active,tampa-bay-buccaneers,153529,2015
38675,150000,0,Adarius Taylor,OLB,active,tampa-bay-buccaneers,150000,2015
38676,131470,0,Da'Quan Bowers,DT,active,tampa-bay-buccaneers,131470,2015
38677,68823,0,Mike James,RB,active,tampa-bay-buccaneers,68823,2015
38678,51176,0,Evan Spencer,WR,active,tampa-bay-buccaneers,51176,2015
38679,25588,0,Darius Eubanks,S,active,tampa-bay-buccaneers,25588,2015
38680,25588,0,Kimario McFadden,SS,active,tampa-bay-buccaneers,25588,2015
38681,25588,0,Tevin Westbrook,TE,active,tampa-bay-buccaneers,25588,2015
38682,9777777,2432000,Vincent Jackson,WR,injured_reserve,tampa-bay-buccaneers,12209777,2015
38683,3250000,0,Clinton McDonald,DT,injured_reserve,tampa-bay-buccaneers,3250000,2015
38684,1000000,500000,Christopher Conte,FS,injured_reserve,tampa-bay-buccaneers,1500000,2015
38685,900000,87500,Louis Murphy,WR,injured_reserve,tampa-bay-buccaneers,987500,2015
38686,550588,121071,Akeem Spence,DT,injured_reserve,tampa-bay-buccaneers,671659,2015
38687,413000,173750,Larry English,OLB,injured_reserve,tampa-bay-buccaneers,586750,2015
38688,374647,0,T.J. Fatinikun,DE,injured_reserve,tampa-bay-buccaneers,374647,2015
38689,3000000,4000000,Michael Johnson,DE,dead_cap,tampa-bay-buccaneers,7000000,2015
38690,0,4714000,Carl Nicks,G,dead_cap,tampa-bay-buccaneers,4714000,2015
38691,4000000,0,Dashon Goldson,FS,dead_cap,tampa-bay-buccaneers,4000000,2015
38692,3000000,0,Anthony Collins,LT,dead_cap,tampa-bay-buccaneers,3000000,2015
38693,0,2240273,Mark Barron,ILB,dead_cap,tampa-bay-buccaneers,2240273,2015
38694,870000,0,Tim Jennings,CB,dead_cap,tampa-bay-buccaneers,870000,2015
38695,424935,0,D.J. Swearinger,FS,dead_cap,tampa-bay-buccaneers,424935,2015
38696,317187,0,Orie Lemon,ILB,dead_cap,tampa-bay-buccaneers,317187,2015
38697,182435,25788,Mike James,RB,dead_cap,tampa-bay-buccaneers,208223,2015
38698,198917,0,Josh Shirley,OLB,dead_cap,tampa-bay-buccaneers,198917,2015
38699,176400,0,Reid Fragel,RT,dead_cap,tampa-bay-buccaneers,176400,2015
38700,153529,0,Jeremiah Warren,C,dead_cap,tampa-bay-buccaneers,153529,2015
38701,122376,24000,Robert Herron,WR,dead_cap,tampa-bay-buccaneers,146376,2015
38702,140294,0,Emmanuel Ogbuehi,TE,dead_cap,tampa-bay-buccaneers,140294,2015
38703,122152,0,Adam Humphries,WR,dead_cap,tampa-bay-buccaneers,122152,2015
38704,120000,0,Matthew Masifilo,G,dead_cap,tampa-bay-buccaneers,120000,2015
38705,103235,0,Josh Martin,OLB,dead_cap,tampa-bay-buccaneers,103235,2015
38706,103164,0,Kimario McFadden,SS,dead_cap,tampa-bay-buccaneers,103164,2015
38707,102400,0,Antoine Everett,G,dead_cap,tampa-bay-buccaneers,102400,2015
38708,102352,0,Kyle Brindza,K,dead_cap,tampa-bay-buccaneers,102352,2015
38709,0,95876,Steven Means,DE,dead_cap,tampa-bay-buccaneers,95876,2015
38710,92400,0,Derrick Lott,DT,dead_cap,tampa-bay-buccaneers,92400,2015
38711,85800,0,Evan Spencer,WR,dead_cap,tampa-bay-buccaneers,85800,2015
38712,85800,0,Tevin Westbrook,TE,dead_cap,tampa-bay-buccaneers,85800,2015
38713,79200,3000,Rannell Hall,WR,dead_cap,tampa-bay-buccaneers,82200,2015
38714,80000,0,Jason Williams,OLB,dead_cap,tampa-bay-buccaneers,80000,2015
38715,57776,0,Kourtnei Brown,OLB,dead_cap,tampa-bay-buccaneers,57776,2015
38716,56118,1000,Quinton Alston,LB,dead_cap,tampa-bay-buccaneers,57118,2015
38717,0,53000,Kadeem Edwards,G,dead_cap,tampa-bay-buccaneers,53000,2015
38718,52800,0,Martin Ifedi,DE,dead_cap,tampa-bay-buccaneers,52800,2015
38719,46200,3334,Josh Allen,C,dead_cap,tampa-bay-buccaneers,49534,2015
38720,39600,0,Ben Gottschalk,RT,dead_cap,tampa-bay-buccaneers,39600,2015
38721,6600,32619,Kaelin Clay,WR,dead_cap,tampa-bay-buccaneers,39219,2015
38722,43823,0,Lawrence Sidbury,OLB,dead_cap,tampa-bay-buccaneers,43823,2015
38723,34411,0,Eric Kush,G,dead_cap,tampa-bay-buccaneers,34411,2015
38724,26400,0,Donteea Dye,WR,dead_cap,tampa-bay-buccaneers,26400,2015
38725,26400,0,Isaiah Frey,CB,dead_cap,tampa-bay-buccaneers,26400,2015
38726,26400,0,Ryan Groy,G,dead_cap,tampa-bay-buccaneers,26400,2015
38727,26400,0,Howard Jones,OLB,dead_cap,tampa-bay-buccaneers,26400,2015
38728,26400,0,Andre Davis,G,dead_cap,tampa-bay-buccaneers,26400,2015
38729,26400,0,Martin Wallace,LT,dead_cap,tampa-bay-buccaneers,26400,2015
38730,19800,2666,Josh Keyes,ILB,dead_cap,tampa-bay-buccaneers,22466,2015
38731,19800,0,Jude Adjei-Barimah,CB,dead_cap,tampa-bay-buccaneers,19800,2015
38732,19800,0,Imoan Claiborne,CB,dead_cap,tampa-bay-buccaneers,19800,2015
38733,0,17085,Joey Iosefa,FB,dead_cap,tampa-bay-buccaneers,17085,2015
38734,13200,0,Quayshawn Nealy,ILB,dead_cap,tampa-bay-buccaneers,13200,2015
38735,13200,0,Akeem Davis,SS,dead_cap,tampa-bay-buccaneers,13200,2015
38736,13200,0,Julian Stanford,OLB,dead_cap,tampa-bay-buccaneers,13200,2015
38737,0,10000,Chaz Sutton,DE,dead_cap,tampa-bay-buccaneers,10000,2015
38738,0,9900,Matt Patchan,RT,dead_cap,tampa-bay-buccaneers,9900,2015
38739,0,6667,Euclid Cummings,DT,dead_cap,tampa-bay-buccaneers,6667,2015
38740,6600,0,Cameron Brate,TE,dead_cap,tampa-bay-buccaneers,6600,2015
38741,6600,0,Darius Eubanks,S,dead_cap,tampa-bay-buccaneers,6600,2015
38742,6600,0,Gerod Holliman,FS,dead_cap,tampa-bay-buccaneers,6600,2015
38743,6600,0,Keon Lyn,CB,dead_cap,tampa-bay-buccaneers,6600,2015
38744,6600,0,Ronald Powell,OLB,dead_cap,tampa-bay-buccaneers,6600,2015
38745,6600,0,C.J. Roberts,CB,dead_cap,tampa-bay-buccaneers,6600,2015
38746,6600,0,Joel Ross,CB,dead_cap,tampa-bay-buccaneers,6600,2015
38747,6600,0,Dax Swanson,SS,dead_cap,tampa-bay-buccaneers,6600,2015
38748,0,6000,Solomon Patton,WR,dead_cap,tampa-bay-buccaneers,6000,2015
38749,0,5000,Nate Askew,OLB,dead_cap,tampa-bay-buccaneers,5000,2015
38750,0,5000,Ryan Delaire,DE,dead_cap,tampa-bay-buccaneers,5000,2015
38751,0,3334,Aaron Burks,WR,dead_cap,tampa-bay-buccaneers,3334,2015
38752,0,3334,Rashaan Melvin,CB,dead_cap,tampa-bay-buccaneers,3334,2015
38753,0,3334,Andrew Miller,G,dead_cap,tampa-bay-buccaneers,3334,2015
38754,0,3334,Tim Wright,TE,dead_cap,tampa-bay-buccaneers,3334,2015
38755,0,3333,Chris Hackett,FS,dead_cap,tampa-bay-buccaneers,3333,2015
38756,0,3333,Caushaud Lyons,DE,dead_cap,tampa-bay-buccaneers,3333,2015
38757,0,2833,Deshazor Everett,SS,dead_cap,tampa-bay-buccaneers,2833,2015
38758,0,2666,Dominique Brown,RB,dead_cap,tampa-bay-buccaneers,2666,2015
38759,0,2000,Keith Lewis,CB,dead_cap,tampa-bay-buccaneers,2000,2015
38760,0,2000,Mycal Swaim,S,dead_cap,tampa-bay-buccaneers,2000,2015
38761,0,1666,Courtland Clavette,LB,dead_cap,tampa-bay-buccaneers,1666,2015
38762,0,1500,Michael Reynolds,DE,dead_cap,tampa-bay-buccaneers,1500,2015
38763,0,1000,Josh Reese,WR,dead_cap,tampa-bay-buccaneers,1000,2015
38764,0,666,Quayshawne Buckley,DT,dead_cap,tampa-bay-buccaneers,666,2015
38765,0,500,Jamal Young,DE,dead_cap,tampa-bay-buccaneers,500,2015
38766,6000000,7000000,Gerald McCoy,DT,active,tampa-bay-buccaneers,13000000,2016
38767,10000000,0,Lavonte David,OLB,active,tampa-bay-buccaneers,10000000,2016
38768,3500000,4500000,Brent Grimes,CB,active,tampa-bay-buccaneers,8000000,2016
38769,3764706,4000000,Doug Martin,RB,active,tampa-bay-buccaneers,7764706,2016
38770,5000000,2750000,Robert Ayers,DE,active,tampa-bay-buccaneers,7750000,2016
38771,6750000,0,Alterraun Verner,CB,active,tampa-bay-buccaneers,6750000,2016
38772,525000,5236654,Jameis Winston,QB,active,tampa-bay-buccaneers,5761654,2016
38773,3000000,1500000,Gosder Cherilus,RT,active,tampa-bay-buccaneers,4500000,2016
38774,1750000,2500000,Demar Dotson,RT,active,tampa-bay-buccaneers,4250000,2016
38775,600000,3390410,Mike Evans,WR,active,tampa-bay-buccaneers,3990410,2016
38776,2500000,1000000,Joe Hawley,C,active,tampa-bay-buccaneers,3500000,2016
38777,2750000,500000,Clinton McDonald,DT,active,tampa-bay-buccaneers,3250000,2016
38778,1500000,1500000,Christopher Conte,FS,active,tampa-bay-buccaneers,3000000,2016
38779,1350000,1650000,Daryl Smith,ILB,active,tampa-bay-buccaneers,3000000,2016
38780,450000,2127756,Vernon Hargreaves,CB,active,tampa-bay-buccaneers,2577756,2016
38781,2553000,0,Bradley McDougald,SS,active,tampa-bay-buccaneers,2553000,2016
38782,2500000,0,Evan Smith,C,active,tampa-bay-buccaneers,2500000,2016
38783,1500000,500000,Josh Robinson,CB,active,tampa-bay-buccaneers,2000000,2016
38784,1750000,166668,Brandon Myers,TE,active,tampa-bay-buccaneers,1916668,2016
38785,1517719,312656,Mike Glennon,QB,active,tampa-bay-buccaneers,1830375,2016
38786,1671000,121071,Akeem Spence,DT,active,tampa-bay-buccaneers,1792071,2016
38787,1671000,100136,William Gholston,DE,active,tampa-bay-buccaneers,1771136,2016
38788,1000000,750000,Bryan Anger,P,active,tampa-bay-buccaneers,1750000,2016
38789,1671000,0,Russell Shepard,WR,active,tampa-bay-buccaneers,1671000,2016
38790,1600000,0,Luke Stocker,TE,active,tampa-bay-buccaneers,1600000,2016
38791,710857,668429,Donovan Smith,LT,active,tampa-bay-buccaneers,1379286,2016
38792,450000,647509,Noah Spence,DE,active,tampa-bay-buccaneers,1097509,2016
38793,760000,250000,Keith Tandy,FS,active,tampa-bay-buccaneers,1010000,2016
38794,606527,251106,Ali Marpet,C,active,tampa-bay-buccaneers,857633,2016
38795,450000,286830,Roberto Aguayo,K,active,tampa-bay-buccaneers,736830,2016
38796,715294,0,Jacquizz Rodgers,RB,active,tampa-bay-buccaneers,715294,2016
38797,600000,49625,Kevin Pamphile,G,active,tampa-bay-buccaneers,649625,2016
38798,525000,119580,Kwon Alexander,ILB,active,tampa-bay-buccaneers,644580,2016
38799,600000,0,Andrew DePaola,LS,active,tampa-bay-buccaneers,600000,2016
38800,600000,0,Ryan Griffin,QB,active,tampa-bay-buccaneers,600000,2016
38801,600000,0,Adarius Taylor,OLB,active,tampa-bay-buccaneers,600000,2016
38802,450000,148040,Ryan Smith,CB,active,tampa-bay-buccaneers,598040,2016
38803,525000,0,Adam Humphries,WR,active,tampa-bay-buccaneers,525000,2016
38804,450000,63296,Caleb Benenoch,T,active,tampa-bay-buccaneers,513296,2016
38805,450000,6666,Leonard Wester,T,active,tampa-bay-buccaneers,456666,2016
38806,450000,0,Peyton Barber,RB,active,tampa-bay-buccaneers,450000,2016
38807,450000,0,Davonte Lambert,DE,active,tampa-bay-buccaneers,450000,2016
38808,401470,0,Cameron Lynch,OLB,active,tampa-bay-buccaneers,401470,2016
38809,397050,0,Alan Cross,TE,active,tampa-bay-buccaneers,397050,2016
38810,339705,0,Freddie Martino,WR,active,tampa-bay-buccaneers,339705,2016
38811,312941,0,Sealver Siliga,DT,active,tampa-bay-buccaneers,312941,2016
38812,247058,0,Ryan Russell,DE,active,tampa-bay-buccaneers,247058,2016
38813,158820,0,Javien Elliott,CB,active,tampa-bay-buccaneers,158820,2016
38814,141176,0,Josh Huff,WR,active,tampa-bay-buccaneers,141176,2016
38815,134117,0,John Hughes,DE,active,tampa-bay-buccaneers,134117,2016
38816,52940,0,Bernard Reedy,WR,active,tampa-bay-buccaneers,52940,2016
38817,35294,0,Austin Johnson,FB,active,tampa-bay-buccaneers,35294,2016
38818,26470,0,Russell Hansbrough,RB,active,tampa-bay-buccaneers,26470,2016
38819,26470,0,Channing Ward,DE,active,tampa-bay-buccaneers,26470,2016
38820,9777777,2432000,Vincent Jackson,WR,injured_reserve,tampa-bay-buccaneers,12209777,2016
38821,2000000,0,George Johnson,DE,injured_reserve,tampa-bay-buccaneers,2000000,2016
38822,800000,171875,Cecil Shorts,WR,injured_reserve,tampa-bay-buccaneers,971875,2016
38823,650000,186023,Charles Sims,RB,injured_reserve,tampa-bay-buccaneers,836023,2016
38824,600000,0,Cameron Brate,TE,injured_reserve,tampa-bay-buccaneers,600000,2016
38825,600000,0,Jacquies Smith,OLB,injured_reserve,tampa-bay-buccaneers,600000,2016
38826,525000,0,Howard Jones,OLB,injured_reserve,tampa-bay-buccaneers,525000,2016
38827,401466,0,Jude Adjei-Barimah,CB,injured_reserve,tampa-bay-buccaneers,401466,2016
38828,491176,0,Antone Smith,RB,injured_reserve,tampa-bay-buccaneers,491176,2016
38829,346760,36176,Devante Bond,OLB,injured_reserve,tampa-bay-buccaneers,382936,2016
38830,211768,0,Ben Gottschalk,RT,injured_reserve,tampa-bay-buccaneers,211768,2016
38831,123528,0,Donteea Dye,WR,injured_reserve,tampa-bay-buccaneers,123528,2016
38832,13800,0,Kendrick Ings,WR,practice_squad,tampa-bay-buccaneers,13800,2016
38833,6900,0,Deonte Gibson,DT,practice_squad,tampa-bay-buccaneers,6900,2016
38834,6900,0,Kyler Kerbyson,T,practice_squad,tampa-bay-buccaneers,6900,2016
38835,1500000,87500,Louis Murphy,WR,dead_cap,tampa-bay-buccaneers,1587500,2016
38836,399763,654331,Johnthan Banks,CB,dead_cap,tampa-bay-buccaneers,1054094,2016
38837,96790,610440,Austin Seferian-Jenkins,TE,dead_cap,tampa-bay-buccaneers,707230,2016
38838,402352,0,John Hughes,DE,dead_cap,tampa-bay-buccaneers,402352,2016
38839,306100,0,Channing Ward,DE,dead_cap,tampa-bay-buccaneers,306100,2016
38840,226128,25788,Mike James,RB,dead_cap,tampa-bay-buccaneers,251916,2016
38841,144564,0,Josh Allen,C,dead_cap,tampa-bay-buccaneers,144564,2016
38842,137328,5334,Josh Keyes,ILB,dead_cap,tampa-bay-buccaneers,142662,2016
38843,117300,833,Isaiah Johnson,S,dead_cap,tampa-bay-buccaneers,118133,2016
38844,0,106000,Kadeem Edwards,G,dead_cap,tampa-bay-buccaneers,106000,2016
38845,99200,0,Josh Huff,WR,dead_cap,tampa-bay-buccaneers,99200,2016
38846,0,97857,Kaelin Clay,WR,dead_cap,tampa-bay-buccaneers,97857,2016
38847,89700,0,Rodney Coe,DT,dead_cap,tampa-bay-buccaneers,89700,2016
38848,89411,0,Major Wright,S,dead_cap,tampa-bay-buccaneers,89411,2016
38849,87440,0,Russell Hansbrough,RB,dead_cap,tampa-bay-buccaneers,87440,2016
38850,75900,0,Javien Elliott,CB,dead_cap,tampa-bay-buccaneers,75900,2016
38851,75900,0,Tevin Westbrook,TE,dead_cap,tampa-bay-buccaneers,75900,2016
38852,75564,0,Freddie Martino,WR,dead_cap,tampa-bay-buccaneers,75564,2016
38853,34500,32588,Dan Vitale,FB,dead_cap,tampa-bay-buccaneers,67088,2016
38854,62100,0,Ben Gottschalk,RT,dead_cap,tampa-bay-buccaneers,62100,2016
38855,0,56000,Robert Herron,WR,dead_cap,tampa-bay-buccaneers,56000,2016
38856,0,51255,Joey Iosefa,FB,dead_cap,tampa-bay-buccaneers,51255,2016
38857,0,51209,Kenny Bell,WR,dead_cap,tampa-bay-buccaneers,51209,2016
38858,48300,0,Ryan Russell,DE,dead_cap,tampa-bay-buccaneers,48300,2016
38859,41400,0,Donteea Dye,WR,dead_cap,tampa-bay-buccaneers,41400,2016
38860,41400,0,Kyler Kerbyson,T,dead_cap,tampa-bay-buccaneers,41400,2016
38861,41400,0,Michael Liedtke,G,dead_cap,tampa-bay-buccaneers,41400,2016
38862,41400,0,Cody Riggs,CB,dead_cap,tampa-bay-buccaneers,41400,2016
38863,41400,0,Myles White,WR,dead_cap,tampa-bay-buccaneers,41400,2016
38864,34500,0,Jonathan Krause,WR,dead_cap,tampa-bay-buccaneers,34500,2016
38865,27600,0,Jeremy Butler,WR,dead_cap,tampa-bay-buccaneers,27600,2016
38866,27600,0,Trae Elston,S,dead_cap,tampa-bay-buccaneers,27600,2016
38867,20700,0,Cameron Lynch,OLB,dead_cap,tampa-bay-buccaneers,20700,2016
38868,13800,0,Kourtnei Brown,OLB,dead_cap,tampa-bay-buccaneers,13800,2016
38869,13800,0,Alan Cross,TE,dead_cap,tampa-bay-buccaneers,13800,2016
38870,13800,0,Austin Johnson,FB,dead_cap,tampa-bay-buccaneers,13800,2016
38871,13800,0,Bernard Reedy,WR,dead_cap,tampa-bay-buccaneers,13800,2016
38872,0,10000,Ryan Delaire,DE,dead_cap,tampa-bay-buccaneers,10000,2016
38873,5000,2500,Dom Robertson,T,dead_cap,tampa-bay-buccaneers,7500,2016
38874,6900,0,Micah Awe,OLB,dead_cap,tampa-bay-buccaneers,6900,2016
38875,6900,0,Peyton Barber,RB,dead_cap,tampa-bay-buccaneers,6900,2016
38876,6900,0,Blake Sims,RB,dead_cap,tampa-bay-buccaneers,6900,2016
38877,6900,0,Evan Spencer,WR,dead_cap,tampa-bay-buccaneers,6900,2016
38878,0,6667,Chris Hackett,FS,dead_cap,tampa-bay-buccaneers,6667,2016
38879,0,6667,Caushaud Lyons,DE,dead_cap,tampa-bay-buccaneers,6667,2016
38880,0,6000,Rannell Hall,WR,dead_cap,tampa-bay-buccaneers,6000,2016
38881,0,5667,Deshazor Everett,SS,dead_cap,tampa-bay-buccaneers,5667,2016
38882,0,5334,Dominique Brown,RB,dead_cap,tampa-bay-buccaneers,5334,2016
38883,0,4333,Elijah Shumate,S,dead_cap,tampa-bay-buccaneers,4333,2016
38884,0,3334,Courtland Clavette,LB,dead_cap,tampa-bay-buccaneers,3334,2016
38885,0,3333,Cassanova Mckinzy,DE,dead_cap,tampa-bay-buccaneers,3333,2016
38886,0,2000,Quinton Alston,LB,dead_cap,tampa-bay-buccaneers,2000,2016
38887,0,1334,Quayshawne Buckley,DT,dead_cap,tampa-bay-buccaneers,1334,2016
38888,0,1000,Jamal Young,DE,dead_cap,tampa-bay-buccaneers,1000,2016
38889,13250000,500000,Gerald McCoy,DT,active,tampa-bay-buccaneers,13750000,2017
38890,6500000,6000000,DeSean Jackson,WR,active,tampa-bay-buccaneers,12500000,2017
38891,6000000,2000000,Brent Grimes,CB,active,tampa-bay-buccaneers,8000000,2017
38892,3000000,4000000,William Gholston,DE,active,tampa-bay-buccaneers,7000000,2017
38893,615000,6298985,Jameis Winston,QB,active,tampa-bay-buccaneers,6913985,2017
38894,4000000,2250000,Robert Ayers,DE,active,tampa-bay-buccaneers,6250000,2017
38895,6000000,0,Lavonte David,OLB,active,tampa-bay-buccaneers,6000000,2017
38896,3000000,3000000,Chris Baker,DT,active,tampa-bay-buccaneers,6000000,2017
38897,5764706,0,Doug Martin,RB,active,tampa-bay-buccaneers,5764706,2017
38898,690000,3965478,Mike Evans,WR,active,tampa-bay-buccaneers,4655478,2017
38899,3000000,1625000,T.J. Ward,SS,active,tampa-bay-buccaneers,4625000,2017
38900,3500000,1000000,Evan Smith,C,active,tampa-bay-buccaneers,4500000,2017
38901,1500000,2500000,Bryan Anger,P,active,tampa-bay-buccaneers,4000000,2017
38902,1750000,1925000,Ryan Fitzpatrick,QB,active,tampa-bay-buccaneers,3675000,2017
38903,2000000,1125000,Josh Robinson,CB,active,tampa-bay-buccaneers,3125000,2017
38904,1750000,1125000,Joe Hawley,C,active,tampa-bay-buccaneers,2875000,2017
38905,1500000,1500000,Christopher Conte,FS,active,tampa-bay-buccaneers,3000000,2017
38906,2000000,0,Clinton McDonald,DT,active,tampa-bay-buccaneers,2000000,2017
38907,1797000,49625,Kevin Pamphile,G,active,tampa-bay-buccaneers,1846625,2017
38908,1100000,600000,Jacquizz Rodgers,RB,active,tampa-bay-buccaneers,1700000,2017
38909,986715,668429,Donovan Smith,LT,active,tampa-bay-buccaneers,1655144,2017
38910,1150000,0,Ryan Griffin,QB,active,tampa-bay-buccaneers,1150000,2017
38911,800000,300000,Sealver Siliga,DT,active,tampa-bay-buccaneers,1100000,2017
38912,764000,186023,Charles Sims,RB,active,tampa-bay-buccaneers,950023,2017
38913,840000,0,Keith Tandy,FS,active,tampa-bay-buccaneers,840000,2017
38914,615000,119580,Kwon Alexander,ILB,active,tampa-bay-buccaneers,734580,2017
38915,690000,0,Cameron Brate,TE,active,tampa-bay-buccaneers,690000,2017
38916,690000,0,Will Clarke,DE,active,tampa-bay-buccaneers,690000,2017
38917,540000,148040,Ryan Smith,CB,active,tampa-bay-buccaneers,688040,2017
38918,465000,198041,Chris Godwin,WR,active,tampa-bay-buccaneers,663041,2017
38919,465000,176572,Kendell Beckwith,OLB,active,tampa-bay-buccaneers,641572,2017
38920,900000,0,Garrison Sanborn,LS,active,tampa-bay-buccaneers,900000,2017
38921,775000,0,Robert McClain,CB,active,tampa-bay-buccaneers,775000,2017
38922,615000,0,Adam Humphries,WR,active,tampa-bay-buccaneers,615000,2017
38923,615000,0,Ryan Russell,DE,active,tampa-bay-buccaneers,615000,2017
38924,540000,63296,Caleb Benenoch,T,active,tampa-bay-buccaneers,603296,2017
38925,540000,6666,Leonard Wester,T,active,tampa-bay-buccaneers,546666,2017
38926,540000,0,Peyton Barber,RB,active,tampa-bay-buccaneers,540000,2017
38927,540000,0,Javien Elliott,CB,active,tampa-bay-buccaneers,540000,2017
38928,465000,36176,Devante Bond,OLB,active,tampa-bay-buccaneers,501176,2017
38929,465000,6666,Antony Auclair,TE,active,tampa-bay-buccaneers,471666,2017
38930,381176,0,Patrick Murray,K,active,tampa-bay-buccaneers,381176,2017
38931,253235,0,Freddie Martino,WR,active,tampa-bay-buccaneers,253235,2017
38932,158825,0,Alan Cross,TE,active,tampa-bay-buccaneers,158825,2017
38933,136765,0,Michael Liedtke,G,active,tampa-bay-buccaneers,136765,2017
38934,136765,0,Pat O'Connor,DE,active,tampa-bay-buccaneers,136765,2017
38935,136765,0,Bobo Wilson,WR,active,tampa-bay-buccaneers,136765,2017
38936,82059,0,Riley Bullough,ILB,active,tampa-bay-buccaneers,82059,2017
38937,81176,0,Adam Gettis,G,active,tampa-bay-buccaneers,81176,2017
38938,54706,0,Nigel Harris,OLB,active,tampa-bay-buccaneers,54706,2017
38939,54706,0,Isaiah Johnson,S,active,tampa-bay-buccaneers,54706,2017
38940,54706,0,David Rivers III,CB,active,tampa-bay-buccaneers,54706,2017
38941,54706,0,Channing Ward,DE,active,tampa-bay-buccaneers,54706,2017
38942,4250000,50000,Demar Dotson,RT,injured_reserve,tampa-bay-buccaneers,4300000,2017
38943,3750000,156250,J.R. Sweezy,G,injured_reserve,tampa-bay-buccaneers,3906250,2017
38944,1094439,2127756,Vernon Hargreaves,CB,injured_reserve,tampa-bay-buccaneers,3222195,2017
38945,451235,1552203,O.J. Howard,TE,injured_reserve,tampa-bay-buccaneers,2003438,2017
38946,1000000,750000,Nick Folk,K,injured_reserve,tampa-bay-buccaneers,1750000,2017
38947,724377,647509,Noah Spence,DE,injured_reserve,tampa-bay-buccaneers,1371886,2017
38948,703054,326106,Ali Marpet,C,injured_reserve,tampa-bay-buccaneers,1029160,2017
38949,451235,480326,Justin Evans,S,injured_reserve,tampa-bay-buccaneers,931561,2017
38950,690000,0,Adarius Taylor,OLB,injured_reserve,tampa-bay-buccaneers,690000,2017
38951,615000,0,Jude Adjei-Barimah,CB,injured_reserve,tampa-bay-buccaneers,615000,2017
38952,775000,80000,Justin Trattou,DE,injured_reserve,tampa-bay-buccaneers,855000,2017
38953,348000,22783,Stevie Tu'ikolovatu,DT,injured_reserve,tampa-bay-buccaneers,370783,2017
38954,363000,0,Davonte Lambert,DE,injured_reserve,tampa-bay-buccaneers,363000,2017
38955,348000,1666,Cole Gardner,T,injured_reserve,tampa-bay-buccaneers,349666,2017
38956,36000,0,Patrick Gamble,DE,practice_squad,tampa-bay-buccaneers,36000,2017
38957,28800,0,Cody Riggs,CB,practice_squad,tampa-bay-buccaneers,28800,2017
38958,1700000,0,Luke Stocker,TE,dead_cap,tampa-bay-buccaneers,1700000,2017
38959,0,1000000,J.J. Wilcox,FS,dead_cap,tampa-bay-buccaneers,1000000,2017
38960,0,535440,Austin Seferian-Jenkins,TE,dead_cap,tampa-bay-buccaneers,535440,2017
38961,434112,0,Cameron Lynch,OLB,dead_cap,tampa-bay-buccaneers,434112,2017
38962,422824,0,Jacquies Smith,OLB,dead_cap,tampa-bay-buccaneers,422824,2017
38963,286580,666,Evan Panfil,DE,dead_cap,tampa-bay-buccaneers,287246,2017
38964,0,286830,Roberto Aguayo,K,dead_cap,tampa-bay-buccaneers,286830,2017
38965,273530,0,Bernard Reedy,WR,dead_cap,tampa-bay-buccaneers,273530,2017
38966,184660,0,Alan Cross,TE,dead_cap,tampa-bay-buccaneers,184660,2017
38967,294118,0,Darryl Tapp,DE,dead_cap,tampa-bay-buccaneers,294118,2017
38968,143290,0,Jhajuan Seales,WR,dead_cap,tampa-bay-buccaneers,143290,2017
38969,127059,0,Deji Olatoye,CB,dead_cap,tampa-bay-buccaneers,127059,2017
38970,110859,1667,Isaiah Johnson,S,dead_cap,tampa-bay-buccaneers,112526,2017
38971,0,102418,Kenny Bell,WR,dead_cap,tampa-bay-buccaneers,102418,2017
38972,100976,0,Freddie Martino,WR,dead_cap,tampa-bay-buccaneers,100976,2017
38973,100800,0,Riley Bullough,ILB,dead_cap,tampa-bay-buccaneers,100800,2017
38974,100800,0,Channing Ward,DE,dead_cap,tampa-bay-buccaneers,100800,2017
38975,0,97767,Dan Vitale,FB,dead_cap,tampa-bay-buccaneers,97767,2017
38976,0,87500,Louis Murphy,WR,dead_cap,tampa-bay-buccaneers,87500,2017
38977,86400,0,Michael Liedtke,G,dead_cap,tampa-bay-buccaneers,86400,2017
38978,86400,0,Bobo Wilson,WR,dead_cap,tampa-bay-buccaneers,86400,2017
38979,79200,0,Justin Murray,T,dead_cap,tampa-bay-buccaneers,79200,2017
38980,0,65944,Jeremy McNichols,RB,dead_cap,tampa-bay-buccaneers,65944,2017
38981,57600,0,David Rivers III,CB,dead_cap,tampa-bay-buccaneers,57600,2017
38982,50400,0,Pat O'Connor,DE,dead_cap,tampa-bay-buccaneers,50400,2017
38983,0,50000,Garrison Sanborn,LS,dead_cap,tampa-bay-buccaneers,50000,2017
38984,0,50000,Derel Walker,WR,dead_cap,tampa-bay-buccaneers,50000,2017
38985,43200,0,Givens Price,T,dead_cap,tampa-bay-buccaneers,43200,2017
38986,36000,0,Maurice Fleming,CB,dead_cap,tampa-bay-buccaneers,36000,2017
38987,36000,0,Austin Johnson,FB,dead_cap,tampa-bay-buccaneers,36000,2017
38988,36000,0,Brad Seaton,T,dead_cap,tampa-bay-buccaneers,36000,2017
38989,36000,0,Sterling Bailey,DE,dead_cap,tampa-bay-buccaneers,36000,2017
38990,36000,0,Jake Lampman,WR,dead_cap,tampa-bay-buccaneers,36000,2017
38991,28800,0,Russell Hansbrough,RB,dead_cap,tampa-bay-buccaneers,28800,2017
38992,28800,0,Marquis Lucas,T,dead_cap,tampa-bay-buccaneers,28800,2017
38993,0,20000,Sean Renfree,QB,dead_cap,tampa-bay-buccaneers,20000,2017
38994,14400,0,Devin Lucien,WR,dead_cap,tampa-bay-buccaneers,14400,2017
38995,14400,0,Jonathan Moxey,CB,dead_cap,tampa-bay-buccaneers,14400,2017
38996,14400,0,Larry Webster,DE,dead_cap,tampa-bay-buccaneers,14400,2017
38997,14400,0,Avery Young,T,dead_cap,tampa-bay-buccaneers,14400,2017
38998,10000,1666,Richie Brown,ILB,dead_cap,tampa-bay-buccaneers,11666,2017
38999,0,8667,Elijah Shumate,S,dead_cap,tampa-bay-buccaneers,8667,2017
39000,7200,0,Patrick Gamble,DE,dead_cap,tampa-bay-buccaneers,7200,2017
39001,7200,0,Senquez Golson,CB,dead_cap,tampa-bay-buccaneers,7200,2017
39002,7200,0,Nigel Harris,OLB,dead_cap,tampa-bay-buccaneers,7200,2017
39003,7200,0,Dare Ogunbowale,RB,dead_cap,tampa-bay-buccaneers,7200,2017
39004,0,6667,Cassanova Mckinzy,DE,dead_cap,tampa-bay-buccaneers,6667,2017
39005,0,5000,Dom Robertson,T,dead_cap,tampa-bay-buccaneers,5000,2017
39006,8258000,10000000,Mike Evans,WR,active,tampa-bay-buccaneers,18258000,2018
39007,12250000,500000,Gerald McCoy,DT,active,tampa-bay-buccaneers,12750000,2018
39008,11250000,1250000,Jason Pierre-Paul,DE,active,tampa-bay-buccaneers,12500000,2018
39009,2000000,10000000,Ryan Jensen,C,active,tampa-bay-buccaneers,12000000,2018
39010,11000000,0,DeSean Jackson,WR,active,tampa-bay-buccaneers,11000000,2018
39011,8750000,0,Lavonte David,OLB,active,tampa-bay-buccaneers,8750000,2018
39012,3500000,4500000,Brent Grimes,CB,active,tampa-bay-buccaneers,8000000,2018
39013,580588,7361315,Jameis Winston,QB,active,tampa-bay-buccaneers,7941903,2018
39014,1000000,6000000,Cameron Brate,TE,active,tampa-bay-buccaneers,7000000,2018
39015,6500000,0,William Gholston,DE,active,tampa-bay-buccaneers,6500000,2018
39016,3000000,3500000,Vinny Curry,DE,active,tampa-bay-buccaneers,6500000,2018
39017,2250000,2750000,Beau Allen,DT,active,tampa-bay-buccaneers,5000000,2018
39018,3975000,828125,Demar Dotson,RT,active,tampa-bay-buccaneers,4803125,2018
39019,2000000,1300000,Ryan Fitzpatrick,QB,active,tampa-bay-buccaneers,3300000,2018
39020,3000000,0,Bryan Anger,P,active,tampa-bay-buccaneers,3000000,2018
39021,2914000,0,Adam Humphries,WR,active,tampa-bay-buccaneers,2914000,2018
39022,480000,2215316,Vita Vea,DT,active,tampa-bay-buccaneers,2695316,2018
39023,1162571,768429,Donovan Smith,LT,active,tampa-bay-buccaneers,1931000,2018
39024,998755,647509,Noah Spence,DE,active,tampa-bay-buccaneers,1646264,2018
39025,874581,726106,Ali Marpet,G,active,tampa-bay-buccaneers,1600687,2018
39026,1600000,0,Jacquizz Rodgers,RB,active,tampa-bay-buccaneers,1600000,2018
39027,1300000,93750,Ryan Griffin,QB,active,tampa-bay-buccaneers,1393750,2018
39028,480000,805801,Ronald Jones II,RB,active,tampa-bay-buccaneers,1285801,2018
39029,790000,250000,Adarius Taylor,OLB,active,tampa-bay-buccaneers,1040000,2018
39030,480000,444202,M.J. Stewart,CB,active,tampa-bay-buccaneers,924202,2018
39031,480000,318748,Carlton Davis,CB,active,tampa-bay-buccaneers,798748,2018
39032,581500,198041,Chris Godwin,WR,active,tampa-bay-buccaneers,779541,2018
39033,630000,148040,Ryan Smith,CB,active,tampa-bay-buccaneers,778040,2018
39034,773000,0,Carl Nassib,DE,active,tampa-bay-buccaneers,773000,2018
39035,705000,0,Cameron Lynch,OLB,active,tampa-bay-buccaneers,705000,2018
39036,630000,63296,Caleb Benenoch,G,active,tampa-bay-buccaneers,693296,2018
39037,480000,198426,Alex Cappa,G,active,tampa-bay-buccaneers,678426,2018
39038,480000,166814,Jordan Whitehead,SS,active,tampa-bay-buccaneers,646814,2018
39039,630000,6668,Leonard Wester,T,active,tampa-bay-buccaneers,636668,2018
39040,1015000,0,Garrison Sanborn,LS,active,tampa-bay-buccaneers,1015000,2018
39041,630000,0,Peyton Barber,RB,active,tampa-bay-buccaneers,630000,2018
39042,555000,6666,Antony Auclair,TE,active,tampa-bay-buccaneers,561666,2018
39043,480000,75434,Justin Watson,WR,active,tampa-bay-buccaneers,555434,2018
39044,555000,0,Isaiah Johnson,S,active,tampa-bay-buccaneers,555000,2018
39045,555000,0,Michael Liedtke,G,active,tampa-bay-buccaneers,555000,2018
39046,539118,0,Rakeem Nunez-Roches,DE,active,tampa-bay-buccaneers,539118,2018
39047,518812,0,Andrew Adams,S,active,tampa-bay-buccaneers,518812,2018
39048,370588,0,Devante Harris,CB,active,tampa-bay-buccaneers,370588,2018
39049,359118,0,Devante Bond,OLB,active,tampa-bay-buccaneers,359118,2018
39050,333531,0,Javien Elliott,CB,active,tampa-bay-buccaneers,333531,2018
39051,326471,0,Riley Bullough,ILB,active,tampa-bay-buccaneers,326471,2018
39052,325294,0,Cairo Santos,K,active,tampa-bay-buccaneers,325294,2018
39053,248824,0,Josh Shaw,CB,active,tampa-bay-buccaneers,248824,2018
39054,163235,0,Bobo Wilson,WR,active,tampa-bay-buccaneers,163235,2018
39055,141175,0,David Rivers III,CB,active,tampa-bay-buccaneers,141175,2018
39056,84705,0,Tanner Hudson,TE,active,tampa-bay-buccaneers,84705,2018
39057,56470,0,Donnie Ernsberger,TE,active,tampa-bay-buccaneers,56470,2018
39058,56470,0,Jeremiah Ledbetter,DT,active,tampa-bay-buccaneers,56470,2018
39059,1738878,2127756,Vernon Hargreaves,CB,injured_reserve,tampa-bay-buccaneers,3866634,2018
39060,1000000,2000000,Mitch Unrein,DE,injured_reserve,tampa-bay-buccaneers,3000000,2018
39061,2250000,750000,Christopher Conte,SS,injured_reserve,tampa-bay-buccaneers,3000000,2018
39062,969301,1552203,O.J. Howard,TE,injured_reserve,tampa-bay-buccaneers,2521504,2018
39063,1000000,1250000,Evan Smith,C,injured_reserve,tampa-bay-buccaneers,2250000,2018
39064,1907000,119582,Kwon Alexander,ILB,injured_reserve,tampa-bay-buccaneers,2026582,2018
39065,701332,480326,Justin Evans,FS,injured_reserve,tampa-bay-buccaneers,1181658,2018
39066,602120,0,Alan Cross,TE,injured_reserve,tampa-bay-buccaneers,602120,2018
39067,411165,36344,Jack Cichy,ILB,injured_reserve,tampa-bay-buccaneers,447509,2018
39068,431814,3333,Shaun Wilson,RB,injured_reserve,tampa-bay-buccaneers,435147,2018
39069,363000,22783,Stevie Tu'ikolovatu,DT,injured_reserve,tampa-bay-buccaneers,385783,2018
39070,363000,333,Sergio Bailey,WR,injured_reserve,tampa-bay-buccaneers,363333,2018
39071,259412,0,Kevin Minter,ILB,injured_reserve,tampa-bay-buccaneers,259412,2018
39072,578000,176572,Kendell Beckwith,OLB,non_fb_injury,tampa-bay-buccaneers,754572,2018
39073,2100000,1650000,Chandler Catanzaro,K,dead_cap,tampa-bay-buccaneers,3750000,2018
39074,746471,0,Freddie Martino,WR,dead_cap,tampa-bay-buccaneers,746471,2018
39075,705000,0,Adam Gettis,G,dead_cap,tampa-bay-buccaneers,705000,2018
39076,630000,0,Jerel Worthy,DT,dead_cap,tampa-bay-buccaneers,630000,2018
39077,0,600000,Keith Tandy,FS,dead_cap,tampa-bay-buccaneers,600000,2018
39078,0,573662,Roberto Aguayo,K,dead_cap,tampa-bay-buccaneers,573662,2018
39079,320294,0,Maurice Fleming,CB,dead_cap,tampa-bay-buccaneers,320294,2018
39080,185882,90000,Will Clarke,DE,dead_cap,tampa-bay-buccaneers,275882,2018
39081,267013,0,Javien Elliott,CB,dead_cap,tampa-bay-buccaneers,267013,2018
39082,247078,0,Demone Harris,DE,dead_cap,tampa-bay-buccaneers,247078,2018
39083,217470,6666,Godwin Igwebuike,S,dead_cap,tampa-bay-buccaneers,224136,2018
39084,222354,0,Marcus Williams,CB,dead_cap,tampa-bay-buccaneers,222354,2018
39085,0,200000,Charles Sims,RB,dead_cap,tampa-bay-buccaneers,200000,2018
39086,0,197835,Jeremy McNichols,RB,dead_cap,tampa-bay-buccaneers,197835,2018
39087,175905,0,Dare Ogunbowale,RB,dead_cap,tampa-bay-buccaneers,175905,2018
39088,149464,0,Amari Coleman,S,dead_cap,tampa-bay-buccaneers,149464,2018
39089,128118,1666,Cole Gardner,T,dead_cap,tampa-bay-buccaneers,129784,2018
39090,129200,0,Cole Boozer,T,dead_cap,tampa-bay-buccaneers,129200,2018
39091,129200,0,Eric Nzeocha,OLB,dead_cap,tampa-bay-buccaneers,129200,2018
39092,129200,0,Pat O'Connor,DE,dead_cap,tampa-bay-buccaneers,129200,2018
39093,0,125000,Joe Hawley,C,dead_cap,tampa-bay-buccaneers,125000,2018
39094,0,125000,Josh Robinson,CB,dead_cap,tampa-bay-buccaneers,125000,2018
39095,114000,0,Jeremiah Ledbetter,DT,dead_cap,tampa-bay-buccaneers,114000,2018
39096,111177,0,Kevin Minter,ILB,dead_cap,tampa-bay-buccaneers,111177,2018
39097,106400,0,Tanner Hudson,TE,dead_cap,tampa-bay-buccaneers,106400,2018
39098,91200,0,Bobo Wilson,WR,dead_cap,tampa-bay-buccaneers,91200,2018
39099,83600,0,Ruben Holcomb,G,dead_cap,tampa-bay-buccaneers,83600,2018
39100,60800,0,Bernard Reedy,WR,dead_cap,tampa-bay-buccaneers,60800,2018
39101,23118,36176,Devante Bond,OLB,dead_cap,tampa-bay-buccaneers,59294,2018
39102,0,50000,Derel Walker,WR,dead_cap,tampa-bay-buccaneers,50000,2018
39103,45600,0,David Rivers III,CB,dead_cap,tampa-bay-buccaneers,45600,2018
39104,44470,0,Channing Ward,DE,dead_cap,tampa-bay-buccaneers,44470,2018
39105,38000,0,Jarron Jones,DT,dead_cap,tampa-bay-buccaneers,38000,2018
39106,30400,0,K.J. Brent,WR,dead_cap,tampa-bay-buccaneers,30400,2018
39107,30400,0,Mark Myers,CB,dead_cap,tampa-bay-buccaneers,30400,2018
39108,30400,0,Damoun Patterson,WR,dead_cap,tampa-bay-buccaneers,30400,2018
39109,28000,0,Azeem Victor,ILB,dead_cap,tampa-bay-buccaneers,28000,2018
39110,23118,0,Devante Harris,CB,dead_cap,tampa-bay-buccaneers,23118,2018
39111,22800,0,Donnie Ernsberger,TE,dead_cap,tampa-bay-buccaneers,22800,2018
39112,22800,0,Emmanuel Smith,LB,dead_cap,tampa-bay-buccaneers,22800,2018
39113,22800,0,Ralph Webb,RB,dead_cap,tampa-bay-buccaneers,22800,2018
39114,0,22783,Stevie Tu'ikolovatu,DT,dead_cap,tampa-bay-buccaneers,22783,2018
39115,22235,0,Riley Bullough,ILB,dead_cap,tampa-bay-buccaneers,22235,2018
39116,15200,0,Farrington Huguenin,DE,dead_cap,tampa-bay-buccaneers,15200,2018
39117,15200,0,Alec James,DE,dead_cap,tampa-bay-buccaneers,15200,2018
39118,15200,0,Jeff Richards,CB,dead_cap,tampa-bay-buccaneers,15200,2018
39119,0,3334,Richie Brown,ILB,dead_cap,tampa-bay-buccaneers,3334,2018
39120,0,1334,Evan Panfil,DE,dead_cap,tampa-bay-buccaneers,1334,2018
39121,20922000,0,Jameis Winston,QB,active,tampa-bay-buccaneers,20922000,2019
39122,7000000,5500000,Donovan Smith,LT,active,tampa-bay-buccaneers,12500000,2019
39123,3125000,7900000,Ali Marpet,G,active,tampa-bay-buccaneers,11025000,2019
39124,10000000,0,Ryan Jensen,C,active,tampa-bay-buccaneers,10000000,2019
39125,9750000,0,Lavonte David,OLB,active,tampa-bay-buccaneers,9750000,2019
39126,5250000,4000000,Ndamukong Suh,DE,active,tampa-bay-buccaneers,9250000,2019
39127,3000000,4750000,Jason Pierre-Paul,DE,active,tampa-bay-buccaneers,7750000,2019
39128,7000000,0,Cameron Brate,TE,active,tampa-bay-buccaneers,7000000,2019
39129,495000,4835148,Devin White,LB,active,tampa-bay-buccaneers,5330148,2019
39130,1000000,4000000,Shaquil Barrett,OLB,active,tampa-bay-buccaneers,5000000,2019
39131,3975000,828125,Demar Dotson,RT,active,tampa-bay-buccaneers,4803125,2019
39132,2000000,2000000,Beau Allen,DT,active,tampa-bay-buccaneers,4000000,2019
39133,2000000,2000000,Breshad Perriman,WR,active,tampa-bay-buccaneers,4000000,2019
39134,3750000,0,William Gholston,DE,active,tampa-bay-buccaneers,3750000,2019
39135,1153829,2215316,Vita Vea,DT,active,tampa-bay-buccaneers,3369145,2019
39136,1473602,1552203,O.J. Howard,TE,active,tampa-bay-buccaneers,3025805,2019
39137,805000,1795000,Bradley Pinion,P,active,tampa-bay-buccaneers,2600000,2019
39138,1125000,1000000,Peyton Barber,RB,active,tampa-bay-buccaneers,2125000,2019
39139,2025000,0,Carl Nassib,OLB,active,tampa-bay-buccaneers,2025000,2019
39140,1548529,148040,Ryan Smith,CB,active,tampa-bay-buccaneers,1696569,2019
39141,801450,805801,Ronald Jones II,RB,active,tampa-bay-buccaneers,1607251,2019
39142,495000,846090,Sean Bunting,CB,active,tampa-bay-buccaneers,1341090,2019
39143,805000,450000,Ryan Griffin,QB,active,tampa-bay-buccaneers,1255000,2019
39144,711051,444202,M.J. Stewart,CB,active,tampa-bay-buccaneers,1155253,2019
39145,679687,318748,Carlton Davis,CB,active,tampa-bay-buccaneers,998435,2019
39146,930000,0,Darian Stewart,FS,active,tampa-bay-buccaneers,930000,2019
39147,677000,198041,Chris Godwin,WR,active,tampa-bay-buccaneers,875041,2019
39148,805000,65000,Earl Watford,G,active,tampa-bay-buccaneers,870000,2019
39149,615000,198426,Alex Cappa,G,active,tampa-bay-buccaneers,813426,2019
39150,805000,90000,Kevin Minter,ILB,active,tampa-bay-buccaneers,895000,2019
39151,805000,90000,Rakeem Nunez-Roches,DE,active,tampa-bay-buccaneers,895000,2019
39152,720000,0,Jerald Hawkins,T,active,tampa-bay-buccaneers,720000,2019
39153,495000,211713,Jamel Dean,CB,active,tampa-bay-buccaneers,706713,2019
39154,495000,205545,Mike Edwards,S,active,tampa-bay-buccaneers,700545,2019
39155,495000,193020,Anthony Nelson,OLB,active,tampa-bay-buccaneers,688020,2019
39156,677647,0,Andrew Adams,S,active,tampa-bay-buccaneers,677647,2019
39157,570000,75434,Justin Watson,WR,active,tampa-bay-buccaneers,645434,2019
39158,757647,0,Josh Wells,RT,active,tampa-bay-buccaneers,757647,2019
39159,495000,81443,Matt Gay,K,active,tampa-bay-buccaneers,576443,2019
39160,570000,0,Tanner Hudson,TE,active,tampa-bay-buccaneers,570000,2019
39161,495000,0,Dare Ogunbowale,RB,active,tampa-bay-buccaneers,495000,2019
39162,495000,0,Zach Triner,LS,active,tampa-bay-buccaneers,495000,2019
39163,469406,0,Pat O'Connor,DE,active,tampa-bay-buccaneers,469406,2019
39164,349412,0,Noah Dawkins,LB,active,tampa-bay-buccaneers,349412,2019
39165,437648,0,Sam Acho,OLB,active,tampa-bay-buccaneers,437648,2019
39166,234703,0,Aaron Stinnie,G,active,tampa-bay-buccaneers,234703,2019
39167,232941,0,Kahzin Daniels,DE,active,tampa-bay-buccaneers,232941,2019
39168,203824,0,Mazzi Wilkins,CB,active,tampa-bay-buccaneers,203824,2019
39169,58236,0,Cyril Grayson,WR,active,tampa-bay-buccaneers,58236,2019
39170,58235,0,Codey McElroy,TE,active,tampa-bay-buccaneers,58235,2019
39171,58235,0,Spencer Schnell,WR,active,tampa-bay-buccaneers,58235,2019
39172,37941,0,Jaydon Mickens,WR,active,tampa-bay-buccaneers,37941,2019
39173,29118,0,John Franklin,CB,active,tampa-bay-buccaneers,29118,2019
39174,9000000,4600000,Mike Evans,WR,injured_reserve,tampa-bay-buccaneers,13600000,2019
39175,937663,480326,Justin Evans,S,injured_reserve,tampa-bay-buccaneers,1417989,2019
39176,1000000,0,Blaine Gabbert,QB,injured_reserve,tampa-bay-buccaneers,1000000,2019
39177,570000,166814,Jordan Whitehead,S,injured_reserve,tampa-bay-buccaneers,736814,2019
39178,645000,6668,Antony Auclair,TE,injured_reserve,tampa-bay-buccaneers,651668,2019
39179,645000,0,Michael Liedtke,G,injured_reserve,tampa-bay-buccaneers,645000,2019
39180,645000,0,T.J. Logan,RB,injured_reserve,tampa-bay-buccaneers,645000,2019
39181,495000,31960,Scott Miller,WR,injured_reserve,tampa-bay-buccaneers,526960,2019
39182,476291,36344,Jack Cichy,ILB,injured_reserve,tampa-bay-buccaneers,512635,2019
39183,412412,7500,Zack Bailey,G,injured_reserve,tampa-bay-buccaneers,419912,2019
39184,378000,333,D’Cota Dixon,S,injured_reserve,tampa-bay-buccaneers,378333,2019
39185,378000,0,Bryant Mitchell,WR,injured_reserve,tampa-bay-buccaneers,378000,2019
39186,378000,0,Orion Stewart,CB,injured_reserve,tampa-bay-buccaneers,378000,2019
39187,668000,176572,Kendell Beckwith,OLB,non_fb_injury,tampa-bay-buccaneers,844572,2019
39188,96000,0,Chad Kanoff,QB,practice_squad,tampa-bay-buccaneers,96000,2019
39189,48000,0,John Franklin,CB,practice_squad,tampa-bay-buccaneers,48000,2019
39190,1401951,2127759,Vernon Hargreaves,CB,dead_cap,tampa-bay-buccaneers,3529710,2019
39191,1050000,1450000,Deone Bucannon,ILB,dead_cap,tampa-bay-buccaneers,2500000,2019
39192,0,1000000,Mitch Unrein,DE,dead_cap,tampa-bay-buccaneers,1000000,2019
39193,0,647510,Noah Spence,DE,dead_cap,tampa-bay-buccaneers,647510,2019
39194,375529,0,Jordan Leggett,TE,dead_cap,tampa-bay-buccaneers,375529,2019
39195,227646,36176,Devante Bond,OLB,dead_cap,tampa-bay-buccaneers,263822,2019
39196,255000,0,Brad Seaton,T,dead_cap,tampa-bay-buccaneers,255000,2019
39197,227646,0,Bobo Wilson,WR,dead_cap,tampa-bay-buccaneers,227646,2019
39198,0,195000,Cairo Santos,K,dead_cap,tampa-bay-buccaneers,195000,2019
39199,185588,0,Nate Trewyn,C,dead_cap,tampa-bay-buccaneers,185588,2019
39200,119118,63297,Caleb Benenoch,RT,dead_cap,tampa-bay-buccaneers,182415,2019
39201,178981,0,Demone Harris,OLB,dead_cap,tampa-bay-buccaneers,178981,2019
39202,146236,0,Ishmael Hyman,WR,dead_cap,tampa-bay-buccaneers,146236,2019
39203,145824,0,Amara Darboh,WR,dead_cap,tampa-bay-buccaneers,145824,2019
39204,138706,0,K.J. Brent,WR,dead_cap,tampa-bay-buccaneers,138706,2019
39205,136000,0,John Battle,S,dead_cap,tampa-bay-buccaneers,136000,2019
39206,103118,0,Jeremiah Ledbetter,DT,dead_cap,tampa-bay-buccaneers,103118,2019
39207,0,91132,Stevie Tu'ikolovatu,DT,dead_cap,tampa-bay-buccaneers,91132,2019
39208,88000,0,Anthony Fabiano,T,dead_cap,tampa-bay-buccaneers,88000,2019
39209,88000,0,Aca’Cedric Ware,RB,dead_cap,tampa-bay-buccaneers,88000,2019
39210,80000,0,Mazzi Wilkins,CB,dead_cap,tampa-bay-buccaneers,80000,2019
39211,64000,0,Quinton Bell,OLB,dead_cap,tampa-bay-buccaneers,64000,2019
39212,56000,0,Codey McElroy,TE,dead_cap,tampa-bay-buccaneers,56000,2019
39213,40000,0,Tony Brooks-James,RB,dead_cap,tampa-bay-buccaneers,40000,2019
39214,40000,0,Nick Fitzgerald,QB,dead_cap,tampa-bay-buccaneers,40000,2019
39215,0,28079,Terry Beckner Jr.,DT,dead_cap,tampa-bay-buccaneers,28079,2019
39216,24000,0,Kahzin Daniels,DE,dead_cap,tampa-bay-buccaneers,24000,2019
39217,24000,0,Pat O'Connor,DE,dead_cap,tampa-bay-buccaneers,24000,2019
39218,16000,0,Herb Miller,S,dead_cap,tampa-bay-buccaneers,16000,2019
39219,0,13334,Godwin Igwebuike,S,dead_cap,tampa-bay-buccaneers,13334,2019
39220,12000,0,Emanuel Hall,WR,dead_cap,tampa-bay-buccaneers,12000,2019
39221,8000,0,Darius Jackson,RB,dead_cap,tampa-bay-buccaneers,8000,2019
39222,8000,0,Jaydon Mickens,WR,dead_cap,tampa-bay-buccaneers,8000,2019
39223,8000,0,Trevion Thompson,WR,dead_cap,tampa-bay-buccaneers,8000,2019
39224,0,3333,Shaun Wilson,RB,dead_cap,tampa-bay-buccaneers,3333,2019
39225,0,1668,Cole Gardner,T,dead_cap,tampa-bay-buccaneers,1668,2019
39226,0,667,Sergio Bailey,WR,dead_cap,tampa-bay-buccaneers,667,2019
39227,0,333,Cortrelle Simpson,WR,dead_cap,tampa-bay-buccaneers,333,2019
39228,16750000,1600000,Mike Evans,WR,active,tampa-bay-buccaneers,18350000,2020
39229,14500000,0,Donovan Smith,LT,active,tampa-bay-buccaneers,14500000,2020
39230,10625000,400000,Ali Marpet,G,active,tampa-bay-buccaneers,11025000,2020
39231,10750000,0,Lavonte David,OLB,active,tampa-bay-buccaneers,10750000,2020
39232,10000000,0,Ryan Jensen,C,active,tampa-bay-buccaneers,10000000,2020
39233,1827537,4835148,Devin White,LB,active,tampa-bay-buccaneers,6662685,2020
39234,6000000,0,Cameron Brate,TE,active,tampa-bay-buccaneers,6000000,2020
39235,4750000,0,William Gholston,DE,active,tampa-bay-buccaneers,4750000,2020
39236,1827658,2215316,Vita Vea,DT,active,tampa-bay-buccaneers,4042974,2020
39237,1977903,1552204,O.J. Howard,TE,active,tampa-bay-buccaneers,3530107,2020
39238,2700000,0,Bradley Pinion,P,active,tampa-bay-buccaneers,2700000,2020
39239,1122901,805801,Ronald Jones II,RB,active,tampa-bay-buccaneers,1928702,2020
39240,830273,846090,Sean Bunting,CB,active,tampa-bay-buccaneers,1676363,2020
39241,1173995,480328,Justin Evans,S,active,tampa-bay-buccaneers,1654323,2020
39242,945000,700000,Ryan Griffin,QB,active,tampa-bay-buccaneers,1645000,2020
39243,942101,444202,M.J. Stewart,CB,active,tampa-bay-buccaneers,1386303,2020
39244,879374,318748,Carlton Davis,CB,active,tampa-bay-buccaneers,1198122,2020
39245,768500,198041,Chris Godwin,WR,active,tampa-bay-buccaneers,966541,2020
39246,758000,176572,Kendell Beckwith,OLB,active,tampa-bay-buccaneers,934572,2020
39247,705000,198426,Alex Cappa,G,active,tampa-bay-buccaneers,903426,2020
39248,649000,211713,Jamel Dean,CB,active,tampa-bay-buccaneers,860713,2020
39249,638623,205545,Mike Edwards,S,active,tampa-bay-buccaneers,844168,2020
39250,660000,166814,Jordan Whitehead,S,active,tampa-bay-buccaneers,826814,2020
39251,585000,193020,Anthony Nelson,OLB,active,tampa-bay-buccaneers,778020,2020
39252,660000,75434,Justin Watson,WR,active,tampa-bay-buccaneers,735434,2020
39253,735000,0,T.J. Logan,RB,active,tampa-bay-buccaneers,735000,2020
39254,660000,36344,Jack Cichy,ILB,active,tampa-bay-buccaneers,696344,2020
39255,585000,81443,Matt Gay,K,active,tampa-bay-buccaneers,666443,2020
39256,660000,0,Pat O'Connor,DE,active,tampa-bay-buccaneers,660000,2020
39257,660000,0,Aaron Stinnie,G,active,tampa-bay-buccaneers,660000,2020
39258,585000,31960,Scott Miller,WR,active,tampa-bay-buccaneers,616960,2020
39259,585000,7500,Zack Bailey,G,active,tampa-bay-buccaneers,592500,2020
39260,585000,0,Kahzin Daniels,DE,active,tampa-bay-buccaneers,585000,2020
39261,585000,0,Noah Dawkins,LB,active,tampa-bay-buccaneers,585000,2020
39262,585000,0,Dare Ogunbowale,RB,active,tampa-bay-buccaneers,585000,2020
39263,585000,0,Zach Triner,LS,active,tampa-bay-buccaneers,585000,2020
39264,585000,0,Mazzi Wilkins,CB,active,tampa-bay-buccaneers,585000,2020
39265,510000,333,D’Cota Dixon,S,active,tampa-bay-buccaneers,510333,2020
39266,510000,0,John Franklin,CB,active,tampa-bay-buccaneers,510000,2020
39267,510000,0,Cyril Grayson,WR,active,tampa-bay-buccaneers,510000,2020
39268,510000,0,Codey McElroy,TE,active,tampa-bay-buccaneers,510000,2020
39269,510000,0,Spencer Schnell,WR,active,tampa-bay-buccaneers,510000,2020
39270,0,0,Quinton Bell,OLB,active,tampa-bay-buccaneers,0,2020
39271,0,0,Anthony Fabiano,T,active,tampa-bay-buccaneers,0,2020
39272,0,0,Deiondre' Hall,CB,active,tampa-bay-buccaneers,0,2020
39273,0,0,Jeremiah Ledbetter,DT,active,tampa-bay-buccaneers,0,2020
39274,0,0,Jordan Leggett,TE,active,tampa-bay-buccaneers,0,2020
39275,0,0,Herb Miller,S,active,tampa-bay-buccaneers,0,2020
39276,0,0,Brad Seaton,T,active,tampa-bay-buccaneers,0,2020
39277,0,0,Aca’Cedric Ware,RB,active,tampa-bay-buccaneers,0,2020
39278,0,84237,Terry Beckner Jr.,DT,dead_cap,tampa-bay-buccaneers,84237,2020
39279,0,3334,Shaun Wilson,RB,dead_cap,tampa-bay-buccaneers,3334,2020
39280,0,667,Cortrelle Simpson,WR,dead_cap,tampa-bay-buccaneers,667,2020
39281,4000000,5308666,Keith Bulluck,LB,active,tennessee-titans,9308666,2007
39282,5553334,1336668,Albert Haynesworth,DT,active,tennessee-titans,6890002,2007
39283,3640000,1187500,Kyle Vanden Bosch,DE,active,tennessee-titans,4827500,2007
39284,285000,3030002,Michael Griffin,FS,active,tennessee-titans,3315002,2007
39285,840000,4920000,Vince Young,QB,active,tennessee-titans,5760000,2007
39286,1000000,1000002,Chris Hope,S,active,tennessee-titans,2000002,2007
39287,1250000,555000,Billy Volek,QB,active,tennessee-titans,1805000,2007
39288,1250000,1125000,Kerry Collins,QB,active,tennessee-titans,2375000,2007
39289,0,3215002,Adam-Pacman Jones,CB,active,tennessee-titans,3215002,2007
39290,1800000,0,Eugene Amano,C,active,tennessee-titans,1800000,2007
39291,720000,400000,Corey Simon,DT,active,tennessee-titans,1120000,2007
39292,467500,955025,Michael Roos,LT,active,tennessee-titans,1422525,2007
39293,510000,210002,Travis LaBoy,DT,active,tennessee-titans,720002,2007
39294,850000,0,Randy Starks,DE,active,tennessee-titans,850000,2007
39295,360000,325000,Lendale White,RB,active,tennessee-titans,685000,2007
39296,600000,0,Mike Williams,WR,active,tennessee-titans,600000,2007
39297,285000,307500,Chris Henry,RB,active,tennessee-titans,592500,2007
39298,435000,118333,Vincent Fuller,S,active,tennessee-titans,553333,2007
39299,435000,113000,David Stewart,RT,active,tennessee-titans,548000,2007
39300,435000,90000,Roydell Williams,WR,active,tennessee-titans,525000,2007
39301,510000,0,Casey Cramer,RB,active,tennessee-titans,510000,2007
39302,360000,121667,Calvin Lowry,S,active,tennessee-titans,481667,2007
39303,435000,42166,Daniel Loper,T,active,tennessee-titans,477166,2007
39304,360000,107375,Stephen Tulloch,ILB,active,tennessee-titans,467375,2007
39305,285000,181750,Paul Williams,WR,active,tennessee-titans,466750,2007
39306,435000,27833,Bo Scaife,TE,active,tennessee-titans,462833,2007
39307,435000,25000,Rob Bironas,K,active,tennessee-titans,460000,2007
39308,435000,14416,Reynaldo Hill,CB,active,tennessee-titans,449416,2007
39309,820000,0,Eric Moulds,WR,active,tennessee-titans,820000,2007
39310,285000,111250,Leroy Harris,C,active,tennessee-titans,396250,2007
39311,360000,14291,Cortland Finnegan,CB,active,tennessee-titans,374291,2007
39312,360000,0,Quinton Ganther,RB,active,tennessee-titans,360000,2007
39313,360000,0,Kevin Vickerson,DT,active,tennessee-titans,360000,2007
39314,285000,21025,Jacob Ford,DE,active,tennessee-titans,306025,2007
39315,190000,43362,Antonio Johnson,DT,active,tennessee-titans,233362,2007
39316,18516,0,Quinton Ganther,RB,active,tennessee-titans,18516,2007
39317,285000,0,Michael Otto,LT,active,tennessee-titans,285000,2007
39318,435000,143750,Brandon Jones,WR,injured_reserve,tennessee-titans,578750,2007
39319,435000,0,Eric King,CB,injured_reserve,tennessee-titans,435000,2007
39320,79900,0,Michael Otto,LT,practice_squad,tennessee-titans,79900,2007
39321,0,7045500,Steve McNair,QB,dead_cap,tennessee-titans,7045500,2007
39322,0,1285000,Andre Woolfolk,CB,dead_cap,tennessee-titans,1285000,2007
39323,602256,0,Travis Henry,RB,dead_cap,tennessee-titans,602256,2007
39324,333333,0,Jesse Mahelona,DT,dead_cap,tennessee-titans,333333,2007
39325,250000,0,Bryan Scott,OLB,dead_cap,tennessee-titans,250000,2007
39326,198750,0,Courtney Roby,WR,dead_cap,tennessee-titans,198750,2007
39327,46967,0,Terna Nande,LB,dead_cap,tennessee-titans,46967,2007
39328,44333,0,Damien Nash,RB,dead_cap,tennessee-titans,44333,2007
39329,28250,0,Jonathan Orr,WR,dead_cap,tennessee-titans,28250,2007
39330,23945,0,Joel Filani,WR,dead_cap,tennessee-titans,23945,2007
39331,20000,0,Ryan Smith,CB,dead_cap,tennessee-titans,20000,2007
39332,18934,0,Spencer Toone,LB,dead_cap,tennessee-titans,18934,2007
39333,13665,0,Michael Otto,LT,dead_cap,tennessee-titans,13665,2007
39334,4250000,5308666,Keith Bulluck,LB,active,tennessee-titans,9558666,2008
39335,7250003,0,Albert Haynesworth,DT,active,tennessee-titans,7250003,2008
39336,620000,5857525,Michael Roos,LT,active,tennessee-titans,6477525,2008
39337,4480000,1187500,Kyle Vanden Bosch,DE,active,tennessee-titans,5667500,2008
39338,1500000,1000002,Chris Hope,S,active,tennessee-titans,2500002,2008
39339,1000000,1000000,David Stewart,RT,active,tennessee-titans,2000000,2008
39340,1500000,4920000,Vince Young,QB,active,tennessee-titans,6420000,2008
39341,500000,3014291,Cortland Finnegan,CB,active,tennessee-titans,3514291,2008
39342,1750000,1125000,Kerry Collins,QB,active,tennessee-titans,2875000,2008
39343,295000,1742502,Chris Johnson,RB,active,tennessee-titans,2037502,2008
39344,1000000,1000000,Jake Scott,G,active,tennessee-titans,2000000,2008
39345,800000,1040000,Chris Carr,CB,active,tennessee-titans,1840000,2008
39346,1417000,0,Rob Bironas,K,active,tennessee-titans,1417000,2008
39347,1417000,0,Bo Scaife,TE,active,tennessee-titans,1417000,2008
39348,464000,1722502,Michael Griffin,FS,active,tennessee-titans,2186502,2008
39349,750000,0,Eugene Amano,C,active,tennessee-titans,750000,2008
39350,295000,680000,Jason Jones,DE,active,tennessee-titans,975000,2008
39351,927000,0,Vincent Fuller,S,active,tennessee-titans,927000,2008
39352,927000,0,Reynaldo Hill,CB,active,tennessee-titans,927000,2008
39353,927000,0,Daniel Loper,T,active,tennessee-titans,927000,2008
39354,445000,325000,Lendale White,RB,active,tennessee-titans,770000,2008
39355,520000,143750,Brandon Jones,WR,active,tennessee-titans,663750,2008
39356,370000,307500,Chris Henry,RB,active,tennessee-titans,677500,2008
39357,605000,0,Casey Cramer,RB,active,tennessee-titans,605000,2008
39358,445000,107375,Stephen Tulloch,ILB,active,tennessee-titans,552375,2008
39359,370000,181750,Paul Williams,WR,active,tennessee-titans,551750,2008
39360,520000,0,Dave Ball,DE,active,tennessee-titans,520000,2008
39361,445000,50000,Kevin Vickerson,DT,active,tennessee-titans,495000,2008
39362,370000,111250,Leroy Harris,C,active,tennessee-titans,481250,2008
39363,295000,174250,Craig Stevens,TE,active,tennessee-titans,469250,2008
39364,445000,0,Quinton Ganther,RB,active,tennessee-titans,445000,2008
39365,295000,124575,William Hayes,DE,active,tennessee-titans,419575,2008
39366,295000,105687,Lavelle Hawkins,WR,active,tennessee-titans,400687,2008
39367,295000,96275,Stanford Keglar,ILB,active,tennessee-titans,391275,2008
39368,295000,21025,Jacob Ford,DE,active,tennessee-titans,316025,2008
39369,295000,0,Michael Otto,LT,active,tennessee-titans,295000,2008
39370,52058,0,Cary Williams,CB,active,tennessee-titans,52058,2008
39371,460000,0,Eric King,CB,injured_reserve,tennessee-titans,460000,2008
39372,88400,0,Antonio Johnson,DT,practice_squad,tennessee-titans,88400,2008
39373,88400,0,Fernando Velasco,G,practice_squad,tennessee-titans,88400,2008
39374,88400,0,Cary Williams,CB,practice_squad,tennessee-titans,88400,2008
39375,800004,0,Adam-Pacman Jones,CB,dead_cap,tennessee-titans,800004,2008
39376,333333,0,Jesse Mahelona,DT,dead_cap,tennessee-titans,333333,2008
39377,198750,0,Courtney Roby,WR,dead_cap,tennessee-titans,198750,2008
39378,121667,0,Calvin Lowry,S,dead_cap,tennessee-titans,121667,2008
39379,90000,0,Roydell Williams,WR,dead_cap,tennessee-titans,90000,2008
39380,71835,0,Joel Filani,WR,dead_cap,tennessee-titans,71835,2008
39381,60000,0,Ryan Smith,CB,dead_cap,tennessee-titans,60000,2008
39382,56500,0,Jonathan Orr,WR,dead_cap,tennessee-titans,56500,2008
39383,46967,0,Terna Nande,LB,dead_cap,tennessee-titans,46967,2008
39384,43362,0,Antonio Johnson,DT,dead_cap,tennessee-titans,43362,2008
39385,40995,0,Michael Otto,LT,dead_cap,tennessee-titans,40995,2008
39386,11925,0,Cary Williams,CB,dead_cap,tennessee-titans,11925,2008
39387,6000,0,Fernando Velasco,G,dead_cap,tennessee-titans,6000,2008
39388,0,2500,Jerrell Freeman,ILB,dead_cap,tennessee-titans,2500,2008
39389,5320000,1187500,Kyle Vanden Bosch,DE,active,tennessee-titans,6507500,2009
39390,4500000,2000000,Kerry Collins,QB,active,tennessee-titans,6500000,2009
39391,4000000,1000002,Chris Hope,S,active,tennessee-titans,5000002,2009
39392,3000000,1000000,David Stewart,RT,active,tennessee-titans,4000000,2009
39393,2160000,4920000,Vince Young,QB,active,tennessee-titans,7080000,2009
39394,3500000,1000000,Jake Scott,G,active,tennessee-titans,4500000,2009
39395,1880000,2620000,Michael Roos,LT,active,tennessee-titans,4500000,2009
39396,4462000,0,Bo Scaife,TE,active,tennessee-titans,4462000,2009
39397,3000000,1900000,Chris Hovan,DT,active,tennessee-titans,4900000,2009
39398,1300000,2900000,Nate Washington,WR,active,tennessee-titans,4200000,2009
39399,2150000,1500000,Cortland Finnegan,CB,active,tennessee-titans,3650000,2009
39400,2000000,1000000,Jovan Haye,DT,active,tennessee-titans,3000000,2009
39401,1500000,825000,Rob Bironas,K,active,tennessee-titans,2325000,2009
39402,1300000,666667,Vincent Fuller,S,active,tennessee-titans,1966667,2009
39403,1675000,0,Eugene Amano,C,active,tennessee-titans,1675000,2009
39404,721500,1722502,Michael Griffin,FS,active,tennessee-titans,2444002,2009
39405,385000,1980002,Chris Johnson,RB,active,tennessee-titans,2365002,2009
39406,310000,843002,Kenny Britt,WR,active,tennessee-titans,1153002,2009
39407,535000,325000,Lendale White,RB,active,tennessee-titans,860000,2009
39408,635000,50000,Kevin Vickerson,DT,active,tennessee-titans,685000,2009
39409,385000,275000,Jason Jones,DE,active,tennessee-titans,660000,2009
39410,535000,107375,Stephen Tulloch,ILB,active,tennessee-titans,642375,2009
39411,620000,0,Dave Ball,DE,active,tennessee-titans,620000,2009
39412,620000,0,Casey Cramer,RB,active,tennessee-titans,620000,2009
39413,620000,0,Alvin Pearman,RB,active,tennessee-titans,620000,2009
39414,460000,111250,Leroy Harris,C,active,tennessee-titans,571250,2009
39415,385000,174250,Craig Stevens,TE,active,tennessee-titans,559250,2009
39416,310000,230000,Sen'Derrick Marks,DT,active,tennessee-titans,540000,2009
39417,385000,124575,William Hayes,DE,active,tennessee-titans,509575,2009
39418,385000,105687,Lavelle Hawkins,WR,active,tennessee-titans,490687,2009
39419,310000,175000,Jared Cook,TE,active,tennessee-titans,485000,2009
39420,385000,96275,Stanford Keglar,ILB,active,tennessee-titans,481275,2009
39421,460000,21025,Jacob Ford,DE,active,tennessee-titans,481025,2009
39422,310000,165937,Ryan Mouton,CB,active,tennessee-titans,475937,2009
39423,310000,106531,Gerald McRath,LB,active,tennessee-titans,416531,2009
39424,385000,0,Brett Kern,P,active,tennessee-titans,385000,2009
39425,385000,0,Nevin McCaskill,T,active,tennessee-titans,385000,2009
39426,385000,0,Michael Otto,LT,active,tennessee-titans,385000,2009
39427,310000,36635,Javon Ringer,RB,active,tennessee-titans,346635,2009
39428,310000,22454,Jason McCourty,CB,active,tennessee-titans,332454,2009
39429,310000,11033,Nick Schommer,S,active,tennessee-titans,321033,2009
39430,310000,0,Dominique Edison,WR,active,tennessee-titans,310000,2009
39431,291176,0,Cary Williams,CB,active,tennessee-titans,291176,2009
39432,54705,0,Fernando Velasco,G,active,tennessee-titans,54705,2009
39433,5500000,5308666,Keith Bulluck,LB,injured_reserve,tennessee-titans,10808666,2009
39434,176800,0,Fernando Velasco,G,practice_squad,tennessee-titans,176800,2009
39435,88400,0,Cary Williams,CB,practice_squad,tennessee-titans,88400,2009
39436,36400,0,Lance Ball,RB,practice_squad,tennessee-titans,36400,2009
39437,351765,50000,Patrick Ramsey,QB,dead_cap,tennessee-titans,401765,2009
39438,181750,0,Paul Williams,WR,dead_cap,tennessee-titans,181750,2009
39439,115000,0,Ryan Durand,G,dead_cap,tennessee-titans,115000,2009
39440,86724,0,Antonio Johnson,DT,dead_cap,tennessee-titans,86724,2009
39441,39725,0,Tim Shaw,OLB,dead_cap,tennessee-titans,39725,2009
39442,35775,0,Cary Williams,CB,dead_cap,tennessee-titans,35775,2009
39443,20150,0,Dominique Edison,WR,dead_cap,tennessee-titans,20150,2009
39444,6000,0,Fernando Velasco,G,dead_cap,tennessee-titans,6000,2009
39445,0,2500,Jerrell Freeman,ILB,dead_cap,tennessee-titans,2500,2009
39446,7500000,4920000,Vince Young,QB,active,tennessee-titans,12420000,2010
39447,5500000,1000002,Chris Hope,S,active,tennessee-titans,6500002,2010
39448,5500000,2000000,Kerry Collins,QB,active,tennessee-titans,7500000,2010
39449,4667000,1500000,Michael Roos,LT,active,tennessee-titans,6167000,2010
39450,4875000,1000000,Jake Scott,G,active,tennessee-titans,5875000,2010
39451,4000000,1000000,David Stewart,RT,active,tennessee-titans,5000000,2010
39452,4908000,0,Bo Scaife,TE,active,tennessee-titans,4908000,2010
39453,3300000,1000000,Jovan Haye,DT,active,tennessee-titans,4300000,2010
39454,2177500,1450000,Eugene Amano,C,active,tennessee-titans,3627500,2010
39455,2900000,1000000,Cortland Finnegan,CB,active,tennessee-titans,3900000,2010
39456,1000000,2000000,Will Witherspoon,OLB,active,tennessee-titans,3000000,2010
39457,395000,3157002,Kenny Britt,WR,active,tennessee-titans,3552002,2010
39458,2140000,666667,Vincent Fuller,S,active,tennessee-titans,2806667,2010
39459,1950000,825000,Rob Bironas,K,active,tennessee-titans,2775000,2010
39460,2521000,0,Stephen Tulloch,ILB,active,tennessee-titans,2521000,2010
39461,550000,2570002,Chris Johnson,RB,active,tennessee-titans,3120002,2010
39462,979000,1822502,Michael Griffin,FS,active,tennessee-titans,2801502,2010
39463,1000000,900000,Nate Washington,WR,active,tennessee-titans,1900000,2010
39464,1809000,0,Dave Ball,DE,active,tennessee-titans,1809000,2010
39465,320000,1126668,Derrick Morgan,OLB,active,tennessee-titans,1446668,2010
39466,1101000,21025,Jacob Ford,DE,active,tennessee-titans,1122025,2010
39467,700000,300000,Jason Babin,DE,active,tennessee-titans,1000000,2010
39468,470000,275000,Jason Jones,DE,active,tennessee-titans,745000,2010
39469,550000,111250,Leroy Harris,C,active,tennessee-titans,661250,2010
39470,470000,174250,Craig Stevens,TE,active,tennessee-titans,644250,2010
39471,395000,230000,Sen'Derrick Marks,DT,active,tennessee-titans,625000,2010
39472,470000,124575,William Hayes,DE,active,tennessee-titans,594575,2010
39473,470000,105687,Lavelle Hawkins,WR,active,tennessee-titans,575687,2010
39474,395000,175000,Jared Cook,TE,active,tennessee-titans,570000,2010
39475,395000,165937,Ryan Mouton,CB,active,tennessee-titans,560937,2010
39476,545000,0,Patrick Bailey,OLB,active,tennessee-titans,545000,2010
39477,545000,0,Tim Shaw,OLB,active,tennessee-titans,545000,2010
39478,320000,205812,Damian Williams,WR,active,tennessee-titans,525812,2010
39479,320000,161110,Rennie Curran,LB,active,tennessee-titans,481110,2010
39480,371764,106531,Gerald McRath,LB,active,tennessee-titans,478295,2010
39481,475000,0,Brett Kern,P,active,tennessee-titans,475000,2010
39482,470000,0,Michael Otto,LT,active,tennessee-titans,470000,2010
39483,320000,131785,Alterraun Verner,CB,active,tennessee-titans,451785,2010
39484,395000,36635,Javon Ringer,RB,active,tennessee-titans,431635,2010
39485,395000,22454,Jason McCourty,CB,active,tennessee-titans,417454,2010
39486,310000,101125,Troy Kropog,RT,active,tennessee-titans,411125,2010
39487,395000,0,Al Afalava,S,active,tennessee-titans,395000,2010
39488,395000,0,Fernando Velasco,G,active,tennessee-titans,395000,2010
39489,320000,47512,Robert Johnson,S,active,tennessee-titans,367512,2010
39490,320000,28556,Rusty Smith,QB,active,tennessee-titans,348556,2010
39491,320000,14850,Marc Mariani,WR,active,tennessee-titans,334850,2010
39492,320000,6250,Kevin Matthews,C,active,tennessee-titans,326250,2010
39493,320000,0,Ryan Durand,G,active,tennessee-titans,320000,2010
39494,320000,0,Malcolm Sheppard,DT,active,tennessee-titans,320000,2010
39495,345000,0,Ryan Durand,G,dead_cap,tennessee-titans,345000,2010
39496,181750,0,Paul Williams,WR,dead_cap,tennessee-titans,181750,2010
39497,96275,0,Stanford Keglar,ILB,dead_cap,tennessee-titans,96275,2010
39498,60450,0,Dominique Edison,WR,dead_cap,tennessee-titans,60450,2010
39499,39725,0,Tim Shaw,OLB,dead_cap,tennessee-titans,39725,2010
39500,0,19550,Myron Rolle,CB,dead_cap,tennessee-titans,19550,2010
39501,0,11221,David Howard,DT,dead_cap,tennessee-titans,11221,2010
39502,6500000,0,Chris Hope,S,active,tennessee-titans,6500000,2011
39503,5000000,1500000,Michael Roos,LT,active,tennessee-titans,6500000,2011
39504,3000000,4335002,Chris Johnson,RB,active,tennessee-titans,7335002,2011
39505,4700000,1000000,Jake Scott,G,active,tennessee-titans,5700000,2011
39506,4500000,1000000,David Stewart,RT,active,tennessee-titans,5500000,2011
39507,3000000,2000000,Matt Hasselbeck,QB,active,tennessee-titans,5000000,2011
39508,3793000,1000000,Cortland Finnegan,CB,active,tennessee-titans,4793000,2011
39509,2680000,1450000,Eugene Amano,C,active,tennessee-titans,4130000,2011
39510,405000,5301668,Derrick Morgan,OLB,active,tennessee-titans,5706668,2011
39511,3310500,1722502,Michael Griffin,FS,active,tennessee-titans,5033002,2011
39512,3300000,900000,Nate Washington,WR,active,tennessee-titans,4200000,2011
39513,4000000,0,Barrett Ruud,LB,active,tennessee-titans,4000000,2011
39514,3000000,1000000,Jovan Haye,DT,active,tennessee-titans,4000000,2011
39515,2500000,1000000,Will Witherspoon,OLB,active,tennessee-titans,3500000,2011
39516,2400000,825000,Rob Bironas,K,active,tennessee-titans,3225000,2011
39517,1750000,666667,Daniel Graham,TE,active,tennessee-titans,2416667,2011
39518,375000,1913364,Jake Locker,QB,active,tennessee-titans,2288364,2011
39519,1750000,500000,Shaun Smith,DT,active,tennessee-titans,2250000,2011
39520,1000000,1250000,Leroy Harris,C,active,tennessee-titans,2250000,2011
39521,575000,1717502,Kenny Britt,WR,active,tennessee-titans,2292502,2011
39522,1000000,300000,Dave Ball,DE,active,tennessee-titans,1300000,2011
39523,1200000,0,Patrick Bailey,OLB,active,tennessee-titans,1200000,2011
39524,1200000,0,Michael Otto,LT,active,tennessee-titans,1200000,2011
39525,1200000,0,Tim Shaw,OLB,active,tennessee-titans,1200000,2011
39526,600000,531875,Brett Kern,P,active,tennessee-titans,1131875,2011
39527,1000000,124575,William Hayes,DE,active,tennessee-titans,1124575,2011
39528,850000,0,Ahmard Hall,FB,active,tennessee-titans,850000,2011
39529,375000,520731,Akeem Ayers,OLB,active,tennessee-titans,895731,2011
39530,600000,275000,Jason Jones,DE,active,tennessee-titans,875000,2011
39531,600000,174250,Craig Stevens,TE,active,tennessee-titans,774250,2011
39532,525000,230000,Sen'Derrick Marks,DT,active,tennessee-titans,755000,2011
39533,600000,105687,Lavelle Hawkins,WR,active,tennessee-titans,705687,2011
39534,525000,175000,Jared Cook,TE,active,tennessee-titans,700000,2011
39535,525000,165937,Ryan Mouton,CB,active,tennessee-titans,690937,2011
39536,450000,205812,Damian Williams,WR,active,tennessee-titans,655812,2011
39537,525000,106531,Gerald McRath,LB,active,tennessee-titans,631531,2011
39538,450000,131785,Alterraun Verner,CB,active,tennessee-titans,581785,2011
39539,525000,36635,Javon Ringer,RB,active,tennessee-titans,561635,2011
39540,525000,22454,Jason McCourty,CB,active,tennessee-titans,547454,2011
39541,375000,154359,Jurrell Casey,DT,active,tennessee-titans,529359,2011
39542,685000,0,Anthony Smith,S,active,tennessee-titans,685000,2011
39543,525000,0,Quinn Johnson,FB,active,tennessee-titans,525000,2011
39544,525000,0,Fernando Velasco,G,active,tennessee-titans,525000,2011
39545,395000,101125,Troy Kropog,RT,active,tennessee-titans,496125,2011
39546,375000,113850,Colin McCarthy,ILB,active,tennessee-titans,488850,2011
39547,450000,28556,Rusty Smith,QB,active,tennessee-titans,478556,2011
39548,450000,14850,Marc Mariani,WR,active,tennessee-titans,464850,2011
39549,460000,0,Al Afalava,S,active,tennessee-titans,460000,2011
39550,450000,6250,Kevin Matthews,C,active,tennessee-titans,456250,2011
39551,375000,75145,Jamie Harper,RB,active,tennessee-titans,450145,2011
39552,450000,0,Robert Johnson,S,active,tennessee-titans,450000,2011
39553,450000,0,Malcolm Sheppard,DT,active,tennessee-titans,450000,2011
39554,375000,48613,Karl Klug,DT,active,tennessee-titans,423613,2011
39555,405000,0,Ryan Durand,G,active,tennessee-titans,405000,2011
39556,405000,0,Nick Schommer,S,active,tennessee-titans,405000,2011
39557,375000,27625,Byron Stingily,RT,active,tennessee-titans,402625,2011
39558,375000,27500,Zach Clayton,DT,active,tennessee-titans,402500,2011
39559,375000,11474,Tommie Campbell,CB,active,tennessee-titans,386474,2011
39560,375000,1000,James Kirkendoll,WR,active,tennessee-titans,376000,2011
39561,375000,0,Chris Hawkins,CB,active,tennessee-titans,375000,2011
39562,375000,0,Kevin Malast,LB,active,tennessee-titans,375000,2011
39563,2460000,0,Vince Young,QB,dead_cap,tennessee-titans,2460000,2011
39564,666667,0,Vincent Fuller,S,dead_cap,tennessee-titans,666667,2011
39565,0,161110,Rennie Curran,LB,dead_cap,tennessee-titans,161110,2011
39566,96275,0,Stanford Keglar,ILB,dead_cap,tennessee-titans,96275,2011
39567,0,58650,Myron Rolle,CB,dead_cap,tennessee-titans,58650,2011
39568,0,47512,Robert Johnson,S,dead_cap,tennessee-titans,47512,2011
39569,0,33663,David Howard,DT,dead_cap,tennessee-titans,33663,2011
39570,1666,0,LeQuan Lewis,CB,dead_cap,tennessee-titans,1666,2011
39571,0,666,Michael Preston,WR,dead_cap,tennessee-titans,666,2011
39572,8000000,4335002,Chris Johnson,RB,active,tennessee-titans,12335002,2012
39573,5500000,2000000,Matt Hasselbeck,QB,active,tennessee-titans,7500000,2012
39574,5500000,1750000,Michael Roos,LT,active,tennessee-titans,7250000,2012
39575,5000000,1000000,David Stewart,RT,active,tennessee-titans,6000000,2012
39576,3000000,1822454,Jason McCourty,CB,active,tennessee-titans,4822454,2012
39577,3700000,1000000,Jovan Haye,DT,active,tennessee-titans,4700000,2012
39578,3500000,1000000,Will Witherspoon,OLB,active,tennessee-titans,4500000,2012
39579,3400000,900000,Nate Washington,WR,active,tennessee-titans,4300000,2012
39580,2500000,1800000,Michael Griffin,FS,active,tennessee-titans,4300000,2012
39581,2500000,1800000,Kamerion Wimbley,OLB,active,tennessee-titans,4300000,2012
39582,2850000,825000,Rob Bironas,K,active,tennessee-titans,3675000,2012
39583,947091,1913364,Jake Locker,QB,active,tennessee-titans,2860455,2012
39584,725000,2556668,Derrick Morgan,OLB,active,tennessee-titans,3281668,2012
39585,1000000,1000000,Craig Stevens,TE,active,tennessee-titans,2000000,2012
39586,666178,1717502,Kenny Britt,WR,active,tennessee-titans,2383680,2012
39587,390000,1104264,Kendall Wright,WR,active,tennessee-titans,1494264,2012
39588,800000,666667,Lavelle Hawkins,WR,active,tennessee-titans,1466667,2012
39589,1200000,200000,Jordan Babineaux,S,active,tennessee-titans,1400000,2012
39590,706000,531875,Brett Kern,P,active,tennessee-titans,1237875,2012
39591,750000,375000,Michael Otto,LT,active,tennessee-titans,1125000,2012
39592,598932,520731,Akeem Ayers,OLB,active,tennessee-titans,1119663,2012
39593,830000,100000,Patrick Bailey,OLB,active,tennessee-titans,930000,2012
39594,830000,100000,Tim Shaw,OLB,active,tennessee-titans,930000,2012
39595,615000,230000,Sen'Derrick Marks,DT,active,tennessee-titans,845000,2012
39596,615000,175000,Jared Cook,TE,active,tennessee-titans,790000,2012
39597,540000,205812,Damian Williams,WR,active,tennessee-titans,745812,2012
39598,565000,165937,Ryan Mouton,CB,active,tennessee-titans,730937,2012
39599,390000,311509,Zach Brown,ILB,active,tennessee-titans,701509,2012
39600,700000,0,Leger Douzable,DT,active,tennessee-titans,700000,2012
39601,540000,131785,Alterraun Verner,CB,active,tennessee-titans,671785,2012
39602,490000,154359,Jurrell Casey,DT,active,tennessee-titans,644359,2012
39603,615000,0,Quinn Johnson,FB,active,tennessee-titans,615000,2012
39604,615000,0,Darius Reynaud,RB,active,tennessee-titans,615000,2012
39605,615000,0,Fernando Velasco,G,active,tennessee-titans,615000,2012
39606,465000,113850,Colin McCarthy,ILB,active,tennessee-titans,578850,2012
39607,540000,28556,Rusty Smith,QB,active,tennessee-titans,568556,2012
39608,565000,0,Al Afalava,S,active,tennessee-titans,565000,2012
39609,540000,14850,Marc Mariani,WR,active,tennessee-titans,554850,2012
39610,465000,75145,Jamie Harper,RB,active,tennessee-titans,540145,2012
39611,700000,0,Taitusi Lutui,G,active,tennessee-titans,700000,2012
39612,540000,0,Al Afalava,S,active,tennessee-titans,540000,2012
39613,540000,0,Robert Johnson,S,active,tennessee-titans,540000,2012
39614,540000,0,Kevin Matthews,C,active,tennessee-titans,540000,2012
39615,540000,0,Mitch Petrus,G,active,tennessee-titans,540000,2012
39616,390000,141890,Mike Martin,DT,active,tennessee-titans,531890,2012
39617,465000,48613,Karl Klug,DT,active,tennessee-titans,513613,2012
39618,390000,108023,Coty Sensabaugh,CB,active,tennessee-titans,498023,2012
39619,465000,27625,Byron Stingily,RT,active,tennessee-titans,492625,2012
39620,465000,11474,Tommie Campbell,CB,active,tennessee-titans,476474,2012
39621,465000,0,Daniel Baldridge,RT,active,tennessee-titans,465000,2012
39622,390000,49500,Taylor Thompson,TE,active,tennessee-titans,439500,2012
39623,390000,25947,Markelle Martin,S,active,tennessee-titans,415947,2012
39624,390000,16741,Scott Solomon,OLB,active,tennessee-titans,406741,2012
39625,390000,6666,Beau Brinkley,LS,active,tennessee-titans,396666,2012
39626,390000,333,DaJohn Harris,DT,active,tennessee-titans,390333,2012
39627,390000,0,Brandon Barden,TE,active,tennessee-titans,390000,2012
39628,390000,0,Jake Ingram,DE,active,tennessee-titans,390000,2012
39629,390000,0,Collin Mooney,FB,active,tennessee-titans,390000,2012
39630,390000,0,Michael Preston,WR,active,tennessee-titans,390000,2012
39631,700000,0,Xavier Adibi,LB,active,tennessee-titans,700000,2012
39632,615000,0,Kyle DeVan,G,active,tennessee-titans,615000,2012
39633,615000,0,Jarius Wynn,OLB,active,tennessee-titans,615000,2012
39634,465000,0,Tracy Wilson,S,active,tennessee-titans,465000,2012
39635,390000,0,Pannel Egboh,DE,active,tennessee-titans,390000,2012
39636,3182500,1450000,Eugene Amano,C,injured_reserve,tennessee-titans,4632500,2012
39637,2700000,1250000,Leroy Harris,C,injured_reserve,tennessee-titans,3950000,2012
39638,2000000,1500000,Steve Hutchinson,G,injured_reserve,tennessee-titans,3500000,2012
39639,825000,200000,Dave Ball,DE,injured_reserve,tennessee-titans,1025000,2012
39640,615000,106531,Gerald McRath,LB,injured_reserve,tennessee-titans,721531,2012
39641,700000,0,Keyunta Dawson,DE,injured_reserve,tennessee-titans,700000,2012
39642,615000,36635,Javon Ringer,RB,injured_reserve,tennessee-titans,651635,2012
39643,465000,0,Darren Evans,RB,injured_reserve,tennessee-titans,465000,2012
39644,465000,0,Kevin Malast,LB,injured_reserve,tennessee-titans,465000,2012
39645,700000,-306250,Zac Diles,ILB,injured_reserve,tennessee-titans,393750,2012
39646,0,666666,Daniel Graham,TE,dead_cap,tennessee-titans,666666,2012
39647,500000,0,Shaun Smith,DT,dead_cap,tennessee-titans,500000,2012
39648,0,214812,Rennie Curran,LB,dead_cap,tennessee-titans,214812,2012
39649,202250,0,Troy Kropog,RT,dead_cap,tennessee-titans,202250,2012
39650,0,95024,Robert Johnson,S,dead_cap,tennessee-titans,95024,2012
39651,0,27500,Zach Clayton,DT,dead_cap,tennessee-titans,27500,2012
39652,3334,0,LeQuan Lewis,CB,dead_cap,tennessee-titans,3334,2012
39653,2000,0,James Kirkendoll,WR,dead_cap,tennessee-titans,2000,2012
39654,0,1334,Michael Preston,WR,dead_cap,tennessee-titans,1334,2012
39655,10000000,2000000,Chris Johnson,RB,active,tennessee-titans,12000000,2013
39656,6000000,1500000,Michael Roos,LT,active,tennessee-titans,7500000,2013
39657,5000000,1000000,David Stewart,RT,active,tennessee-titans,6000000,2013
39658,5000000,1800000,Jason McCourty,CB,active,tennessee-titans,6800000,2013
39659,3500000,2594118,Michael Griffin,FS,active,tennessee-titans,6094118,2013
39660,4000000,1800000,Kamerion Wimbley,OLB,active,tennessee-titans,5800000,2013
39661,4200000,900000,Nate Washington,WR,active,tennessee-titans,5100000,2013
39662,2500000,2100000,Andy Levitre,G,active,tennessee-titans,4600000,2013
39663,2500000,1000000,Craig Stevens,TE,active,tennessee-titans,3500000,2013
39664,2000000,950000,Delanie Walker,TE,active,tennessee-titans,2950000,2013
39665,2050000,750000,Rob Bironas,K,active,tennessee-titans,2800000,2013
39666,2000000,666666,Sammie Lee Hill,DT,active,tennessee-titans,2666666,2013
39667,1650000,933333,Shonn Greene,RB,active,tennessee-titans,2583333,2013
39668,1045000,2671668,Derrick Morgan,OLB,active,tennessee-titans,3716668,2013
39669,1500000,875000,Ryan Fitzpatrick,QB,active,tennessee-titans,2375000,2013
39670,405000,1807118,Chance Warmack,G,active,tennessee-titans,2212118,2013
39671,1700000,375000,Michael Otto,LT,active,tennessee-titans,2075000,2013
39672,1300000,500000,Bernard Pollard,S,active,tennessee-titans,1800000,2013
39673,897500,1717502,Kenny Britt,WR,active,tennessee-titans,2615002,2013
39674,480000,1387830,Kendall Wright,WR,active,tennessee-titans,1867830,2013
39675,1400000,300000,George Wilson,S,active,tennessee-titans,1700000,2013
39676,1323000,131785,Alterraun Verner,CB,active,tennessee-titans,1454785,2013
39677,821500,531875,Brett Kern,P,active,tennessee-titans,1353375,2013
39678,822864,520731,Akeem Ayers,OLB,active,tennessee-titans,1343595,2013
39679,1100000,150000,Moise Fokou,ILB,active,tennessee-titans,1250000,2013
39680,970000,100000,Patrick Bailey,OLB,active,tennessee-titans,1070000,2013
39681,800000,200000,Ropati Pitoitua,DE,active,tennessee-titans,1000000,2013
39682,405000,581209,Justin Hunter,WR,active,tennessee-titans,986209,2013
39683,565377,311509,Zach Brown,ILB,active,tennessee-titans,876886,2013
39684,800000,50000,Antonio Johnson,DT,active,tennessee-titans,850000,2013
39685,630000,205812,Damian Williams,WR,active,tennessee-titans,835812,2013
39686,580000,154359,Jurrell Casey,DT,active,tennessee-titans,734359,2013
39687,555000,113850,Colin McCarthy,ILB,active,tennessee-titans,668850,2013
39688,500000,141890,Mike Martin,DT,active,tennessee-titans,641890,2013
39689,840000,65000,Chris Spencer,G,active,tennessee-titans,905000,2013
39690,555000,48613,Karl Klug,DT,active,tennessee-titans,603613,2013
39691,575000,14850,Marc Mariani,WR,active,tennessee-titans,589850,2013
39692,480000,108023,Coty Sensabaugh,CB,active,tennessee-titans,588023,2013
39693,555000,27625,Byron Stingily,RT,active,tennessee-titans,582625,2013
39694,405000,164081,Blidi Wreh-Wilson,CB,active,tennessee-titans,569081,2013
39695,555000,11474,Tommie Campbell,CB,active,tennessee-titans,566474,2013
39696,715000,0,Jackie Battle,FB,active,tennessee-titans,715000,2013
39697,405000,126504,Zaviar Gooden,ILB,active,tennessee-titans,531504,2013
39698,480000,49500,Taylor Thompson,TE,active,tennessee-titans,529500,2013
39699,405000,116065,Brian Schwenke,C,active,tennessee-titans,521065,2013
39700,480000,6666,Beau Brinkley,LS,active,tennessee-titans,486666,2013
39701,630000,0,Rusty Smith,QB,active,tennessee-titans,630000,2013
39702,480000,0,Michael Preston,WR,active,tennessee-titans,480000,2013
39703,405000,49625,Lavar Edwards,DE,active,tennessee-titans,454625,2013
39704,405000,11474,Daimion Stafford,SS,active,tennessee-titans,416474,2013
39705,840000,0,Leon Washington,RB,active,tennessee-titans,840000,2013
39706,715000,0,Quinn Johnson,FB,active,tennessee-titans,715000,2013
39707,405000,0,Micah Pellerin,CB,active,tennessee-titans,405000,2013
39708,630000,0,Kevin Matthews,C,active,tennessee-titans,630000,2013
39709,405000,0,Tyler Wilson,QB,active,tennessee-titans,405000,2013
39710,405000,0,Khalid Wooten,FS,active,tennessee-titans,405000,2013
39711,1519182,1913364,Jake Locker,QB,injured_reserve,tennessee-titans,3432546,2013
39712,1000000,500000,Robert Turner,C,injured_reserve,tennessee-titans,1500000,2013
39713,405000,0,Collin Mooney,FB,injured_reserve,tennessee-titans,405000,2013
39714,239647,0,Michael Preston,WR,practice_squad,tennessee-titans,239647,2013
39715,89120,0,Brandon Barden,TE,practice_squad,tennessee-titans,89120,2013
39716,48000,0,Stefan Charles,DT,practice_squad,tennessee-titans,48000,2013
39717,48000,0,Rashad Ross,WR,practice_squad,tennessee-titans,48000,2013
39718,30000,0,Oscar Johnson,G,practice_squad,tennessee-titans,30000,2013
39719,30000,0,Al Netter,RT,practice_squad,tennessee-titans,30000,2013
39720,24000,0,Brandon Copeland,DE,practice_squad,tennessee-titans,24000,2013
39721,24000,0,Rusty Smith,QB,practice_squad,tennessee-titans,24000,2013
39722,12000,0,Kendall Gaskins,FB,practice_squad,tennessee-titans,12000,2013
39723,3000000,0,Steve Hutchinson,G,dead_cap,tennessee-titans,3000000,2013
39724,0,2067500,Eugene Amano,C,dead_cap,tennessee-titans,2067500,2013
39725,2000000,0,Matt Hasselbeck,QB,dead_cap,tennessee-titans,2000000,2013
39726,1333334,0,Lavelle Hawkins,WR,dead_cap,tennessee-titans,1333334,2013
39727,1015000,0,Darius Reynaud,RB,dead_cap,tennessee-titans,1015000,2013
39728,0,666668,Daniel Graham,TE,dead_cap,tennessee-titans,666668,2013
39729,500000,0,Shaun Smith,DT,dead_cap,tennessee-titans,500000,2013
39730,101247,137500,Quinn Johnson,FB,dead_cap,tennessee-titans,238747,2013
39731,228529,0,Zac Diles,ILB,dead_cap,tennessee-titans,228529,2013
39732,200000,0,Jordan Babineaux,S,dead_cap,tennessee-titans,200000,2013
39733,163235,0,Keyunta Dawson,DE,dead_cap,tennessee-titans,163235,2013
39734,0,150290,Jamie Harper,RB,dead_cap,tennessee-titans,150290,2013
39735,148236,0,Kevin Matthews,C,dead_cap,tennessee-titans,148236,2013
39736,148235,0,John Skelton,QB,dead_cap,tennessee-titans,148235,2013
39737,130588,0,Corey Lynch,S,dead_cap,tennessee-titans,130588,2013
39738,89910,19670,Khalid Wooten,FS,dead_cap,tennessee-titans,109580,2013
39739,0,100000,Tim Shaw,OLB,dead_cap,tennessee-titans,100000,2013
39740,65294,0,Pat McQuistan,RT,dead_cap,tennessee-titans,65294,2013
39741,62471,0,Devon Wylie,WR,dead_cap,tennessee-titans,62471,2013
39742,0,55000,Zach Clayton,DT,dead_cap,tennessee-titans,55000,2013
39743,32647,0,Shann Schillinger,S,dead_cap,tennessee-titans,32647,2013
39744,32647,0,Visanthe Shiancoe,TE,dead_cap,tennessee-titans,32647,2013
39745,28557,0,Rusty Smith,QB,dead_cap,tennessee-titans,28557,2013
39746,0,25947,Markelle Martin,S,dead_cap,tennessee-titans,25947,2013
39747,18000,0,Frank Kearse,DE,dead_cap,tennessee-titans,18000,2013
39748,0,16741,Scott Solomon,OLB,dead_cap,tennessee-titans,16741,2013
39749,0,5000,Stefan Charles,DT,dead_cap,tennessee-titans,5000,2013
39750,0,1666,Jack Doyle,TE,dead_cap,tennessee-titans,1666,2013
39751,0,1666,Oscar Johnson,G,dead_cap,tennessee-titans,1666,2013
39752,0,833,George Baker,CB,dead_cap,tennessee-titans,833,2013
39753,0,666,Travis Harvey,WR,dead_cap,tennessee-titans,666,2013
39754,0,666,Matt Pierce,CB,dead_cap,tennessee-titans,666,2013
39755,0,666,Jonathan Willard,OLB,dead_cap,tennessee-titans,666,2013
39756,0,333,Eloy Atkinson,C,dead_cap,tennessee-titans,333,2013
39757,0,333,Maikon Bonani,K,dead_cap,tennessee-titans,333,2013
39758,0,333,DaJohn Harris,DT,dead_cap,tennessee-titans,333,2013
39759,0,333,Nigel Nicholas,DE,dead_cap,tennessee-titans,333,2013
39760,0,333,Rashad Ross,WR,dead_cap,tennessee-titans,333,2013
39761,6500000,2100000,Andy Levitre,G,active,tennessee-titans,8600000,2014
39762,3500000,4800000,Jason McCourty,CB,active,tennessee-titans,8300000,2014
39763,6200000,1800000,Michael Griffin,FS,active,tennessee-titans,8000000,2014
39764,4800000,0,Nate Washington,WR,active,tennessee-titans,4800000,2014
39765,2250000,2550000,Kamerion Wimbley,OLB,active,tennessee-titans,4800000,2014
39766,2400000,2274359,Jurrell Casey,DT,active,tennessee-titans,4674359,2014
39767,3300000,766666,Sammie Lee Hill,DT,active,tennessee-titans,4066666,2014
39768,3000000,1000000,Delanie Walker,TE,active,tennessee-titans,4000000,2014
39769,2065000,2671668,Derrick Morgan,OLB,active,tennessee-titans,4736668,2014
39770,2300000,933333,Shonn Greene,RB,active,tennessee-titans,3233333,2014
39771,2000000,1000000,Michael Oher,RT,active,tennessee-titans,3000000,2014
39772,495000,2270147,Chance Warmack,G,active,tennessee-titans,2765147,2014
39773,1750000,750000,Wesley Woodyard,ILB,active,tennessee-titans,2500000,2014
39774,2000000,300000,George Wilson,S,active,tennessee-titans,2300000,2014
39775,570000,1671396,Kendall Wright,WR,active,tennessee-titans,2241396,2014
39776,420000,1668183,Taylor Lewan,LT,active,tennessee-titans,2088183,2014
39777,1000000,1050000,Dexter McCluster,RB,active,tennessee-titans,2050000,2014
39778,975000,975000,Ropati Pitoitua,DE,active,tennessee-titans,1950000,2014
39779,1431000,113850,Colin McCarthy,ILB,active,tennessee-titans,1544850,2014
39780,1000000,500000,Charlie Whitehurst,QB,active,tennessee-titans,1500000,2014
39781,937500,531875,Brett Kern,P,active,tennessee-titans,1469375,2014
39782,900000,500000,Al Woods,DT,active,tennessee-titans,1400000,2014
39783,651552,581209,Justin Hunter,WR,active,tennessee-titans,1232761,2014
39784,740754,311509,Zach Brown,ILB,active,tennessee-titans,1052263,2014
39785,824907,0,Brandon Harris,CB,active,tennessee-titans,824907,2014
39786,590000,141890,Mike Martin,DT,active,tennessee-titans,731890,2014
39787,420000,278818,Bishop Sankey,RB,active,tennessee-titans,698818,2014
39788,645000,48613,Karl Klug,DT,active,tennessee-titans,693613,2014
39789,519360,164081,Blidi Wreh-Wilson,CB,active,tennessee-titans,683441,2014
39790,570000,108023,Coty Sensabaugh,CB,active,tennessee-titans,678023,2014
39791,645000,27625,Byron Stingily,RT,active,tennessee-titans,672625,2014
39792,645000,0,Kris Durham,WR,active,tennessee-titans,645000,2014
39793,855000,65000,Chris Spencer,G,active,tennessee-titans,920000,2014
39794,855000,65000,Leon Washington,RB,active,tennessee-titans,920000,2014
39795,500000,126504,Zaviar Gooden,ILB,active,tennessee-titans,626504,2014
39796,495000,116065,Brian Schwenke,C,active,tennessee-titans,611065,2014
39797,730000,15000,Ryan Succop,K,active,tennessee-titans,745000,2014
39798,570000,6667,Beau Brinkley,LS,active,tennessee-titans,576667,2014
39799,855000,0,Jackie Battle,FB,active,tennessee-titans,855000,2014
39800,855000,0,Derek Hagan,WR,active,tennessee-titans,855000,2014
39801,730000,0,Quentin Groves,OLB,active,tennessee-titans,730000,2014
39802,420000,113850,DaQuan Jones,DE,active,tennessee-titans,533850,2014
39803,420000,106301,Marqueston Huff,FS,active,tennessee-titans,526301,2014
39804,495000,11474,Daimion Stafford,SS,active,tennessee-titans,506474,2014
39805,730000,0,Chase Coffman,TE,active,tennessee-titans,730000,2014
39806,420000,48613,Avery Williamson,ILB,active,tennessee-titans,468613,2014
39807,420000,31279,Zach Mettenberger,QB,active,tennessee-titans,451279,2014
39808,553235,0,Will Svitek,LT,active,tennessee-titans,553235,2014
39809,303000,3333,Gabe Ikard,C,active,tennessee-titans,306333,2014
39810,420000,0,Antonio Andrews,RB,active,tennessee-titans,420000,2014
39811,645000,0,Eric Olsen,C,active,tennessee-titans,645000,2014
39812,570000,0,Kaelin Burnett,OLB,active,tennessee-titans,570000,2014
39813,570000,0,Dontay Moch,DE,active,tennessee-titans,570000,2014
39814,420000,0,Justin Staples,OLB,active,tennessee-titans,420000,2014
39815,730000,0,Jamon Meredith,RT,active,tennessee-titans,730000,2014
39816,495000,0,Jemea Thomas,CB,active,tennessee-titans,495000,2014
39817,495000,0,Terren Jones,LT,active,tennessee-titans,495000,2014
39818,420000,0,Khalid Wooten,FS,active,tennessee-titans,420000,2014
39819,730000,0,Matthew Mulligan,TE,active,tennessee-titans,730000,2014
39820,730000,0,Jordan Palmer,QB,active,tennessee-titans,730000,2014
39821,420000,0,Rico Richardson,WR,active,tennessee-titans,420000,2014
39822,6625000,0,Michael Roos,LT,injured_reserve,tennessee-titans,6625000,2014
39823,2091273,1913364,Jake Locker,QB,injured_reserve,tennessee-titans,4004637,2014
39824,1600000,1093750,Craig Stevens,TE,injured_reserve,tennessee-titans,2693750,2014
39825,1650000,1025000,Bernard Pollard,S,injured_reserve,tennessee-titans,2675000,2014
39826,570000,49500,Taylor Thompson,TE,injured_reserve,tennessee-titans,619500,2014
39827,303000,2500,Josh Stewart,WR,injured_reserve,tennessee-titans,305500,2014
39828,197647,0,Brett Brackett,TE,injured_reserve,tennessee-titans,197647,2014
39829,107100,0,Chigbo Anunoby,DT,practice_squad,tennessee-titans,107100,2014
39830,107100,0,Justin McCray,G,practice_squad,tennessee-titans,107100,2014
39831,107100,0,William Poehls,G,practice_squad,tennessee-titans,107100,2014
39832,81900,0,Lache Seastrunk,RB,practice_squad,tennessee-titans,81900,2014
39833,63000,0,Nate Askew,OLB,practice_squad,tennessee-titans,63000,2014
39834,31500,0,Chaz Sutton,DE,practice_squad,tennessee-titans,31500,2014
39835,12600,0,Alex Tanney,QB,practice_squad,tennessee-titans,12600,2014
39836,6300,0,Rishard Anderson,CB,practice_squad,tennessee-titans,6300,2014
39837,0,4000000,Chris Johnson,RB,dead_cap,tennessee-titans,4000000,2014
39838,0,2067500,Eugene Amano,C,dead_cap,tennessee-titans,2067500,2014
39839,1058823,475000,Shaun Phillips,DE,dead_cap,tennessee-titans,1533823,2014
39840,431033,520731,Akeem Ayers,OLB,dead_cap,tennessee-titans,951764,2014
39841,0,875000,Ryan Fitzpatrick,QB,dead_cap,tennessee-titans,875000,2014
39842,0,750000,Rob Bironas,K,dead_cap,tennessee-titans,750000,2014
39843,374118,0,Brandon Ghee,CB,dead_cap,tennessee-titans,374118,2014
39844,301765,0,James Anderson,OLB,dead_cap,tennessee-titans,301765,2014
39845,227647,0,Richard Gordon,TE,dead_cap,tennessee-titans,227647,2014
39846,0,150000,Moise Fokou,ILB,dead_cap,tennessee-titans,150000,2014
39847,88200,59010,Khalid Wooten,FS,dead_cap,tennessee-titans,147210,2014
39848,0,137500,Antonio Johnson,DT,dead_cap,tennessee-titans,137500,2014
39849,0,112500,Quinn Johnson,FB,dead_cap,tennessee-titans,112500,2014
39850,102353,0,T.J. Graham,WR,dead_cap,tennessee-titans,102353,2014
39851,0,100000,Patrick Bailey,OLB,dead_cap,tennessee-titans,100000,2014
39852,0,100000,Tim Shaw,OLB,dead_cap,tennessee-titans,100000,2014
39853,94500,0,Rico Richardson,WR,dead_cap,tennessee-titans,94500,2014
39854,75600,0,Dontay Moch,DE,dead_cap,tennessee-titans,75600,2014
39855,74612,0,Brett Brackett,TE,dead_cap,tennessee-titans,74612,2014
39856,65824,0,Dorin Dickerson,TE,dead_cap,tennessee-titans,65824,2014
39857,63000,0,Derek Moye,WR,dead_cap,tennessee-titans,63000,2014
39858,56700,0,Justin Staples,OLB,dead_cap,tennessee-titans,56700,2014
39859,0,51894,Markelle Martin,S,dead_cap,tennessee-titans,51894,2014
39860,0,49625,Lavar Edwards,DE,dead_cap,tennessee-titans,49625,2014
39861,44100,3333,Antonio Andrews,RB,dead_cap,tennessee-titans,47433,2014
39862,0,40000,Marc Mariani,WR,dead_cap,tennessee-titans,40000,2014
39863,0,33482,Scott Solomon,OLB,dead_cap,tennessee-titans,33482,2014
39864,25200,1000,Rishard Anderson,CB,dead_cap,tennessee-titans,26200,2014
39865,12600,0,Brandon Copeland,DE,dead_cap,tennessee-titans,12600,2014
39866,0,11474,Tommie Campbell,CB,dead_cap,tennessee-titans,11474,2014
39867,0,10000,Stefan Charles,DT,dead_cap,tennessee-titans,10000,2014
39868,6300,0,Orson Charles,FB,dead_cap,tennessee-titans,6300,2014
39869,6300,0,Brad Sorensen,QB,dead_cap,tennessee-titans,6300,2014
39870,0,5000,James Gayle,DE,dead_cap,tennessee-titans,5000,2014
39871,0,5000,Jamall Merrell,DE,dead_cap,tennessee-titans,5000,2014
39872,0,3334,Jack Doyle,TE,dead_cap,tennessee-titans,3334,2014
39873,0,3334,Oscar Johnson,G,dead_cap,tennessee-titans,3334,2014
39874,0,1667,George Baker,CB,dead_cap,tennessee-titans,1667,2014
39875,0,1666,Travis Coons,K,dead_cap,tennessee-titans,1666,2014
39876,0,1666,Eric Ward,WR,dead_cap,tennessee-titans,1666,2014
39877,0,1334,Travis Harvey,WR,dead_cap,tennessee-titans,1334,2014
39878,0,1334,Matt Pierce,CB,dead_cap,tennessee-titans,1334,2014
39879,0,1334,Jonathan Willard,OLB,dead_cap,tennessee-titans,1334,2014
39880,0,1333,Derel Walker,WR,dead_cap,tennessee-titans,1333,2014
39881,0,833,Justin McCray,G,dead_cap,tennessee-titans,833,2014
39882,0,667,Eloy Atkinson,C,dead_cap,tennessee-titans,667,2014
39883,0,667,Maikon Bonani,K,dead_cap,tennessee-titans,667,2014
39884,0,667,Nigel Nicholas,DE,dead_cap,tennessee-titans,667,2014
39885,0,667,Rashad Ross,WR,dead_cap,tennessee-titans,667,2014
39886,0,666,Hakeem Smith,S,dead_cap,tennessee-titans,666,2014
39887,0,334,DaJohn Harris,DT,dead_cap,tennessee-titans,334,2014
39888,0,333,William Poehls,G,dead_cap,tennessee-titans,333,2014
39889,0,333,Jaz Reynolds,WR,dead_cap,tennessee-titans,333,2014
39890,6300000,1800000,Michael Griffin,FS,active,tennessee-titans,8100000,2015
39891,4500000,2220000,Jurrell Casey,DT,active,tennessee-titans,6720000,2015
39892,4275000,1000000,Delanie Walker,TE,active,tennessee-titans,5275000,2015
39893,3800000,866668,Sammie Lee Hill,DT,active,tennessee-titans,4666668,2015
39894,3000000,1468750,Brian Orakpo,OLB,active,tennessee-titans,4468750,2015
39895,435000,3967541,Marcus Mariota,QB,active,tennessee-titans,4402541,2015
39896,2500000,1125000,Da'Norris Searcy,SS,active,tennessee-titans,3625000,2015
39897,2100000,1512500,Ropati Pitoitua,DE,active,tennessee-titans,3612500,2015
39898,2750000,750000,Wesley Woodyard,ILB,active,tennessee-titans,3500000,2015
39899,2500000,833333,Perrish Cox,CB,active,tennessee-titans,3333333,2015
39900,585000,2733177,Chance Warmack,G,active,tennessee-titans,3318177,2015
39901,884000,1730962,Kendall Wright,WR,active,tennessee-titans,2614962,2015
39902,942045,1668183,Taylor Lewan,LT,active,tennessee-titans,2610228,2015
39903,2100000,500000,Al Woods,DT,active,tennessee-titans,2600000,2015
39904,1550000,733333,Harry Douglas,WR,active,tennessee-titans,2283333,2015
39905,1120000,1150000,Craig Stevens,TE,active,tennessee-titans,2270000,2015
39906,1000000,1031250,Anthony Fasano,TE,active,tennessee-titans,2031250,2015
39907,1500000,500000,Brett Kern,P,active,tennessee-titans,2000000,2015
39908,1500000,416666,Ryan Succop,K,active,tennessee-titans,1916666,2015
39909,1542000,108023,Coty Sensabaugh,CB,active,tennessee-titans,1650023,2015
39910,1000000,500000,Karl Klug,DT,active,tennessee-titans,1500000,2015
39911,1000000,475000,Byron Bell,RT,active,tennessee-titans,1475000,2015
39912,916131,311509,Zach Brown,ILB,active,tennessee-titans,1227640,2015
39913,435000,583836,Dorial Green-Beckham,WR,active,tennessee-titans,1018836,2015
39914,594704,278818,Bishop Sankey,RB,active,tennessee-titans,873522,2015
39915,660000,168000,Beau Brinkley,LS,active,tennessee-titans,828000,2015
39916,625335,164081,Blidi Wreh-Wilson,CB,active,tennessee-titans,789416,2015
39917,745000,0,Jamon Meredith,RT,active,tennessee-titans,745000,2015
39918,660000,25000,Steven Johnson,ILB,active,tennessee-titans,685000,2015
39919,660000,0,Dorin Dickerson,TE,active,tennessee-titans,660000,2015
39920,435000,200564,Jeremiah Poutasi,RT,active,tennessee-titans,635564,2015
39921,510000,113850,DaQuan Jones,DE,active,tennessee-titans,623850,2015
39922,510000,106301,Marqueston Huff,FS,active,tennessee-titans,616301,2015
39923,585000,11474,Daimion Stafford,SS,active,tennessee-titans,596474,2015
39924,585000,0,David Bass,DE,active,tennessee-titans,585000,2015
39925,435000,142903,Angelo Blackson,DE,active,tennessee-titans,577903,2015
39926,435000,134429,Jalston Fowler,FB,active,tennessee-titans,569429,2015
39927,510000,48613,Avery Williamson,ILB,active,tennessee-titans,558613,2015
39928,510000,31279,Zach Mettenberger,QB,active,tennessee-titans,541279,2015
39929,510000,0,Antonio Andrews,RB,active,tennessee-titans,510000,2015
39930,510000,0,Phillip Supernaw,TE,active,tennessee-titans,510000,2015
39931,435000,61417,David Cobb,RB,active,tennessee-titans,496417,2015
39932,435000,25368,Andy Gallik,C,active,tennessee-titans,460368,2015
39933,435000,2333,Cody Riggs,CB,active,tennessee-titans,437333,2015
39934,435000,2000,Quinton Spain,G,active,tennessee-titans,437000,2015
39935,427058,0,Joe Looney,G,active,tennessee-titans,427058,2015
39936,360000,0,Justin Staples,OLB,active,tennessee-titans,360000,2015
39937,745000,0,Brandon Harris,CB,active,tennessee-titans,745000,2015
39938,318000,4000,Curtis Riley,CB,active,tennessee-titans,322000,2015
39939,309705,0,B.W. Webb,CB,active,tennessee-titans,309705,2015
39940,179117,0,Tre McBride,WR,active,tennessee-titans,179117,2015
39941,179117,0,Andrew Turzilli,WR,active,tennessee-titans,179117,2015
39942,116470,0,Damaris Johnson,WR,active,tennessee-titans,116470,2015
39943,103235,0,Josh Aubrey,SS,active,tennessee-titans,103235,2015
39944,102352,0,J.R. Tavai,DT,active,tennessee-titans,102352,2015
39945,51176,0,Alex Tanney,QB,active,tennessee-titans,51176,2015
39946,6800000,1800000,Jason McCourty,CB,injured_reserve,tennessee-titans,8600000,2015
39947,2500000,1500000,Derrick Morgan,OLB,injured_reserve,tennessee-titans,4000000,2015
39948,2350000,1000000,Dexter McCluster,RB,injured_reserve,tennessee-titans,3350000,2015
39949,898104,581209,Justin Hunter,WR,injured_reserve,tennessee-titans,1479313,2015
39950,680000,141890,Mike Martin,DT,injured_reserve,tennessee-titans,821890,2015
39951,431647,116065,Brian Schwenke,C,injured_reserve,tennessee-titans,547712,2015
39952,352411,37038,Deiontrez Mount,OLB,injured_reserve,tennessee-titans,389449,2015
39953,153529,0,Yannik Cudjoe-Virgil,OLB,injured_reserve,tennessee-titans,153529,2015
39954,1340000,3000000,Michael Oher,RT,dead_cap,tennessee-titans,4340000,2015
39955,0,3600000,Kamerion Wimbley,OLB,dead_cap,tennessee-titans,3600000,2015
39956,0,2100000,Andy Levitre,G,dead_cap,tennessee-titans,2100000,2015
39957,1058824,500000,Charlie Whitehurst,QB,dead_cap,tennessee-titans,1558824,2015
39958,0,2556672,Derrick Morgan,OLB,dead_cap,tennessee-titans,2556672,2015
39959,0,833334,Shonn Greene,RB,dead_cap,tennessee-titans,833334,2015
39960,788823,0,Chase Coffman,TE,dead_cap,tennessee-titans,788823,2015
39961,0,425000,Bernard Pollard,S,dead_cap,tennessee-titans,425000,2015
39962,0,375000,Shaun Phillips,DE,dead_cap,tennessee-titans,375000,2015
39963,0,250000,Fernando Velasco,G,dead_cap,tennessee-titans,250000,2015
39964,244705,0,Terrance West,RB,dead_cap,tennessee-titans,244705,2015
39965,200540,0,Rico Richardson,WR,dead_cap,tennessee-titans,200540,2015
39966,0,150000,Hakeem Nicks,WR,dead_cap,tennessee-titans,150000,2015
39967,0,126504,Zaviar Gooden,ILB,dead_cap,tennessee-titans,126504,2015
39968,0,125000,Byron Stingily,RT,dead_cap,tennessee-titans,125000,2015
39969,112200,4166,Josue Matias,G,dead_cap,tennessee-titans,116366,2015
39970,112200,667,William Poehls,G,dead_cap,tennessee-titans,112867,2015
39971,112235,166,Connor Neighbors,RB,dead_cap,tennessee-titans,112401,2015
39972,112200,0,Jason Ankrah,DE,dead_cap,tennessee-titans,112200,2015
39973,112200,0,David Fluellen,RB,dead_cap,tennessee-titans,112200,2015
39974,0,99250,Lavar Edwards,DE,dead_cap,tennessee-titans,99250,2015
39975,99000,0,Dillon Farrell,C,dead_cap,tennessee-titans,99000,2015
39976,92400,0,Josh Aubrey,SS,dead_cap,tennessee-titans,92400,2015
39977,0,87500,Antonio Johnson,DT,dead_cap,tennessee-titans,87500,2015
39978,74824,2500,Cody Prewitt,S,dead_cap,tennessee-titans,77324,2015
39979,56000,13858,Tre McBride,WR,dead_cap,tennessee-titans,69858,2015
39980,52800,0,Kevin Greene,TE,dead_cap,tennessee-titans,52800,2015
39981,52800,0,B.W. Webb,CB,dead_cap,tennessee-titans,52800,2015
39982,0,49500,Taylor Thompson,TE,dead_cap,tennessee-titans,49500,2015
39983,44012,2666,Yannik Cudjoe-Virgil,OLB,dead_cap,tennessee-titans,46678,2015
39984,46200,0,Shaquille Richardson,CB,dead_cap,tennessee-titans,46200,2015
39985,33000,0,Justin Staples,OLB,dead_cap,tennessee-titans,33000,2015
39986,26400,3666,J.R. Tavai,DT,dead_cap,tennessee-titans,30066,2015
39987,26400,0,Marcus Pierce-Brewster,LB,dead_cap,tennessee-titans,26400,2015
39988,19800,0,Nick Harwell,WR,dead_cap,tennessee-titans,19800,2015
39989,18706,1000,Andrew Turzilli,WR,dead_cap,tennessee-titans,19706,2015
39990,13200,0,Gavin Lutman,WR,dead_cap,tennessee-titans,13200,2015
39991,13200,0,Bryn Renner,QB,dead_cap,tennessee-titans,13200,2015
39992,13200,0,Tevin Westbrook,TE,dead_cap,tennessee-titans,13200,2015
39993,0,10000,James Gayle,DE,dead_cap,tennessee-titans,10000,2015
39994,0,6667,Antonio Andrews,RB,dead_cap,tennessee-titans,6667,2015
39995,6600,0,Mike Kafka,QB,dead_cap,tennessee-titans,6600,2015
39996,0,3334,Travis Coons,K,dead_cap,tennessee-titans,3334,2015
39997,0,3334,Eric Ward,WR,dead_cap,tennessee-titans,3334,2015
39998,0,3333,Gabe Ikard,C,dead_cap,tennessee-titans,3333,2015
39999,0,2667,Derel Walker,WR,dead_cap,tennessee-titans,2667,2015
40000,0,2500,Josh Stewart,WR,dead_cap,tennessee-titans,2500,2015
40001,0,2000,Rishard Anderson,CB,dead_cap,tennessee-titans,2000,2015
40002,0,1667,Justin McCray,G,dead_cap,tennessee-titans,1667,2015
40003,0,1666,Derrick Lott,DT,dead_cap,tennessee-titans,1666,2015
40004,0,1334,Hakeem Smith,S,dead_cap,tennessee-titans,1334,2015
40005,0,1000,Deon Long,WR,dead_cap,tennessee-titans,1000,2015
40006,0,833,Toby Johnson,DT,dead_cap,tennessee-titans,833,2015
40007,0,667,Jaz Reynolds,WR,dead_cap,tennessee-titans,667,2015
40008,0,333,Mike Meyer,K,dead_cap,tennessee-titans,333,2015
40009,0,333,Lucas Vincent,DT,dead_cap,tennessee-titans,333,2015
40010,7000000,1800000,Jason McCourty,CB,active,tennessee-titans,8800000,2016
40011,6500000,1750000,Brian Orakpo,OLB,active,tennessee-titans,8250000,2016
40012,5400000,2720000,Jurrell Casey,DT,active,tennessee-titans,8120000,2016
40013,7320000,0,Kendall Wright,WR,active,tennessee-titans,7320000,2016
40014,4500000,1812500,Derrick Morgan,OLB,active,tennessee-titans,6312500,2016
40015,2700000,3567708,Delanie Walker,TE,active,tennessee-titans,6267708,2016
40016,5000000,1125000,Da'Norris Searcy,SS,active,tennessee-titans,6125000,2016
40017,6000000,0,DeMarco Murray,RB,active,tennessee-titans,6000000,2016
40018,3500000,750000,Wesley Woodyard,ILB,active,tennessee-titans,4250000,2016
40019,2500000,833333,Rishard Matthews,WR,active,tennessee-titans,3333333,2016
40020,1975000,1212500,Anthony Fasano,TE,active,tennessee-titans,3187500,2016
40021,1464091,1668183,Taylor Lewan,LT,active,tennessee-titans,3132274,2016
40022,450000,2440483,Jack Conklin,RT,active,tennessee-titans,2890483,2016
40023,1500000,1233333,Harry Douglas,WR,active,tennessee-titans,2733333,2016
40024,2200000,500000,Brett Kern,P,active,tennessee-titans,2700000,2016
40025,1500000,1000000,Rashad Johnson,FS,active,tennessee-titans,2500000,2016
40026,1500000,968750,Sean Spence,ILB,active,tennessee-titans,2468750,2016
40027,1500000,968750,Al Woods,DT,active,tennessee-titans,2468750,2016
40028,2050000,416666,Ryan Succop,K,active,tennessee-titans,2466666,2016
40029,1000000,1375000,Ben Jones,C,active,tennessee-titans,2375000,2016
40030,1250000,750000,Matt Cassel,QB,active,tennessee-titans,2000000,2016
40031,950000,1050000,Josh Kline,G,active,tennessee-titans,2000000,2016
40032,1671000,116065,Brian Schwenke,C,active,tennessee-titans,1787065,2016
40033,1000000,700000,Brice McCain,CB,active,tennessee-titans,1700000,2016
40034,1300000,200000,Antwon Blake,CB,active,tennessee-titans,1500000,2016
40035,900000,168000,Beau Brinkley,LS,active,tennessee-titans,1068000,2016
40036,450000,579496,Austin Johnson,DT,active,tennessee-titans,1029496,2016
40037,450000,533259,Derrick Henry,RB,active,tennessee-titans,983259,2016
40038,810272,0,Jace Amaro,TE,active,tennessee-titans,810272,2016
40039,760000,0,Dennis Kelly,RT,active,tennessee-titans,760000,2016
40040,600000,113850,DaQuan Jones,DE,active,tennessee-titans,713850,2016
40041,675000,11474,Daimion Stafford,SS,active,tennessee-titans,686474,2016
40042,675000,0,David Bass,DE,active,tennessee-titans,675000,2016
40043,675000,0,Nate Palmer,ILB,active,tennessee-titans,675000,2016
40044,450000,224265,Kevin Byard,FS,active,tennessee-titans,674265,2016
40045,525000,142903,Angelo Blackson,DE,active,tennessee-titans,667903,2016
40046,525000,134429,Jalston Fowler,FB,active,tennessee-titans,659429,2016
40047,600000,48613,Avery Williamson,ILB,active,tennessee-titans,648613,2016
40048,760000,0,Marc Mariani,WR,active,tennessee-titans,760000,2016
40049,600000,0,Antonio Andrews,RB,active,tennessee-titans,600000,2016
40050,600000,0,Phillip Supernaw,TE,active,tennessee-titans,600000,2016
40051,525000,2000,Quinton Spain,G,active,tennessee-titans,527000,2016
40052,450000,68721,Tajae Sharpe,WR,active,tennessee-titans,518721,2016
40053,450000,59546,LeShaun Sims,CB,active,tennessee-titans,509546,2016
40054,450000,33185,Sebastian Tretola,G,active,tennessee-titans,483185,2016
40055,450000,22041,Aaron Wallace,OLB,active,tennessee-titans,472041,2016
40056,397050,0,Curtis Riley,CB,active,tennessee-titans,397050,2016
40057,277938,0,Tre McBride,WR,active,tennessee-titans,277938,2016
40058,141176,0,Justin Staples,OLB,active,tennessee-titans,141176,2016
40059,132350,0,Kalan Reed,CB,active,tennessee-titans,132350,2016
40060,61764,0,D'Joun Smith,CB,active,tennessee-titans,61764,2016
40061,30882,0,Alex Tanney,QB,active,tennessee-titans,30882,2016
40062,26470,0,Antwaun Woods,DT,active,tennessee-titans,26470,2016
40063,525000,4978176,Marcus Mariota,QB,injured_reserve,tennessee-titans,5503176,2016
40064,675000,3196206,Chance Warmack,G,injured_reserve,tennessee-titans,3871206,2016
40065,1750000,500000,Byron Bell,RT,injured_reserve,tennessee-titans,2250000,2016
40066,1550000,700000,Karl Klug,DT,injured_reserve,tennessee-titans,2250000,2016
40067,450000,741328,Kevin Dodd,OLB,injured_reserve,tennessee-titans,1191328,2016
40068,333000,0,Bennett Okotcha,CB,injured_reserve,tennessee-titans,333000,2016
40069,330000,0,Josue Matias,G,injured_reserve,tennessee-titans,330000,2016
40070,79410,0,Mehdi Abdesmad,DE,injured_reserve,tennessee-titans,79410,2016
40071,27600,0,J.R. Tavai,DT,practice_squad,tennessee-titans,27600,2016
40072,5000000,833333,Perrish Cox,CB,dead_cap,tennessee-titans,5833333,2016
40073,0,4200000,Andy Levitre,G,dead_cap,tennessee-titans,4200000,2016
40074,0,1800000,Michael Griffin,FS,dead_cap,tennessee-titans,1800000,2016
40075,0,1375000,Dexter McCluster,RB,dead_cap,tennessee-titans,1375000,2016
40076,0,725000,Ropati Pitoitua,DE,dead_cap,tennessee-titans,725000,2016
40077,0,583836,Dorial Green-Beckham,WR,dead_cap,tennessee-titans,583836,2016
40078,0,581209,Justin Hunter,WR,dead_cap,tennessee-titans,581209,2016
40079,463529,0,Andre Johnson,WR,dead_cap,tennessee-titans,463529,2016
40080,0,278818,Bishop Sankey,RB,dead_cap,tennessee-titans,278818,2016
40081,253958,2333,Cody Riggs,CB,dead_cap,tennessee-titans,256291,2016
40082,0,200565,Jeremiah Poutasi,RT,dead_cap,tennessee-titans,200565,2016
40083,188680,0,David Fluellen,RB,dead_cap,tennessee-titans,188680,2016
40084,0,184251,David Cobb,RB,dead_cap,tennessee-titans,184251,2016
40085,0,164081,Blidi Wreh-Wilson,CB,dead_cap,tennessee-titans,164081,2016
40086,134382,0,Alex Tanney,QB,dead_cap,tennessee-titans,134382,2016
40087,0,126504,Zaviar Gooden,ILB,dead_cap,tennessee-titans,126504,2016
40088,0,125000,Byron Stingily,RT,dead_cap,tennessee-titans,125000,2016
40089,117300,0,Jerome Cunningham,TE,dead_cap,tennessee-titans,117300,2016
40090,117300,0,Tyler Marz,T,dead_cap,tennessee-titans,117300,2016
40091,0,106301,Marqueston Huff,FS,dead_cap,tennessee-titans,106301,2016
40092,103500,0,Karim Barton,G,dead_cap,tennessee-titans,103500,2016
40093,103500,0,Antwaun Woods,DT,dead_cap,tennessee-titans,103500,2016
40094,82800,14635,Kalan Reed,CB,dead_cap,tennessee-titans,97435,2016
40095,55200,41574,Tre McBride,WR,dead_cap,tennessee-titans,96774,2016
40096,96600,0,Mehdi Abdesmad,DE,dead_cap,tennessee-titans,96600,2016
40097,89700,0,Justin Staples,OLB,dead_cap,tennessee-titans,89700,2016
40098,0,62558,Zach Mettenberger,QB,dead_cap,tennessee-titans,62558,2016
40099,62100,0,Jonathan Krause,WR,dead_cap,tennessee-titans,62100,2016
40100,48300,0,Jeremiah McKinnon,CB,dead_cap,tennessee-titans,48300,2016
40101,0,37038,Deiontrez Mount,OLB,dead_cap,tennessee-titans,37038,2016
40102,0,25368,Andy Gallik,C,dead_cap,tennessee-titans,25368,2016
40103,20000,4000,Curtis Riley,CB,dead_cap,tennessee-titans,24000,2016
40104,20700,0,D'Joun Smith,CB,dead_cap,tennessee-titans,20700,2016
40105,0,8334,Josue Matias,G,dead_cap,tennessee-titans,8334,2016
40106,0,7334,J.R. Tavai,DT,dead_cap,tennessee-titans,7334,2016
40107,6900,0,Kourtnei Brown,OLB,dead_cap,tennessee-titans,6900,2016
40108,6900,0,Jordan Leslie,WR,dead_cap,tennessee-titans,6900,2016
40109,6900,0,K.J. Maye,WR,dead_cap,tennessee-titans,6900,2016
40110,6900,0,Ronald Patrick,C,dead_cap,tennessee-titans,6900,2016
40111,6900,0,Ben Roberts,WR,dead_cap,tennessee-titans,6900,2016
40112,0,5334,Yannik Cudjoe-Virgil,OLB,dead_cap,tennessee-titans,5334,2016
40113,0,5000,Cody Prewitt,S,dead_cap,tennessee-titans,5000,2016
40114,0,3334,Gabe Ikard,C,dead_cap,tennessee-titans,3334,2016
40115,0,3334,Derrick Lott,DT,dead_cap,tennessee-titans,3334,2016
40116,0,2500,Josh Stewart,WR,dead_cap,tennessee-titans,2500,2016
40117,0,2000,Deon Long,WR,dead_cap,tennessee-titans,2000,2016
40118,0,2000,Andrew Turzilli,WR,dead_cap,tennessee-titans,2000,2016
40119,0,1666,Lamarcus Brutus,S,dead_cap,tennessee-titans,1666,2016
40120,0,1334,Toby Johnson,DT,dead_cap,tennessee-titans,1334,2016
40121,0,1333,Samuel Carlson,T,dead_cap,tennessee-titans,1333,2016
40122,0,667,Mike Meyer,K,dead_cap,tennessee-titans,667,2016
40123,0,667,Lucas Vincent,DT,dead_cap,tennessee-titans,667,2016
40124,0,334,Connor Neighbors,RB,dead_cap,tennessee-titans,334,2016
40125,0,333,Aldrick Rosas,K,dead_cap,tennessee-titans,333,2016
40126,3000000,8288750,Jurrell Casey,DT,active,tennessee-titans,11288750,2017
40127,6200000,3250000,Brian Orakpo,OLB,active,tennessee-titans,9450000,2017
40128,5000000,3666666,Logan Ryan,CB,active,tennessee-titans,8666666,2017
40129,6000000,1968750,Derrick Morgan,OLB,active,tennessee-titans,7968750,2017
40130,6250000,700000,DeMarco Murray,RB,active,tennessee-titans,6950000,2017
40131,615000,5988811,Marcus Mariota,QB,active,tennessee-titans,6603811,2017
40132,5000000,1333333,Rishard Matthews,WR,active,tennessee-titans,6333333,2017
40133,4200000,1117708,Delanie Walker,TE,active,tennessee-titans,5317708,2017
40134,2000000,2750000,John Cyprien,SS,active,tennessee-titans,4750000,2017
40135,2000000,2666666,Sylvester Williams,DT,active,tennessee-titans,4666666,2017
40136,465000,4152216,Corey Davis,WR,active,tennessee-titans,4617216,2017
40137,2400000,2062500,Da'Norris Searcy,SS,active,tennessee-titans,4462500,2017
40138,3500000,875000,Ben Jones,C,active,tennessee-titans,4375000,2017
40139,2200000,2050000,Wesley Woodyard,ILB,active,tennessee-titans,4250000,2017
40140,1350000,2528125,Eric Decker,WR,active,tennessee-titans,3878125,2017
40141,1986136,1668183,Taylor Lewan,LT,active,tennessee-titans,3654319,2017
40142,1172621,2440483,Jack Conklin,RT,active,tennessee-titans,3613104,2017
40143,2800000,500000,Brett Kern,P,active,tennessee-titans,3300000,2017
40144,1350000,1900000,Erik Walden,OLB,active,tennessee-titans,3250000,2017
40145,2000000,1000000,Brynden Trawick,SS,active,tennessee-titans,3000000,2017
40146,2000000,900000,Brice McCain,CB,active,tennessee-titans,2900000,2017
40147,2400000,416668,Ryan Succop,K,active,tennessee-titans,2816668,2017
40148,1750000,1000000,Matt Cassel,QB,active,tennessee-titans,2750000,2017
40149,1250000,1218750,Karl Klug,DT,active,tennessee-titans,2468750,2017
40150,1400000,975000,Josh Kline,G,active,tennessee-titans,2375000,2017
40151,1200000,1142709,Harry Douglas,WR,active,tennessee-titans,2342709,2017
40152,465000,1586415,Adoree' Jackson,CB,active,tennessee-titans,2051415,2017
40153,1797000,48613,Avery Williamson,ILB,active,tennessee-titans,1845613,2017
40154,747832,741328,Kevin Dodd,OLB,active,tennessee-titans,1489160,2017
40155,1250000,166666,Daren Bates,ILB,active,tennessee-titans,1416666,2017
40156,707374,579496,Austin Johnson,DT,active,tennessee-titans,1286870,2017
40157,695815,533259,Derrick Henry,RB,active,tennessee-titans,1229074,2017
40158,900000,300000,Phillip Supernaw,TE,active,tennessee-titans,1200000,2017
40159,1000000,168000,Beau Brinkley,LS,active,tennessee-titans,1168000,2017
40160,1000000,37500,Eric Weems,WR,active,tennessee-titans,1037500,2017
40161,850000,175000,Nate Palmer,ILB,active,tennessee-titans,1025000,2017
40162,775000,238333,Dennis Kelly,RT,active,tennessee-titans,1013333,2017
40163,618566,224265,Kevin Byard,FS,active,tennessee-titans,842831,2017
40164,775000,0,Brian Schwenke,C,active,tennessee-titans,775000,2017
40165,465000,229003,Taywan Taylor,WR,active,tennessee-titans,694003,2017
40166,690000,0,David King,DE,active,tennessee-titans,690000,2017
40167,465000,176572,Jonnu Smith,TE,active,tennessee-titans,641572,2017
40168,615000,2000,Quinton Spain,G,active,tennessee-titans,617000,2017
40169,540000,0,David Fluellen,RB,active,tennessee-titans,540000,2017
40170,540000,0,Kalan Reed,CB,active,tennessee-titans,540000,2017
40171,540000,0,Curtis Riley,CB,active,tennessee-titans,540000,2017
40172,540000,0,Tye Smith,CB,active,tennessee-titans,540000,2017
40173,465000,67888,Jayon Brown,ILB,active,tennessee-titans,532888,2017
40174,465000,27503,Corey Levin,G,active,tennessee-titans,492503,2017
40175,592647,0,Brandon Weeden,QB,active,tennessee-titans,592647,2017
40176,182353,62500,Luke Stocker,TE,active,tennessee-titans,244853,2017
40177,109412,0,Josh Carraway,OLB,active,tennessee-titans,109412,2017
40178,27353,0,Khalfani Muhammad,RB,active,tennessee-titans,27353,2017
40179,1797000,113850,DaQuan Jones,DE,injured_reserve,tennessee-titans,1910850,2017
40180,540000,59546,LeShaun Sims,CB,injured_reserve,tennessee-titans,599546,2017
40181,363000,68721,Tajae Sharpe,WR,injured_reserve,tennessee-titans,431721,2017
40182,383824,22041,Aaron Wallace,OLB,injured_reserve,tennessee-titans,405865,2017
40183,363000,0,Victor Ochi,OLB,injured_reserve,tennessee-titans,363000,2017
40184,363000,0,Alex Tanney,QB,injured_reserve,tennessee-titans,363000,2017
40185,0,1500000,Al Woods,DT,dead_cap,tennessee-titans,1500000,2017
40186,0,1167672,Dorial Green-Beckham,WR,dead_cap,tennessee-titans,1167672,2017
40187,0,833334,Perrish Cox,CB,dead_cap,tennessee-titans,833334,2017
40188,470294,134429,Jalston Fowler,FB,dead_cap,tennessee-titans,604723,2017
40189,0,401130,Jeremiah Poutasi,RT,dead_cap,tennessee-titans,401130,2017
40190,0,368502,David Cobb,RB,dead_cap,tennessee-titans,368502,2017
40191,336282,0,Darius Jennings,WR,dead_cap,tennessee-titans,336282,2017
40192,0,278818,Bishop Sankey,RB,dead_cap,tennessee-titans,278818,2017
40193,0,275000,Eric Weems,WR,dead_cap,tennessee-titans,275000,2017
40194,174212,21771,Josh Carraway,OLB,dead_cap,tennessee-titans,195983,2017
40195,143290,0,Ryan DiSalvo,LS,dead_cap,tennessee-titans,143290,2017
40196,0,142904,Angelo Blackson,DE,dead_cap,tennessee-titans,142904,2017
40197,115200,17621,Khalfani Muhammad,RB,dead_cap,tennessee-titans,132821,2017
40198,122400,333,Denzel Johnson,S,dead_cap,tennessee-titans,122733,2017
40199,122400,0,Antwaun Woods,DT,dead_cap,tennessee-titans,122400,2017
40200,0,120000,Tim Lelito,G,dead_cap,tennessee-titans,120000,2017
40201,115200,1666,Tyler Ferguson,QB,dead_cap,tennessee-titans,116866,2017
40202,115200,0,Tim Semisch,TE,dead_cap,tennessee-titans,115200,2017
40203,115200,0,Cody Wichmann,G,dead_cap,tennessee-titans,115200,2017
40204,115200,0,Zach Pascal,WR,dead_cap,tennessee-titans,115200,2017
40205,0,106301,Marqueston Huff,FS,dead_cap,tennessee-titans,106301,2017
40206,102350,2333,Akeem Judd,RB,dead_cap,tennessee-titans,104683,2017
40207,0,74076,Deiontrez Mount,OLB,dead_cap,tennessee-titans,74076,2017
40208,72000,0,Julius Warmsley,DE,dead_cap,tennessee-titans,72000,2017
40209,72000,0,Tyler Marz,T,dead_cap,tennessee-titans,72000,2017
40210,43200,19887,Brad Seaton,T,dead_cap,tennessee-titans,63087,2017
40211,57600,0,C.J. Board,WR,dead_cap,tennessee-titans,57600,2017
40212,0,50736,Andy Gallik,C,dead_cap,tennessee-titans,50736,2017
40213,0,43905,Kalan Reed,CB,dead_cap,tennessee-titans,43905,2017
40214,40588,0,Demontre Hurst,CB,dead_cap,tennessee-titans,40588,2017
40215,0,33186,Sebastian Tretola,G,dead_cap,tennessee-titans,33186,2017
40216,28800,0,Kenneth Durden,S,dead_cap,tennessee-titans,28800,2017
40217,20471,0,Joe Bacci,FB,dead_cap,tennessee-titans,20471,2017
40218,20471,0,Jimmy Staten,DT,dead_cap,tennessee-titans,20471,2017
40219,14400,0,Johnny Maxey,DT,dead_cap,tennessee-titans,14400,2017
40220,14400,0,Tony Washington,OLB,dead_cap,tennessee-titans,14400,2017
40221,14400,0,Jerome Cunningham,TE,dead_cap,tennessee-titans,14400,2017
40222,7200,1666,Steven Moore,T,dead_cap,tennessee-titans,8866,2017
40223,0,4000,Curtis Riley,CB,dead_cap,tennessee-titans,4000,2017
40224,0,3334,Lamarcus Brutus,S,dead_cap,tennessee-titans,3334,2017
40225,0,3333,DeAngelo Brown,DT,dead_cap,tennessee-titans,3333,2017
40226,0,2667,Samuel Carlson,T,dead_cap,tennessee-titans,2667,2017
40227,0,2334,Cody Riggs,CB,dead_cap,tennessee-titans,2334,2017
40228,0,1666,Jonah Pirsig,T,dead_cap,tennessee-titans,1666,2017
40229,0,1166,Kevonn Mabon,WR,dead_cap,tennessee-titans,1166,2017
40230,0,1000,Jeremy Boykins,CB,dead_cap,tennessee-titans,1000,2017
40231,0,667,Aldrick Rosas,K,dead_cap,tennessee-titans,667,2017
40232,0,500,Giovanni Pascascio,WR,dead_cap,tennessee-titans,500,2017
40233,1000000,9700000,Taylor Lewan,LT,active,tennessee-titans,10700000,2018
40234,7250000,1750000,Brian Orakpo,OLB,active,tennessee-titans,9000000,2018
40235,6500000,1906250,Derrick Morgan,OLB,active,tennessee-titans,8406250,2018
40236,705000,6999446,Marcus Mariota,QB,active,tennessee-titans,7704446,2018
40237,3500000,2500000,Malcolm Butler,CB,active,tennessee-titans,6000000,2018
40238,555000,5216523,Corey Davis,WR,active,tennessee-titans,5771523,2018
40239,2500000,3250000,Josh Kline,G,active,tennessee-titans,5750000,2018
40240,4500000,875000,Ben Jones,C,active,tennessee-titans,5375000,2018
40241,4000000,1333333,DaQuan Jones,DE,active,tennessee-titans,5333333,2018
40242,2000000,2312500,Dion Lewis,RB,active,tennessee-titans,4312500,2018
40243,2700000,1550000,Wesley Woodyard,ILB,active,tennessee-titans,4250000,2018
40244,2000000,2000000,Bennie Logan,DT,active,tennessee-titans,4000000,2018
40245,3000000,500000,Brett Kern,P,active,tennessee-titans,3500000,2018
40246,2250000,700000,Ryan Succop,K,active,tennessee-titans,2950000,2018
40247,977854,1586415,Adoree' Jackson,CB,active,tennessee-titans,2564269,2018
40248,1800000,366666,Daren Bates,ILB,active,tennessee-titans,2166666,2018
40249,480000,1624944,Rashaan Evans,LB,active,tennessee-titans,2104944,2018
40250,1500000,500000,Blaine Gabbert,QB,active,tennessee-titans,2000000,2018
40251,1907000,0,Quinton Spain,G,active,tennessee-titans,1907000,2018
40252,1750000,0,Brynden Trawick,SS,active,tennessee-titans,1750000,2018
40253,964748,579496,Austin Johnson,DT,active,tennessee-titans,1544244,2018
40254,900000,581250,Kenny Vaccaro,SS,active,tennessee-titans,1481250,2018
40255,941630,533259,Derrick Henry,RB,active,tennessee-titans,1474889,2018
40256,1100000,208333,Dennis Kelly,RT,active,tennessee-titans,1308333,2018
40257,1100000,168000,Beau Brinkley,LS,active,tennessee-titans,1268000,2018
40258,1000000,250000,Will Compton,ILB,active,tennessee-titans,1250000,2018
40259,480000,744307,Harold Landry,LB,active,tennessee-titans,1224307,2018
40260,1000000,137500,Luke Stocker,TE,active,tennessee-titans,1137500,2018
40261,784566,224265,Kevin Byard,FS,active,tennessee-titans,1008831,2018
40262,972694,0,Kamalei Correa,ILB,active,tennessee-titans,972694,2018
40263,630000,229003,Taywan Taylor,WR,active,tennessee-titans,859003,2018
40264,630000,68721,Tajae Sharpe,WR,active,tennessee-titans,698721,2018
40265,630000,59546,LeShaun Sims,CB,active,tennessee-titans,689546,2018
40266,915000,0,Kendrick Lewis,SS,active,tennessee-titans,915000,2018
40267,630000,0,Darius Jennings,WR,active,tennessee-titans,630000,2018
40268,555000,67888,Jayon Brown,ILB,active,tennessee-titans,622888,2018
40269,592941,0,MyCole Pruitt,TE,active,tennessee-titans,592941,2018
40270,555000,27503,Corey Levin,G,active,tennessee-titans,582503,2018
40271,480000,71973,Dane Cruikshank,S,active,tennessee-titans,551973,2018
40272,522353,0,Tyler Marz,T,active,tennessee-titans,522353,2018
40273,518826,0,Darius Kilgo,DT,active,tennessee-titans,518826,2018
40274,480000,5333,Sharif Finch,LB,active,tennessee-titans,485333,2018
40275,480000,3000,Matt Dickerson,DE,active,tennessee-titans,483000,2018
40276,480000,1666,Aaron Stinnie,G,active,tennessee-titans,481666,2018
40277,338820,0,Cameron Batson,WR,active,tennessee-titans,338820,2018
40278,338820,0,Anthony Firkser,TE,active,tennessee-titans,338820,2018
40279,141175,0,Joshua Kalu,S,active,tennessee-titans,141175,2018
40280,139412,0,Austin Pasztor,T,active,tennessee-titans,139412,2018
40281,130588,0,Jeremy McNichols,RB,active,tennessee-titans,130588,2018
40282,65294,0,Nigel Harris,OLB,active,tennessee-titans,65294,2018
40283,56470,0,Kenneth Durden,S,active,tennessee-titans,56470,2018
40284,46471,0,Austin Davis,QB,active,tennessee-titans,46471,2018
40285,32647,0,LaTroy Lewis,ILB,active,tennessee-titans,32647,2018
40286,10600000,4288750,Jurrell Casey,DT,injured_reserve,tennessee-titans,14888750,2018
40287,10000000,1166666,Logan Ryan,CB,injured_reserve,tennessee-titans,11166666,2018
40288,2570000,6065625,Delanie Walker,TE,injured_reserve,tennessee-titans,8635625,2018
40289,4500000,2062500,John Cyprien,SS,injured_reserve,tennessee-titans,6562500,2018
40290,1895242,2440483,Jack Conklin,RT,injured_reserve,tennessee-titans,4335725,2018
40291,1000000,1250000,Kevin Pamphile,RT,injured_reserve,tennessee-titans,2250000,2018
40292,1100000,175000,Nate Palmer,ILB,injured_reserve,tennessee-titans,1275000,2018
40293,579000,176572,Jonnu Smith,TE,injured_reserve,tennessee-titans,755572,2018
40294,630000,0,David Fluellen,RB,injured_reserve,tennessee-titans,630000,2018
40295,393000,0,Tye Smith,CB,injured_reserve,tennessee-titans,393000,2018
40296,363000,666,Austin Barnard,P,injured_reserve,tennessee-titans,363666,2018
40297,87529,0,Cole Wick,TE,injured_reserve,tennessee-titans,87529,2018
40298,882353,4247397,Rishard Matthews,WR,dead_cap,tennessee-titans,5129750,2018
40299,1250000,1333334,Sylvester Williams,DT,dead_cap,tennessee-titans,2583334,2018
40300,0,1125000,Da'Norris Searcy,SS,dead_cap,tennessee-titans,1125000,2018
40301,450000,650000,Phillip Supernaw,TE,dead_cap,tennessee-titans,1100000,2018
40302,0,741328,Kevin Dodd,OLB,dead_cap,tennessee-titans,741328,2018
40303,0,480667,Denzel Johnson,S,dead_cap,tennessee-titans,480667,2018
40304,354020,0,Kenneth Durden,S,dead_cap,tennessee-titans,354020,2018
40305,214412,90000,Michael Campanaro,WR,dead_cap,tennessee-titans,304412,2018
40306,271010,600,Dalyn Dawkins,RB,dead_cap,tennessee-titans,271610,2018
40307,82941,134429,Jalston Fowler,FB,dead_cap,tennessee-titans,217370,2018
40308,185295,0,Nick Williams,WR,dead_cap,tennessee-titans,185295,2018
40309,149464,0,Johnny Maxey,DT,dead_cap,tennessee-titans,149464,2018
40310,0,142904,Angelo Blackson,DE,dead_cap,tennessee-titans,142904,2018
40311,134200,1666,Damon Webb,S,dead_cap,tennessee-titans,135866,2018
40312,122705,0,Robert Spillane,LB,dead_cap,tennessee-titans,122705,2018
40313,121600,0,David Quessenberry,LT,dead_cap,tennessee-titans,121600,2018
40314,98800,0,Jamil Douglas,C,dead_cap,tennessee-titans,98800,2018
40315,96200,1666,Joshua Kalu,S,dead_cap,tennessee-titans,97866,2018
40316,74118,22041,Aaron Wallace,OLB,dead_cap,tennessee-titans,96159,2018
40317,92941,0,Austin Davis,QB,dead_cap,tennessee-titans,92941,2018
40318,91200,0,LaTroy Lewis,ILB,dead_cap,tennessee-titans,91200,2018
40319,91200,0,Roger Lewis,WR,dead_cap,tennessee-titans,91200,2018
40320,83600,1000,Devin Ross,WR,dead_cap,tennessee-titans,84600,2018
40321,79271,2666,Cameron Batson,WR,dead_cap,tennessee-titans,81937,2018
40322,79270,0,Anthony Firkser,FB,dead_cap,tennessee-titans,79270,2018
40323,76000,0,Nigel Harris,OLB,dead_cap,tennessee-titans,76000,2018
40324,0,66372,Sebastian Tretola,G,dead_cap,tennessee-titans,66372,2018
40325,0,65313,Josh Carraway,OLB,dead_cap,tennessee-titans,65313,2018
40326,0,59664,Brad Seaton,T,dead_cap,tennessee-titans,59664,2018
40327,53200,0,Mike Jordan,CB,dead_cap,tennessee-titans,53200,2018
40328,0,52868,Khalfani Muhammad,RB,dead_cap,tennessee-titans,52868,2018
40329,36000,4666,Mike Ramsay,DT,dead_cap,tennessee-titans,40666,2018
40330,38000,0,Tim Semisch,TE,dead_cap,tennessee-titans,38000,2018
40331,38000,0,Coleman Shelton,T,dead_cap,tennessee-titans,38000,2018
40332,0,37500,Eric Weems,WR,dead_cap,tennessee-titans,37500,2018
40333,0,37208,Luke Falk,QB,dead_cap,tennessee-titans,37208,2018
40334,0,30000,Xavier Su'a-Filo,G,dead_cap,tennessee-titans,30000,2018
40335,30000,0,Jordan Morgan,G,dead_cap,tennessee-titans,30000,2018
40336,22800,0,Deon Simon,DT,dead_cap,tennessee-titans,22800,2018
40337,22800,0,Logan Woodside,QB,dead_cap,tennessee-titans,22800,2018
40338,15000,1666,Deontay Burnett,WR,dead_cap,tennessee-titans,16666,2018
40339,15200,0,Jerome Cunningham,TE,dead_cap,tennessee-titans,15200,2018
40340,15200,0,Chad Hansen,WR,dead_cap,tennessee-titans,15200,2018
40341,15200,0,Darius Kilgo,DT,dead_cap,tennessee-titans,15200,2018
40342,15200,0,Gimel President,OLB,dead_cap,tennessee-titans,15200,2018
40343,15200,0,Kalif Raymond,WR,dead_cap,tennessee-titans,15200,2018
40344,12000,1000,Akrum Wadley,RB,dead_cap,tennessee-titans,13000,2018
40345,7600,0,Tyler Marz,T,dead_cap,tennessee-titans,7600,2018
40346,7600,0,Ian Silberman,G,dead_cap,tennessee-titans,7600,2018
40347,7600,0,Damore'ea Stringfellow,WR,dead_cap,tennessee-titans,7600,2018
40348,7600,0,Kendal Vickers,DE,dead_cap,tennessee-titans,7600,2018
40349,0,6667,DeAngelo Brown,DT,dead_cap,tennessee-titans,6667,2018
40350,5000,1666,NIco Falah,C,dead_cap,tennessee-titans,6666,2018
40351,0,4667,Akeem Judd,RB,dead_cap,tennessee-titans,4667,2018
40352,0,3334,Tyler Ferguson,QB,dead_cap,tennessee-titans,3334,2018
40353,0,3334,Steven Moore,T,dead_cap,tennessee-titans,3334,2018
40354,0,3334,Jonah Pirsig,T,dead_cap,tennessee-titans,3334,2018
40355,2500,833,Jordan Veasy,WR,dead_cap,tennessee-titans,3333,2018
40356,0,2334,Kevonn Mabon,WR,dead_cap,tennessee-titans,2334,2018
40357,0,2000,Jeremy Boykins,CB,dead_cap,tennessee-titans,2000,2018
40358,0,1666,Elijah Nkansah,T,dead_cap,tennessee-titans,1666,2018
40359,0,1166,Rico Gafford,CB,dead_cap,tennessee-titans,1166,2018
40360,0,1000,Giovanni Pascascio,WR,dead_cap,tennessee-titans,1000,2018
40361,20922000,0,Marcus Mariota,QB,active,tennessee-titans,20922000,2019
40362,11088235,2200000,Taylor Lewan,LT,active,tennessee-titans,13288235,2019
40363,10550000,2137500,Jurrell Casey,DT,active,tennessee-titans,12687500,2019
40364,9500000,1166668,Logan Ryan,CB,active,tennessee-titans,10666668,2019
40365,6000000,1333333,DaQuan Jones,DE,active,tennessee-titans,7333333,2019
40366,645000,6280830,Corey Davis,WR,active,tennessee-titans,6925830,2019
40367,3500000,2875000,Rodger Saffold,G,active,tennessee-titans,6375000,2019
40368,1750000,3675000,Ryan Tannehill,QB,active,tennessee-titans,5425000,2019
40369,3500000,1875000,Ben Jones,C,active,tennessee-titans,5375000,2019
40370,2617862,2440484,Jack Conklin,RT,active,tennessee-titans,5058346,2019
40371,2000000,2875000,Adam Humphries,WR,active,tennessee-titans,4875000,2019
40372,4000000,862500,Dion Lewis,RB,active,tennessee-titans,4862500,2019
40373,2950000,1181250,Wesley Woodyard,ILB,active,tennessee-titans,4131250,2019
40374,2025000,2024265,Kevin Byard,FS,active,tennessee-titans,4049265,2019
40375,1250000,2000000,Kenny Vaccaro,SS,active,tennessee-titans,3250000,2019
40376,1490708,1586415,Adoree' Jackson,CB,active,tennessee-titans,3077123,2019
40377,1800000,1150000,Brett Kern,P,active,tennessee-titans,2950000,2019
40378,1006236,1624944,Rashaan Evans,LB,active,tennessee-titans,2631180,2019
40379,2050000,366668,Daren Bates,ILB,active,tennessee-titans,2416668,2019
40380,495000,1807501,Jeffery Simmons,DT,active,tennessee-titans,2302501,2019
40381,2025000,68721,Tajae Sharpe,WR,active,tennessee-titans,2093721,2019
40382,1222122,579497,Austin Johnson,DT,active,tennessee-titans,1801619,2019
40383,1187445,533261,Derrick Henry,RB,active,tennessee-titans,1720706,2019
40384,1350000,258334,Dennis Kelly,RT,active,tennessee-titans,1608334,2019
40385,786077,744307,Harold Landry,LB,active,tennessee-titans,1530384,2019
40386,1000000,365625,Kevin Pamphile,G,active,tennessee-titans,1365625,2019
40387,950000,318000,Beau Brinkley,LS,active,tennessee-titans,1268000,2019
40388,1234043,0,Kamalei Correa,OLB,active,tennessee-titans,1234043,2019
40389,495000,532703,A.J. Brown,WR,active,tennessee-titans,1027703,2019
40390,669000,176572,Jonnu Smith,TE,active,tennessee-titans,845572,2019
40391,720000,59548,LeShaun Sims,CB,active,tennessee-titans,779548,2019
40392,495000,233670,Nate Davis,G,active,tennessee-titans,728670,2019
40393,720000,0,MyCole Pruitt,TE,active,tennessee-titans,720000,2019
40394,645000,67888,Jayon Brown,ILB,active,tennessee-titans,712888,2019
40395,495000,183370,Amani Hooker,S,active,tennessee-titans,678370,2019
40396,570000,71973,Dane Cruikshank,S,active,tennessee-titans,641973,2019
40397,607059,0,Tye Smith,CB,active,tennessee-titans,607059,2019
40398,570000,0,Jamil Douglas,G,active,tennessee-titans,570000,2019
40399,570000,0,Anthony Firkser,FB,active,tennessee-titans,570000,2019
40400,570000,0,Reggie Gilbert,DT,active,tennessee-titans,570000,2019
40401,495000,42429,David Long,LB,active,tennessee-titans,537429,2019
40402,495000,4166,Isaiah Mack,DT,active,tennessee-titans,499166,2019
40403,486706,0,Joshua Kalu,S,active,tennessee-titans,486706,2019
40404,341469,0,Kalif Raymond,WR,active,tennessee-titans,341469,2019
40405,335294,0,Matt Dickerson,DE,active,tennessee-titans,335294,2019
40406,235296,87500,Tramaine Brock,CB,active,tennessee-titans,322796,2019
40407,232944,0,Cody Hollister,WR,active,tennessee-titans,232944,2019
40408,203824,0,Khari Blasingame,FB,active,tennessee-titans,203824,2019
40409,145588,0,Derick Roberson,OLB,active,tennessee-titans,145588,2019
40410,87353,0,Joey Ivie,DT,active,tennessee-titans,87353,2019
40411,67059,0,Greg Joseph,K,active,tennessee-titans,67059,2019
40412,42353,0,Darius Jennings,WR,active,tennessee-titans,42353,2019
40413,29118,0,Rashard Davis,WR,active,tennessee-titans,29118,2019
40414,10500000,2381250,Malcolm Butler,CB,injured_reserve,tennessee-titans,12881250,2019
40415,4080000,2435416,Delanie Walker,TE,injured_reserve,tennessee-titans,6515416,2019
40416,3250000,1755208,Cameron Wake,OLB,injured_reserve,tennessee-titans,5005208,2019
40417,2500000,700000,Ryan Succop,K,injured_reserve,tennessee-titans,3200000,2019
40418,900000,0,Chris Milton,CB,injured_reserve,tennessee-titans,900000,2019
40419,720000,0,David Fluellen,RB,injured_reserve,tennessee-titans,720000,2019
40420,378000,66687,D'Andre Walker,OLB,injured_reserve,tennessee-titans,444687,2019
40421,393000,0,Cameron Batson,WR,injured_reserve,tennessee-titans,393000,2019
40422,393000,0,Jordan Williams,DT,injured_reserve,tennessee-titans,393000,2019
40423,136000,0,Logan Woodside,QB,injured_reserve,tennessee-titans,136000,2019
40424,40000,0,Kenneth Durden,S,practice_squad,tennessee-titans,40000,2019
40425,2000000,1500000,Josh Kline,G,dead_cap,tennessee-titans,3500000,2019
40426,0,1500000,John Cyprien,SS,dead_cap,tennessee-titans,1500000,2019
40427,850000,306250,Brent Urban,DE,dead_cap,tennessee-titans,1156250,2019
40428,805000,0,Cairo Santos,K,dead_cap,tennessee-titans,805000,2019
40429,0,741328,Kevin Dodd,OLB,dead_cap,tennessee-titans,741328,2019
40430,720000,0,Darius Jennings,WR,dead_cap,tennessee-titans,720000,2019
40431,502935,5333,Sharif Finch,LB,dead_cap,tennessee-titans,508268,2019
40432,0,500000,Blaine Gabbert,QB,dead_cap,tennessee-titans,500000,2019
40433,381177,0,Hroniss Grasu,C,dead_cap,tennessee-titans,381177,2019
40434,301761,1666,Aaron Stinnie,G,dead_cap,tennessee-titans,303427,2019
40435,263646,1200,Dalyn Dawkins,RB,dead_cap,tennessee-titans,264846,2019
40436,249588,0,Kareem Orr,CB,dead_cap,tennessee-titans,249588,2019
40437,241590,0,David Quessenberry,G,dead_cap,tennessee-titans,241590,2019
40438,234706,3000,Matt Dickerson,DE,dead_cap,tennessee-titans,237706,2019
40439,0,229003,Taywan Taylor,WR,dead_cap,tennessee-titans,229003,2019
40440,216118,0,Josh Smith,LB,dead_cap,tennessee-titans,216118,2019
40441,216000,0,Riley Bullough,ILB,dead_cap,tennessee-titans,216000,2019
40442,236765,0,Rod Smith,RB,dead_cap,tennessee-titans,236765,2019
40443,153000,2666,Amani Bledsoe,DE,dead_cap,tennessee-titans,155666,2019
40444,136000,0,Parker Hesse,TE,dead_cap,tennessee-titans,136000,2019
40445,136000,0,Logan Woodside,QB,dead_cap,tennessee-titans,136000,2019
40446,132118,3333,Derick Roberson,OLB,dead_cap,tennessee-titans,135451,2019
40447,142059,0,Cody Parkey,K,dead_cap,tennessee-titans,142059,2019
40448,113529,0,Nigel Harris,OLB,dead_cap,tennessee-titans,113529,2019
40449,0,111624,Luke Falk,QB,dead_cap,tennessee-titans,111624,2019
40450,88000,0,Daniel Munyer,C,dead_cap,tennessee-titans,88000,2019
40451,87353,0,Ryan Santoso,K,dead_cap,tennessee-titans,87353,2019
40452,72000,0,Jamal Davis,OLB,dead_cap,tennessee-titans,72000,2019
40453,72000,0,Cody Hollister,WR,dead_cap,tennessee-titans,72000,2019
40454,56000,0,Rashard Davis,WR,dead_cap,tennessee-titans,56000,2019
40455,56000,0,Kalif Raymond,WR,dead_cap,tennessee-titans,56000,2019
40456,48000,0,Ukeme Eligwe,ILB,dead_cap,tennessee-titans,48000,2019
40457,40000,0,Papi White,WR,dead_cap,tennessee-titans,40000,2019
40458,36000,0,Adam Pankey,T,dead_cap,tennessee-titans,36000,2019
40459,0,27504,Corey Levin,G,dead_cap,tennessee-titans,27504,2019
40460,0,22044,Aaron Wallace,OLB,dead_cap,tennessee-titans,22044,2019
40461,15000,3333,Cody Conway,T,dead_cap,tennessee-titans,18333,2019
40462,16000,0,Joey Ivie,DT,dead_cap,tennessee-titans,16000,2019
40463,16000,0,Trevion Thompson,WR,dead_cap,tennessee-titans,16000,2019
40464,10000,5000,Braxton Hoyett,DT,dead_cap,tennessee-titans,15000,2019
40465,0,9334,Mike Ramsay,DT,dead_cap,tennessee-titans,9334,2019
40466,8000,0,Lyndon Johnson,DE,dead_cap,tennessee-titans,8000,2019
40467,0,5334,Cameron Batson,WR,dead_cap,tennessee-titans,5334,2019
40468,0,3334,Deontay Burnett,WR,dead_cap,tennessee-titans,3334,2019
40469,0,3334,NIco Falah,C,dead_cap,tennessee-titans,3334,2019
40470,0,3334,Joshua Kalu,S,dead_cap,tennessee-titans,3334,2019
40471,0,3334,Elijah Nkansah,T,dead_cap,tennessee-titans,3334,2019
40472,0,3334,Damon Webb,S,dead_cap,tennessee-titans,3334,2019
40473,0,2334,Rico Gafford,CB,dead_cap,tennessee-titans,2334,2019
40474,0,2000,Devin Ross,WR,dead_cap,tennessee-titans,2000,2019
40475,0,2000,Akrum Wadley,RB,dead_cap,tennessee-titans,2000,2019
40476,0,1750,Alex Barnes,RB,dead_cap,tennessee-titans,1750,2019
40477,0,1667,Jordan Veasy,WR,dead_cap,tennessee-titans,1667,2019
40478,0,1666,A.T. Hall,T,dead_cap,tennessee-titans,1666,2019
40479,0,1333,JoJo Tillery,S,dead_cap,tennessee-titans,1333,2019
40480,0,833,Anthony Ratliff-Williams,WR,dead_cap,tennessee-titans,833,2019
40481,0,666,Austin Barnard,P,dead_cap,tennessee-titans,666,2019
40482,16000000,2200000,Taylor Lewan,LT,active,tennessee-titans,18200000,2020
40483,11250000,2137500,Jurrell Casey,DT,active,tennessee-titans,13387500,2020
40484,11000000,2381250,Malcolm Butler,CB,active,tennessee-titans,13381250,2020
40485,9500000,2875000,Rodger Saffold,G,active,tennessee-titans,12375000,2020
40486,8600000,2300000,Kevin Byard,FS,active,tennessee-titans,10900000,2020
40487,7000000,2875000,Adam Humphries,WR,active,tennessee-titans,9875000,2020
40488,7000000,1333334,DaQuan Jones,DE,active,tennessee-titans,8333334,2020
40489,5500000,2755208,Cameron Wake,OLB,active,tennessee-titans,8255208,2020
40490,5400000,2685418,Delanie Walker,TE,active,tennessee-titans,8085418,2020
40491,735000,7345137,Corey Davis,WR,active,tennessee-titans,8080137,2020
40492,5250000,1000000,Ben Jones,C,active,tennessee-titans,6250000,2020
40493,4250000,2000000,Kenny Vaccaro,SS,active,tennessee-titans,6250000,2020
40494,4300000,862500,Dion Lewis,RB,active,tennessee-titans,5162500,2020
40495,3400000,700000,Ryan Succop,K,active,tennessee-titans,4100000,2020
40496,2003561,1586416,Adoree' Jackson,CB,active,tennessee-titans,3589977,2020
40497,1900000,1300000,Brett Kern,P,active,tennessee-titans,3200000,2020
40498,1532472,1624944,Rashaan Evans,LB,active,tennessee-titans,3157416,2020
40499,1070625,1807501,Jeffery Simmons,DT,active,tennessee-titans,2878126,2020
40500,1092153,744307,Harold Landry,LB,active,tennessee-titans,1836460,2020
40501,751926,532703,A.J. Brown,WR,active,tennessee-titans,1284629,2020
40502,1000000,150000,Beau Brinkley,LS,active,tennessee-titans,1150000,2020
40503,756625,176572,Jonnu Smith,TE,active,tennessee-titans,933197,2020
40504,661500,233670,Nate Davis,G,active,tennessee-titans,895170,2020
40505,735000,67889,Jayon Brown,ILB,active,tennessee-titans,802889,2020
40506,585000,183370,Amani Hooker,S,active,tennessee-titans,768370,2020
40507,735000,0,Kalif Raymond,WR,active,tennessee-titans,735000,2020
40508,660000,71973,Dane Cruikshank,S,active,tennessee-titans,731973,2020
40509,660000,0,Matt Dickerson,DE,active,tennessee-titans,660000,2020
40510,660000,0,Jamil Douglas,G,active,tennessee-titans,660000,2020
40511,660000,0,Joshua Kalu,S,active,tennessee-titans,660000,2020
40512,660000,0,Daniel Munyer,C,active,tennessee-titans,660000,2020
40513,660000,0,Jordan Williams,DT,active,tennessee-titans,660000,2020
40514,585000,42429,David Long,LB,active,tennessee-titans,627429,2020
40515,585000,4166,Isaiah Mack,DT,active,tennessee-titans,589166,2020
40516,585000,0,Khari Blasingame,FB,active,tennessee-titans,585000,2020
40517,585000,0,Dalyn Dawkins,RB,active,tennessee-titans,585000,2020
40518,585000,0,Nigel Harris,OLB,active,tennessee-titans,585000,2020
40519,585000,0,Cody Hollister,WR,active,tennessee-titans,585000,2020
40520,585000,0,Joey Ivie,DT,active,tennessee-titans,585000,2020
40521,585000,0,Greg Joseph,K,active,tennessee-titans,585000,2020
40522,585000,0,David Quessenberry,G,active,tennessee-titans,585000,2020
40523,585000,0,Derick Roberson,OLB,active,tennessee-titans,585000,2020
40524,510000,66687,D'Andre Walker,OLB,active,tennessee-titans,576687,2020
40525,510000,0,Amani Bledsoe,DE,active,tennessee-titans,510000,2020
40526,510000,0,Rashard Davis,WR,active,tennessee-titans,510000,2020
40527,510000,0,Parker Hesse,TE,active,tennessee-titans,510000,2020
40528,510000,0,Kareem Orr,CB,active,tennessee-titans,510000,2020
40529,510000,0,Trevion Thompson,WR,active,tennessee-titans,510000,2020
40530,510000,0,Shaun Wilson,RB,active,tennessee-titans,510000,2020
40531,510000,0,Logan Woodside,QB,active,tennessee-titans,510000,2020
40532,0,229003,Taywan Taylor,WR,dead_cap,tennessee-titans,229003,2020
40533,0,27504,Corey Levin,G,dead_cap,tennessee-titans,27504,2020
40534,0,10000,Braxton Hoyett,DT,dead_cap,tennessee-titans,10000,2020
40535,0,6667,Cody Conway,T,dead_cap,tennessee-titans,6667,2020
40536,0,6667,Derick Roberson,OLB,dead_cap,tennessee-titans,6667,2020
40537,0,5334,Amani Bledsoe,DE,dead_cap,tennessee-titans,5334,2020
40538,0,5334,Sharif Finch,LB,dead_cap,tennessee-titans,5334,2020
40539,0,3500,Alex Barnes,RB,dead_cap,tennessee-titans,3500,2020
40540,0,3334,A.T. Hall,T,dead_cap,tennessee-titans,3334,2020
40541,0,3000,Matt Dickerson,DE,dead_cap,tennessee-titans,3000,2020
40542,0,2667,JoJo Tillery,S,dead_cap,tennessee-titans,2667,2020
40543,0,1667,Anthony Ratliff-Williams,WR,dead_cap,tennessee-titans,1667,2020
40544,0,1667,Aaron Stinnie,G,dead_cap,tennessee-titans,1667,2020
40545,0,667,Austin Barnard,P,dead_cap,tennessee-titans,667,2020
40546,2450000,5150000,Chris Samuels,T,active,washington-redskins,7600000,2007
40547,595000,4092833,Clinton Portis,RB,active,washington-redskins,4687833,2007
40548,995000,600000,Santana Moss,WR,active,washington-redskins,1595000,2007
40549,1125000,3396000,Sean Taylor,S,active,washington-redskins,4521000,2007
40550,810000,2200000,London Fletcher,ILB,active,washington-redskins,3010000,2007
40551,595000,2666666,Antwaan Randle El,WR,active,washington-redskins,3261666,2007
40552,595000,2333332,Andre Carter,DE,active,washington-redskins,2928332,2007
40553,285000,1878333,LaRon Landry,S,active,washington-redskins,2163333,2007
40554,600000,1400000,Fred Smoot,CB,active,washington-redskins,2000000,2007
40555,572500,2033000,Jason Campbell,QB,active,washington-redskins,2605500,2007
40556,1250000,225000,Todd Collins,QB,active,washington-redskins,1475000,2007
40557,510000,663750,Chris Cooley,TE,active,washington-redskins,1173750,2007
40558,720000,225000,Mike Sellers,FB,active,washington-redskins,945000,2007
40559,360000,455000,Rocky McIntosh,OLB,active,washington-redskins,815000,2007
40560,600000,75000,Rock Cartwright,RB,active,washington-redskins,675000,2007
40561,435000,0,Nehemiah Broughton,RB,active,washington-redskins,435000,2007
40562,435000,0,Shaun Suisham,K,active,washington-redskins,435000,2007
40563,360000,41158,Anthony Montgomery,DT,active,washington-redskins,401158,2007
40564,360000,28306,Reed Doughty,S,active,washington-redskins,388306,2007
40565,360000,21858,Kedric Golston,DT,active,washington-redskins,381858,2007
40566,285000,26625,H.B. Blades,LB,active,washington-redskins,311625,2007
40567,285000,14500,Tyler Ecker,TE,active,washington-redskins,299500,2007
40568,285000,3333,Stephon Heyer,T,active,washington-redskins,288333,2007
40569,285000,0,Lorenzo Alexander,OLB,active,washington-redskins,285000,2007
40570,285000,0,Chris Wilson,LB,active,washington-redskins,285000,2007
40571,720000,2000000,Randy Thomas,G,injured_reserve,washington-redskins,2720000,2007
40572,435000,3929900,Carlos Rogers,CB,injured_reserve,washington-redskins,4364900,2007
40573,595000,2666666,Brandon Lloyd,WR,injured_reserve,washington-redskins,3261666,2007
40574,0,6748000,Sean Taylor,S,dead_cap,washington-redskins,6748000,2007
40575,212500,0,Manuel White,RB,dead_cap,washington-redskins,212500,2007
40576,45875,0,Dallas Sartz,LB,dead_cap,washington-redskins,45875,2007
40577,25941,0,Kili Lefotu,G,dead_cap,washington-redskins,25941,2007
40578,20750,0,Jordan Palmer,QB,dead_cap,washington-redskins,20750,2007
40579,19875,0,Kevin Simon,LB,dead_cap,washington-redskins,19875,2007
40580,14083,0,Nehemiah Broughton,RB,dead_cap,washington-redskins,14083,2007
40581,605000,4295933,Clinton Portis,RB,active,washington-redskins,4900933,2008
40582,1180000,600000,Santana Moss,WR,active,washington-redskins,1780000,2008
40583,730000,2000000,Randy Thomas,G,active,washington-redskins,2730000,2008
40584,1240000,2200000,London Fletcher,ILB,active,washington-redskins,3440000,2008
40585,605000,3559641,Antwaan Randle El,WR,active,washington-redskins,4164641,2008
40586,605000,500000,Chris Cooley,TE,active,washington-redskins,1105000,2008
40587,730000,2764998,Andre Carter,DE,active,washington-redskins,3494998,2008
40588,602500,3103333,LaRon Landry,S,active,washington-redskins,3705833,2008
40589,950000,1400000,Fred Smoot,CB,active,washington-redskins,2350000,2008
40590,522500,3641400,Carlos Rogers,CB,active,washington-redskins,4163900,2008
40591,1235000,2033000,Jason Campbell,QB,active,washington-redskins,3268000,2008
40592,445000,1075000,Rocky McIntosh,OLB,active,washington-redskins,1520000,2008
40593,900000,600000,Todd Collins,QB,active,washington-redskins,1500000,2008
40594,730000,175000,Mike Sellers,FB,active,washington-redskins,905000,2008
40595,295000,393500,Devin Thomas,WR,active,washington-redskins,688500,2008
40596,605000,175000,Rock Cartwright,RB,active,washington-redskins,780000,2008
40597,295000,345500,Fred Davis,TE,active,washington-redskins,640500,2008
40598,608125,0,Erasmus James,DE,active,washington-redskins,608125,2008
40599,520000,0,Alfred Fincher,LB,active,washington-redskins,520000,2008
40600,520000,0,Shaun Suisham,K,active,washington-redskins,520000,2008
40601,445000,41158,Anthony Montgomery,DT,active,washington-redskins,486158,2008
40602,445000,28306,Reed Doughty,S,active,washington-redskins,473306,2008
40603,445000,21858,Kedric Golston,DT,active,washington-redskins,466858,2008
40604,295000,152843,Chad Rinehart,G,active,washington-redskins,447843,2008
40605,730000,0,Shaun Alexander,RB,active,washington-redskins,730000,2008
40606,445000,0,Ryan Plackemeier,P,active,washington-redskins,445000,2008
40607,370000,26625,H.B. Blades,LB,active,washington-redskins,396625,2008
40608,370000,3333,Stephon Heyer,T,active,washington-redskins,373333,2008
40609,370000,0,Lorenzo Alexander,OLB,active,washington-redskins,370000,2008
40610,295000,29112,Durant Brooks,P,active,washington-redskins,324112,2008
40611,295000,24675,Kareem Moore,S,active,washington-redskins,319675,2008
40612,295000,24200,Colt Brennan,QB,active,washington-redskins,319200,2008
40613,295000,10347,Rob Jackson,OLB,active,washington-redskins,305347,2008
40614,295000,9129,Chris Horton,S,active,washington-redskins,304129,2008
40615,78529,0,D'Anthony Batiste,G,active,washington-redskins,78529,2008
40616,370000,0,Chris Wilson,LB,active,washington-redskins,370000,2008
40617,730000,5778333,Chris Samuels,T,injured_reserve,washington-redskins,6508333,2008
40618,88400,0,Nehemiah Broughton,RB,practice_squad,washington-redskins,88400,2008
40619,88400,0,Andrew Crummey,G,practice_squad,washington-redskins,88400,2008
40620,137625,0,Dallas Sartz,LB,dead_cap,washington-redskins,137625,2008
40621,62250,0,Jordan Palmer,QB,dead_cap,washington-redskins,62250,2008
40622,14500,0,Tyler Ecker,TE,dead_cap,washington-redskins,14500,2008
40623,935000,5919333,LaRon Landry,S,active,washington-redskins,6854333,2009
40624,5000000,300000,DeAngelo Hall,CB,active,washington-redskins,5300000,2009
40625,745000,600000,Santana Moss,WR,active,washington-redskins,1345000,2009
40626,3600000,1000000,Albert Haynesworth,DT,active,washington-redskins,4600000,2009
40627,2150000,2200000,London Fletcher,ILB,active,washington-redskins,4350000,2009
40628,1500000,3364998,Andre Carter,DE,active,washington-redskins,4864998,2009
40629,1500000,3559641,Antwaan Randle El,WR,active,washington-redskins,5059641,2009
40630,2857000,2033000,Jason Campbell,QB,active,washington-redskins,4890000,2009
40631,1420500,3641400,Carlos Rogers,CB,active,washington-redskins,5061900,2009
40632,3200000,0,Derrick Dockery,G,active,washington-redskins,3200000,2009
40633,620000,500000,Chris Cooley,TE,active,washington-redskins,1120000,2009
40634,745000,1400000,Fred Smoot,CB,active,washington-redskins,2145000,2009
40635,950000,758333,Todd Collins,QB,active,washington-redskins,1708333,2009
40636,888000,700000,Brian Orakpo,OLB,active,washington-redskins,1588000,2009
40637,1045000,500000,Kedric Golston,DT,active,washington-redskins,1545000,2009
40638,385000,775500,Fred Davis,TE,active,washington-redskins,1160500,2009
40639,745000,175000,Rock Cartwright,RB,active,washington-redskins,920000,2009
40640,746470,350000,Mike Sellers,FB,active,washington-redskins,1096470,2009
40641,535000,555000,Rocky McIntosh,OLB,active,washington-redskins,1090000,2009
40642,1010000,0,Anthony Montgomery,DT,active,washington-redskins,1010000,2009
40643,385000,393500,Devin Thomas,WR,active,washington-redskins,778500,2009
40644,385000,152843,Chad Rinehart,G,active,washington-redskins,537843,2009
40645,535000,0,Reed Doughty,S,active,washington-redskins,535000,2009
40646,535000,0,Will Montgomery,C,active,washington-redskins,535000,2009
40647,310000,195625,Kevin Barnes,CB,active,washington-redskins,505625,2009
40648,460000,26625,H.B. Blades,LB,active,washington-redskins,486625,2009
40649,310000,159559,Jeremy Jarmon,DT,active,washington-redskins,469559,2009
40650,460000,3333,Stephon Heyer,T,active,washington-redskins,463333,2009
40651,745000,0,Levi Jones,T,active,washington-redskins,745000,2009
40652,620000,0,Mike Williams,T,active,washington-redskins,620000,2009
40653,460000,0,Lorenzo Alexander,OLB,active,washington-redskins,460000,2009
40654,440588,0,D'Anthony Batiste,G,active,washington-redskins,440588,2009
40655,385000,24675,Kareem Moore,S,active,washington-redskins,409675,2009
40656,385000,24200,Colt Brennan,QB,active,washington-redskins,409200,2009
40657,385000,9129,Chris Horton,S,active,washington-redskins,394129,2009
40658,385000,0,Rob Jackson,OLB,active,washington-redskins,385000,2009
40659,310000,25631,Robert Henson,LB,active,washington-redskins,335631,2009
40660,310000,10862,Marko Mitchell,WR,active,washington-redskins,320862,2009
40661,310000,0,Paul Fanaika,G,active,washington-redskins,310000,2009
40662,310000,0,Graham Gano,K,active,washington-redskins,310000,2009
40663,310000,0,Edwin Williams,C,active,washington-redskins,310000,2009
40664,310000,0,Eddie Williams,FB,active,washington-redskins,310000,2009
40665,310000,0,Anthony Alridge,RB,active,washington-redskins,310000,2009
40666,109411,0,Richard Bartel,QB,active,washington-redskins,109411,2009
40667,460000,0,Chris Wilson,LB,active,washington-redskins,460000,2009
40668,2000000,6378333,Chris Samuels,T,injured_reserve,washington-redskins,8378333,2009
40669,745000,4295933,Clinton Portis,RB,injured_reserve,washington-redskins,5040933,2009
40670,1600000,2000000,Randy Thomas,G,injured_reserve,washington-redskins,3600000,2009
40671,285000,0,Roydell Williams,WR,injured_reserve,washington-redskins,285000,2009
40672,88400,0,Paul Fanaika,G,practice_squad,washington-redskins,88400,2009
40673,0,5666664,Brandon Lloyd,WR,dead_cap,washington-redskins,5666664,2009
40674,44578,0,Cody Glenn,LB,dead_cap,washington-redskins,44578,2009
40675,29112,0,Durant Brooks,P,dead_cap,washington-redskins,29112,2009
40676,29000,0,Tyler Ecker,TE,dead_cap,washington-redskins,29000,2009
40677,15600,0,Darrel Young,FB,dead_cap,washington-redskins,15600,2009
40678,14625,0,Eddie Williams,FB,dead_cap,washington-redskins,14625,2009
40679,5000,0,Antonio Dixon,DT,dead_cap,washington-redskins,5000,2009
40680,3000000,31700000,DeAngelo Hall,CB,active,washington-redskins,34700000,2010
40681,3500000,24712500,Donovan McNabb,QB,active,washington-redskins,28212500,2010
40682,2752941,5200000,Albert Haynesworth,DT,active,washington-redskins,7952941,2010
40683,4900000,2200000,London Fletcher,ILB,active,washington-redskins,7100000,2010
40684,3017500,4840333,LaRon Landry,S,active,washington-redskins,7857833,2010
40685,395000,5872000,Brian Orakpo,OLB,active,washington-redskins,6267000,2010
40686,2325000,500000,Chris Cooley,TE,active,washington-redskins,2825000,2010
40687,968500,0,Santana Moss,WR,active,washington-redskins,968500,2010
40688,1300000,4644998,Andre Carter,DE,active,washington-redskins,5944998,2010
40689,2910000,1250000,Derrick Dockery,G,active,washington-redskins,4160000,2010
40690,3619000,0,Jammal Brown,T,active,washington-redskins,3619000,2010
40691,2398000,500000,Trent Williams,LT,active,washington-redskins,2898000,2010
40692,755000,0,Artis Hicks,G,active,washington-redskins,755000,2010
40693,1759000,0,Reed Doughty,S,active,washington-redskins,1759000,2010
40694,1759000,0,Kedric Golston,DT,active,washington-redskins,1759000,2010
40695,1759000,0,Rocky McIntosh,OLB,active,washington-redskins,1759000,2010
40696,1450000,300000,Phillip Buchanon,CB,active,washington-redskins,1750000,2010
40697,1684000,0,Stephon Heyer,T,active,washington-redskins,1684000,2010
40698,1684000,0,Chris Wilson,LB,active,washington-redskins,1684000,2010
40699,1542000,0,Carlos Rogers,CB,active,washington-redskins,1542000,2010
40700,855000,350000,Mike Sellers,FB,active,washington-redskins,1205000,2010
40701,875000,368750,Vonnie Holliday,DT,active,washington-redskins,1243750,2010
40702,1176000,0,Anthony Montgomery,DT,active,washington-redskins,1176000,2010
40703,1070000,0,Adam Carriker,DE,active,washington-redskins,1070000,2010
40704,900000,0,Josh Bidwell,P,active,washington-redskins,900000,2010
40705,800000,200000,Larry Johnson,RB,active,washington-redskins,1000000,2010
40706,550000,400000,Lorenzo Alexander,OLB,active,washington-redskins,950000,2010
40707,470000,345500,Fred Davis,TE,active,washington-redskins,815500,2010
40708,630000,0,Will Montgomery,C,active,washington-redskins,630000,2010
40709,755000,0,Rex Grossman,QB,active,washington-redskins,755000,2010
40710,600000,0,John Beck,QB,active,washington-redskins,600000,2010
40711,630000,0,Darrion Scott,DT,active,washington-redskins,630000,2010
40712,395000,195625,Kevin Barnes,CB,active,washington-redskins,590625,2010
40713,550000,26625,H.B. Blades,LB,active,washington-redskins,576625,2010
40714,395000,159559,Jeremy Jarmon,DT,active,washington-redskins,554559,2010
40715,545000,0,Anthony Bryant,DT,active,washington-redskins,545000,2010
40716,545000,0,Edgar Jones,OLB,active,washington-redskins,545000,2010
40717,545000,0,Roydell Williams,WR,active,washington-redskins,545000,2010
40718,470000,24675,Kareem Moore,S,active,washington-redskins,494675,2010
40719,470000,9129,Chris Horton,S,active,washington-redskins,479129,2010
40720,470000,0,Rob Jackson,OLB,active,washington-redskins,470000,2010
40721,470000,0,Kory Lichtensteiger,C,active,washington-redskins,470000,2010
40722,320000,132500,Perry Riley,ILB,active,washington-redskins,452500,2010
40723,395000,25631,Robert Henson,LB,active,washington-redskins,420631,2010
40724,395000,0,James Davis,RB,active,washington-redskins,395000,2010
40725,395000,0,Graham Gano,K,active,washington-redskins,395000,2010
40726,395000,0,Macho Harris,CB,active,washington-redskins,395000,2010
40727,320000,3333,Logan Paulsen,TE,active,washington-redskins,323333,2010
40728,320000,0,Anthony Armstrong,WR,active,washington-redskins,320000,2010
40729,320000,0,Brandon Banks,WR,active,washington-redskins,320000,2010
40730,320000,0,Andre Brown,RB,active,washington-redskins,320000,2010
40731,320000,0,Nick Sundberg,LS,active,washington-redskins,320000,2010
40732,320000,0,Keiland Williams,RB,active,washington-redskins,320000,2010
40733,320000,0,Darrel Young,FB,active,washington-redskins,320000,2010
40734,112941,0,Terrence Austin,WR,active,washington-redskins,112941,2010
40735,94117,0,Erik Cook,C,active,washington-redskins,94117,2010
40736,7190500,2365100,Clinton Portis,RB,injured_reserve,washington-redskins,9555600,2010
40737,850000,1137500,Maake Kemoeatu,DT,injured_reserve,washington-redskins,1987500,2010
40738,650000,300000,Mike Williams,T,non_fb_injury,washington-redskins,950000,2010
40739,88400,0,Maurice Price,WR,practice_squad,washington-redskins,88400,2010
40740,0,7513332,Chris Samuels,T,dead_cap,washington-redskins,7513332,2010
40741,0,8119516,Antwaan Randle El,WR,dead_cap,washington-redskins,8119516,2010
40742,3547499,0,Andre Carter,DE,dead_cap,washington-redskins,3547499,2010
40743,3158588,0,Fred Smoot,CB,dead_cap,washington-redskins,3158588,2010
40744,0,2791665,Todd Collins,QB,dead_cap,washington-redskins,2791665,2010
40745,2051400,0,Carlos Rogers,CB,dead_cap,washington-redskins,2051400,2010
40746,1865100,0,Clinton Portis,RB,dead_cap,washington-redskins,1865100,2010
40747,1775000,0,Randy Thomas,G,dead_cap,washington-redskins,1775000,2010
40748,152843,0,Chad Rinehart,G,dead_cap,washington-redskins,152843,2010
40749,133734,0,Cody Glenn,LB,dead_cap,washington-redskins,133734,2010
40750,100000,0,Rock Cartwright,RB,dead_cap,washington-redskins,100000,2010
40751,66300,12720,Erik Cook,C,dead_cap,washington-redskins,79020,2010
40752,60775,15064,Terrence Austin,WR,dead_cap,washington-redskins,75839,2010
40753,58224,0,Durant Brooks,P,dead_cap,washington-redskins,58224,2010
40754,50000,0,Willie Parker,RB,dead_cap,washington-redskins,50000,2010
40755,43875,0,Eddie Williams,FB,dead_cap,washington-redskins,43875,2010
40756,43500,0,Marko Mitchell,WR,dead_cap,washington-redskins,43500,2010
40757,0,37734,Jonathan Crompton,QB,dead_cap,washington-redskins,37734,2010
40758,0,29482,Dennis Morris,TE,dead_cap,washington-redskins,29482,2010
40759,24200,0,Colt Brennan,QB,dead_cap,washington-redskins,24200,2010
40760,0,12456,Selvish Capers,G,dead_cap,washington-redskins,12456,2010
40761,10347,0,Rob Jackson,OLB,dead_cap,washington-redskins,10347,2010
40762,900000,7100000,Oshiomogho Atogwe,S,active,washington-redskins,8000000,2011
40763,6004470,3460786,Trent Williams,LT,active,washington-redskins,9465256,2011
40764,5215000,3649333,LaRon Landry,S,active,washington-redskins,8864333,2011
40765,4900000,2200000,London Fletcher,ILB,active,washington-redskins,7100000,2011
40766,3700000,500000,Chris Cooley,TE,active,washington-redskins,4200000,2011
40767,3200000,2100000,Barry Cofield,DT,active,washington-redskins,5300000,2011
40768,4500000,500000,DeAngelo Hall,CB,active,washington-redskins,5000000,2011
40769,3000000,1500000,Stephen Bowen,DE,active,washington-redskins,4500000,2011
40770,2250000,1666666,Santana Moss,WR,active,washington-redskins,3916666,2011
40771,2750000,1287500,Jammal Brown,T,active,washington-redskins,4037500,2011
40772,2000000,1333333,Josh Wilson,CB,active,washington-redskins,3333333,2011
40773,1250000,1750000,Rocky McIntosh,OLB,active,washington-redskins,3000000,2011
40774,1500000,1300000,Chris Chester,G,active,washington-redskins,2800000,2011
40775,2400000,375000,Jabar Gaffney,WR,active,washington-redskins,2775000,2011
40776,525000,2267000,Brian Orakpo,OLB,active,washington-redskins,2792000,2011
40777,1835000,0,Tim Hightower,RB,active,washington-redskins,1835000,2011
40778,375000,1210508,Ryan Kerrigan,OLB,active,washington-redskins,1585508,2011
40779,1250000,0,Artis Hicks,G,active,washington-redskins,1250000,2011
40780,1420000,0,Adam Carriker,DE,active,washington-redskins,1420000,2011
40781,725000,650000,Reed Doughty,S,active,washington-redskins,1375000,2011
40782,1050000,300000,Sav Rocca,P,active,washington-redskins,1350000,2011
40783,950000,120000,Mike Sellers,FB,active,washington-redskins,1070000,2011
40784,810000,340000,Rex Grossman,QB,active,washington-redskins,1150000,2011
40785,800000,150000,Lorenzo Alexander,OLB,active,washington-redskins,950000,2011
40786,600000,345500,Fred Davis,TE,active,washington-redskins,945500,2011
40787,800000,0,John Beck,QB,active,washington-redskins,800000,2011
40788,375000,465483,Jarvis Jenkins,DE,active,washington-redskins,840483,2011
40789,810000,0,Keyaron Fox,ILB,active,washington-redskins,810000,2011
40790,810000,0,Sean Locklear,T,active,washington-redskins,810000,2011
40791,685000,0,Will Montgomery,C,active,washington-redskins,685000,2011
40792,685000,50000,H.B. Blades,LB,active,washington-redskins,735000,2011
40793,525000,195625,Kevin Barnes,CB,active,washington-redskins,720625,2011
40794,685000,0,Anthony Bryant,DT,active,washington-redskins,685000,2011
40795,685000,0,Edgar Jones,OLB,active,washington-redskins,685000,2011
40796,685000,0,Derek Schouman,TE,active,washington-redskins,685000,2011
40797,685000,0,Darrion Scott,DT,active,washington-redskins,685000,2011
40798,640000,0,Will Montgomery,C,active,washington-redskins,640000,2011
40799,600000,0,Kentwan Balmer,DE,active,washington-redskins,600000,2011
40800,600000,0,Kory Lichtensteiger,C,active,washington-redskins,600000,2011
40801,450000,132500,Perry Riley,ILB,active,washington-redskins,582500,2011
40802,555000,24675,Kareem Moore,S,active,washington-redskins,579675,2011
40803,375000,151594,Leonard Hankerson,WR,active,washington-redskins,526594,2011
40804,810000,50000,Donte Stallworth,WR,active,washington-redskins,860000,2011
40805,685000,0,David Anderson,WR,active,washington-redskins,685000,2011
40806,685000,0,Kellen Clemens,QB,active,washington-redskins,685000,2011
40807,685000,50000,Kedric Golston,DT,active,washington-redskins,735000,2011
40808,525000,0,Chris Baker,DT,active,washington-redskins,525000,2011
40809,525000,0,Graham Gano,K,active,washington-redskins,525000,2011
40810,525000,0,Rob Jackson,OLB,active,washington-redskins,525000,2011
40811,375000,117563,Roy Helu,RB,active,washington-redskins,492563,2011
40812,480000,0,James Davis,RB,active,washington-redskins,480000,2011
40813,480000,0,Richard Quinn,TE,active,washington-redskins,480000,2011
40814,450000,3333,Logan Paulsen,TE,active,washington-redskins,453333,2011
40815,450000,0,Anthony Armstrong,WR,active,washington-redskins,450000,2011
40816,450000,0,Terrence Austin,WR,active,washington-redskins,450000,2011
40817,450000,0,Brandon Banks,WR,active,washington-redskins,450000,2011
40818,450000,0,Erik Cook,C,active,washington-redskins,450000,2011
40819,450000,0,Nevin McCaskill,T,active,washington-redskins,450000,2011
40820,450000,0,Nick Sundberg,LS,active,washington-redskins,450000,2011
40821,450000,0,Darrel Young,FB,active,washington-redskins,450000,2011
40822,375000,47825,Dejon Gomes,S,active,washington-redskins,422825,2011
40823,375000,45413,Niles Paul,TE,active,washington-redskins,420413,2011
40824,375000,12721,Markus White,DE,active,washington-redskins,387721,2011
40825,375000,11475,Chris Neild,DT,active,washington-redskins,386475,2011
40826,375000,5000,Willie Smith,LT,active,washington-redskins,380000,2011
40827,375000,0,Maurice Hurt,G,active,washington-redskins,375000,2011
40828,375000,0,Aldrick Robinson,WR,active,washington-redskins,375000,2011
40829,96900,0,Evan Royster,RB,active,washington-redskins,96900,2011
40830,96900,0,Brandyn Thompson,CB,active,washington-redskins,96900,2011
40831,96900,0,Doug Worthington,DE,active,washington-redskins,96900,2011
40832,764705,1125000,Phillip Buchanon,CB,injured_reserve,washington-redskins,1889705,2011
40833,4325000,0,Randy Thomas,G,dead_cap,washington-redskins,4325000,2011
40834,3750000,0,Derrick Dockery,G,dead_cap,washington-redskins,3750000,2011
40835,3547499,0,Andre Carter,DE,dead_cap,washington-redskins,3547499,2011
40836,1865100,0,Clinton Portis,RB,dead_cap,washington-redskins,1865100,2011
40837,1000000,0,Albert Haynesworth,DT,dead_cap,washington-redskins,1000000,2011
40838,787000,0,Devin Thomas,WR,dead_cap,washington-redskins,787000,2011
40839,159559,0,Jeremy Jarmon,DT,dead_cap,washington-redskins,159559,2011
40840,152843,0,Chad Rinehart,G,dead_cap,washington-redskins,152843,2011
40841,141176,0,Dominique Byrd,T,dead_cap,washington-redskins,141176,2011
40842,0,113202,Jonathan Crompton,QB,dead_cap,washington-redskins,113202,2011
40843,0,88446,Dennis Morris,TE,dead_cap,washington-redskins,88446,2011
40844,0,45192,Terrence Austin,WR,dead_cap,washington-redskins,45192,2011
40845,0,38160,Erik Cook,C,dead_cap,washington-redskins,38160,2011
40846,0,37368,Selvish Capers,G,dead_cap,washington-redskins,37368,2011
40847,0,26918,Evan Royster,RB,dead_cap,washington-redskins,26918,2011
40848,0,26550,Aldrick Robinson,WR,dead_cap,washington-redskins,26550,2011
40849,25631,0,Robert Henson,LB,dead_cap,washington-redskins,25631,2011
40850,24200,0,Colt Brennan,QB,dead_cap,washington-redskins,24200,2011
40851,20694,0,Rob Jackson,OLB,dead_cap,washington-redskins,20694,2011
40852,0,15151,Brandyn Thompson,CB,dead_cap,washington-redskins,15151,2011
40853,0,14943,Maurice Hurt,G,dead_cap,washington-redskins,14943,2011
40854,0,12721,Markus White,DE,dead_cap,washington-redskins,12721,2011
40855,9129,0,Chris Horton,S,dead_cap,washington-redskins,9129,2011
40856,0,2666,Shaun Draughn,RB,dead_cap,washington-redskins,2666,2011
40857,11000000,3460786,Trent Williams,LT,active,washington-redskins,14460786,2012
40858,6000000,500000,DeAngelo Hall,CB,active,washington-redskins,6500000,2012
40859,5446000,0,Fred Davis,TE,active,washington-redskins,5446000,2012
40860,3400000,1433333,Josh Wilson,CB,active,washington-redskins,4833333,2012
40861,2550000,2250000,Barry Cofield,DT,active,washington-redskins,4800000,2012
40862,2100000,2584375,Pierre Garcon,WR,active,washington-redskins,4684375,2012
40863,2650000,1666666,Santana Moss,WR,active,washington-redskins,4316666,2012
40864,2900000,1600000,Stephen Bowen,DE,active,washington-redskins,4500000,2012
40865,3250000,1100000,Jammal Brown,T,active,washington-redskins,4350000,2012
40866,390000,3449836,Robert Griffin III,QB,active,washington-redskins,3839836,2012
40867,2500000,1300000,Chris Chester,G,active,washington-redskins,3800000,2012
40868,1800000,1300000,Josh Morgan,WR,active,washington-redskins,3100000,2012
40869,765000,2704000,Brian Orakpo,OLB,active,washington-redskins,3469000,2012
40870,1750000,700000,London Fletcher,ILB,active,washington-redskins,2450000,2012
40871,1250000,750000,Cedric Griffin,CB,active,washington-redskins,2000000,2012
40872,771377,1210508,Ryan Kerrigan,OLB,active,washington-redskins,1981885,2012
40873,1550000,300000,Sav Rocca,P,active,washington-redskins,1850000,2012
40874,950000,350000,Rex Grossman,QB,active,washington-redskins,1300000,2012
40875,1260000,0,Kory Lichtensteiger,C,active,washington-redskins,1260000,2012
40876,700000,500000,Will Montgomery,C,active,washington-redskins,1200000,2012
40877,900000,225000,Reed Doughty,S,active,washington-redskins,1125000,2012
40878,542395,465483,Jarvis Jenkins,DE,active,washington-redskins,1007878,2012
40879,825000,65000,Jordan Black,T,active,washington-redskins,890000,2012
40880,825000,65000,Madieu Williams,S,active,washington-redskins,890000,2012
40881,700000,100000,Lorenzo Alexander,OLB,active,washington-redskins,800000,2012
40882,700000,0,Kentwan Balmer,DE,active,washington-redskins,700000,2012
40883,540000,132500,Perry Riley,ILB,active,washington-redskins,672500,2012
40884,465000,176594,Leonard Hankerson,WR,active,washington-redskins,641594,2012
40885,615000,0,Rob Jackson,OLB,active,washington-redskins,615000,2012
40886,465000,117563,Roy Helu,RB,active,washington-redskins,582563,2012
40887,565000,0,James Davis,RB,active,washington-redskins,565000,2012
40888,390000,164081,Josh LeRibeus,C,active,washington-redskins,554081,2012
40889,540000,3333,Logan Paulsen,TE,active,washington-redskins,543333,2012
40890,700000,65000,Kedric Golston,DT,active,washington-redskins,765000,2012
40891,700000,0,David Jones,CB,active,washington-redskins,700000,2012
40892,700000,0,Tyler Polumbus,LT,active,washington-redskins,700000,2012
40893,700000,0,Chris Wilson,LB,active,washington-redskins,700000,2012
40894,540000,0,Chris Baker,DT,active,washington-redskins,540000,2012
40895,540000,0,Brandon Banks,WR,active,washington-redskins,540000,2012
40896,540000,0,Dezmon Briscoe,WR,active,washington-redskins,540000,2012
40897,540000,0,Roddrick Muckelroy,ILB,active,washington-redskins,540000,2012
40898,540000,0,Jordan Pugh,S,active,washington-redskins,540000,2012
40899,540000,0,Nick Sundberg,LS,active,washington-redskins,540000,2012
40900,540000,0,Keiland Williams,RB,active,washington-redskins,540000,2012
40901,540000,0,Darrel Young,FB,active,washington-redskins,540000,2012
40902,465000,47825,Dejon Gomes,S,active,washington-redskins,512825,2012
40903,465000,45413,Niles Paul,TE,active,washington-redskins,510413,2012
40904,390000,118172,Kirk Cousins,QB,active,washington-redskins,508172,2012
40905,480000,0,Rob Myers,TE,active,washington-redskins,480000,2012
40906,465000,11475,Chris Neild,DT,active,washington-redskins,476475,2012
40907,465000,0,Maurice Hurt,G,active,washington-redskins,465000,2012
40908,465000,0,Jerome Murphy,CB,active,washington-redskins,465000,2012
40909,465000,0,Evan Royster,RB,active,washington-redskins,465000,2012
40910,465000,0,Vic So'oto,OLB,active,washington-redskins,465000,2012
40911,825000,0,Chris Cooley,TE,active,washington-redskins,825000,2012
40912,390000,50493,Adam Gettis,G,active,washington-redskins,440493,2012
40913,390000,30775,Alfred Morris,RB,active,washington-redskins,420775,2012
40914,390000,15933,Richard Crawford,CB,active,washington-redskins,405933,2012
40915,390000,15455,Jordan Bernstine,S,active,washington-redskins,405455,2012
40916,390000,0,Kai Forbath,K,active,washington-redskins,390000,2012
40917,390000,0,Aldrick Robinson,WR,active,washington-redskins,390000,2012
40918,390000,0,Doug Worthington,DE,active,washington-redskins,390000,2012
40919,465000,0,Mario Addison,DE,active,washington-redskins,465000,2012
40920,195000,105027,Keenan Robinson,OLB,active,washington-redskins,300027,2012
40921,615000,0,Domonique Johnson,CB,active,washington-redskins,615000,2012
40922,91764,0,Tom Compton,T,active,washington-redskins,91764,2012
40923,1450000,450000,Brandon Meriweather,SS,injured_reserve,washington-redskins,1900000,2012
40924,700000,831250,Adam Carriker,DE,injured_reserve,washington-redskins,1531250,2012
40925,390000,0,Dorson Boyce,FB,injured_reserve,washington-redskins,390000,2012
40926,390000,0,Tristan Davis,RB,injured_reserve,washington-redskins,390000,2012
40927,390000,0,Darius Hanks,WR,injured_reserve,washington-redskins,390000,2012
40928,390000,0,Chase Minnifield,CB,injured_reserve,washington-redskins,390000,2012
40929,96900,0,Chigbo Anunoby,DT,practice_squad,washington-redskins,96900,2012
40930,96900,0,Tom Compton,T,practice_squad,washington-redskins,96900,2012
40931,96900,0,Dominique Hamilton,DE,practice_squad,washington-redskins,96900,2012
40932,96900,0,Eric Kettani,FB,practice_squad,washington-redskins,96900,2012
40933,2000000,0,Albert Haynesworth,DT,dead_cap,washington-redskins,2000000,2012
40934,1900000,0,Oshiomogho Atogwe,S,dead_cap,washington-redskins,1900000,2012
40935,1092000,0,LaRon Landry,S,dead_cap,washington-redskins,1092000,2012
40936,500000,0,Chris Cooley,TE,dead_cap,washington-redskins,500000,2012
40937,240000,0,Mike Sellers,FB,dead_cap,washington-redskins,240000,2012
40938,195625,0,Kevin Barnes,CB,dead_cap,washington-redskins,195625,2012
40939,187500,0,Ryan Grant,RB,dead_cap,washington-redskins,187500,2012
40940,159559,0,Jeremy Jarmon,DT,dead_cap,washington-redskins,159559,2012
40941,0,80754,Evan Royster,RB,dead_cap,washington-redskins,80754,2012
40942,0,79650,Aldrick Robinson,WR,dead_cap,washington-redskins,79650,2012
40943,65000,0,Billy Cundiff,K,dead_cap,washington-redskins,65000,2012
40944,65000,0,Neil Rackers,K,dead_cap,washington-redskins,65000,2012
40945,0,45453,Brandyn Thompson,CB,dead_cap,washington-redskins,45453,2012
40946,0,44829,Maurice Hurt,G,dead_cap,washington-redskins,44829,2012
40947,25631,0,Robert Henson,LB,dead_cap,washington-redskins,25631,2012
40948,0,25442,Markus White,DE,dead_cap,washington-redskins,25442,2012
40949,25250,0,Tom Compton,T,dead_cap,washington-redskins,25250,2012
40950,0,5334,Shaun Draughn,RB,dead_cap,washington-redskins,5334,2012
40951,5000,0,Willie Smith,LT,dead_cap,washington-redskins,5000,2012
40952,334,0,Darius Hanks,WR,dead_cap,washington-redskins,334,2012
40953,5600000,2506250,Pierre Garcon,WR,active,washington-redskins,8106250,2013
40954,5000000,3460786,Trent Williams,LT,active,washington-redskins,8460786,2013
40955,5500000,700000,London Fletcher,ILB,active,washington-redskins,6200000,2013
40956,2810000,3014000,Brian Orakpo,OLB,active,washington-redskins,5824000,2013
40957,3800000,1300000,Josh Morgan,WR,active,washington-redskins,5100000,2013
40958,1349959,3449836,Robert Griffin III,QB,active,washington-redskins,4799795,2013
40959,3000000,1300000,Chris Chester,G,active,washington-redskins,4300000,2013
40960,2000000,1666668,Santana Moss,WR,active,washington-redskins,3666668,2013
40961,840000,2827500,Barry Cofield,DT,active,washington-redskins,3667500,2013
40962,840000,2620000,Stephen Bowen,DE,active,washington-redskins,3460000,2013
40963,2000000,1333333,Josh Wilson,CB,active,washington-redskins,3333333,2013
40964,1000000,1500000,Fred Davis,TE,active,washington-redskins,2500000,2013
40965,1167754,1210508,Ryan Kerrigan,OLB,active,washington-redskins,2378262,2013
40966,1850000,500000,Will Montgomery,C,active,washington-redskins,2350000,2013
40967,1129412,450000,Brandon Meriweather,SS,active,washington-redskins,1579412,2013
40968,1000000,550000,Kory Lichtensteiger,C,active,washington-redskins,1550000,2013
40969,1150000,350000,Reed Doughty,S,active,washington-redskins,1500000,2013
40970,635000,865000,E.J. Biggers,CB,active,washington-redskins,1500000,2013
40971,1323000,132500,Perry Riley,ILB,active,washington-redskins,1455500,2013
40972,1323000,0,Chris Baker,DT,active,washington-redskins,1323000,2013
40973,1323000,0,J.D. Walton,C,active,washington-redskins,1323000,2013
40974,1000000,250000,DeAngelo Hall,CB,active,washington-redskins,1250000,2013
40975,715000,196154,Rob Jackson,OLB,active,washington-redskins,911154,2013
40976,542780,465483,Jarvis Jenkins,DE,active,washington-redskins,1008263,2013
40977,630000,366666,Logan Paulsen,TE,active,washington-redskins,996666,2013
40978,630000,353333,Darrel Young,FB,active,washington-redskins,983333,2013
40979,840000,120000,Kedric Golston,DT,active,washington-redskins,960000,2013
40980,800000,100000,Tyler Polumbus,LT,active,washington-redskins,900000,2013
40981,715000,162500,Sav Rocca,P,active,washington-redskins,877500,2013
40982,650000,162500,Nick Sundberg,LS,active,washington-redskins,812500,2013
40983,555000,176594,Leonard Hankerson,WR,active,washington-redskins,731594,2013
40984,405000,295164,David Amerson,CB,active,washington-redskins,700164,2013
40985,500000,174081,Josh LeRibeus,C,active,washington-redskins,674081,2013
40986,555000,117563,Roy Helu,RB,active,washington-redskins,672563,2013
40987,630000,0,Dezmon Briscoe,WR,active,washington-redskins,630000,2013
40988,555000,45413,Niles Paul,TE,active,washington-redskins,600413,2013
40989,480000,118172,Kirk Cousins,QB,active,washington-redskins,598172,2013
40990,840000,25000,Darryl Tapp,DE,active,washington-redskins,865000,2013
40991,940000,20000,Rex Grossman,QB,active,washington-redskins,960000,2013
40992,555000,11475,Chris Neild,DT,active,washington-redskins,566475,2013
40993,555000,0,Josh Hull,ILB,active,washington-redskins,555000,2013
40994,555000,0,Evan Royster,RB,active,washington-redskins,555000,2013
40995,405000,137278,Jordan Reed,TE,active,washington-redskins,542278,2013
40996,480000,50493,Adam Gettis,G,active,washington-redskins,530493,2013
40997,480000,30775,Alfred Morris,RB,active,washington-redskins,510775,2013
40998,480000,0,Tom Compton,T,active,washington-redskins,480000,2013
40999,480000,0,Kai Forbath,K,active,washington-redskins,480000,2013
41000,480000,0,Kyle Nelson,LS,active,washington-redskins,480000,2013
41001,480000,0,Aldrick Robinson,WR,active,washington-redskins,480000,2013
41002,480000,0,Trenton Robinson,FS,active,washington-redskins,480000,2013
41003,480000,0,Adrian Robinson,OLB,active,washington-redskins,480000,2013
41004,405000,46250,Chris Thompson,RB,active,washington-redskins,451250,2013
41005,405000,42215,Brandon Jenkins,OLB,active,washington-redskins,447215,2013
41006,405000,25418,Bacarri Rambo,SS,active,washington-redskins,430418,2013
41007,303000,105027,Keenan Robinson,OLB,active,washington-redskins,408027,2013
41008,405000,0,Jose Gumbs,S,active,washington-redskins,405000,2013
41009,405000,0,Chase Minnifield,CB,active,washington-redskins,405000,2013
41010,405000,0,Nick Williams,WR,active,washington-redskins,405000,2013
41011,303000,15933,Richard Crawford,CB,active,washington-redskins,318933,2013
41012,303000,0,Doug Worthington,DE,active,washington-redskins,303000,2013
41013,480000,0,Josh Bellamy,WR,active,washington-redskins,480000,2013
41014,405000,0,Jawan Jamison,RB,active,washington-redskins,405000,2013
41015,405000,0,Will Compton,ILB,active,washington-redskins,405000,2013
41016,2000000,800000,Adam Carriker,DE,injured_reserve,washington-redskins,2800000,2013
41017,715000,0,Bryan Kehl,ILB,injured_reserve,washington-redskins,715000,2013
41018,940000,0,Nick Barnett,ILB,injured_reserve,washington-redskins,940000,2013
41019,405000,1333,Jeremy Kimbrough,ILB,injured_reserve,washington-redskins,406333,2013
41020,288000,106301,Phillip Thomas,SS,injured_reserve,washington-redskins,394301,2013
41021,96000,0,Will Compton,ILB,practice_squad,washington-redskins,96000,2013
41022,84000,0,Jawan Jamison,RB,practice_squad,washington-redskins,84000,2013
41023,18000,0,Xavier Nixon,LT,practice_squad,washington-redskins,18000,2013
41024,0,3300000,Jammal Brown,T,dead_cap,washington-redskins,3300000,2013
41025,1833335,0,Chris Cooley,TE,dead_cap,washington-redskins,1833335,2013
41026,391765,0,Jerome Murphy,CB,dead_cap,washington-redskins,391765,2013
41027,259412,0,Jordan Pugh,S,dead_cap,washington-redskins,259412,2013
41028,185118,0,Lance Lewis,WR,dead_cap,washington-redskins,185118,2013
41029,130588,0,Phillip Merling,DE,dead_cap,washington-redskins,130588,2013
41030,84705,0,John Potter,K,dead_cap,washington-redskins,84705,2013
41031,75750,0,Tom Compton,T,dead_cap,washington-redskins,75750,2013
41032,72000,1666,Chase Minnifield,CB,dead_cap,washington-redskins,73666,2013
41033,65000,0,Jeremy Trueblood,RT,dead_cap,washington-redskins,65000,2013
41034,60000,3333,Nick Williams,WR,dead_cap,washington-redskins,63333,2013
41035,56471,0,Pat White,QB,dead_cap,washington-redskins,56471,2013
41036,0,47825,Dejon Gomes,S,dead_cap,washington-redskins,47825,2013
41037,0,15455,Jordan Bernstine,S,dead_cap,washington-redskins,15455,2013
41038,0,12720,Jawan Jamison,RB,dead_cap,washington-redskins,12720,2013
41039,6000,0,Josh Bellamy,WR,dead_cap,washington-redskins,6000,2013
41040,5000,0,Willie Smith,LT,dead_cap,washington-redskins,5000,2013
41041,5000,0,Kyle Wilborn,C,dead_cap,washington-redskins,5000,2013
41042,0,3333,Emmanuel Ogbuehi,TE,dead_cap,washington-redskins,3333,2013
41043,0,2666,Xavier Nixon,LT,dead_cap,washington-redskins,2666,2013
41044,0,2500,Skye Dawson,WR,dead_cap,washington-redskins,2500,2013
41045,1667,0,Darius Hanks,WR,dead_cap,washington-redskins,1667,2013
41046,0,1666,Will Compton,ILB,dead_cap,washington-redskins,1666,2013
41047,0,1666,Chip Reeves,WR,dead_cap,washington-redskins,1666,2013
41048,0,666,Jacoby Ashworth,G,dead_cap,washington-redskins,666,2013
41049,11455000,0,Brian Orakpo,OLB,active,washington-redskins,11455000,2014
41050,7250000,5210786,Trent Williams,LT,active,washington-redskins,12460786,2014
41051,7100000,2600000,Pierre Garcon,WR,active,washington-redskins,9700000,2014
41052,4550000,3127500,Barry Cofield,DT,active,washington-redskins,7677500,2014
41053,2309918,3449836,Robert Griffin III,QB,active,washington-redskins,5759754,2014
41054,1600000,3088750,Stephen Bowen,DE,active,washington-redskins,4688750,2014
41055,3000000,1300000,Chris Chester,G,active,washington-redskins,4300000,2014
41056,1000000,3250000,DeSean Jackson,WR,active,washington-redskins,4250000,2014
41057,2500000,800000,Kory Lichtensteiger,C,active,washington-redskins,3300000,2014
41058,2000000,1000000,Shawn Lauvao,G,active,washington-redskins,3000000,2014
41059,2000000,1000000,Perry Riley,ILB,active,washington-redskins,3000000,2014
41060,1250000,1550000,Tracy Porter,CB,active,washington-redskins,2800000,2014
41061,1564131,1210508,Ryan Kerrigan,OLB,active,washington-redskins,2774639,2014
41062,1500000,1100000,Tyler Polumbus,LT,active,washington-redskins,2600000,2014
41063,1250000,1000000,Andre Roberts,WR,active,washington-redskins,2250000,2014
41064,870000,1366666,Logan Paulsen,TE,active,washington-redskins,2236666,2014
41065,1250000,812500,DeAngelo Hall,CB,active,washington-redskins,2062500,2014
41066,950000,1050000,Chris Baker,DT,active,washington-redskins,2000000,2014
41067,1431000,117563,Roy Helu,RB,active,washington-redskins,1548563,2014
41068,927184,565483,Jarvis Jenkins,DE,active,washington-redskins,1492667,2014
41069,875000,492708,Darrel Young,FB,active,washington-redskins,1367708,2014
41070,900000,345000,Kedric Golston,DT,active,washington-redskins,1245000,2014
41071,750000,162500,Nick Sundberg,LS,active,washington-redskins,912500,2014
41072,530041,345164,David Amerson,CB,active,washington-redskins,875205,2014
41073,420000,393236,Trent Murphy,OLB,active,washington-redskins,813236,2014
41074,645000,167219,Leonard Hankerson,WR,active,washington-redskins,812219,2014
41075,590000,174081,Josh LeRibeus,C,active,washington-redskins,764081,2014
41076,645000,45413,Niles Paul,TE,active,washington-redskins,690413,2014
41077,570000,118172,Kirk Cousins,QB,active,washington-redskins,688172,2014
41078,570000,105027,Keenan Robinson,OLB,active,washington-redskins,675027,2014
41079,645000,11475,Chris Neild,DT,active,washington-redskins,656475,2014
41080,495000,147278,Jordan Reed,TE,active,washington-redskins,642278,2014
41081,955000,65000,Ryan Clark,S,active,washington-redskins,1020000,2014
41082,955000,65000,Santana Moss,WR,active,washington-redskins,1020000,2014
41083,730000,65000,E.J. Biggers,CB,active,washington-redskins,795000,2014
41084,730000,65000,Colt McCoy,QB,active,washington-redskins,795000,2014
41085,570000,30775,Alfred Morris,RB,active,washington-redskins,600775,2014
41086,303000,174394,Morgan Moses,RT,active,washington-redskins,477394,2014
41087,420000,153450,Spencer Long,C,active,washington-redskins,573450,2014
41088,570000,0,Tom Compton,T,active,washington-redskins,570000,2014
41089,570000,0,Kai Forbath,K,active,washington-redskins,570000,2014
41090,570000,0,Duke Ihenacho,SS,active,washington-redskins,570000,2014
41091,570000,0,Frank Kearse,DE,active,washington-redskins,570000,2014
41092,570000,0,Travian Robertson,DT,active,washington-redskins,570000,2014
41093,570000,0,Trenton Robinson,FS,active,washington-redskins,570000,2014
41094,420000,121500,Bashaud Breeland,CB,active,washington-redskins,541500,2014
41095,420000,53403,Ryan Grant,WR,active,washington-redskins,473403,2014
41096,420000,2666,Silas Redd,RB,active,washington-redskins,422666,2014
41097,420000,0,Will Compton,ILB,active,washington-redskins,420000,2014
41098,420000,0,Tress Way,P,active,washington-redskins,420000,2014
41099,247058,0,Akeem Davis,SS,active,washington-redskins,247058,2014
41100,222352,0,Phillip Thomas,SS,active,washington-redskins,222352,2014
41101,645000,0,Justin Rogers,CB,active,washington-redskins,645000,2014
41102,420000,0,Kenny Okoro,CB,active,washington-redskins,420000,2014
41103,420000,0,Gabe Miller,TE,active,washington-redskins,420000,2014
41104,495000,0,Chris Thompson,RB,active,washington-redskins,495000,2014
41105,420000,0,Ja'Gared Davis,ILB,active,washington-redskins,420000,2014
41106,420000,0,Trevardo Williams,DE,active,washington-redskins,420000,2014
41107,495000,0,Steve Beauharnais,ILB,active,washington-redskins,495000,2014
41108,420000,0,Jackson Jeffcoat,OLB,active,washington-redskins,420000,2014
41109,570000,0,Rishaw  Johnson,G,active,washington-redskins,570000,2014
41110,1500000,2250000,Jason Hatcher,DE,injured_reserve,washington-redskins,3750000,2014
41111,855000,100000,Adam Hayward,OLB,injured_reserve,washington-redskins,955000,2014
41112,754411,145000,Brandon Meriweather,SS,injured_reserve,washington-redskins,899411,2014
41113,303000,0,Courtney Bridget,CB,injured_reserve,washington-redskins,303000,2014
41114,303000,0,Jerry Rice Jr.,WR,injured_reserve,washington-redskins,303000,2014
41115,495000,0,Chase Minnifield,CB,injured_reserve,washington-redskins,495000,2014
41116,100800,0,Je'Ron Hamm,WR,practice_squad,washington-redskins,100800,2014
41117,81900,0,Robert Thomas,DT,practice_squad,washington-redskins,81900,2014
41118,44100,0,Chase Dixon,TE,practice_squad,washington-redskins,44100,2014
41119,18900,0,Edawn Coughman,LT,practice_squad,washington-redskins,18900,2014
41120,18900,0,Michael Hill,RB,practice_squad,washington-redskins,18900,2014
41121,18900,0,Rashad Ross,WR,practice_squad,washington-redskins,18900,2014
41122,12600,0,Isaako Aaitui,DT,practice_squad,washington-redskins,12600,2014
41123,6300,0,Colin Lockett,TE,practice_squad,washington-redskins,6300,2014
41124,0,3300000,Josh Morgan,WR,dead_cap,washington-redskins,3300000,2014
41125,0,2100000,London Fletcher,ILB,dead_cap,washington-redskins,2100000,2014
41126,0,1500000,Adam Carriker,DE,dead_cap,washington-redskins,1500000,2014
41127,0,1500000,Will Montgomery,C,dead_cap,washington-redskins,1500000,2014
41128,1075000,275000,Clifton Geathers,DE,dead_cap,washington-redskins,1350000,2014
41129,0,1200000,Brandon Meriweather,SS,dead_cap,washington-redskins,1200000,2014
41130,948824,0,Darryl Sharpton,ILB,dead_cap,washington-redskins,948824,2014
41131,0,1430000,Brian Orakpo,OLB,dead_cap,washington-redskins,1430000,2014
41132,855000,65000,Akeem Jordan,ILB,dead_cap,washington-redskins,920000,2014
41133,469412,0,Aldrick Robinson,WR,dead_cap,washington-redskins,469412,2014
41134,237389,3334,Chase Minnifield,CB,dead_cap,washington-redskins,240723,2014
41135,234706,0,Everette Brown,OLB,dead_cap,washington-redskins,234706,2014
41136,222353,0,Greg Ducre,CB,dead_cap,washington-redskins,222353,2014
41137,199130,0,Jackson Jeffcoat,OLB,dead_cap,washington-redskins,199130,2014
41138,0,162500,Sav Rocca,P,dead_cap,washington-redskins,162500,2014
41139,155524,0,Gabe Miller,TE,dead_cap,washington-redskins,155524,2014
41140,88200,46250,Chris Thompson,RB,dead_cap,washington-redskins,134450,2014
41141,171764,0,Jamarca Sanford,SS,dead_cap,washington-redskins,171764,2014
41142,0,125000,Mike McGlynn,G,dead_cap,washington-redskins,125000,2014
41143,117724,0,Akeem Davis,SS,dead_cap,washington-redskins,117724,2014
41144,109706,0,Mike Caussin,TE,dead_cap,washington-redskins,109706,2014
41145,108635,0,Steve Beauharnais,ILB,dead_cap,washington-redskins,108635,2014
41146,0,106301,Phillip Thomas,SS,dead_cap,washington-redskins,106301,2014
41147,88200,2000,Tevita Stevens,C,dead_cap,washington-redskins,90200,2014
41148,58235,25418,Bacarri Rambo,SS,dead_cap,washington-redskins,83653,2014
41149,0,65000,Rob Jackson,OLB,dead_cap,washington-redskins,65000,2014
41150,35418,15933,Richard Crawford,CB,dead_cap,washington-redskins,51351,2014
41151,0,50493,Adam Gettis,G,dead_cap,washington-redskins,50493,2014
41152,31500,17225,Ted Bolser,TE,dead_cap,washington-redskins,48725,2014
41153,0,47825,Dejon Gomes,S,dead_cap,washington-redskins,47825,2014
41154,43606,4000,Robert Thomas,DT,dead_cap,washington-redskins,47606,2014
41155,0,42215,Brandon Jenkins,OLB,dead_cap,washington-redskins,42215,2014
41156,0,38160,Jawan Jamison,RB,dead_cap,washington-redskins,38160,2014
41157,31500,0,Terren Jones,LT,dead_cap,washington-redskins,31500,2014
41158,31500,0,Marvin McNutt,WR,dead_cap,washington-redskins,31500,2014
41159,31500,0,Rashad Ross,WR,dead_cap,washington-redskins,31500,2014
41160,0,30910,Jordan Bernstine,S,dead_cap,washington-redskins,30910,2014
41161,0,27625,Lache Seastrunk,RB,dead_cap,washington-redskins,27625,2014
41162,18900,0,Braxston Cave,C,dead_cap,washington-redskins,18900,2014
41163,0,15062,Zach Hocker,K,dead_cap,washington-redskins,15062,2014
41164,6300,6667,Nick Williams,WR,dead_cap,washington-redskins,12967,2014
41165,12600,0,Hebron Fangupo,DT,dead_cap,washington-redskins,12600,2014
41166,12600,0,Michael Huey,G,dead_cap,washington-redskins,12600,2014
41167,0,7500,Chris Davenport,G,dead_cap,washington-redskins,7500,2014
41168,0,6667,Emmanuel Ogbuehi,TE,dead_cap,washington-redskins,6667,2014
41169,6300,0,Derrick Hopkins,DT,dead_cap,washington-redskins,6300,2014
41170,6300,0,Justin Jackson,OLB,dead_cap,washington-redskins,6300,2014
41171,6300,0,Kenny Okoro,CB,dead_cap,washington-redskins,6300,2014
41172,6300,0,Trevardo Williams,DE,dead_cap,washington-redskins,6300,2014
41173,0,5334,Xavier Nixon,LT,dead_cap,washington-redskins,5334,2014
41174,0,5000,Skye Dawson,WR,dead_cap,washington-redskins,5000,2014
41175,0,3334,Will Compton,ILB,dead_cap,washington-redskins,3334,2014
41176,0,3334,Chip Reeves,WR,dead_cap,washington-redskins,3334,2014
41177,0,3000,Kevin Perry,TE,dead_cap,washington-redskins,3000,2014
41178,0,3000,Tommy Rees,QB,dead_cap,washington-redskins,3000,2014
41179,0,2666,Bryan Shepherd,CB,dead_cap,washington-redskins,2666,2014
41180,0,2500,Cody Hoffman,WR,dead_cap,washington-redskins,2500,2014
41181,0,1334,Jacoby Ashworth,G,dead_cap,washington-redskins,1334,2014
41182,0,1334,Marvin Burdette,ILB,dead_cap,washington-redskins,1334,2014
41183,0,1333,Jeremy Kimbrough,ILB,dead_cap,washington-redskins,1333,2014
41184,0,1333,Rashad Lawrence,WR,dead_cap,washington-redskins,1333,2014
41185,0,666,Lee Doss,WR,dead_cap,washington-redskins,666,2014
41186,4750000,7330776,Trent Williams,LT,active,washington-redskins,12080776,2015
41187,7100000,2600000,Pierre Garcon,WR,active,washington-redskins,9700000,2015
41188,3750000,5500000,DeSean Jackson,WR,active,washington-redskins,9250000,2015
41189,3269877,3449836,Robert Griffin III,QB,active,washington-redskins,6719713,2015
41190,2788000,3450000,Ryan Kerrigan,OLB,active,washington-redskins,6238000,2015
41191,2750000,2453125,Jason Hatcher,DE,active,washington-redskins,5203125,2015
41192,4000000,812500,DeAngelo Hall,CB,active,washington-redskins,4812500,2015
41193,3500000,800000,Kory Lichtensteiger,C,active,washington-redskins,4300000,2015
41194,3000000,1099608,Perry Riley,ILB,active,washington-redskins,4099608,2015
41195,3000000,1000000,Shawn Lauvao,G,active,washington-redskins,4000000,2015
41196,1600000,2400000,Dashon Goldson,FS,active,washington-redskins,4000000,2015
41197,950000,3050000,Terrance Knighton,DT,active,washington-redskins,4000000,2015
41198,435000,3422388,Brandon Scherff,G,active,washington-redskins,3857388,2015
41199,1700000,1284375,Chris Baker,DT,active,washington-redskins,2984375,2015
41200,1550000,566668,Logan Paulsen,TE,active,washington-redskins,2116668,2015
41201,1000000,1000000,Ricky Jean Francois,DT,active,washington-redskins,2000000,2015
41202,1250000,583333,Niles Paul,TE,active,washington-redskins,1833333,2015
41203,1542000,30775,Alfred Morris,RB,active,washington-redskins,1572775,2015
41204,1025000,508334,Darrel Young,FB,active,washington-redskins,1533334,2015
41205,850000,525000,Colt McCoy,QB,active,washington-redskins,1375000,2015
41206,800000,409375,Jeron Johnson,SS,active,washington-redskins,1209375,2015
41207,1000000,195000,Kedric Golston,DT,active,washington-redskins,1195000,2015
41208,950000,162500,Nick Sundberg,LS,active,washington-redskins,1112500,2015
41209,435000,615791,Preston Smith,OLB,active,washington-redskins,1050791,2015
41210,623309,393236,Trent Murphy,OLB,active,washington-redskins,1016545,2015
41211,690000,174081,Josh LeRibeus,C,active,washington-redskins,864081,2015
41212,660000,118172,Kirk Cousins,QB,active,washington-redskins,778172,2015
41213,660000,105027,Keenan Robinson,OLB,active,washington-redskins,765027,2015
41214,595000,147278,Jordan Reed,TE,active,washington-redskins,742278,2015
41215,545000,184394,Morgan Moses,RT,active,washington-redskins,729394,2015
41216,510000,163450,Spencer Long,C,active,washington-redskins,673450,2015
41217,660000,0,Tom Compton,T,active,washington-redskins,660000,2015
41218,660000,0,Duke Ihenacho,SS,active,washington-redskins,660000,2015
41219,480000,121500,Bashaud Breeland,CB,active,washington-redskins,601500,2015
41220,585000,0,Chris Thompson,RB,active,washington-redskins,585000,2015
41221,435000,149853,Matt Jones,RB,active,washington-redskins,584853,2015
41222,435000,136406,Jamison Crowder,WR,active,washington-redskins,571406,2015
41223,435000,130417,Arie Kouandjio,G,active,washington-redskins,565417,2015
41224,510000,53403,Ryan Grant,WR,active,washington-redskins,563403,2015
41225,818823,0,Will Blackmon,CB,active,washington-redskins,818823,2015
41226,510000,2666,Silas Redd,RB,active,washington-redskins,512666,2015
41227,510000,0,Will Compton,ILB,active,washington-redskins,510000,2015
41228,510000,0,Ty Nsekhe,LT,active,washington-redskins,510000,2015
41229,510000,0,Tress Way,P,active,washington-redskins,510000,2015
41230,504705,0,Frank Kearse,DE,active,washington-redskins,504705,2015
41231,613529,0,Mason Foster,ILB,active,washington-redskins,613529,2015
41232,480000,0,Dustin Hopkins,K,active,washington-redskins,480000,2015
41233,435000,0,Rashad Ross,WR,active,washington-redskins,435000,2015
41234,413000,0,Junior Galette,OLB,active,washington-redskins,413000,2015
41235,331764,59487,Martrell Spaight,ILB,active,washington-redskins,391251,2015
41236,358235,0,Quinton Dunbar,CB,active,washington-redskins,358235,2015
41237,358235,0,Deshazor Everett,SS,active,washington-redskins,358235,2015
41238,290294,0,Houston Bates,OLB,active,washington-redskins,290294,2015
41239,175294,0,Pierre Thomas,RB,active,washington-redskins,175294,2015
41240,153529,0,Dashaun Phillips,CB,active,washington-redskins,153529,2015
41241,127941,0,Carlos Fields,OLB,active,washington-redskins,127941,2015
41242,153529,0,Alex Smith,TE,active,washington-redskins,153529,2015
41243,51176,0,Marcel Jensen,TE,active,washington-redskins,51176,2015
41244,25588,0,Jeremy Harris,CB,active,washington-redskins,25588,2015
41245,0,0,Cary Williams,CB,active,washington-redskins,0,2015
41246,2850000,1400000,Stephen Paea,DT,injured_reserve,washington-redskins,4250000,2015
41247,2823529,1250000,Chris Culliver,CB,injured_reserve,washington-redskins,4073529,2015
41248,2750000,1000000,Andre Roberts,WR,injured_reserve,washington-redskins,3750000,2015
41249,870000,120625,Adam Hayward,OLB,injured_reserve,washington-redskins,990625,2015
41250,585000,0,Derek Carrier,TE,injured_reserve,washington-redskins,585000,2015
41251,435000,33907,Kyshoen Jarrett,FS,injured_reserve,washington-redskins,468907,2015
41252,416294,0,Jackson Jeffcoat,OLB,injured_reserve,washington-redskins,416294,2015
41253,318000,0,James Gayle,DE,injured_reserve,washington-redskins,318000,2015
41254,0,5310000,Barry Cofield,DT,dead_cap,washington-redskins,5310000,2015
41255,0,2520000,Stephen Bowen,DE,dead_cap,washington-redskins,2520000,2015
41256,0,1000000,Tracy Porter,CB,dead_cap,washington-redskins,1000000,2015
41257,0,800000,Chris Chester,G,dead_cap,washington-redskins,800000,2015
41258,660000,0,Anthony McCoy,TE,dead_cap,washington-redskins,660000,2015
41259,543529,23438,Trenton Robinson,FS,dead_cap,washington-redskins,566967,2015
41260,82950,345164,David Amerson,CB,dead_cap,washington-redskins,428114,2015
41261,350588,0,Brian De La Puente,C,dead_cap,washington-redskins,350588,2015
41262,259588,0,Jackson Jeffcoat,OLB,dead_cap,washington-redskins,259588,2015
41263,0,250000,Clifton Geathers,DE,dead_cap,washington-redskins,250000,2015
41264,0,212602,Phillip Thomas,SS,dead_cap,washington-redskins,212602,2015
41265,200541,0,Je'Ron Hamm,WR,dead_cap,washington-redskins,200541,2015
41266,175294,0,Justin Rogers,CB,dead_cap,washington-redskins,175294,2015
41267,119700,833,Takoby Cofield,T,dead_cap,washington-redskins,120533,2015
41268,112200,2500,Corey Crawford,DE,dead_cap,washington-redskins,114700,2015
41269,112135,833,Tony Jones,WR,dead_cap,washington-redskins,112968,2015
41270,92400,18731,Austin Reiter,C,dead_cap,washington-redskins,111131,2015
41271,0,100000,Mike McGlynn,G,dead_cap,washington-redskins,100000,2015
41272,0,92500,Chris Thompson,RB,dead_cap,washington-redskins,92500,2015
41273,90705,0,Kai Forbath,K,dead_cap,washington-redskins,90705,2015
41274,85800,0,Issac Blakeney,WR,dead_cap,washington-redskins,85800,2015
41275,0,84430,Brandon Jenkins,OLB,dead_cap,washington-redskins,84430,2015
41276,0,82875,Lache Seastrunk,RB,dead_cap,washington-redskins,82875,2015
41277,79200,0,Deveron Carr,CB,dead_cap,washington-redskins,79200,2015
41278,77646,0,Frank Kearse,DE,dead_cap,washington-redskins,77646,2015
41279,71788,0,Houston Bates,OLB,dead_cap,washington-redskins,71788,2015
41280,66000,0,Dashaun Phillips,CB,dead_cap,washington-redskins,66000,2015
41281,57776,0,Terrance Plummer,ILB,dead_cap,washington-redskins,57776,2015
41282,56117,0,Jordan Campbell,OLB,dead_cap,washington-redskins,56117,2015
41283,52800,0,Laron Byrd,WR,dead_cap,washington-redskins,52800,2015
41284,52800,0,Anthony Johnson,DE,dead_cap,washington-redskins,52800,2015
41285,52800,0,Mack Brown,RB,dead_cap,washington-redskins,52800,2015
41286,0,51675,Ted Bolser,TE,dead_cap,washington-redskins,51675,2015
41287,0,50836,Bacarri Rambo,SS,dead_cap,washington-redskins,50836,2015
41288,0,50493,Adam Gettis,G,dead_cap,washington-redskins,50493,2015
41289,46200,0,Lynden Trail,OLB,dead_cap,washington-redskins,46200,2015
41290,0,45186,Zach Hocker,K,dead_cap,washington-redskins,45186,2015
41291,39600,0,Derrick Mathews,ILB,dead_cap,washington-redskins,39600,2015
41292,39600,0,Trey Williams,RB,dead_cap,washington-redskins,39600,2015
41293,0,33291,Tevin Mitchel,CB,dead_cap,washington-redskins,33291,2015
41294,0,31644,Evan Spencer,WR,dead_cap,washington-redskins,31644,2015
41295,26400,0,Jeremy Harris,CB,dead_cap,washington-redskins,26400,2015
41296,26400,0,Nico Johnson,ILB,dead_cap,washington-redskins,26400,2015
41297,26400,0,Christine Michael,RB,dead_cap,washington-redskins,26400,2015
41298,19800,333,Quinton Dunbar,CB,dead_cap,washington-redskins,20133,2015
41299,19800,0,Ryan Delaire,DE,dead_cap,washington-redskins,19800,2015
41300,19800,0,Deshazor Everett,SS,dead_cap,washington-redskins,19800,2015
41301,19800,0,Carlos Fields,OLB,dead_cap,washington-redskins,19800,2015
41302,19800,0,Colin Lockett,TE,dead_cap,washington-redskins,19800,2015
41303,0,15933,Richard Crawford,CB,dead_cap,washington-redskins,15933,2015
41304,13200,0,Corey Washington,WR,dead_cap,washington-redskins,13200,2015
41305,0,8000,Robert Thomas,DT,dead_cap,washington-redskins,8000,2015
41306,0,7500,Connor Halliday,QB,dead_cap,washington-redskins,7500,2015
41307,6600,0,Ray Agnew,FB,dead_cap,washington-redskins,6600,2015
41308,6600,0,Ray Hamilton,TE,dead_cap,washington-redskins,6600,2015
41309,6600,0,Sage Harold,DE,dead_cap,washington-redskins,6600,2015
41310,6600,0,Kamal Johnson,DT,dead_cap,washington-redskins,6600,2015
41311,0,5334,Bryan Shepherd,CB,dead_cap,washington-redskins,5334,2015
41312,0,5000,Cody Hoffman,WR,dead_cap,washington-redskins,5000,2015
41313,0,2667,Rashad Lawrence,WR,dead_cap,washington-redskins,2667,2015
41314,0,2500,Brey Cook,T,dead_cap,washington-redskins,2500,2015
41315,0,1334,Lee Doss,WR,dead_cap,washington-redskins,1334,2015
41316,0,1334,Jeremy Kimbrough,ILB,dead_cap,washington-redskins,1334,2015
41317,0,1000,Tyler Rutenbeck,WR,dead_cap,washington-redskins,1000,2015
41318,0,833,Devin Mahina,TE,dead_cap,washington-redskins,833,2015
41319,0,333,Reggie Bell,WR,dead_cap,washington-redskins,333,2015
41320,0,333,Dyshawn Davis,LB,dead_cap,washington-redskins,333,2015
41321,19953000,0,Kirk Cousins,QB,active,washington-redskins,19953000,2016
41322,7600000,2600000,Pierre Garcon,WR,active,washington-redskins,10200000,2016
41323,3750000,5500000,DeSean Jackson,WR,active,washington-redskins,9250000,2016
41324,5161764,5650510,Trent Williams,LT,active,washington-redskins,10812274,2016
41325,5000000,3450000,Ryan Kerrigan,OLB,active,washington-redskins,8450000,2016
41326,5000000,3000000,Josh Norman,CB,active,washington-redskins,8000000,2016
41327,4000000,1000000,Shawn Lauvao,G,active,washington-redskins,5000000,2016
41328,525000,4296735,Brandon Scherff,G,active,washington-redskins,4821735,2016
41329,2700000,1575000,Chris Baker,DT,active,washington-redskins,4275000,2016
41330,1250000,2156028,Jordan Reed,TE,active,washington-redskins,3406028,2016
41331,2000000,1000000,Ricky Jean Francois,DT,active,washington-redskins,3000000,2016
41332,2000000,628125,Kory Lichtensteiger,C,active,washington-redskins,2628125,2016
41333,1350000,1031250,Vernon Davis,TE,active,washington-redskins,2381250,2016
41334,1000000,800000,Colt McCoy,QB,active,washington-redskins,1800000,2016
41335,697698,615792,Preston Smith,OLB,active,washington-redskins,1313490,2016
41336,826618,393236,Trent Murphy,OLB,active,washington-redskins,1219854,2016
41337,1000000,162500,Nick Sundberg,LS,active,washington-redskins,1162500,2016
41338,925000,175000,Mason Foster,ILB,active,washington-redskins,1100000,2016
41339,900000,75000,Will Blackmon,CB,active,washington-redskins,975000,2016
41340,927058,0,Cullen Jenkins,DE,active,washington-redskins,927058,2016
41341,800000,100000,Derek Carrier,TE,active,washington-redskins,900000,2016
41342,680000,184394,Morgan Moses,RT,active,washington-redskins,864394,2016
41343,600000,250000,Tress Way,P,active,washington-redskins,850000,2016
41344,450000,355630,Su'a Cravens,S,active,washington-redskins,805630,2016
41345,600000,163450,Spencer Long,C,active,washington-redskins,763450,2016
41346,675000,75000,Terence Garvin,ILB,active,washington-redskins,750000,2016
41347,728823,0,John Sullivan,C,active,washington-redskins,728823,2016
41348,600000,121500,Bashaud Breeland,CB,active,washington-redskins,721500,2016
41349,539000,159854,Matt Jones,RB,active,washington-redskins,698854,2016
41350,760000,80000,Greg Toler,CB,active,washington-redskins,840000,2016
41351,675000,0,Duke Ihenacho,SS,active,washington-redskins,675000,2016
41352,675000,0,Chris Thompson,RB,active,washington-redskins,675000,2016
41353,525000,136406,Jamison Crowder,WR,active,washington-redskins,661406,2016
41354,525000,130417,Arie Kouandjio,G,active,washington-redskins,655417,2016
41355,600000,53403,Ryan Grant,WR,active,washington-redskins,653403,2016
41356,450000,179606,Kendall Fuller,CB,active,washington-redskins,629606,2016
41357,885000,25625,Evander Hood,DE,active,washington-redskins,910625,2016
41358,600000,0,Will Compton,ILB,active,washington-redskins,600000,2016
41359,600000,0,Dustin Hopkins,K,active,washington-redskins,600000,2016
41360,600000,0,Ty Nsekhe,LT,active,washington-redskins,600000,2016
41361,525000,0,Quinton Dunbar,CB,active,washington-redskins,525000,2016
41362,525000,0,Deshazor Everett,SS,active,washington-redskins,525000,2016
41363,450000,59487,Martrell Spaight,ILB,active,washington-redskins,509487,2016
41364,450000,34333,Nate Sudfeld,QB,active,washington-redskins,484333,2016
41365,450000,1000,Rob Kelley,RB,active,washington-redskins,451000,2016
41366,432348,0,Vinston Painter,RT,active,washington-redskins,432348,2016
41367,397058,0,Matthew Ioannidis,DE,active,washington-redskins,397058,2016
41368,291170,0,Maurice Harris,WR,active,washington-redskins,291170,2016
41369,264700,0,Mack Brown,RB,active,washington-redskins,264700,2016
41370,61764,0,Dashaun Phillips,CB,active,washington-redskins,61764,2016
41371,61764,0,Zach Vigil,OLB,active,washington-redskins,61764,2016
41372,52940,0,Lynden Trail,OLB,active,washington-redskins,52940,2016
41373,39705,0,Josh Evans,SS,active,washington-redskins,39705,2016
41374,4250000,812500,DeAngelo Hall,CB,injured_reserve,washington-redskins,5062500,2016
41375,338288,1377207,Josh Doctson,WR,injured_reserve,washington-redskins,1715495,2016
41376,1250000,333333,Niles Paul,TE,injured_reserve,washington-redskins,1583333,2016
41377,985000,20000,Kedric Golston,DT,injured_reserve,washington-redskins,1005000,2016
41378,525000,0,Houston Bates,OLB,injured_reserve,washington-redskins,525000,2016
41379,753235,0,Donte Whitner,SS,injured_reserve,washington-redskins,753235,2016
41380,450000,2666,Anthony Lanier,DE,injured_reserve,washington-redskins,452666,2016
41381,333000,19324,Steven Daniels,ILB,injured_reserve,washington-redskins,352324,2016
41382,333000,16387,Keith Marshall,RB,injured_reserve,washington-redskins,349387,2016
41383,333000,2333,Kevin Bowen,T,injured_reserve,washington-redskins,335333,2016
41384,333000,666,Reginald Diggs,WR,injured_reserve,washington-redskins,333666,2016
41385,500000,100000,Junior Galette,OLB,non_fb_injury,washington-redskins,600000,2016
41386,0,4500000,Jason Hatcher,DE,dead_cap,washington-redskins,4500000,2016
41387,0,2000000,Andre Roberts,WR,dead_cap,washington-redskins,2000000,2016
41388,900000,833333,David Bruton,SS,dead_cap,washington-redskins,1733333,2016
41389,1400000,125000,Kendall Reyes,DE,dead_cap,washington-redskins,1525000,2016
41390,0,1250000,Chris Culliver,CB,dead_cap,washington-redskins,1250000,2016
41391,0,1250000,Stephen Paea,DT,dead_cap,washington-redskins,1250000,2016
41392,0,1099608,Perry Riley,ILB,dead_cap,washington-redskins,1099608,2016
41393,463230,0,Rashad Ross,WR,dead_cap,washington-redskins,463230,2016
41394,336420,0,Dashaun Phillips,CB,dead_cap,washington-redskins,336420,2016
41395,0,295164,David Amerson,CB,dead_cap,washington-redskins,295164,2016
41396,0,175000,Jeron Johnson,SS,dead_cap,washington-redskins,175000,2016
41397,119117,0,Josh Evans,SS,dead_cap,washington-redskins,119117,2016
41398,117300,0,Wes Saxton,TE,dead_cap,washington-redskins,117300,2016
41399,117300,0,Kendal Thompson,WR,dead_cap,washington-redskins,117300,2016
41400,117300,0,Isaiah Williams,WR,dead_cap,washington-redskins,117300,2016
41401,104294,0,A.J. Francis,DE,dead_cap,washington-redskins,104294,2016
41402,103500,0,Ronald Patrick,C,dead_cap,washington-redskins,103500,2016
41403,0,100000,Adam Hayward,OLB,dead_cap,washington-redskins,100000,2016
41404,0,99873,Tevin Mitchel,CB,dead_cap,washington-redskins,99873,2016
41405,96600,0,Tye Smith,CB,dead_cap,washington-redskins,96600,2016
41406,0,94932,Evan Spencer,WR,dead_cap,washington-redskins,94932,2016
41407,33370,56193,Austin Reiter,C,dead_cap,washington-redskins,89563,2016
41408,82800,0,Joey Mbu,DT,dead_cap,washington-redskins,82800,2016
41409,0,80000,Josh LeRibeus,C,dead_cap,washington-redskins,80000,2016
41410,79410,0,Blaine Clausell,T,dead_cap,washington-redskins,79410,2016
41411,13800,61223,Matthew Ioannidis,DE,dead_cap,washington-redskins,75023,2016
41412,69000,0,Matt Hazel,WR,dead_cap,washington-redskins,69000,2016
41413,52940,0,Rick Lovato,LS,dead_cap,washington-redskins,52940,2016
41414,48300,0,Mack Brown,RB,dead_cap,washington-redskins,48300,2016
41415,48300,0,Carlos Fields,OLB,dead_cap,washington-redskins,48300,2016
41416,41400,1166,Maurice Harris,WR,dead_cap,washington-redskins,42566,2016
41417,39705,0,Jordan Hill,DT,dead_cap,washington-redskins,39705,2016
41418,39705,0,Nick Moody,ILB,dead_cap,washington-redskins,39705,2016
41419,0,35000,Logan Paulsen,TE,dead_cap,washington-redskins,35000,2016
41420,34500,0,Lee Hightower,S,dead_cap,washington-redskins,34500,2016
41421,0,33907,Kyshoen Jarrett,FS,dead_cap,washington-redskins,33907,2016
41422,27600,0,Bobby Richardson,DE,dead_cap,washington-redskins,27600,2016
41423,20700,0,Jason Fanaika,DE,dead_cap,washington-redskins,20700,2016
41424,20700,0,Vinston Painter,RT,dead_cap,washington-redskins,20700,2016
41425,20700,0,Shakiel Randolph,S,dead_cap,washington-redskins,20700,2016
41426,20700,0,Lynden Trail,OLB,dead_cap,washington-redskins,20700,2016
41427,0,16667,Takoby Cofield,T,dead_cap,washington-redskins,16667,2016
41428,13800,0,Trevon Coley,DT,dead_cap,washington-redskins,13800,2016
41429,13800,0,Louis Nix,DT,dead_cap,washington-redskins,13800,2016
41430,6900,0,Lloyd Carrington,CB,dead_cap,washington-redskins,6900,2016
41431,6900,0,Robertson Daniel,CB,dead_cap,washington-redskins,6900,2016
41432,6900,0,Amarlo Herrera,ILB,dead_cap,washington-redskins,6900,2016
41433,6900,0,Rufus Johnson,OLB,dead_cap,washington-redskins,6900,2016
41434,6900,0,Nila Kasitati,G,dead_cap,washington-redskins,6900,2016
41435,6900,0,Joe Kerridge,FB,dead_cap,washington-redskins,6900,2016
41436,0,5000,Corey Crawford,DE,dead_cap,washington-redskins,5000,2016
41437,0,5000,Dominick Jackson,T,dead_cap,washington-redskins,5000,2016
41438,0,4000,Tevin Carter,S,dead_cap,washington-redskins,4000,2016
41439,0,3000,Joe Gore,T,dead_cap,washington-redskins,3000,2016
41440,0,2668,Silas Redd,RB,dead_cap,washington-redskins,2668,2016
41441,0,1667,Tony Jones,WR,dead_cap,washington-redskins,1667,2016
41442,0,1667,Devin Mahina,TE,dead_cap,washington-redskins,1667,2016
41443,0,1666,Shiro Davis,DE,dead_cap,washington-redskins,1666,2016
41444,0,1666,Geno Matias-Smith,S,dead_cap,washington-redskins,1666,2016
41445,0,667,Reggie Bell,WR,dead_cap,washington-redskins,667,2016
41446,0,667,Dyshawn Davis,LB,dead_cap,washington-redskins,667,2016
41447,0,667,Quinton Dunbar,CB,dead_cap,washington-redskins,667,2016
41448,0,500,Michael Cooper,TE,dead_cap,washington-redskins,500,2016
41449,23943600,0,Kirk Cousins,QB,active,washington-redskins,23943600,2017
41450,16500000,3500000,Josh Norman,CB,active,washington-redskins,20000000,2017
41451,8250000,3450000,Ryan Kerrigan,OLB,active,washington-redskins,11700000,2017
41452,615000,5171082,Brandon Scherff,G,active,washington-redskins,5786082,2017
41453,2250000,1484375,Terrell McClain,DE,active,washington-redskins,3734375,2017
41454,1297000,2324394,Morgan Moses,RT,active,washington-redskins,3621394,2017
41455,2800000,800000,Colt McCoy,QB,active,washington-redskins,3600000,2017
41456,2000000,1333333,Vernon Davis,TE,active,washington-redskins,3333333,2017
41457,2000000,1333333,D.J. Swearinger,FS,active,washington-redskins,3333333,2017
41458,2250000,940625,Stacy McGee,DT,active,washington-redskins,3190625,2017
41459,1550000,1000000,Zach Brown,ILB,active,washington-redskins,2550000,2017
41460,906802,1377207,Josh Doctson,WR,active,washington-redskins,2284009,2017
41461,1750000,458334,Niles Paul,TE,active,washington-redskins,2208334,2017
41462,1797000,121500,Bashaud Breeland,CB,active,washington-redskins,1918500,2017
41463,1100000,812500,DeAngelo Hall,CB,active,washington-redskins,1912500,2017
41464,960395,615792,Preston Smith,OLB,active,washington-redskins,1576187,2017
41465,1100000,400000,Tress Way,P,active,washington-redskins,1500000,2017
41466,900000,400000,Evander Hood,DE,active,washington-redskins,1300000,2017
41467,900000,152500,Nick Sundberg,LS,active,washington-redskins,1052500,2017
41468,465000,503131,Ryan Anderson,OLB,active,washington-redskins,968131,2017
41469,615000,250334,Quinton Dunbar,CB,active,washington-redskins,865334,2017
41470,775000,25000,Junior Galette,OLB,active,washington-redskins,800000,2017
41471,615000,136406,Jamison Crowder,WR,active,washington-redskins,751406,2017
41472,690000,53403,Ryan Grant,WR,active,washington-redskins,743403,2017
41473,557500,179606,Kendall Fuller,CB,active,washington-redskins,737106,2017
41474,775000,80000,Brian Quick,WR,active,washington-redskins,855000,2017
41475,690000,0,Dustin Hopkins,K,active,washington-redskins,690000,2017
41476,690000,0,Ty Nsekhe,LT,active,washington-redskins,690000,2017
41477,615000,59487,Martrell Spaight,ILB,active,washington-redskins,674487,2017
41478,465000,206348,Fabian Moreau,CB,active,washington-redskins,671348,2017
41479,465000,164945,Samaje Perine,RB,active,washington-redskins,629945,2017
41480,615000,0,Quinton Dunbar,CB,active,washington-redskins,615000,2017
41481,615000,0,Deshazor Everett,SS,active,washington-redskins,615000,2017
41482,540000,2666,Anthony Lanier,DE,active,washington-redskins,542666,2017
41483,540000,0,Matthew Ioannidis,DE,active,washington-redskins,540000,2017
41484,465000,69125,Jeremy Sprinkle,TE,active,washington-redskins,534125,2017
41485,465000,36792,Chase Roullier,C,active,washington-redskins,501792,2017
41486,465000,21076,Josh Harvey-Clemons,ILB,active,washington-redskins,486076,2017
41487,465000,20236,Joshua Holsey,CB,active,washington-redskins,485236,2017
41488,455882,0,Tony Bergstrom,C,active,washington-redskins,455882,2017
41489,361765,0,Arie Kouandjio,G,active,washington-redskins,361765,2017
41490,254118,0,Maurice Harris,WR,active,washington-redskins,254118,2017
41491,253235,0,Zach Vigil,OLB,active,washington-redskins,253235,2017
41492,217059,0,A.J. Francis,DE,active,washington-redskins,217059,2017
41493,217059,0,Demetrius Rhaney,C,active,washington-redskins,217059,2017
41494,191471,0,Tyler Catalina,T,active,washington-redskins,191471,2017
41495,109412,0,Robert Davis,WR,active,washington-redskins,109412,2017
41496,109412,0,Kyle Kalis,T,active,washington-redskins,109412,2017
41497,108528,0,Kapri Bibbs,RB,active,washington-redskins,108528,2017
41498,82059,0,Otha Peters,OLB,active,washington-redskins,82059,2017
41499,82059,0,Pete Robertson,OLB,active,washington-redskins,82059,2017
41500,54706,0,Dare Ogunbowale,RB,active,washington-redskins,54706,2017
41501,54706,0,Fish Smithson,S,active,washington-redskins,54706,2017
41502,27353,0,Manasseh Garner,RB,active,washington-redskins,27353,2017
41503,11250000,5619260,Trent Williams,LT,injured_reserve,washington-redskins,16869260,2017
41504,3000000,3000000,Terrelle Pryor,WR,injured_reserve,washington-redskins,6000000,2017
41505,3750000,1987500,Jordan Reed,TE,injured_reserve,washington-redskins,5737500,2017
41506,4000000,1000000,Shawn Lauvao,G,injured_reserve,washington-redskins,5000000,2017
41507,1506800,1000000,Chris Thompson,RB,injured_reserve,washington-redskins,2506800,2017
41508,389294,1643432,Jonathan Allen,DE,injured_reserve,washington-redskins,2032726,2017
41509,1225000,775000,Mason Foster,ILB,injured_reserve,washington-redskins,2000000,2017
41510,1787000,163450,Spencer Long,C,injured_reserve,washington-redskins,1950450,2017
41511,1797000,0,Will Compton,ILB,injured_reserve,washington-redskins,1797000,2017
41512,787591,393236,Trent Murphy,OLB,injured_reserve,washington-redskins,1180827,2017
41513,775000,80000,Chris Carter,ILB,injured_reserve,washington-redskins,855000,2017
41514,615000,0,T.J. Clemmings,RT,injured_reserve,washington-redskins,615000,2017
41515,451235,154723,Montae Nicholson,S,injured_reserve,washington-redskins,605958,2017
41516,467121,1000,Rob Kelley,RB,injured_reserve,washington-redskins,468121,2017
41517,775000,0,Phil Taylor,DT,injured_reserve,washington-redskins,775000,2017
41518,348000,16387,Keith Marshall,RB,injured_reserve,washington-redskins,364387,2017
41519,348000,2333,Kevin Bowen,T,injured_reserve,washington-redskins,350333,2017
41520,476471,0,Arthur Jones,DT,injured_reserve,washington-redskins,476471,2017
41521,222353,0,Byron Marshall,RB,injured_reserve,washington-redskins,222353,2017
41522,164118,0,LeShun Daniels,RB,injured_reserve,washington-redskins,164118,2017
41523,100800,0,Shakeir Ryan,WR,practice_squad,washington-redskins,100800,2017
41524,0,2500000,Chris Culliver,CB,dead_cap,washington-redskins,2500000,2017
41525,0,2500000,Stephen Paea,DT,dead_cap,washington-redskins,2500000,2017
41526,0,1666668,David Bruton,SS,dead_cap,washington-redskins,1666668,2017
41527,0,1250000,DeSean Jackson,WR,dead_cap,washington-redskins,1250000,2017
41528,0,1000000,Ricky Jean Francois,DT,dead_cap,washington-redskins,1000000,2017
41529,0,550000,Kory Lichtensteiger,C,dead_cap,washington-redskins,550000,2017
41530,254120,0,Mack Brown,RB,dead_cap,washington-redskins,254120,2017
41531,246177,0,Stefan McClure,S,dead_cap,washington-redskins,246177,2017
41532,218824,5000,Tyler Catalina,T,dead_cap,washington-redskins,223824,2017
41533,191471,0,Nick Rose,K,dead_cap,washington-redskins,191471,2017
41534,0,183672,Matthew Ioannidis,DE,dead_cap,washington-redskins,183672,2017
41535,0,159854,Matt Jones,RB,dead_cap,washington-redskins,159854,2017
41536,141106,0,Pete Robertson,OLB,dead_cap,washington-redskins,141106,2017
41537,0,130418,Arie Kouandjio,G,dead_cap,washington-redskins,130418,2017
41538,93600,34555,Robert Davis,WR,dead_cap,washington-redskins,128155,2017
41539,121765,0,Caraun Reid,DE,dead_cap,washington-redskins,121765,2017
41540,115200,0,Alex Balducci,G,dead_cap,washington-redskins,115200,2017
41541,115200,0,Manasseh Garner,RB,dead_cap,washington-redskins,115200,2017
41542,108000,0,Fish Smithson,S,dead_cap,washington-redskins,108000,2017
41543,92153,0,Brandon Banks,DE,dead_cap,washington-redskins,92153,2017
41544,79200,0,Ondre Pipkins,DT,dead_cap,washington-redskins,79200,2017
41545,0,75000,Will Blackmon,CB,dead_cap,washington-redskins,75000,2017
41546,0,67814,Kyshoen Jarrett,FS,dead_cap,washington-redskins,67814,2017
41547,64800,2334,Maurice Harris,WR,dead_cap,washington-redskins,67134,2017
41548,0,57972,Steven Daniels,ILB,dead_cap,washington-redskins,57972,2017
41549,57600,0,Keenan Reynolds,WR,dead_cap,washington-redskins,57600,2017
41550,45588,0,Orlando Franklin,G,dead_cap,washington-redskins,45588,2017
41551,43200,0,John Kling,T,dead_cap,washington-redskins,43200,2017
41552,43200,0,Orion Stewart,CB,dead_cap,washington-redskins,43200,2017
41553,36176,0,A.J. Francis,DE,dead_cap,washington-redskins,36176,2017
41554,34553,0,Kenny Hilliard,RB,dead_cap,washington-redskins,34553,2017
41555,0,34334,Nate Sudfeld,QB,dead_cap,washington-redskins,34334,2017
41556,28800,0,Cameron Jefferson,T,dead_cap,washington-redskins,28800,2017
41557,28800,0,Kyle Kalis,T,dead_cap,washington-redskins,28800,2017
41558,28800,0,Otha Peters,OLB,dead_cap,washington-redskins,28800,2017
41559,28800,0,Alex Torgersen,QB,dead_cap,washington-redskins,28800,2017
41560,0,25000,Derek Carrier,TE,dead_cap,washington-redskins,25000,2017
41561,21600,0,Dres Anderson,WR,dead_cap,washington-redskins,21600,2017
41562,21600,0,Kapri Bibbs,RB,dead_cap,washington-redskins,21600,2017
41563,21600,0,Alex McCalister,DE,dead_cap,washington-redskins,21600,2017
41564,21600,0,Tavaris Barnes,DE,dead_cap,washington-redskins,21600,2017
41565,14400,0,Andreas Knappe,T,dead_cap,washington-redskins,14400,2017
41566,14400,0,Givens Price,T,dead_cap,washington-redskins,14400,2017
41567,14400,0,Joel Stave,QB,dead_cap,washington-redskins,14400,2017
41568,14400,0,Jerry Ugokwe,T,dead_cap,washington-redskins,14400,2017
41569,7200,0,LeShun Daniels,RB,dead_cap,washington-redskins,7200,2017
41570,7200,0,Anthony Fabiano,T,dead_cap,washington-redskins,7200,2017
41571,7200,0,Dare Ogunbowale,RB,dead_cap,washington-redskins,7200,2017
41572,0,3334,Shiro Davis,DE,dead_cap,washington-redskins,3334,2017
41573,0,3334,Geno Matias-Smith,S,dead_cap,washington-redskins,3334,2017
41574,0,1334,Reginald Diggs,WR,dead_cap,washington-redskins,1334,2017
41575,0,1000,Michael Cooper,TE,dead_cap,washington-redskins,1000,2017
41576,13300000,3500000,Josh Norman,CB,active,washington-redskins,16800000,2018
41577,9850000,5634885,Trent Williams,LT,active,washington-redskins,15484885,2018
41578,9000000,3450000,Ryan Kerrigan,OLB,active,washington-redskins,12450000,2018
41579,3250000,2150000,Morgan Moses,RT,active,washington-redskins,5400000,2018
41580,3750000,1552083,Vernon Davis,TE,active,washington-redskins,5302083,2018
41581,3750000,925000,Stacy McGee,DT,active,washington-redskins,4675000,2018
41582,3153706,0,HaHa Clinton-Dix,FS,active,washington-redskins,3153706,2018
41583,1996000,1156250,Chris Thompson,RB,active,washington-redskins,3152250,2018
41584,1000000,1953125,Zach Brown,ILB,active,washington-redskins,2953125,2018
41585,2914000,0,Ty Nsekhe,LT,active,washington-redskins,2914000,2018
41586,1363604,1377207,Josh Doctson,WR,active,washington-redskins,2740811,2018
41587,992108,1643432,Jonathan Allen,DE,active,washington-redskins,2635540,2018
41588,480000,2141520,Da'Ron Payne,DT,active,washington-redskins,2621520,2018
41589,1907000,136406,Jamison Crowder,WR,active,washington-redskins,2043406,2018
41590,1223094,615792,Preston Smith,OLB,active,washington-redskins,1838886,2018
41591,1350000,400000,Tress Way,P,active,washington-redskins,1750000,2018
41592,1000000,750000,Mason Foster,ILB,active,washington-redskins,1750000,2018
41593,950000,756250,Pernell McPhee,OLB,active,washington-redskins,1706250,2018
41594,798928,800357,Dustin Hopkins,K,active,washington-redskins,1599285,2018
41595,707033,503131,Ryan Anderson,OLB,active,washington-redskins,1210164,2018
41596,875000,250000,Deshazor Everett,SS,active,washington-redskins,1125000,2018
41597,588000,206348,Fabian Moreau,CB,active,washington-redskins,794348,2018
41598,790000,90000,Tony Bergstrom,C,active,washington-redskins,880000,2018
41599,555000,164945,Samaje Perine,RB,active,washington-redskins,719945,2018
41600,705000,0,Zach Vigil,OLB,active,washington-redskins,705000,2018
41601,1015000,0,Adrian Peterson,RB,active,washington-redskins,1015000,2018
41602,630000,0,Matthew Ioannidis,DE,active,washington-redskins,630000,2018
41603,555000,69125,Jeremy Sprinkle,TE,active,washington-redskins,624125,2018
41604,555000,36792,Chase Roullier,C,active,washington-redskins,591792,2018
41605,555000,21076,Josh Harvey-Clemons,ILB,active,washington-redskins,576076,2018
41606,697065,0,Michael Floyd,WR,active,washington-redskins,697065,2018
41607,555000,0,Caleb Brantley,DT,active,washington-redskins,555000,2018
41608,480000,67010,Tim Settle,DT,active,washington-redskins,547010,2018
41609,480000,39048,Adonis Alexander,CB,active,washington-redskins,519048,2018
41610,480000,38252,Shaun-Dion Hamilton,ILB,active,washington-redskins,518252,2018
41611,480000,18944,Greg Stroman,CB,active,washington-redskins,498944,2018
41612,490589,0,Byron Marshall,RB,active,washington-redskins,490589,2018
41613,359118,0,Jehu Chesson,WR,active,washington-redskins,359118,2018
41614,371765,0,Luke Bowanko,C,active,washington-redskins,371765,2018
41615,322941,0,Mark Sanchez,QB,active,washington-redskins,322941,2018
41616,165882,0,Zac Kerin,C,active,washington-redskins,165882,2018
41617,148235,0,Josh Johnson,QB,active,washington-redskins,148235,2018
41618,97941,0,Kyle Fuller,C,active,washington-redskins,97941,2018
41619,84705,0,Andrew East,LS,active,washington-redskins,84705,2018
41620,84705,0,Matt Flanagan,TE,active,washington-redskins,84705,2018
41621,65294,0,Harlan Miller,CB,active,washington-redskins,65294,2018
41622,56470,0,Darvin Kidsy,WR,active,washington-redskins,56470,2018
41623,56470,0,Timon Parris,T,active,washington-redskins,56470,2018
41624,56470,0,Jeremy Reaves,S,active,washington-redskins,56470,2018
41625,41471,0,Marquis Flowers,OLB,active,washington-redskins,41471,2018
41626,46471,0,Marcus Smith,DE,active,washington-redskins,46471,2018
41627,28235,0,Alex Carter,S,active,washington-redskins,28235,2018
41628,28235,0,J.P. Holtz,TE,active,washington-redskins,28235,2018
41629,13000000,5400000,Alex Smith,QB,injured_reserve,washington-redskins,18400000,2018
41630,8250000,2003125,Jordan Reed,TE,injured_reserve,washington-redskins,10253125,2018
41631,705000,6045432,Brandon Scherff,G,injured_reserve,washington-redskins,6750432,2018
41632,1500000,2218750,Paul Richardson,WR,injured_reserve,washington-redskins,3718750,2018
41633,2800000,756860,Colt McCoy,QB,injured_reserve,washington-redskins,3556860,2018
41634,750000,1750000,Quinton Dunbar,CB,injured_reserve,washington-redskins,2500000,2018
41635,950000,378125,Shawn Lauvao,G,injured_reserve,washington-redskins,1328125,2018
41636,915000,152500,Nick Sundberg,LS,injured_reserve,washington-redskins,1067500,2018
41637,480000,345806,Derrius Guice,RB,injured_reserve,washington-redskins,825806,2018
41638,705000,0,Arie Kouandjio,G,injured_reserve,washington-redskins,705000,2018
41639,431814,242248,Geron Christian,T,injured_reserve,washington-redskins,674062,2018
41640,630000,1000,Rob Kelley,RB,injured_reserve,washington-redskins,631000,2018
41641,616059,0,Maurice Harris,WR,injured_reserve,washington-redskins,616059,2018
41642,418048,175908,Troy Apke,S,injured_reserve,washington-redskins,593956,2018
41643,466229,3333,Danny Johnson,CB,injured_reserve,washington-redskins,469562,2018
41644,430588,0,Austin Howard,RT,injured_reserve,washington-redskins,430588,2018
41645,383633,17267,Trey Quinn,WR,injured_reserve,washington-redskins,400900,2018
41646,378000,0,Tyler Catalina,T,injured_reserve,washington-redskins,378000,2018
41647,378000,0,Robert Davis,WR,injured_reserve,washington-redskins,378000,2018
41648,371765,0,Jonathan Cooper,G,injured_reserve,washington-redskins,371765,2018
41649,369882,0,Cam Sims,WR,injured_reserve,washington-redskins,369882,2018
41650,363000,0,Manasseh Garner,RB,injured_reserve,washington-redskins,363000,2018
41651,191470,0,Cassanova Mckinzy,OLB,injured_reserve,washington-redskins,191470,2018
41652,77117,0,Joshua Holsey,CB,injured_reserve,washington-redskins,77117,2018
41653,555000,154723,Montae Nicholson,SS,non_fb_injury,washington-redskins,709723,2018
41654,0,0,Chris Cooper,S,practice_squad,washington-redskins,0,2018
41655,2823529,1333333,D.J. Swearinger,FS,dead_cap,washington-redskins,4156862,2018
41656,0,3750000,Terrell McClain,DE,dead_cap,washington-redskins,3750000,2018
41657,1200000,228125,Evander Hood,DE,dead_cap,washington-redskins,1428125,2018
41658,0,711262,Su'a Cravens,S,dead_cap,washington-redskins,711262,2018
41659,512847,0,Kapri Bibbs,RB,dead_cap,washington-redskins,512847,2018
41660,0,500000,Orlando Scandrick,CB,dead_cap,washington-redskins,500000,2018
41661,418235,90000,Brian Quick,WR,dead_cap,washington-redskins,508235,2018
41662,356871,20236,Joshua Holsey,CB,dead_cap,washington-redskins,377107,2018
41663,0,359212,Kendall Fuller,CB,dead_cap,washington-redskins,359212,2018
41664,335553,0,Casey Dunn,C,dead_cap,washington-redskins,335553,2018
41665,268776,0,Kenny Ladler,SS,dead_cap,washington-redskins,268776,2018
41666,0,149854,Matt Jones,RB,dead_cap,washington-redskins,149854,2018
41667,0,130418,Arie Kouandjio,G,dead_cap,washington-redskins,130418,2018
41668,129200,0,Jojo Wicker,DE,dead_cap,washington-redskins,129200,2018
41669,121600,0,J.P. Holtz,TE,dead_cap,washington-redskins,121600,2018
41670,114000,0,Darvin Kidsy,WR,dead_cap,washington-redskins,114000,2018
41671,114000,0,Timon Parris,T,dead_cap,washington-redskins,114000,2018
41672,106400,0,Simmie Cobbs Jr.,WR,dead_cap,washington-redskins,106400,2018
41673,106400,0,Matt Flanagan,TE,dead_cap,washington-redskins,106400,2018
41674,0,103666,Robert Davis,WR,dead_cap,washington-redskins,103666,2018
41675,70647,0,Jehu Chesson,WR,dead_cap,washington-redskins,70647,2018
41676,0,68668,Nate Sudfeld,QB,dead_cap,washington-redskins,68668,2018
41677,60800,0,Cassanova Mckinzy,DE,dead_cap,washington-redskins,60800,2018
41678,60800,0,Jeremy Reaves,S,dead_cap,washington-redskins,60800,2018
41679,0,59488,Martrell Spaight,ILB,dead_cap,washington-redskins,59488,2018
41680,45600,0,Mack Brown,RB,dead_cap,washington-redskins,45600,2018
41681,41471,0,Josh Keyes,ILB,dead_cap,washington-redskins,41471,2018
41682,41471,0,Demetrius Rhaney,C,dead_cap,washington-redskins,41471,2018
41683,38000,0,Josh Carraway,OLB,dead_cap,washington-redskins,38000,2018
41684,46471,0,Marcus Smith,DE,dead_cap,washington-redskins,46471,2018
41685,30400,0,Justin Evans,G,dead_cap,washington-redskins,30400,2018
41686,22800,0,Chris Durant,T,dead_cap,washington-redskins,22800,2018
41687,22800,0,Roubbens Joseph,T,dead_cap,washington-redskins,22800,2018
41688,0,16387,Keith Marshall,RB,dead_cap,washington-redskins,16387,2018
41689,15200,0,Montay Crockett,WR,dead_cap,washington-redskins,15200,2018
41690,15200,0,Russell Hansbrough,RB,dead_cap,washington-redskins,15200,2018
41691,15200,0,Jarron Jones,DT,dead_cap,washington-redskins,15200,2018
41692,15200,0,Jack Tocho,CB,dead_cap,washington-redskins,15200,2018
41693,0,10000,Tyler Catalina,T,dead_cap,washington-redskins,10000,2018
41694,7600,0,Alex Carter,S,dead_cap,washington-redskins,7600,2018
41695,7600,0,Carlos Henderson,WR,dead_cap,washington-redskins,7600,2018
41696,7600,0,Teo Redding,WR,dead_cap,washington-redskins,7600,2018
41697,7600,0,ArDarius Stewart,WR,dead_cap,washington-redskins,7600,2018
41698,0,2668,Anthony Lanier,DE,dead_cap,washington-redskins,2668,2018
41699,0,2334,Kevin Bowen,T,dead_cap,washington-redskins,2334,2018
41700,10800000,3437500,Josh Norman,CB,active,washington-redskins,14237500,2019
41701,4750000,2150000,Morgan Moses,RT,active,washington-redskins,6900000,2019
41702,2750000,1171875,Chris Thompson,RB,active,washington-redskins,3921875,2019
41703,825000,3000000,Landon Collins,SS,active,washington-redskins,3825000,2019
41704,3500000,0,Case Keenum,QB,active,washington-redskins,3500000,2019
41705,1135380,2141520,Da'Ron Payne,DT,active,washington-redskins,3276900,2019
41706,2000000,1250000,Ereck Flowers,G,active,washington-redskins,3250000,2019
41707,2275000,950357,Dustin Hopkins,K,active,washington-redskins,3225357,2019
41708,1519216,1643432,Jonathan Allen,DE,active,washington-redskins,3162648,2019
41709,3000000,93750,Colt McCoy,QB,active,washington-redskins,3093750,2019
41710,495000,2126202,Dwayne Haskins,QB,active,washington-redskins,2621202,2019
41711,1025000,1500000,Matthew Ioannidis,DE,active,washington-redskins,2525000,2019
41712,495000,1621593,Montez Sweat,OLB,active,washington-redskins,2116593,2019
41713,1030000,1000000,Donald Penn,RT,active,washington-redskins,2030000,2019
41714,1500000,500000,Tress Way,P,active,washington-redskins,2000000,2019
41715,1030000,750000,Adrian Peterson,RB,active,washington-redskins,1780000,2019
41716,949066,503131,Ryan Anderson,OLB,active,washington-redskins,1452197,2019
41717,930000,152500,Nick Sundberg,LS,active,washington-redskins,1082500,2019
41718,647000,242248,Geron Christian,T,active,washington-redskins,889248,2019
41719,757647,0,Aaron Colvin,CB,active,washington-redskins,757647,2019
41720,570000,175908,Troy Apke,S,active,washington-redskins,745908,2019
41721,495000,250805,Terry McLaurin,WR,active,washington-redskins,745805,2019
41722,805000,90000,Tony Bergstrom,C,active,washington-redskins,895000,2019
41723,805000,90000,Jon Bostic,ILB,active,washington-redskins,895000,2019
41724,720000,0,Wendell Smallwood,RB,active,washington-redskins,720000,2019
41725,645000,69125,Jeremy Sprinkle,TE,active,washington-redskins,714125,2019
41726,645000,36792,Chase Roullier,C,active,washington-redskins,681792,2019
41727,645000,21076,Josh Harvey-Clemons,ILB,active,washington-redskins,666076,2019
41728,495000,162702,Wes Martin,G,active,washington-redskins,657702,2019
41729,645000,0,Treyvon Hester,DE,active,washington-redskins,645000,2019
41730,570000,67010,Tim Settle,DT,active,washington-redskins,637010,2019
41731,570000,38252,Shaun-Dion Hamilton,ILB,active,washington-redskins,608252,2019
41732,495000,77706,Ross Pierschbacher,G,active,washington-redskins,572706,2019
41733,495000,58721,Cole Holcomb,LB,active,washington-redskins,553721,2019
41734,495000,31960,Kelvin Harmon,WR,active,washington-redskins,526960,2019
41735,495000,5000,Steven Sims Jr.,WR,active,washington-redskins,500000,2019
41736,520882,0,Michael Burton,FB,active,washington-redskins,520882,2019
41737,349416,0,Hale Hentges,TE,active,washington-redskins,349416,2019
41738,349416,0,Jeremy Reaves,S,active,washington-redskins,349416,2019
41739,236765,0,Nate Orchard,DE,active,washington-redskins,236765,2019
41740,174706,0,Cam Sims,WR,active,washington-redskins,174706,2019
41741,167647,0,Chris Odom,DE,active,washington-redskins,167647,2019
41742,116472,0,Darvin Kidsy,WR,active,washington-redskins,116472,2019
41743,113824,0,Josh Ferguson,RB,active,washington-redskins,113824,2019
41744,99412,0,Coty Sensabaugh,CB,active,washington-redskins,99412,2019
41745,99412,0,Kayvon Webster,CB,active,washington-redskins,99412,2019
41746,87354,0,Timon Parris,T,active,washington-redskins,87354,2019
41747,87353,0,Caleb Wilson,TE,active,washington-redskins,87353,2019
41748,67058,0,Maurice Smith,S,active,washington-redskins,67058,2019
41749,37941,0,Kenny Ladler,SS,active,washington-redskins,37941,2019
41750,33529,0,Breon Borders,CB,active,washington-redskins,33529,2019
41751,29118,0,Dee Delaney,CB,active,washington-redskins,29118,2019
41752,29118,0,Jester Weah,WR,active,washington-redskins,29118,2019
41753,10500000,3387500,Ryan Kerrigan,OLB,injured_reserve,washington-redskins,13887500,2019
41754,12525000,0,Brandon Scherff,G,injured_reserve,washington-redskins,12525000,2019
41755,7671000,1800000,Jordan Reed,TE,injured_reserve,washington-redskins,9471000,2019
41756,4850000,2312500,Paul Richardson,WR,injured_reserve,washington-redskins,7162500,2019
41757,4700000,1395834,Vernon Davis,TE,injured_reserve,washington-redskins,6095834,2019
41758,2900000,1921875,Quinton Dunbar,CB,injured_reserve,washington-redskins,4821875,2019
41759,1225000,484375,Deshazor Everett,SS,injured_reserve,washington-redskins,1709375,2019
41760,1286392,0,Reuben Foster,ILB,injured_reserve,washington-redskins,1286392,2019
41761,686452,345806,Derrius Guice,RB,injured_reserve,washington-redskins,1032258,2019
41762,684000,206348,Fabian Moreau,CB,injured_reserve,washington-redskins,890348,2019
41763,645000,154723,Montae Nicholson,S,injured_reserve,washington-redskins,799723,2019
41764,570000,17267,Trey Quinn,WR,injured_reserve,washington-redskins,587267,2019
41765,531176,0,Jerome Cunningham,TE,injured_reserve,washington-redskins,531176,2019
41766,495000,24473,Jimmy Moreland,CB,injured_reserve,washington-redskins,519473,2019
41767,507529,3333,Danny Johnson,CB,injured_reserve,washington-redskins,510862,2019
41768,435882,45000,Dominique Rodgers-Cromartie,CB,injured_reserve,washington-redskins,480882,2019
41769,403411,18944,Greg Stroman,CB,injured_reserve,washington-redskins,422355,2019
41770,421941,0,Caleb Brantley,DE,injured_reserve,washington-redskins,421941,2019
41771,378000,18644,Jordan Brailford,OLB,injured_reserve,washington-redskins,396644,2019
41772,378000,0,Myles Humphrey,DE,injured_reserve,washington-redskins,378000,2019
41773,378000,0,Josh Woodrum,QB,injured_reserve,washington-redskins,378000,2019
41774,136000,0,Jehu Chesson,WR,injured_reserve,washington-redskins,136000,2019
41775,96000,0,Cassanova Mckinzy,OLB,injured_reserve,washington-redskins,96000,2019
41776,10850000,4574113,Trent Williams,LT,non_fb_injury,washington-redskins,15424113,2019
41777,453706,188583,Bryce Love,RB,non_fb_injury,washington-redskins,642289,2019
41778,56000,0,Keith Towbridge,TE,practice_squad,washington-redskins,56000,2019
41779,48000,0,Jojo Wicker,DE,practice_squad,washington-redskins,48000,2019
41780,24000,0,Derrick Gore,RB,practice_squad,washington-redskins,24000,2019
41781,24000,0,Pete Robertson,OLB,practice_squad,washington-redskins,24000,2019
41782,0,3000000,Zach Brown,ILB,dead_cap,washington-redskins,3000000,2019
41783,1142758,1377210,Josh Doctson,WR,dead_cap,washington-redskins,2519968,2019
41784,0,2400000,Stacy McGee,DT,dead_cap,washington-redskins,2400000,2019
41785,0,1333334,D.J. Swearinger,FS,dead_cap,washington-redskins,1333334,2019
41786,0,500000,Orlando Scandrick,CB,dead_cap,washington-redskins,500000,2019
41787,417351,0,Tanner Vallejo,OLB,dead_cap,washington-redskins,417351,2019
41788,381176,0,Noah Spence,DE,dead_cap,washington-redskins,381176,2019
41789,0,250000,Mason Foster,ILB,dead_cap,washington-redskins,250000,2019
41790,177880,0,Shaun Wilson,RB,dead_cap,washington-redskins,177880,2019
41791,170589,0,T.Y. McGill,DT,dead_cap,washington-redskins,170589,2019
41792,167645,0,Cassanova Mckinzy,OLB,dead_cap,washington-redskins,167645,2019
41793,0,164945,Samaje Perine,RB,dead_cap,washington-redskins,164945,2019
41794,157118,1666,Ryan Bee,DT,dead_cap,washington-redskins,158784,2019
41795,151353,0,Cam Sims,WR,dead_cap,washington-redskins,151353,2019
41796,142118,0,Robert Davis,WR,dead_cap,washington-redskins,142118,2019
41797,136000,0,Jehu Chesson,WR,dead_cap,washington-redskins,136000,2019
41798,135353,0,Craig Reynolds,RB,dead_cap,washington-redskins,135353,2019
41799,112000,0,Timon Parris,T,dead_cap,washington-redskins,112000,2019
41800,88000,0,Jester Weah,WR,dead_cap,washington-redskins,88000,2019
41801,80000,0,Paul Adams,T,dead_cap,washington-redskins,80000,2019
41802,72000,0,Darvin Kidsy,WR,dead_cap,washington-redskins,72000,2019
41803,32000,39048,Adonis Alexander,CB,dead_cap,washington-redskins,71048,2019
41804,69354,0,Casey Dunn,C,dead_cap,washington-redskins,69354,2019
41805,64000,0,Josh Ferguson,RB,dead_cap,washington-redskins,64000,2019
41806,61941,0,Carroll Phillips,OLB,dead_cap,washington-redskins,61941,2019
41807,48000,0,Chris Odom,DE,dead_cap,washington-redskins,48000,2019
41808,0,40472,Joshua Holsey,CB,dead_cap,washington-redskins,40472,2019
41809,40000,0,Jeremy Reaves,S,dead_cap,washington-redskins,40000,2019
41810,32000,0,Drew Belcher,TE,dead_cap,washington-redskins,32000,2019
41811,32000,0,Deion Harris,CB,dead_cap,washington-redskins,32000,2019
41812,32000,0,Wes Saxton,TE,dead_cap,washington-redskins,32000,2019
41813,32000,0,Jordan Veasy,WR,dead_cap,washington-redskins,32000,2019
41814,29118,0,J.P. Holtz,TE,dead_cap,washington-redskins,29118,2019
41815,10000,15000,Chidi Okeke,T,dead_cap,washington-redskins,25000,2019
41816,24000,0,Travis Vornkahl,T,dead_cap,washington-redskins,24000,2019
41817,0,16389,Keith Marshall,RB,dead_cap,washington-redskins,16389,2019
41818,16000,0,Emanuel Hall,WR,dead_cap,washington-redskins,16000,2019
41819,16000,0,Cameron Malveaux,DE,dead_cap,washington-redskins,16000,2019
41820,16000,0,Maurice Smith,S,dead_cap,washington-redskins,16000,2019
41821,0,15000,Juwann Bushell-Beatty,T,dead_cap,washington-redskins,15000,2019
41822,10000,5000,Bryan Blunt,LB,dead_cap,washington-redskins,15000,2019
41823,8000,0,Donald Parham,TE,dead_cap,washington-redskins,8000,2019
41824,8000,0,Jojo Wicker,DE,dead_cap,washington-redskins,8000,2019
41825,8000,0,Darrell Williams,LB,dead_cap,washington-redskins,8000,2019
41826,0,5333,JoJo McIntosh,S,dead_cap,washington-redskins,5333,2019
41827,0,3333,Todd Rahming,WR,dead_cap,washington-redskins,3333,2019
41828,16000000,5400000,Alex Smith,QB,active,washington-redskins,21400000,2020
41829,12000000,3437500,Josh Norman,CB,active,washington-redskins,15437500,2020
41830,12500000,4000000,Trent Williams,LT,active,washington-redskins,16500000,2020
41831,10000000,5400000,Landon Collins,SS,active,washington-redskins,15400000,2020
41832,11500000,187500,Ryan Kerrigan,OLB,active,washington-redskins,11687500,2020
41833,8250000,1800000,Jordan Reed,TE,active,washington-redskins,10050000,2020
41834,6500000,2150000,Morgan Moses,RT,active,washington-redskins,8650000,2020
41835,6000000,2312500,Paul Richardson,WR,active,washington-redskins,8312500,2020
41836,4200000,1800000,Matthew Ioannidis,DE,active,washington-redskins,6000000,2020
41837,3250000,1921875,Quinton Dunbar,CB,active,washington-redskins,5171875,2020
41838,1790760,2141520,Da'Ron Payne,DT,active,washington-redskins,3932280,2020
41839,2046324,1643432,Jonathan Allen,DE,active,washington-redskins,3689756,2020
41840,2400000,900358,Dustin Hopkins,K,active,washington-redskins,3300358,2020
41841,1150301,2126202,Dwayne Haskins,QB,active,washington-redskins,3276503,2020
41842,2250000,859375,Adrian Peterson,RB,active,washington-redskins,3109375,2020
41843,1024148,1621593,Montez Sweat,OLB,active,washington-redskins,2645741,2020
41844,1450000,400000,Tress Way,P,active,washington-redskins,1850000,2020
41845,1697088,0,Reuben Foster,ILB,active,washington-redskins,1697088,2020
41846,1191099,503133,Ryan Anderson,OLB,active,washington-redskins,1694232,2020
41847,1035000,359375,Deshazor Everett,SS,active,washington-redskins,1394375,2020
41848,1045000,252500,Nick Sundberg,LS,active,washington-redskins,1297500,2020
41849,892903,345806,Derrius Guice,RB,active,washington-redskins,1238709,2020
41850,779000,242248,Geron Christian,T,active,washington-redskins,1021248,2020
41851,777000,206348,Fabian Moreau,CB,active,washington-redskins,983348,2020
41852,945000,0,Coty Sensabaugh,CB,active,washington-redskins,945000,2020
41853,945000,0,Kayvon Webster,CB,active,washington-redskins,945000,2020
41854,681451,250805,Terry McLaurin,WR,active,washington-redskins,932256,2020
41855,735000,154723,Montae Nicholson,S,active,washington-redskins,889723,2020
41856,660000,175908,Troy Apke,S,active,washington-redskins,835908,2020
41857,735000,69128,Jeremy Sprinkle,TE,active,washington-redskins,804128,2020
41858,585000,188583,Bryce Love,RB,active,washington-redskins,773583,2020
41859,735000,36792,Chase Roullier,C,active,washington-redskins,771792,2020
41860,735000,21078,Josh Harvey-Clemons,ILB,active,washington-redskins,756078,2020
41861,585000,162702,Wes Martin,G,active,washington-redskins,747702,2020
41862,735000,0,Josh Ferguson,RB,active,washington-redskins,735000,2020
41863,660000,67010,Tim Settle,DT,active,washington-redskins,727010,2020
41864,660000,38252,Shaun-Dion Hamilton,ILB,active,washington-redskins,698252,2020
41865,660000,18944,Greg Stroman,CB,active,washington-redskins,678944,2020
41866,660000,17267,Trey Quinn,WR,active,washington-redskins,677267,2020
41867,660000,3334,Danny Johnson,CB,active,washington-redskins,663334,2020
41868,585000,77706,Ross Pierschbacher,G,active,washington-redskins,662706,2020
41869,660000,0,Breon Borders,CB,active,washington-redskins,660000,2020
41870,660000,0,Chris Odom,DE,active,washington-redskins,660000,2020
41871,660000,0,Maurice Smith,S,active,washington-redskins,660000,2020
41872,585000,58721,Cole Holcomb,LB,active,washington-redskins,643721,2020
41873,585000,31960,Kelvin Harmon,WR,active,washington-redskins,616960,2020
41874,585000,24473,Jimmy Moreland,CB,active,washington-redskins,609473,2020
41875,585000,18644,Jordan Brailford,OLB,active,washington-redskins,603644,2020
41876,585000,5000,Steven Sims Jr.,WR,active,washington-redskins,590000,2020
41877,585000,0,Dee Delaney,CB,active,washington-redskins,585000,2020
41878,585000,0,Hale Hentges,TE,active,washington-redskins,585000,2020
41879,585000,0,Darvin Kidsy,WR,active,washington-redskins,585000,2020
41880,585000,0,Timon Parris,T,active,washington-redskins,585000,2020
41881,585000,0,Jeremy Reaves,S,active,washington-redskins,585000,2020
41882,585000,0,Cam Sims,WR,active,washington-redskins,585000,2020
41883,585000,0,Simeon Thomas,CB,active,washington-redskins,585000,2020
41884,585000,0,Caleb Wilson,TE,active,washington-redskins,585000,2020
41885,510000,0,Jester Weah,WR,active,washington-redskins,510000,2020
41886,0,0,Paul Adams,T,active,washington-redskins,0,2020
41887,0,0,Ryan Bee,DT,active,washington-redskins,0,2020
41888,0,0,Emanuel Hall,WR,active,washington-redskins,0,2020
41889,0,0,Cameron Malveaux,DE,active,washington-redskins,0,2020
41890,0,0,Jordan Veasy,WR,active,washington-redskins,0,2020
41891,0,164947,Samaje Perine,RB,dead_cap,washington-redskins,164947,2020
41892,0,78096,Adonis Alexander,CB,dead_cap,washington-redskins,78096,2020
41893,0,10667,JoJo McIntosh,S,dead_cap,washington-redskins,10667,2020
41894,0,10000,Bryan Blunt,LB,dead_cap,washington-redskins,10000,2020
41895,0,6667,Todd Rahming,WR,dead_cap,washington-redskins,6667,2020
41896,0,3334,Ryan Bee,DT,dead_cap,washington-redskins,3334,2020
